player_id,latest_match,joined_date,retention_days,location,age,total_spending
0001f4cd1d6a46758ac99d9ec08c6107,364,347,17,Asia,25,2992.76
0002b134ae784531a58545a2c8cd9228,48,29,19,Africa,23,298.18
0004909f34fb416e9e159181dc2bf4c4,249,209,40,South America,19,1188.72
0007b666ebe94db7a528988e1f2944d8,204,161,43,Africa,19,785.02
000841868c214033ba6739cb9a28df2e,365,349,16,North America,20,3148.04
000f13e3122c4ed792eca90c5e848355,332,290,42,North America,18,1861.72
000f3d8443e549fbafa4c9afa68c03f5,303,270,33,Europe,16,1952.08
000f78a079554cbf8c372f484819ced1,213,184,29,Asia,21,1263.56
00103bcca20f4ffeb55b192225289e59,357,321,36,Africa,24,1649.12
0012da83447245479b4afa953aa83ec0,133,88,45,South America,17,1022.72
0014427bcb264a989a33ef4124c1db30,213,186,27,Asia,21,1050.72
0014dabe5df649d8aea5bb2df8107985,159,143,16,Europe,21,1626.01
001731f9e14e4e39b7ee6ea1b50ce1f4,128,76,52,South America,22,533.71
001828cb4e434dc0b29152cc53fd1cc1,237,189,48,Oceania,15,763.55
001ac0a36f21461ba778688987a91ace,246,200,46,Oceania,21,1313.36
001c1e752739457c8cfca1b0bdb43775,168,118,50,Europe,21,774.73
001ca71dc40747ec86512ee5fefe39a7,325,295,30,Asia,18,2548.81
0020186fea7c43a89c6930a704b68277,78,38,40,Asia,19,376.43
0021a88b0fc34fc4b5eb92dce092ad63,253,214,39,South America,22,1682.49
0022c67eb02040329cafdcd4a8c12efc,193,148,45,North America,22,845.49
002700cc836b474e966c732426a21777,365,353,12,Asia,22,2652.66
00282cef81064c8fba04767a5abefd3a,247,220,27,South America,14,2463.93
002a3a76068f4ae79aa416de1f7706dc,134,113,21,North America,19,1097.26
002a3ae45490469cb3e8a7e67b6ee63b,206,156,50,North America,24,1302.21
002a4b4641b7459980f11e0d234fcb4d,268,238,30,Europe,19,2423.51
002b39708ee941a69e126a8c747fefaa,299,278,21,Africa,23,2422.62
002c0b85bacd4d5caa5ea96cf6b493e2,276,238,38,South America,19,2046.86
002c2658fbcb4e1693dd44084b29c5c8,263,221,42,South America,14,1178.21
002e1e8a23cf4858a17f8928630e50c8,43,2,41,Oceania,22,275.49
002ef630cf7f44bfb4e5e75e3d52b860,203,174,29,North America,24,1842.38
003040919fc24794a508088652e31073,168,134,34,Oceania,23,1183.17
0030de310e7f4ebfa8fea403b0cff36e,222,183,39,South America,27,1505.33
0033e51527004ef28ded899994def129,247,198,49,Oceania,20,1153.65
00341b78342b4ebb810bfcc730f6d382,186,143,43,Asia,16,467.88
00347bc4b5c94a669f1811338a3b8eb8,81,46,35,Oceania,22,668.76
0034aacc04f14a6d8da4920aa9e6f242,201,144,57,Europe,20,683.01
00370be9e4e5473c834352fb257ce3af,107,52,55,North America,26,522.07
0038e6258f464765a17cfd705d97e84b,147,115,32,Asia,25,957.88
003cf663371b47b98bdfd803ae68fd25,364,349,15,South America,13,2845.39
003da51c0d7142d0a518a382ec341d6f,77,56,21,North America,21,559.69
00414d3eb9cd492da1204f5d3ac083c2,101,57,44,Europe,20,309.16
00419a5fa67c405c861cc481e54d9b8f,282,239,43,Africa,22,1564.76
0048c1a481064418ac75d59666dee36f,133,88,45,Asia,19,698.9
004e4eefd4264734ad5bff432b839fc1,286,237,49,Europe,20,1795.46
004f38cce14f4226885e03b983b5db30,245,224,21,North America,19,2467.64
004fc919fc3d469ba3d54d7a9de722f6,144,92,52,North America,16,828.56
004fd97cd3b0426aafc2295642363688,326,280,46,South America,18,2017.31
004ff41baac349aa95e153abd3562d32,240,212,28,Africa,20,1756.38
0054d36ff66a42848739f06ce71963f1,365,330,35,Europe,26,1880.07
0054ef3b151742218924c166952b5f2c,293,250,43,South America,18,2171.69
0057000c5dbc4f07951250d3dd0483b0,365,337,28,Oceania,22,2801.87
00594c901b09407ab09cf1802f8d891e,142,110,32,Europe,21,1197.61
00594f62543d4f7ea00576fcd5d8d6b7,134,91,43,North America,21,630.37
0059e715c3014c4ca0c85e2fe57dc019,50,9,41,Asia,16,471.48
005c883963e24a9189bec7771a90a82a,293,237,56,South America,19,1259.72
005cafd8f8e64feb95b712d2f377877f,140,100,40,Asia,20,1051.9
0061c74f3c644a099b9b36cc0bd99cad,155,117,38,Europe,17,807.56
006556c0bc39413bbf791b2399cf71e8,365,311,54,Europe,17,2407.81
006ae6fbe457401fbc6aba216e90dd8d,71,26,45,North America,25,282.8
006e3bb67a1449e9a16e263a03d76c0a,210,172,38,North America,25,1409.22
00714675e04d4601a2f16bbe9bd9c81e,329,288,41,South America,21,2339.83
0073fcc681ad4fa48e63dcec62b308bb,133,98,35,Europe,16,511.3
00743cb7425e46cdb2bd0c1ac024dac0,363,347,16,Oceania,23,2336.67
0075ab07c4ed43fd8099c68d4b67c6c4,215,187,28,North America,21,1333.49
0078e50f23dd46f5b0de37916fe447fe,339,316,23,Africa,21,2440.04
007c3f82daef4682b8b0a9d63b04b47c,319,283,36,Europe,22,2133.64
007c4cbcac774932b79d105e9d284be8,365,345,20,North America,21,2094.91
007d39ca6bb14244866ff3951a372fbe,194,172,22,North America,30,1895.1
007e6dc595f44fb788e425076472bff1,193,141,52,Asia,20,867.88
007ef9b051e8494abeb9895181c9b14a,287,248,39,Asia,19,1417.17
007fae4c130e4f5b8083c52934b7840a,363,344,19,Africa,20,3158.02
0082275ae0f449f3bf1990a42aa0ae6a,204,151,53,Oceania,18,913.59
00824672a98348a4a6cda5f41b8de4c7,341,310,31,Oceania,18,2815.49
0082add90a3b49b995c457a0544a18ce,124,82,42,Africa,22,909.75
0082f4f2940d464ba06d42d3df02d717,365,350,15,North America,19,2359.5
00868d7b28bb4b9483659708fe0f5695,324,277,47,Africa,17,1678.59
0086d657ece0424f9562f99c2d64bce0,231,179,52,North America,24,1228.84
0087867faff3429f935329904f161520,362,325,37,South America,21,2814.73
008cd5973db9488d8c559bdaf50f8cac,319,284,35,Africa,11,2890.92
0090561bdbbf46548ae7f50fb5fef556,103,68,35,North America,23,711.47
0090f3a8299c42e6bf01fb11caed8ce2,283,242,41,Africa,25,1221.87
00941b562a864cc7bbb9a497754e96e2,309,277,32,North America,16,2244.7
0095c2d34ac243a089ba5b6b3cfca100,338,311,27,South America,22,2389.98
0096eb449c9144029c48fd374caf576f,363,337,26,Asia,22,2485.44
009957b4c18749a99367ded5251e7bb9,208,182,26,North America,18,1970.07
009bed3fe7ea4d71b3fb7ce652fffd2a,50,18,32,Asia,21,317.37
009f89e1739e4a39a22a613b237e68a9,309,265,44,South America,21,1984.65
00a184c8bbde4b879f7c8d20664b0c29,167,127,40,South America,23,922.18
00a1c2c711ed4290ab7ab84652dfc1d7,52,13,39,South America,19,286.46
00a36df1afe942d09be79b7b7c96ceec,228,205,23,North America,21,1940.13
00a6c31654924157a6aea78dbf662713,180,146,34,Europe,19,1085.6
00a9b6787ccc41ec9a9dfd467894bdf8,48,21,27,Asia,22,331.22
00ab713b34174090a19b04b0ec63928a,158,112,46,Oceania,21,1058.57
00ac6d38f1ff4a84b811429db08d88f1,76,49,27,Africa,24,427.53
00ad4b53e78548cdbb0870bdd31ff728,313,280,33,North America,24,1199.34
00aec6d176b440aeb369b45922ab529c,69,23,46,Europe,16,178.18
00afbef8120947e68c080b01dccd3f34,295,260,35,Europe,21,2584.86
00b014753ceb4df8baa962d0b57c3e7a,222,190,32,North America,22,1692.09
00b081755cbc4778a6809fce5a0fc6db,236,213,23,Africa,22,1636.59
00b16207206b4647b82f2418964b12da,75,46,29,Asia,20,560.16
00b4ed5d03834a88befbba4e74f09534,197,156,41,Asia,24,822.14
00b5329d84044808afcb18a05eb2c3a7,200,150,50,North America,18,1403.95
00b5c8498b7d4382aff565d08685adda,133,95,38,North America,19,913.68
00b7cfd4cf5d4ceeb1eb9df5b015cf3f,259,210,49,South America,20,1266.03
00b7f1948eed46a29afc887e0ae27261,188,166,22,South America,13,809.03
00bd6010eaa0482993342301a2d5d1a0,179,134,45,Africa,21,1341.41
00bd7a263559401a9119b6cc866752a6,350,293,57,Asia,22,1421.88
00bf7a1deeb0431eb965455771523be1,365,352,13,Europe,22,3123.89
00c32156c03b404e8e83da1197029264,158,117,41,Asia,18,640.07
00c35641c07b4c6ea39e3e8b696189f6,365,316,49,South America,17,1772.71
00c5d112a6ef4e928b9f54e23ae29b6a,278,233,45,Asia,22,1806.03
00c61798f4ff4c57852fcc0fb1ccb760,267,245,22,North America,16,2278.26
00c8afc7a9d74630bc6a41f79bfc65dd,365,360,5,North America,22,1988.09
00caed7c0b4c461483029ec07dec9ad8,228,179,49,Oceania,18,971.22
00cb2a6734de4f44bf1d35a6b8ab58fc,231,179,52,North America,19,1242.78
00cee6abe1da45249bd32e4e56e06a1b,231,186,45,South America,25,1557.07
00cff1f7f7304314b54a988fcdcc2318,72,42,30,North America,23,374.19
00cff6d233f644b49f3c3d70931bae56,319,277,42,Asia,13,2268.09
00d492d89ef949239dc682e13441510e,194,147,47,South America,16,1147.27
00d5f33881bd45409901743236b6ff81,160,135,25,Europe,21,1232.71
00d81d581d9b4cee8dcf37295d4bc564,129,70,59,South America,17,734.59
00d8e80073524d31ab628deba74c9ad3,307,283,24,Oceania,18,2101.47
00d9b49f87304f07b308b606bf82ad66,151,113,38,Oceania,18,842.99
00e012a4717c42f798b9bcd6190e9bd9,77,53,24,Europe,21,386.31
00e03568711440bc9358bca1b9bc94cb,186,146,40,Oceania,16,1548.74
00e126d4cc364498873ed18cee41dcb8,365,358,7,Africa,19,1445.31
00e1a34c76f2490f8ac2b92cb5b6878b,101,77,24,South America,24,801.73
00e3c5685c2f494082809c4a20127895,363,354,9,Oceania,24,1401.92
00e473ea716e4d5faa3552a0f1e55062,352,303,49,South America,20,1222.16
00e5351709c04c80bbe3a5e53c6f98bc,132,97,35,North America,18,826.59
00e5ab952ab844d2baf6da14530d7682,40,16,24,North America,17,136.21
00e998bc9739439785e7e6d205b15113,261,209,52,Europe,23,889.18
00ecc5e36dd240d487b7be167a1b25ef,57,12,45,South America,21,300
00ecf77ca70941a780c27bc29afeadcd,249,197,52,Oceania,24,955.79
00ef19e9f3bb492eb102a40251ce7be5,294,263,31,Asia,17,2730.71
00f0646471ad4592a34c0c53c7a7b0aa,364,337,27,Europe,20,1317.64
00f13fa500af412486f9317e06520245,133,82,51,Europe,19,499.29
00f1f2edb7e94c7b96d2b76ea1eaa927,126,100,26,Asia,20,696.13
00f36cd610fc41d6a01702c5bbfe4a89,115,69,46,Africa,15,561.38
00f43c7858e74d09811fc9e167556559,299,270,29,North America,25,2037.11
00f47ee36a69455099f6aceda083005e,330,294,36,Europe,18,2273.02
00f4e5d5d35542fcb173c40346b998d0,364,358,6,North America,22,2304.24
00f52417bfe5427e95e70f8388788bec,96,59,37,Europe,20,804.76
00f85f15e5704e9d919becbb4e33e63e,261,219,42,Oceania,20,1339.89
00f8e79267c94f24a86317b7920a63e5,338,308,30,Asia,17,3241.87
00f922ea7051443b96ec19873f414c46,210,175,35,Asia,19,1305.95
00f9b33ffe904aef8dac5629330728ea,268,233,35,Asia,16,1278.65
00f9f419c32a43df822d9664afcf6d8b,336,298,38,Africa,21,2703.01
00faa60644204afc85d2472a1726ed17,116,83,33,Africa,13,946.16
00fc49a287b4424785dc6cf5c0e133e9,363,332,31,Europe,20,2841.96
00fdd911faf04c418ec2751c468fb4bf,52,17,35,Oceania,20,223.42
00fe2e7113364b3d86c7be713615294b,290,252,38,North America,18,1889.75
01002086a4d74ee4a049f8da8a0c693f,179,147,32,Africa,21,1199.51
01003934414c4092839611e3f7855810,225,195,30,Europe,20,1153.03
01043a645c6d408780c2c64a6c0fedb7,260,232,28,South America,26,1931.05
0107a5a6456941a79542dd21d7b35fa2,273,223,50,Europe,19,1381.65
010adc8b5b3e4dc1ac14ed2e1221d389,167,122,45,Oceania,21,580.85
010b417cdcd4408e876a817433f60934,365,353,12,Asia,21,2466.08
010b90d66f8b41eb931d314adc56e871,85,43,42,South America,22,620.09
010df69c87674fc296f68bc34d00afa0,66,16,50,Africa,22,57.55
010efe2ee3cf405fb965d51e46de5bd4,63,38,25,Europe,17,389.29
0115ca89eff247918a5d431010a0c6e3,73,14,59,Europe,19,268.25
0116d662333f48dba0773cc8feca489f,80,49,31,Africa,23,804.63
01171d9252644d0caa18b2470ca08e5c,327,277,50,South America,17,2153.39
01175669a1db49df832f3820afbb93ee,365,320,45,Africa,14,2467.07
01186325f13f482487b1efe8c16395b2,275,235,40,Africa,19,2970.27
0118df955cb640a48e60657487b34829,335,286,49,Asia,19,1493.38
011b4206e74146a38d855e4d74f56509,139,101,38,Asia,21,629
011d1fefab4c4cde819edc420aef375f,365,354,11,South America,22,2027.46
011e611f4f264ade92d391b7045c9070,42,7,35,Europe,17,157.23
011e74044fa941268f439b6bb68d39cc,127,101,26,North America,25,692.52
011ee4cd02f6409aa963431adb4f9ba8,59,30,29,South America,21,292.14
011f11206532414d8bc775645b7501a2,88,40,48,Asia,19,426.97
011f8a913b704253a17e7327b45c544f,363,361,2,South America,21,2576.04
0120c1902aab4aeab5c8ea17392ab129,94,54,40,North America,19,741.32
0121959656c747908166778c8c45f806,88,50,38,Africa,26,597.1
0123b062364040e59598c6caae47ef29,225,188,37,Oceania,22,1271.44
0123bbcca1f54ef79e2fd41da292a830,363,350,13,Africa,21,2423.83
0126e6bc2aa54bfe978584129b35184a,160,124,36,Europe,17,1016.6
012b72b128f042ac8af8f674444f9d09,339,289,50,South America,17,1218.02
012bd594a8a24eb0b19d641d14cd144e,365,343,22,Europe,20,1825.58
012c934ced9140c0a37688616b987b6f,185,142,43,Oceania,21,1230.62
012ce0c7fc4e4b9793c92191748bd669,218,174,44,North America,21,975.62
012cf74483c64abc914121ec009e53a6,167,137,30,Africa,16,960
012d830993be48558d0ae9fb82195d7f,178,123,55,Europe,19,994
01315ca42dd14708942100f84ac44f2f,356,337,19,North America,22,3285.89
0132d989d7f044348661e3cdfb32475d,365,347,18,Asia,24,2836.11
01336b2dbc704554833c0247dcfadd2f,107,73,34,Europe,17,737.51
0135789d974f42cfafd31bb5af523799,55,28,27,South America,26,486.5
0135d6b186524b4a92a9e874bac71986,290,239,51,South America,21,1068.41
01368e112b0440c5bb653ca0a7db4f32,358,322,36,Europe,21,2222.08
0136c1875d4941099506167f950a92fd,303,261,42,Europe,20,1874.56
013829dcf2f342b89f2cf179c87266e1,93,73,20,South America,20,724.78
0138f5076f6d4339ad610e6f50c3d0d2,260,225,35,North America,17,1392.41
013d0c9f0799414091a8cec9b70927af,362,315,47,Europe,23,1837.98
013d0edcaaa04038ba9a75ee1f4ef40f,258,217,41,Oceania,17,1489.92
013df928265743ccb7e9f934c29a9355,293,241,52,Africa,25,1773.51
013ef4af07c64bdd8f4cb269bebef5b2,365,348,17,North America,26,2548.78
013f2a80ba5a48c4a4ac835d1015872c,290,256,34,Asia,18,1529.83
01407765da214aed88f1629682648969,107,45,62,Asia,20,677.68
0140f56f6f5e4753bcdb622c05627c50,284,239,45,Europe,17,2140.63
014240dcf1e64fb59426581716a8a1c5,207,158,49,Europe,26,1053.42
0142a9a49947487eac749b5575cc93ba,364,326,38,Oceania,16,1821.48
01445204313d49d9ae6524785b320992,167,144,23,South America,21,1079.85
0144672e53d641f784650ed0755fdaac,102,67,35,South America,18,664.13
0144681192f44d25a3d1d2116fdf082d,237,219,18,Africa,19,1961.78
01449ed5198b4512bf5433a60fcd5bea,309,287,22,Oceania,24,2203.52
014640f18da14f90ba602fbab8090278,254,226,28,Oceania,16,1922.39
0147a5e3a18748b3998ba7abc33c9fb9,134,82,52,Asia,22,593.3
0147be03a32141628264fd730dfe896c,196,168,28,Africa,23,1217.4
014c542798e34099b1a0c49dddcfa820,298,284,14,South America,22,1990.29
014e4922d6ec47d89b0fd9d862e21344,193,163,30,North America,18,1133.62
014ead086e874e54aebed2a3c1bf6c41,361,320,41,Europe,21,1825.65
014f32cdbf584565a2120ec744eaaa21,332,277,55,Africa,19,1811.37
014f389404814f03b08f638bf9f3d890,307,292,15,North America,25,1930.35
0150e5318a364d9b8386bee843c27b32,235,193,42,Africa,15,1874.04
01536da394f94c08a6dbb825632f0778,281,259,22,Asia,21,2655.87
015415d1e66841578704fb532863942a,153,104,49,North America,17,331.27
01553cfda09a4911ada172191bda3e2c,283,258,25,South America,19,2252.83
01588e5550d94e3ebabadde5a3e17e9f,91,41,50,South America,26,406.5
015a65a041cd4af29af4d59989156a4d,35,8,27,South America,21,364.49
015b67d94ccd45508d1df2125da21b24,111,77,34,Africa,21,500.08
015b72af7c394c1f9b254a1d8cd3a42c,89,45,44,South America,21,519.19
015b9a2a77ca40b68d6d485699523f95,342,304,38,Oceania,22,2173.51
015df855f6e742258f7d6dca6211c44a,108,83,25,Asia,23,713.68
01643cb1beb7463f893ce17151340182,319,277,42,North America,15,1281.35
0164db6de9ea4fb5b92136ff63158386,244,185,59,North America,25,1615.51
01653bf811d54d08868f81fe16aaa44f,160,135,25,Asia,24,1127.39
016682c055e64ad596cd0f0b361c4edb,327,290,37,Africa,19,2009.23
0167efa800c2481f8b6be1107c8ab653,313,275,38,Europe,22,1661.08
0168f2c5d2c143f6a73ddda479c31308,365,358,7,North America,26,3899.76
016af1b873b84957a02960a1f7aeec47,330,303,27,Asia,20,2381.09
016da3fa9eee48cdb2618673d731aea1,363,342,21,North America,16,2143.19
016f30870f3e4580b17b227c43bf1b8f,245,218,27,Oceania,20,2196.31
017290d240364d3dae6837c64177fe85,175,159,16,South America,20,1289.39
0172de03112240fcbd7fc7f56b8a59ce,193,174,19,Asia,21,1361.82
01744b11538b4ccdaea74d245aea2ffd,316,292,24,Oceania,20,2361.7
017a4ccb9cd946ccb9abbf941f4d47e9,215,165,50,Oceania,20,1118.23
017b49706e0944d5864a9dba7409ec3e,191,148,43,Europe,16,1226.19
017cbdf7d99f49259077a15623935831,365,365,0,Asia,19,2186.77
017f28d7ea47479dbebc9ac128ca8118,51,4,47,Oceania,14,306.51
017fb6c02cf345b4b58b85680ea627e0,358,312,46,Asia,20,1049.32
0180dd270d0c4320af3e8f559f3f1647,355,315,40,Africa,23,1965.78
01812259937a47a6930643e4730d38c1,244,203,41,Europe,20,1463.57
01837093cacd421fa03c4626ea948686,168,144,24,South America,23,1838.75
01839f0753804a5b8eb9d6b2910e28e3,91,39,52,Asia,20,498.64
0183b83f9b8b464397868b0458ec72c6,252,212,40,South America,21,2021.44
0184e50727f5443e8e9f8075d5a7919c,232,198,34,Oceania,23,1981.79
0186a066ca434bf4a6b1cfc8d52566bf,203,189,14,Asia,21,1805.67
018bf20f72c746059c56b2ea42daf99e,250,204,46,North America,20,1187.6
018dfcc35fd84d5da1e470e6e1a52ac5,365,328,37,Africa,18,1812.24
018e653225244cf196d179398069bed7,152,127,25,Europe,19,1131.56
018f1337bce54bf4ae8230075ee60257,335,301,34,Europe,20,2751.91
01902ba06fef4af0a28ae694a995f2a3,290,266,24,Europe,21,1781.94
01908f5bd8b04154a87d2c9a0a7f530b,91,37,54,North America,17,575.96
0191e6f29f204ff18be63341e7fe488d,362,326,36,Oceania,22,2311.91
0193286c9159400d96797dd07a13620d,99,69,30,Oceania,15,622.4
019378e8e82b4ebe9b7ca3e9baac58fa,212,153,59,South America,16,1215.99
019700e0b8a3467bb89c6f6c6753452d,197,183,14,Europe,22,1525.75
019746ee682541cd97a3f8e228638e5b,68,45,23,South America,21,554.18
019c7031631949e3807188ff5e535a3e,352,333,19,South America,18,3210.12
019db7b6821b46a5b8582311cc4b62e6,222,187,35,Asia,20,1659.44
019ee22437f2482693d014c624a7d28a,264,209,55,Oceania,20,1991.13
01a040dd453f4b21834fbce7ed99b50b,297,276,21,Africa,22,2262.83
01a0bd820ab54e92807af84b624e75f9,200,162,38,Oceania,20,1686.17
01a14fe6eed24a6db241b0d813ca6046,264,247,17,Africa,20,1965.8
01a495e8acae4adda30069c32c0cb941,269,233,36,Africa,17,1651.24
01a5a65410944fc5af1a0de893ef00c4,365,328,37,Africa,21,2343.08
01a67688ee2f4811932585060c628022,278,253,25,Africa,15,2187.85
01a70e08b9bd4898a6593e47024ba85b,114,69,45,Africa,19,325.58
01a75fdbb7d44abca788bb6fadcbadc4,337,290,47,Africa,24,1523.19
01ac0a4960d043d6861938aa75058878,307,290,17,Europe,20,1912.24
01ad308d304e4facbe9c9bee354eb35f,365,315,50,Europe,19,1545.09
01adc803879c4bf0ac55d102f2092460,148,104,44,Europe,19,784.39
01afe4e23c8d4a62810e0a16364d32ad,347,306,41,North America,22,1702.56
01b1237bdc6c479880a7f1ba38d54783,280,254,26,Africa,20,2178.39
01b34371c5c649b5885c7664aec9101b,362,355,7,South America,20,1708.82
01b47f34392e4eb19b59b2ddbc8fd68e,92,48,44,Asia,26,983.91
01b4c8bf4af0483eb7b8ef37cb87331f,101,51,50,Asia,19,645.98
01b7f2f6ca204c9fb27b8a9004c2e5d4,364,347,17,South America,23,2397.41
01b862ab4b324c29851d3db88a8daf3a,64,19,45,South America,21,118.28
01b95dd95c0543b99da480f49b97f616,341,291,50,Europe,14,1712.98
01bbe7a5733e43a1b06f30e1929f763d,136,113,23,North America,23,1257.4
01bc2bbaf06e48f5918768282c1e7667,69,20,49,Asia,20,103.36
01bd454ee83a487e83273d2052070ab8,304,274,30,Asia,21,2107.15
01bd7c6aebae447a81f918ca8210a073,343,326,17,Asia,19,1764.49
01be2e8e9df94a9891392333765b37e1,364,350,14,Asia,19,2368.25
01beae935d0742e0b18cde61a51d5f6a,87,38,49,Asia,20,581
01c16a7b2346474198335bda9fbcf471,133,81,52,Europe,25,730.8
01c212f66d264ff5abba82ad17a7f296,78,50,28,Oceania,14,751.27
01c31fd58c24407887ab7482caa0b655,361,327,34,Europe,23,2139.75
01c445654e9746368350497f11608d51,345,304,41,Africa,16,2321.69
01c7ee0ce0164963ac43fa7d2b4c7686,331,298,33,Oceania,21,2487.81
01cb33b55e8a4839957e23a6db94fb94,67,42,25,North America,18,493.18
01cb3e489bb04ab395bd50456570dfb7,344,301,43,South America,20,2526.59
01cbc8c61b114c499e35bf315d221934,121,66,55,Oceania,22,579.22
01cdce6437104c63aec3c1c2164c9b63,54,26,28,Europe,22,495.65
01d26dee62e04f86b8555f66d750cf97,115,90,25,North America,17,1062.39
01d597865e5f43c1905c6d7ded67ac73,246,205,41,Europe,22,1461.85
01d7ce960baa442589485bc64903a8a1,239,190,49,Asia,18,1621.04
01d7eef3a85943cd868932e4f0bb8dcf,284,229,55,Asia,20,1830.6
01d983e951b643c2befed5858e4f776d,77,43,34,Oceania,19,417.69
01dbccb603a24f06859177b33e10794f,195,177,18,South America,24,1502.17
01de0c3c4668409296c9f93752c0e1e3,345,310,35,Asia,23,1925.48
01e0402e1b934ab3b3147a3f9bd2ecbf,134,77,57,Africa,21,1023.63
01e05589dd3349fbb366ab2123229621,57,23,34,Europe,22,223.68
01e232447f714a0f92547b01f038ce3d,149,135,14,Asia,21,1025.58
01e2d6335a1d45c692df135c4a6b85e2,165,118,47,South America,25,1010.89
01e49178dcc44118ba5a51152f7dd07e,263,206,57,Africa,18,1668.29
01e541aeb09b441b946908b46717d0b6,59,21,38,Asia,20,249.07
01e63e4e55884db4ab4cb10d79079199,162,118,44,Oceania,23,713.7
01e763808390417e977967cde9952ab8,353,327,26,Africa,25,2428.49
01e7b0eeb03f4304b02fc4f219708463,207,188,19,Africa,20,1236.59
01e9a22d1c844410bb3e17f8559854fa,32,3,29,Asia,22,275.11
01e9a8a145e645a58345393f81d69573,270,247,23,Europe,21,1637.06
01eae6a009b047298cb60b159564d961,215,182,33,Asia,21,1724.25
01ec2a34ee4e42119a53584bcae9eb83,90,40,50,Oceania,15,625.81
01ecbbda01924e4a95d5fc0a3cfd55a7,219,189,30,South America,20,1549.01
01ed9c5f3e1f4c82bc391058605576c1,134,106,28,Oceania,21,1390.03
01ee984e501f44598eb354eb8503b051,235,209,26,Africa,24,1280.51
01eebb741e064309994a4e0265622e37,362,333,29,Asia,25,3934.36
01f579becdf340028180d647e9cafefa,266,212,54,Europe,16,1471.35
01f7059c7baa46a4acc1f55d7ede8964,154,103,51,Africa,21,791.63
01f79f4fb839466ebfe702ecdcb725ed,332,303,29,Oceania,22,2762.93
01f86b8c18e042a2938ace6f82159626,166,140,26,South America,20,1176.6
01f8f7094fc5407ba46b4df370cf0dad,306,273,33,Asia,24,2493.79
01f9f16576294266801b5bb5001db384,205,160,45,Africa,15,1345.64
01fce3a69af34496bcc6becc32a97d1a,364,339,25,South America,24,1853.02
01fcff46ce014580b242e6e2780d0d8a,261,206,55,Asia,23,1411.2
01fd76577bfd4d8a96f8f5e2cbfbb2b7,48,26,22,Oceania,23,359.79
01fe55d6f59d4b86bf4f7175bb359047,72,55,17,Europe,18,811.15
01feb588cc1d4bd89411b7cc327a76d0,283,231,52,Asia,22,1233.19
0200209a8a6e49418d3af58c091c7e79,325,274,51,Europe,24,1455.99
0200aba1faf844dba1e3afd9aedf26da,364,340,24,Oceania,24,2801.35
0200e279bd79445ea9f5739b080e9f91,156,107,49,North America,21,1054.07
020206f9aff7469580c9b1ed25f314a9,66,16,50,North America,20,414.74
0202f2f998c24ee1a19bfba2c68b0910,182,133,49,Asia,19,1068.18
0203b9276a1b47c08e3927b33effa9ae,311,260,51,South America,19,1905.42
020485430d3e40669f6217703724365f,363,346,17,North America,22,2994.45
020485c7aa19495bb7deea974452c969,291,256,35,Europe,17,1935.07
020510859b974304aae7713f0ecc40cb,362,325,37,Oceania,16,2251.38
020759ba3c3b4e128b956551ca1255ca,351,312,39,Europe,23,3207.5
0207c9629401421187be97b6e1bf4e04,109,85,24,Africa,15,723.73
02089c3730484a4290cd92471317e602,262,218,44,South America,18,1579.32
020900d4d32b4d4fa7df1fc13e0b54fd,200,154,46,South America,18,1072
0209b13536e045a48e502033e8e6e6a1,340,283,57,North America,20,2128.53
020b670a849a402081a6e8732d538929,138,113,25,South America,16,1419.51
020bd22d6d3d49759542947a17d832a3,290,255,35,Asia,20,2140.87
020dec8cb4d04f85b4ab1a866bc8dfd1,77,43,34,South America,17,372.61
020e5eb4f5c948ba8917b3d4a57a65cd,106,73,33,Asia,11,601.14
020e8143b5434896969f9a1052ccb17b,287,235,52,Oceania,22,1687.41
020f35c7549c475689249ce7f39744ca,59,12,47,Africa,19,199.03
02102ba3b6b44ffea41b8dc715f505f4,324,307,17,Oceania,21,2964.81
0210a34370514973b9e18d58fa382e12,258,212,46,North America,20,1414.26
0210b9e57db449a1b8189f6aa97162b8,214,164,50,South America,18,1218.25
0213181ab65c46359ff4e4282059b9c8,251,226,25,Africa,19,2272.22
0214cec38f4749beb91b9befac01d009,86,50,36,Asia,15,595.93
021679f29a8b49ed98eef3621c8a3284,263,210,53,Oceania,23,1271.17
021c90736dc3411ba039e2f8cd3492dd,227,176,51,South America,20,1305.41
021d9f85636944c39beff09452690685,182,177,5,North America,18,894.25
021e3225cef341daa54201177f23e508,223,194,29,Europe,23,1877.72
021e41aab9da424c9eaf63b9becc3428,244,215,29,Oceania,21,2646.16
022256e5dab046578554b6569fbbba33,194,159,35,Oceania,22,1569.82
0223311ac1fd4ac8a5e259b30f177619,106,86,20,Africa,22,634.1
02249e08815d4ec9b6a36cecd495b747,260,223,37,Oceania,17,1664.71
0225f53257444976a8e1bca1a8b7ea58,347,310,37,Asia,13,2356.59
02272533aa314579bb7db86a4223e230,308,259,49,Africa,18,1407.86
0228069c2d784384936d55e149679673,238,195,43,Africa,19,902
02285956884646cab898d9857e951b47,46,24,22,North America,21,317.69
02295daffc784c2f941b5203473b554b,171,150,21,Asia,19,1060.91
022bf4a8c73d45aa99065442544fea0d,187,132,55,South America,21,531.76
022f84f8635e4d718472bdef9158a6b6,365,321,44,South America,22,2470.68
023222d6762b422e9564de0aebbbb5fe,43,11,32,Oceania,18,265.79
02348ad012474e56b3c7d378cafe35ec,365,359,6,North America,21,2810.96
02349465c3274adb990413bd8085c7e2,349,302,47,Africa,21,1466.15
0234d640e10a496bba981321a8a9403a,261,206,55,Europe,24,1697.57
023661aded8449f1a70956e9aef81f2a,74,33,41,South America,15,348.29
02373100771140fbb29cc4bdfb3523fd,363,317,46,Europe,18,1828.2
023766ca3a3946babd48fdb974b3bb65,365,355,10,North America,22,2583.59
0238fa996ece4daf9620672588bffb79,224,173,51,Europe,19,816.16
02393fca639a4eabb16df46022cfdd53,276,244,32,North America,17,1630.54
0239dd7be90b4120ac34eab7232edcf3,35,3,32,Africa,23,102.53
023ac40cfd034be381983e50cb79cb91,61,37,24,North America,18,561.07
023bd0668b8c4240ae63a77b90678fd2,71,22,49,North America,27,581.35
023bf6ed6b4b43188776b38cd26bb366,173,130,43,Oceania,19,1225.73
023bfc2c2e814330aff1dd1ff4e59d4d,172,132,40,Europe,19,314.72
023c8a82d735450b8e210a9948c7ef39,244,212,32,Asia,20,1641.21
02438591bc754c5297907f00e4abfd6d,38,5,33,Europe,24,347.31
02453ffd76644d8fa7ec5edf1456653c,84,59,25,South America,22,646.87
0247b9c043024574b0175ab971cc1db4,159,126,33,South America,20,735.71
02482f76945d444caea1a462cf3937dd,315,282,33,Oceania,15,2227.75
024954b5104743a9b41bfdd8989a3ca0,49,27,22,Europe,19,268.25
024a75e86edc40ba905de74cf32be1a0,364,357,7,Oceania,15,2242.95
024e384114914ab9b5be2c780cdaffe1,40,5,35,Europe,20,191.65
024fa076f1b44ff08909965da30dfb2c,308,284,24,Oceania,21,2124.43
02501079710d434bba186ee82afac8fc,365,355,10,South America,23,3097.03
0250bfe074a84469a97eb0699454da2d,234,202,32,Oceania,22,2186.06
025194b09ad94c7cbfcd1d440445f22e,365,350,15,Oceania,22,1725.38
0251eb094d7c4063acb7d36a4c710612,296,250,46,Africa,19,1601.83
0252b2e3c98349bab8daa09a09c6ab70,319,280,39,South America,20,1749.91
0254fc2796c44b1b922cb3cbc55971f8,364,335,29,Europe,25,2607.13
0255379400d14270b1498b3e1a84aef4,75,45,30,Africa,17,943.39
02560bf58b1842bbabb2fd9cbf3fe39f,224,203,21,Europe,19,1683.3
02572f5934544dbb94f1aeb6cb1b9009,363,331,32,South America,19,2669.27
0257582eb48d4130af8049bd7a68b477,213,181,32,North America,19,1689.16
025831c3c89f4998a55c41c0842b0672,193,143,50,Europe,20,767
0259c85f73b44c849ed8994c6e90e721,365,339,26,Asia,18,2116.67
025aeecaa5684f7f8eb48c3d88a75fc8,334,297,37,Africa,23,2367.28
025b4d22167a444397fcceb903e4fff5,357,326,31,Asia,22,2521.54
025bf17cf0dc484ba48a0d67ee17058f,164,128,36,Africa,19,1236.97
025c13ab749b42d78bd9583e8b7a8950,364,353,11,Africa,20,1675.04
025f4d81183b466bb5814b4eb7bcf7ce,333,308,25,Europe,23,3409.2
02605b07208946459ad07d185ee11c52,235,196,39,South America,21,1648.57
02621904b1a7433888c56ae831cd9af6,188,143,45,Europe,19,901.34
0263851266e1478e925d34cef66c0a64,346,328,18,Asia,20,3082.86
0263e9ceae3e49b8866ccaccd3f90ba1,329,280,49,South America,23,1328.13
02641197928941a682eab312e4e8fbb9,45,17,28,Asia,25,349.85
02663dd4b46a4fb7930c40df3bcc9cf5,278,250,28,Africa,18,2269.28
0268131c1d264e8fbec72394ca91fa51,305,287,18,North America,21,3189.14
02693d6ce35a478d9e4ca0a609cf6b05,127,96,31,Oceania,19,951.5
026b2141760740d59a49902e8e2c88ff,309,274,35,Oceania,26,2015.9
026b22d0120e421aa523e34988bd033e,133,91,42,South America,24,620.62
026be9f24633493badd6af6fe84248d9,147,115,32,Asia,21,817.12
026df4ae054c4e20af2a18bbe7264f86,326,286,40,North America,18,1634.74
026e24cf3be44d10a531bebf70166de6,169,125,44,Africa,22,949.62
026f3a565afa45df91fe655847e2cbcd,128,96,32,Asia,18,922.25
02708929b3d047bd85d66e74a44fa477,213,166,47,Oceania,23,905.26
0270d2eabe2946c8b511ce83927427ae,248,222,26,Asia,17,2583.07
02711e8241b940ce82d93cee9b8aecff,135,83,52,Europe,19,430.01
0272a8f9d1234d8db1891f76c14c0df2,252,227,25,South America,20,1628.29
027323cd444c43b08acac012dae75e26,303,281,22,Asia,22,1994.11
02743cada3a74473a1f0d8f2a2ad3eb8,175,130,45,Oceania,22,942.65
02765a5dfdcd4095bccbb73d0517737d,267,220,47,Africa,17,1290.51
0276ccd95ba3421181f3c20085d1bbf1,365,350,15,Asia,22,2183.26
0277c3e07fdf4524915ee3c2beb663fe,364,350,14,Europe,20,2571.4
0278d05610cf46fca37b411b2af86b86,133,89,44,Asia,14,1087.71
0278e70bf0b1420daf9c1436322fab36,282,240,42,North America,19,1818.49
027a11cd48ea424799e6f1852f06b642,347,310,37,North America,18,1362.35
027a521f3fa342fb997a3d4e9adf183d,137,92,45,South America,18,565.64
027d2a6d64b14042adede28e27d44f9f,351,334,17,Europe,19,2830.77
027eb4d6d9b44aca939c274cdd4936bf,138,93,45,North America,19,718.3
0280aefe893a4adb9df8a793551f3fc7,186,158,28,Africa,14,1048.67
02813f5adf954fd6b097079443e1d202,224,171,53,Asia,20,1623.45
0281a881751244e787722595ab982ba2,45,17,28,Oceania,21,183.01
0281ff6ccca742c69d2385dd5aac268d,101,59,42,Africa,16,826.9
028357e43b344ed9bd6210838cad7f25,93,50,43,South America,18,526.13
0289a2d8031b4cd49742ef2bf347a3fb,102,74,28,Africa,18,1003.27
0289d0be95d146e49d36144ad97e7ba4,45,4,41,Oceania,23,334.73
028ad6e07fcb481baa6c364ecc8e16cd,217,182,35,Africa,22,1886.84
028b86c458f341039573feecd07b6e82,101,76,25,North America,21,807.17
028c461fab854348baa19d6e6c465979,256,231,25,Oceania,20,1746.5
028de14e2a02479580c3f0cf8b98108e,45,25,20,Africa,18,163.58
028ea54e0f584a37803f04249637bf83,194,164,30,Asia,19,1595.83
028fd5ada31d497b97e95affd23145ef,356,346,10,North America,31,1644.66
02905a5887824cf787d5bc76af80c7be,365,344,21,North America,21,1936.53
02907ac95c4a441fba2d965eda46113e,219,163,56,North America,16,1139.86
0292b9f6834c40c7840f9abca557d1f3,318,286,32,Europe,22,2539.75
0294d770958948cdb0dee6ac43b737a5,365,341,24,Africa,22,1589.94
0297cb3811974b9dbeb5b5da12b6f8ba,102,56,46,Oceania,18,374.66
0298efba0408402e80da11c00c70f9f1,294,267,27,Oceania,19,2305.88
029abd67c363433289ee4a5a9cb2a437,56,6,50,South America,27,348.5
029b0734e1c84215963e9d34517c69fd,123,88,35,South America,22,812.68
029b2268ea104b6db1405f577ea77ece,242,207,35,Oceania,26,1825.54
029e2f630c924f19882e486053f0f71d,289,261,28,Europe,21,2392.48
029e546baf754e83abf5aecaf93cd5f2,269,232,37,Asia,17,2154.52
02a0cc09ffa346c992a9cf4571e3085b,348,310,38,Asia,25,1512.81
02a15581ed8d41b292cec1eebe7c4cd2,356,312,44,South America,24,3045.93
02a1a568738d457084477ade6a36fa89,174,146,28,South America,18,1219.52
02a375c033044d70a45c011cf1fe3fe0,361,333,28,Oceania,19,1608.65
02a3d0509ca042a0985720418f5c890f,359,356,3,Asia,17,3069.19
02a48befcaf14a9187b382a6bbae4e08,351,295,56,South America,13,1436.63
02a5229986154bb582f1d05229b3ad30,205,156,49,North America,17,1148.27
02a6fdfdfbba441ea1393e87ef74400d,174,122,52,Europe,15,606.07
02a8d2b0d0a748eea107cdb3a386323e,134,96,38,Oceania,24,1042.44
02a97a42238b468ba26b2b26bb2883b8,167,139,28,Oceania,16,1271.41
02abf4e495634129b81a33f3ca9d63fc,66,16,50,Europe,19,579.17
02ac87c6c02245b1a4364d6a675bdfba,253,222,31,South America,23,1966.13
02acbbd954b746b88b0ab983778a28d4,350,331,19,South America,19,2684.58
02ae1177fb544a308ca6bf23eb312ea0,95,69,26,South America,19,381.95
02ae3a34f1294a25be63047968f4d4b6,131,103,28,South America,26,748.71
02af39fb3c824d52b5d31f235f49a6dd,331,300,31,South America,19,2906.87
02af4557cd4f423dbecafed6e7cba1aa,328,280,48,Africa,19,1734.23
02b03adf13084810b6136ad7bde4fea9,93,77,16,North America,18,476.05
02b19e7983c04c5685a0d3a112dedbdc,219,187,32,South America,16,1816.46
02b2c107a6974fcf9e679025a3999e91,257,207,50,South America,20,1429.92
02b5b7bce1764c24ace52adc63c99121,193,147,46,Asia,18,1147.35
02b67dfd6522495d8fc0a3bc8890ed2b,156,107,49,North America,21,860.44
02b77db4d8f94ddda1b60e211e0702d0,282,224,58,Europe,25,1387.85
02b8c78b0a2a44cdb3452c50d8f916ff,229,200,29,Oceania,15,1932.83
02b98cbef6e34f8b9eb64160094dd42c,349,299,50,Oceania,21,2013.89
02bac73a1a5a4f3994b0d24b261b6f5d,307,281,26,North America,16,2297.54
02bfb975f9bd4b15a2e90d9f02619c3a,241,209,32,Africa,23,1463.73
02bfd17c39824788a8474eb329136e20,96,38,58,North America,17,480.58
02c0ac8c84fe4730b559e370f26a2d3c,365,346,19,Europe,22,2555.89
02c12f46efb746e9ab8d606a2d64d720,140,101,39,South America,19,752.28
02c26758aaa24987b61ef1c60feedf20,218,177,41,South America,25,1762.69
02c32c89f406460fae36618705f5183d,352,322,30,Oceania,18,2987.12
02c5086a78064ce1a09f8e331fe5bc03,342,313,29,North America,22,2187.05
02c7fea52de645b79841e6b06f5de6d1,145,107,38,Oceania,20,869.69
02c937dbfc0f4437a470f54f8c28386f,212,182,30,Oceania,17,1718.18
02cb20a8755045e39739fa9e753c27da,365,331,34,Africa,23,2019.56
02d1487d36744125839331dae80a5d19,365,361,4,North America,21,1883.26
02d22eb9e2ac450e874c58e3e0653f00,71,44,27,Asia,22,797.17
02dde530ba724e5dbdec4c89a350efe6,176,126,50,Europe,25,682.02
02e24c6b1e34476d865d9823d21cc001,172,121,51,Africa,22,980.68
02e26e0b73c84dca9848a97730a84aa3,227,172,55,Asia,19,1028.74
02e2a949780840cea4236be503202eb8,280,235,45,Europe,19,1544.84
02e9676114674694abd7732e4d7e4768,355,307,48,South America,18,1968.74
02eb90c7f2574121b61699920353aa54,186,160,26,Oceania,18,1398.29
02ee2681ef7f499ca771842973d186b6,86,35,51,Europe,21,454.53
02ee281f98cf4b77b5adef7e7facac2a,178,128,50,Africa,21,795.96
02ee331947e24ef18cb3fd3e35bd2382,363,318,45,Oceania,17,2686.97
02f188daccb545bf8dded0e94df69b1b,123,78,45,Europe,15,736.48
02f18b3c3897459d9d61b8f282da9044,228,214,14,Africa,19,1808.93
02f2a2725bc84d7b8d5bccfd3b4465f4,365,332,33,Europe,23,1966.27
02f2afe2e639431cba75a78a61644882,230,176,54,North America,21,1103.13
02f2d88f808f49fdac8a1ac90b8c5d38,90,45,45,Oceania,22,397.28
02f30d8228d94defa60a7e3fe3918b96,162,111,51,Africa,21,1402.65
02f44acc8ed043f48daab044451e1a67,348,311,37,Asia,22,2407.55
02f4aa9c92d94eec8dd65d00a5f41242,125,88,37,South America,14,438.21
02f4f746c40e4afc8084513a2b128164,332,275,57,North America,17,1585.92
02f6025fba7c4e038eb5594ab06f6cc4,220,175,45,Africa,21,1556.36
02f653caf3714fd29f7773ea082f70f0,299,251,48,North America,21,1828.44
02f6f8bc5cde4d28b26bb67364c53b60,165,126,39,South America,16,997.64
02f76b17c2b04bf987360267a5c5a748,298,261,37,Europe,15,2336
02fa5bbd800f4e8d9d798bdbcda5ab75,117,73,44,North America,20,472.58
02fa61b4e63548c8a48c85fa28ebe229,165,121,44,Asia,18,795.11
02fdb12adf1242bfb4b94bb1d3e8c6bf,295,261,34,South America,17,2466.68
02fe9a243ea34e41aa7555f452542c07,202,167,35,Oceania,24,1335.14
030004607d7740ee90378e9998c0acf0,182,131,51,Oceania,17,548.7
030269063f844442afb8c1cdddbd5bbd,190,153,37,Africa,19,1233.74
0302eadd95f845aba692d448798783fd,204,169,35,Asia,23,1263.61
0303373ebb4745c2aafed7631a339902,362,327,35,Africa,24,2823.29
030437007119473c94c9789e3aff451c,251,203,48,Asia,21,765.67
0307e0d41ac748bcb2c7ada257fd1e7c,88,58,30,Oceania,17,756.99
0307f1f9c0a847c6b7e24082a3d64791,287,232,55,Europe,18,1560.27
0308d072af3c4e2298d250d6ff7b26b6,284,245,39,Europe,19,1796.47
030bd549fd1c471e8755840f7ceb40c4,99,78,21,Oceania,17,1013.28
030e58683fd1471a8f37fbf3bc6dd1eb,179,139,40,South America,16,1235.72
030fd3644802414c91b775e4c1be4056,158,141,17,Europe,15,1129.58
031196363cc64a319b22e6a9bc164fe7,174,126,48,North America,23,582.74
031404f6d9034a98b83c9a153a91c3d8,310,266,44,Oceania,23,1651.36
031470697ab749b1be80f9821f8cf16b,345,311,34,Oceania,16,1144.82
0314c77515cb412dbf7d61a3cb94974a,203,158,45,Europe,29,1159.24
03170d9321d549cf8d175c34284bdb5f,91,47,44,Africa,20,493.55
03184eced9a84673b5ba964a0077945e,365,363,2,Oceania,18,3242.8
031916af7d134223bfe78df7415b5c9f,253,219,34,South America,18,1466.24
0319ef7cb11f4b1d8d11ff92626eb3fe,185,129,56,Oceania,23,846.72
031a92acee3747c7882c4aa265f6277e,158,111,47,Europe,20,804.04
031acd9f83d1494aa04720bcf3a8a071,84,35,49,Africa,23,375.41
031b1670fe3e4014bc1cd4e640d532d6,192,157,35,Asia,20,1406.11
031c9782aff14e149c33f0e17ae9f26f,266,246,20,Europe,22,1913.63
031dc780938043cda32941f784c56bb0,364,353,11,Asia,22,2486.87
031f87f836e044b39194d27fb601fe5a,262,213,49,South America,22,1314.92
031fda2080fe4fb7af6710005714fc40,355,328,27,Asia,23,2424.22
03200ffc8f4d47978848a5c37b9d4746,134,96,38,Oceania,23,387.72
03218d15acd64eb898e873f2063f60d6,341,320,21,Europe,19,2332.31
032247b3bda14c26baa7a10173b13449,364,358,6,Oceania,25,2321.97
03240cf9d8184b6399283f0fe5a1ee59,364,355,9,Europe,18,2164.77
0324a489a2134bdeae58c06c086d447a,62,16,46,Oceania,16,432.05
032676bdabdf4952b5416ae32f119fad,233,182,51,Asia,26,1506.83
0326936316784b8b8103f09ddd37f163,112,83,29,North America,13,1145.66
0328c6731a7749d993a954baa92613a6,262,221,41,Oceania,21,1513.65
0328ff69e34443bab12e246f066410ea,153,108,45,South America,18,508.93
03295c6ef448481da6a6dff4241d9b72,72,55,17,Asia,16,397.96
032afa2d88284a9a847e3f1144ae7863,294,261,33,North America,23,1611.65
032b2de4a64f472dbf3ff7d80da282c0,137,96,41,Oceania,20,1054.7
032c5f3d7a6d42cdac7f89435a40a5a1,202,164,38,Oceania,19,1370.73
032c6d86a4e246cab27abef63ce6091d,364,327,37,Africa,19,2835.94
032d3e4e5aed45b290ddff6dc634ddd3,292,253,39,Asia,23,2156.11
033042336ce24c4584436273a28d2d4e,355,316,39,Asia,17,2226.13
03307f2bcbbf421c993334e61835801b,70,49,21,Oceania,15,573.77
03337ece4e474980a4c4438206878dd0,145,101,44,Europe,18,802.55
03358fce85f14c33aedb9b86e0e2dfc1,213,182,31,Asia,17,1260.77
033830ead33a4b499ce952fda99f1510,70,28,42,North America,21,302.38
033b6cb45e344c08b7aa362a8707954d,61,41,20,Africa,24,147.53
033fcb833d614fdfbeb6c3d2bd91c2a5,224,179,45,North America,22,1517.41
034155a797f8453b97e56f7866203860,158,110,48,North America,22,732.99
0342adccfaef41ff8fbe616ca070e587,105,62,43,Africa,21,865.43
0342b82a69c440d08fe00460601fbe54,139,94,45,Europe,17,693.14
03436e641b484b309a6c7badf8bf89be,96,70,26,Asia,24,653
03456c7421b44c68a93ad5e7e5b1c3aa,46,26,20,North America,18,430.62
03468477d55a4b098f18a6c1ad8580b1,49,13,36,North America,22,598.36
0346af8d14524775bb5ceed95188d76b,121,87,34,Africa,19,655.45
0348740fd1ff4c6eba6bcb78ab2fbd7d,231,177,54,Africa,19,1248.34
0349392783aa4103b6471321ebdc021f,362,336,26,South America,14,2110.4
0349891c0bf347ebab42677d9847b93b,134,89,45,North America,27,568.85
034aaa116844467884532331004ce988,116,73,43,Asia,19,1136.82
034af1eacedf41f896714a2d21323922,76,46,30,Oceania,19,375.16
034b7fb714ae4009b82de8d7b24ed987,354,332,22,North America,19,2479.53
034c74c5b83d420bbbd0cdcbc330bda2,330,289,41,Africa,22,2737.1
034cf8f670d841b0b65c64ce7ad13fdc,204,180,24,Oceania,16,1506.25
034fa48790c0498eb3bd08b0a068a4d4,317,274,43,Africa,20,2055.76
03500d8cef8a414a9b400179e5ed9b9f,105,75,30,South America,19,954.12
0350a0cdeee545c08632caa13dbeac2c,263,241,22,South America,22,2424.2
0351fd5f622842c2b4e3d64cb3ee7ef9,161,113,48,Asia,23,800.65
035210de9cdb4d6894f88dec73817373,71,28,43,Asia,23,516.78
035232f0d03a4d5282084e3c80a46cb1,361,327,34,Europe,22,1622.64
03548cce3d7249609c0cfb57d9ac7a43,300,269,31,Asia,15,2589.57
03554ea27bac43b3a7ebbd1f78b7dd74,350,298,52,South America,21,1939.62
0359e5a02eef435fb485b4c266f53920,280,232,48,Africa,21,1602.39
035c103d047d4b38a2b3dafe9e13174a,299,269,30,South America,20,2368.49
035c4ab76df2485eb1f197e11fe88b90,300,243,57,Africa,18,1478.16
035ed4dbcc9a48628ec08f70571d5812,364,359,5,Europe,19,1973.88
035f216b0fea42a389a12aa1dcc6fbfe,217,184,33,South America,20,1603.21
035fe7266b5b409495afe3a6a5f47d4f,281,229,52,Asia,20,1561.22
036138a8efc74e529df7276d579c201a,244,210,34,Europe,20,1765.1
03613b3e75ff4fbab5ee668adf85f79d,358,336,22,North America,22,2856.95
0361d88341c140bf897644d0044cee9e,137,109,28,North America,18,819.36
03626d18697d49f4825a617a1d832d37,150,107,43,Oceania,20,1199.93
03639cc040f94293bfe79786a46d2f62,365,328,37,Asia,19,2218.54
0364412a508549d68f8917a3a6ff8304,223,190,33,South America,17,1757.5
03654ff991b941aca574ae2fd4c50dce,293,247,46,Oceania,14,2120.5
0365a352a37e4002ba38e3c28dd9fbb3,83,56,27,Asia,26,586.67
036657a7c7044ad68f55a5d76659965d,251,207,44,North America,24,1575.94
03683e83d88348e685e6be8e50834ae7,93,58,35,Oceania,18,690.53
0369cceb90eb415a91c8d5f736a85eae,196,176,20,Europe,20,1441.69
036b9d7d7fb34a29bb3efabd5e24f535,310,271,39,Europe,13,984.74
036fb45bd3fe4f9698e5a4ed67691eba,209,183,26,South America,16,1368.24
036fc5ecb7ff45529e005ea180c86e8a,231,193,38,Africa,25,2050.69
03718cdb84f646f48f8aed866f7fb833,358,302,56,Africa,16,1282.87
03720d7cfa1f432e98bb8eb19bf1997a,243,187,56,South America,22,1160.58
037406bec6d544239f6fefa2db8bfeb5,185,162,23,Africa,23,1179.66
037a64c3a5884df6924c1d1d3b336da3,97,55,42,Asia,18,1025.19
037b2ddab0984f62a25d79110364eefa,194,145,49,South America,21,1191.06
037ba34994204324acdfb49bd6025fde,209,160,49,Asia,23,1046.24
037c071ea83642738aca14ae839a31b7,364,361,3,Oceania,18,1429.66
037d3e8ed9544a4ab11e12a0548aff9d,34,7,27,South America,19,98.83
037d41cf95634d52814d69cc0b07cf35,274,245,29,Asia,23,2023.86
037ddf1273c64b59b42a4bd5808ea391,351,316,35,Oceania,16,2439.71
037f620d258c4ca8ada141bcd3f83192,92,61,31,Europe,20,531.38
037f854ad77048ddaff075fb71ae67f2,343,306,37,Europe,22,2643.91
037fd83151b9482187979f1912f84d08,193,159,34,Europe,20,1549.91
038128291c6d49c1a0806b1fe19a2ffa,74,34,40,Asia,24,366.38
0382b609a96d4001a14fd69c460ab1ea,123,78,45,Africa,22,873.33
0382bd007c0c4a3da077c1c1bbff2db2,130,101,29,Oceania,21,643.95
0383a75262b54eee8546ab255cf5d890,333,305,28,North America,23,2319.67
0383ef53d3ec4d9d942398692d80d2fd,220,191,29,Oceania,15,2350.02
0383f8c548e34c0ba4f55dd6b0d48f03,262,219,43,Africa,15,1802.8
0385efec27c94093b84eb3e17ccba83e,103,69,34,Africa,22,539.28
03869c82a20a42108b255e4e6c76daca,293,240,53,Oceania,15,1201.98
038726a9f80b44048b67dd800b5f3ea3,62,42,20,Asia,23,365.95
03895e65beb54aa2b2c380a2c274afcf,268,217,51,North America,22,1224.38
038af7286a9044bbbaacc9fbbc9a2d51,336,294,42,North America,21,1658.57
038cefb0f2be4a82ac2214f8e7c73091,365,340,25,South America,18,2859.06
038de06c94c84bb3b9b115034c9ae015,364,352,12,Asia,17,1719.13
038ed7a7217646099602fe00a9f7df01,110,74,36,Asia,21,648.54
03928bdf6d0a4f2995310fa3a8f1a49e,365,354,11,Africa,22,2309.89
03969735cf1f45949d73322a30b839ef,125,74,51,North America,21,463.87
039a6fe22d85474abadbba4d6b70b71d,274,259,15,South America,18,1859.67
039ad8f5f519481a8de9b9d47cc0e1da,353,331,22,Africa,18,2831.93
039bf9b087644ccfb8d05ed36c036f98,365,345,20,Asia,24,1316.94
039e6292bf294c8ea1f5514c79765acd,295,248,47,South America,19,1368.09
039ecfed2d0740f9a379a21a4402813d,160,121,39,Oceania,19,1216.98
03a10597f73e43ea8f28f891dbc2afa9,134,81,53,North America,18,888.34
03a45c85982e48b4a690cd7f000ad085,363,350,13,Oceania,15,3192.29
03a66595a808446d9def5c30375e3afe,72,39,33,North America,14,479.7
03a77a96a4b44967bb3e64dd22b2d415,84,60,24,Africa,18,671.92
03a83bbd6ce74ae09264a2a241039ae3,40,21,19,Europe,20,315.95
03a8eeecd1e847ed869bdab5e3c00b36,323,284,39,North America,21,2389.02
03aae5b5082349ad9a55a80a31189cda,364,345,19,Europe,14,2562.71
03adc93c3d9e4977927bde2c4f1f1e4f,307,286,21,Asia,26,2383.84
03ae4e20a45d433eaeba2f8ffddb1d2a,293,261,32,Europe,19,1873.63
03aeff2b05304f10b93626204cfe60c4,127,87,40,Oceania,17,942.39
03af1f5db3c84616b1f636c10bdd2a48,108,52,56,Europe,23,709.21
03b1677583f644c98fbeabd2dcf9c075,108,71,37,Europe,16,882.85
03b1eaa6220144639983b3ab7e1613e4,282,246,36,Africa,17,1722.36
03b1fddd02be40b282087da1fee41729,61,18,43,Europe,25,343.19
03b26feb3c1e42898daef92eecafb600,188,170,18,Europe,21,1349.57
03b8693efaec4c358a5df6e015295f28,85,55,30,Oceania,19,903.53
03b8aed34b984af99ac8e66959e4ed5f,214,160,54,North America,20,968.42
03b91ea7bf0648b98130f927b50ff77d,47,26,21,Europe,18,234.6
03b95fa2446a4a3eb27b65d0a4e45c68,203,172,31,South America,26,1459.77
03b9d78218db4dc1b7417af265add78a,344,297,47,North America,23,1467.99
03ba4219d55d40e6b40e371770d2579b,251,218,33,Oceania,25,1924.75
03ba9d51910845cc841b7a5f00d5e318,65,43,22,Africa,19,278.59
03bcf308494f435ea8bf0544c427102e,303,282,21,Europe,13,2233.53
03c0a8f2667d47f399ebbbe44a3b8a0f,331,312,19,North America,22,2671
03c0b5384e58417698d749280aa12ac6,155,109,46,Oceania,18,603.87
03c1b5b455c2457686d1c05c7fc2d996,291,257,34,South America,25,2328.53
03c3700a98ea4198b8fea8a22166a723,287,252,35,North America,20,2200.58
03c4280134a545a6b2ef1a2c55fd5edc,305,262,43,North America,24,2551.79
03c5c532dc7444c7ba9b39a4ced391a0,101,51,50,Africa,15,736.74
03c8a01b3c594ee6a2e3882a6600cb90,61,4,57,North America,21,134.95
03ca85c6855741b8a2010607da3f259e,171,149,22,Europe,15,940.99
03cdb6dc18224e91afe4341fbb7d890d,188,139,49,Africa,19,1210.32
03ce9ab1e072409aaf3f00aef056f6d0,294,277,17,Oceania,20,1848.77
03ceef5651814c7caf8f8ecc1db368a4,161,128,33,Oceania,19,1067.5
03d02e134e7445b7848ce97cf07052ab,252,225,27,North America,13,1570.82
03d0b20d435847d29f51e72b2b502ebc,363,347,16,Africa,17,2735.26
03d2863717f149a9a2bc3c0c00ced7ee,61,4,57,Africa,11,150.74
03d2b034587043a4a86c6b6fc6435903,191,148,43,Oceania,24,989.2
03d40701d8c044c5af7b993e55298a41,234,190,44,North America,19,2132.96
03d4c21bc690460cb76164e0debb7533,43,4,39,Asia,17,102.99
03d69f87ac0946a9bf1a897acd8b5741,342,308,34,South America,20,2652.08
03d6d25ea1ee4d0e9ad887097e024aa6,244,226,18,Asia,19,1985.44
03d7dd139d2a49909937eb26afc08710,289,231,58,Europe,24,1584.45
03d8432e0f554589801d037325e4dbaa,122,96,26,Oceania,21,945.47
03ddf1366f9e44b78066f1169fa4ed4b,122,90,32,Europe,15,738.84
03dfe6bf7acb4e93ab4be7d2af2fe989,355,319,36,Oceania,18,1750.61
03e0643f1b7543bbb2d261f8a5c9e504,364,352,12,Africa,22,2382.27
03e083211d80472ab92efd1475b9161e,66,25,41,Europe,20,433.56
03e0e04d2b9e45cab54960074ef58066,365,330,35,South America,18,2032.96
03e229a2b56b4aa595c92561dddce0e9,272,224,48,Europe,21,1558.28
03e29d22d6a04f459e566b0e1658fc6a,309,280,29,South America,20,1446.9
03e41e19702041cebc5cc0cd560a714d,188,151,37,Asia,18,1234.37
03e51a204ea74d018988282056ae67d1,349,325,24,Europe,19,2611.57
03e5b968a9e94e13b08e40871d9d11e3,243,220,23,North America,20,1678.74
03e8a86ad36c43bb8aa156940cbdf4d1,120,88,32,Africa,21,1301.06
03eb8bbc1c094829841ef95b50fe6d69,200,165,35,Asia,21,1558.04
03ec93604c9d4b4ca61b0fb56c3c6ed8,183,138,45,Europe,22,1813.47
03ee52c754004005a365eec51fb3e33f,131,93,38,Africa,15,591.88
03ee66ab599548c9bf4cd0745e5e5ccc,358,318,40,Africa,19,2359.13
03f0a09d9f42467ba8bc81ef3fc0f5fb,96,45,51,Asia,24,859.71
03f4ccedb0644546bd7595277d83519e,265,220,45,Oceania,21,896.5
03f850e3831949058f4ab9ba0a5d8816,190,137,53,Oceania,17,1395.38
03f993e59e224288aef58321c3b7504e,272,222,50,South America,22,1788.67
03fa71fe5c2944f5bdd110886ee30f29,259,229,30,Africa,25,1933.42
03fab9e8a01d4cf987e155312ff7b11d,251,212,39,North America,18,1743.52
03fbad2d59794f928b571a40bf81fb94,36,1,35,Oceania,23,216.31
03fbbeb73ef24d0892bc145b2e0dacd1,255,208,47,South America,17,1354.4
03fbc61cf0664e398a4c17c0dd85872f,365,343,22,North America,18,3014.21
03fce2f5d78445f2b45afa7328f5ddc1,114,71,43,South America,15,315.82
03fdd2efbdac46a9acc1c273636977e2,326,297,29,Asia,16,1836.22
04030d11ae0c4214868103baa00ab5ab,288,231,57,Africa,21,652.75
0403219f89764e79908a98c364629206,362,354,8,North America,18,2037.82
0403771dcdbd4b4c81b5d110d9cf9915,201,163,38,Europe,22,1557.7
0403ebc5724b4aec9f03335eadca8c04,365,339,26,Africa,19,2452.95
0404317ea6634a3aad621f0d151c0e04,189,149,40,Africa,17,1759.26
04074d1a847e41e48febfec353ed561e,77,25,52,North America,18,258.39
0409fc21cca543ecb856145685fa5e44,54,32,22,Asia,23,676.43
040ed6238be84bf9baa00ad328323742,250,201,49,Africa,26,1499.72
041043d17a724bdfaf54d97d27f46b98,365,346,19,South America,19,2611.16
04107567a59a427cba4e2aa44669ae36,308,276,32,Oceania,22,1528.46
04110fe17a48495bb517d7db29d44af6,26,3,23,North America,18,126.46
0412a88744d048b282c397d4e29b89cf,318,283,35,Oceania,20,1983.85
04130c5d3b2d46118b539e02aba83d75,361,347,14,South America,25,3218.11
0413740da9fc4129a18a15ba367a281c,33,2,31,Asia,21,239.56
0413d5652db94a6f86c985ba38a0e562,53,14,39,Oceania,23,309.02
04144bef342c483db76afffe19c084a4,275,248,27,Asia,15,2179.37
0414d6e67ed04697979e0ece5d3dd6d0,155,92,63,North America,22,1034.86
04154e86ab9d49b4b77c1263e332311c,364,363,1,South America,18,2504.15
04168b985ede40faa357040427dd05a4,208,169,39,North America,20,1836.49
0416d01df95b4cb6aa60fe114cd70e18,340,316,24,Asia,20,2283.36
04176c612bb04127b3e4a4763d4d0b7a,364,314,50,Asia,22,1786.41
041943fb02494d7d804b1a0a46dc7a00,87,48,39,North America,21,772.92
041af5a8605f4b5da4490e8cc8d80516,272,256,16,Africa,14,2249.28
041afb6eb36c42abab100a7d09b82a5d,308,289,19,Europe,25,2762.51
041b332516504785b7c991f28674d69d,247,215,32,Asia,21,1844.44
041b6a07c48a4539bb677bcd08a5baf9,162,110,52,Europe,17,987.39
041e2b401ae64caba833c970e8f96b61,297,270,27,Africa,17,1513.65
0421df7ac33d4c37a3b22337dd33e8c4,285,233,52,South America,12,1581.86
0424ab5a89414686b50e5d45d2472799,115,64,51,Asia,19,620.9
0429b62fa57e459cb76768dba4aec8ae,260,231,29,Africa,19,2130.84
042a452f634c469cad899710a341c96a,313,288,25,Asia,21,2160.51
042b2177fa804ffca1261da4204e9c23,259,210,49,Africa,24,1561.56
042d133d67aa47dbab2037b462d79312,112,68,44,Asia,14,486.72
042f092c896d4a0fa15dc98e140b1e06,161,123,38,Oceania,22,1109.19
0430d08212234c6694ac9a6d684596f1,351,312,39,Asia,24,2619.73
0430f1a05a6440539eed31944fa387b0,255,210,45,South America,18,1480.69
04315768917449b58ab1812323383348,35,7,28,Asia,14,287.29
04332bc20b3d4ac08be3f0c15799323b,339,301,38,North America,17,2681.51
043349df084847fe90b64d089b9645ef,304,281,23,Asia,22,2671.8
0433ddc83bf04332b8fe7cfc60fcf721,229,180,49,Europe,22,820.34
0436ea1f48c84860acc850a23ce8c8b6,317,277,40,South America,24,2285.55
043921fd4df4466bb8b3af4ce889280b,339,297,42,North America,19,2361.14
043932d1870b4bf7a4e86cf4f7fc8648,365,359,6,Europe,21,1576.48
043e4e567b174c9c9ef0a77c3aad2bca,323,277,46,Oceania,21,1943.78
043f500f8a774431932a0dafdc3922f5,83,39,44,Africa,20,444.08
04405e01cb3e4c60a2ab3a7b857f1331,206,161,45,North America,19,1497.34
0440f511c5b94837812e845e6a87c3af,350,305,45,Oceania,21,1778.65
0441ada117494d1c9a24271f6cd51e97,364,354,10,North America,21,2700.9
0441f2d3f1e9491a8785cc37ee50e30c,173,125,48,Europe,18,1529.26
044267cfb4e14b1d899e3da36b68a483,76,33,43,Africa,17,451.91
0445b0f4f9744ffcaff25ef7a27b11fe,227,191,36,North America,15,1392.25
044df092773b4f5b9eb7a2c0ffae66f9,305,277,28,North America,17,1734.72
044e0cd1df6f4baebce3a2aaee9e2e29,186,132,54,Africa,16,1061.11
04509d859e144e6fa547ea7d350472ad,256,206,50,Africa,24,1126.62
0450e164ef1b4e8aa82c72dc713e81c3,145,112,33,North America,22,1120.15
04522370c4a3401581151be78158d9c5,258,224,34,Asia,24,1528.13
04569b5c07814fdf8cd86403e43a70c5,163,125,38,Africa,17,1370.77
0457b1c2bcb642a6b8be689308db27cd,365,357,8,South America,17,2420.09
045a4270e45d4433a5780b85c4367aa8,253,218,35,North America,19,1115.57
045b6e1f61c44a069f5c98ed17a991ae,58,20,38,North America,18,320.83
045f4c99c22a477fbe5e48638bc163fd,165,130,35,Asia,16,966.62
04601e54b9004c0fb92ced0d137f53b9,117,104,13,Africa,21,1349.59
0461dea29ef04d518da9388fd261e6d3,365,329,36,Oceania,20,2082.79
0462733c8d9c4ba5bf7720c92a1c8e12,363,330,33,Europe,23,2710.9
0466050ef6bc4c72a2bd97644ed96585,365,358,7,Oceania,22,2666.26
04675dd08a224d0b86e7ae77ad75d351,197,156,41,South America,16,1036.72
04688189f8d040aca3adb1c809133fd5,235,192,43,Oceania,16,1408.77
04689fcfec4846c2a79a9d011731fe50,91,68,23,Africa,23,417.8
046c418778ae4c11a2174899091b2119,75,29,46,Asia,21,571.73
046c9dfc93414535a4a9df3b56d7969b,77,56,21,Africa,17,636.06
046d740caa1c478f8bef82a2a63002a6,44,5,39,Africa,14,299.92
046ecda2df814fadad509c27bff9e735,271,219,52,Europe,15,1217.11
0470bba036b64ca99f7b470f3f46c8ab,364,346,18,Asia,17,1984.1
0472510dfe2a4830add46d1e48679d65,287,243,44,Oceania,21,884.96
0472f0b7bd6b46bd844539fa07a6c1cf,258,214,44,Europe,22,1439.96
04736642f81e49b78b7d68f632726d67,364,361,3,South America,17,2111.07
0474ffd9f1964a569dfee0b831b422f1,250,232,18,North America,18,2154.99
04751fee6209424f8af96017d58d85cc,353,301,52,North America,16,1476.22
04761093e80643c396ebdd4d8ac5f9e4,285,248,37,Asia,22,1846.6
0477dc8fd708468ebc42bb0e4d0f6bc3,111,87,24,North America,21,1610.05
0478083f788b4b528f2e099ea7551066,104,84,20,Asia,17,868.27
0478e9b13bc2453384276fabdd4d8223,360,353,7,Asia,19,2696.79
047a490e8fef478fb661516d8d864a69,364,358,6,Africa,22,2995.48
047a5e0171894e14bbf29ead1d7b75db,339,300,39,Asia,17,1950.64
047b76389319413bb0660ec3273b1b92,296,268,28,South America,21,1281.14
047c1b8e69f945b8a48f01b5f22f56fd,221,167,54,North America,22,1057.66
047c2d103f2f4e00a7ca949143c0ec63,120,81,39,Europe,19,713.02
047db34d67564796acecf57829e0425a,236,210,26,North America,15,2050.85
0485d09149eb44e89a65d77b9762f123,364,348,16,Oceania,19,3013.22
04865fbca88d4bb884906cb095d1329a,287,263,24,Asia,20,1956.31
04875468ea514c72a8e25f643d856999,138,92,46,Oceania,19,800.8
0488ae0802634dde960aa6f6d7a6fa46,74,22,52,Europe,19,641.66
04898f9445db47118fa06db3a9a457d0,67,32,35,South America,21,387.88
0489f39042824afaa7381a292aeddb06,312,263,49,Europe,24,1744.16
048a4793b4124d59979c5ea7a5571345,283,245,38,Oceania,23,1976.49
048b10a2b9ad4013ae9e43480b5157c6,123,95,28,Europe,19,1125.46
048bafe18e154d29854234363a6a9840,156,141,15,Oceania,18,998.59
048beafa3e7d4328a6b82ef4e8f57008,185,151,34,North America,17,1061.84
048daac19fec4c4c944f704eeee89faf,131,109,22,Oceania,20,1378
048de37a7f06485da2622e36deda0aaf,190,149,41,South America,17,1164.31
048ef0a7e83041faab4dc36beec93175,120,60,60,South America,24,657.07
048fdcaa43104ef0a516c2c015cd453e,246,217,29,South America,24,1890.23
04901496e8c34e7b8aa368cd5c32bb4b,142,91,51,South America,16,566.42
04919e8d0bf644c4b57213448ad49e55,305,255,50,Africa,24,1033.01
049650c6847a43dca22e842d41f930f7,169,125,44,Asia,21,1209.14
0496fb58105e456e8bf5908758544bf6,237,199,38,North America,19,2124.1
049901ae7e434ea18e847f668a5d87fc,126,108,18,Europe,20,826.66
049903e10e584680ab87fa16db365513,119,100,19,Oceania,23,781.98
049e41196c074312b52cd54dd6890e56,29,2,27,South America,23,176.34
049e6274ecc747069ed22cfa497477ac,364,343,21,South America,19,2891.23
049f413ec19f45689896ec76de694cdd,361,344,17,South America,18,2875.88
04a0c5eed0d341a19296426130280305,250,193,57,Oceania,26,1311.99
04a183801ff64512ae5929b48e2369db,355,300,55,Asia,24,1256.39
04a18ca8de734fd3a6b96e826f545c1c,162,124,38,South America,16,717.94
04a2daed66d348dea664e4de61d87e69,284,261,23,North America,16,2172.26
04a64148c1f448759fcd9f47be1e7ad5,341,308,33,Europe,20,2452.99
04a7e426c0204a7299f3cc50bc3d5d4f,357,321,36,Oceania,16,2295.55
04aa320ddb55442bb291c5a800d22dd2,365,346,19,Oceania,24,2417.3
04acfe50a336450e8ca6ec8c7d7dcd53,362,340,22,South America,16,2290.82
04ae44f040ca40ba877f4b60bb14a6d8,181,137,44,Oceania,22,856.92
04ae721ca29b41799711ad7685a39dd0,73,34,39,Asia,17,145.86
04af24b96a5648cc89d733a2b4c6f957,99,65,34,North America,18,685.76
04af8fc8fe064794a8e007a4b521a247,266,217,49,Africa,23,1655.59
04b06fbaa543424196f7da11b4a573e1,62,23,39,Europe,20,420.47
04b3959e3ef0485f8f73e96c742493a5,365,351,14,North America,21,1715.32
04b5147f22fd485e948c33e65e18c258,98,67,31,Asia,22,857.41
04b5c609fb654b8b8d0c827824231bcf,152,120,32,Africa,22,653.53
04b683d2ad1e48f3895ff5f284fe5b36,296,267,29,North America,23,1929.47
04b76d573f454fccb5ea6aea3739f229,112,60,52,Asia,21,198.23
04b7977248c849fb99ef7691b24ce99a,362,351,11,Africa,19,2255.2
04b8200f8d5b4bcbbcd718c95680a696,177,136,41,Europe,22,1260.56
04b92f95b2da4d2fae4d0bf9c06bfb92,55,11,44,Europe,21,366.06
04c5578e70dc40c690078017ce93840d,85,41,44,Africa,20,281.94
04c5f7ee041f41a49849b483d376aeca,217,174,43,South America,23,707.41
04c62175edb7472981e9e20b7c489c64,64,21,43,Africa,22,482.28
04c80c7cbd204ebd930c41a50f184ede,228,168,60,Asia,20,807.78
04c8320e0b71491b8f84a4580b41c961,152,103,49,Europe,22,581.59
04cb1612aaac4d2294b624397e418801,357,339,18,Asia,17,2823.17
04cbe2a669be474ab6d9e1cd4a287e7a,364,356,8,North America,19,2227.1
04d123e432624b9e9f575cc0e79929d4,136,113,23,Asia,20,914.8
04d287311c5e4dbb8905750f4e21f8ac,363,329,34,North America,18,1410.07
04d358b9013d40a29e63af2f7ca75a2b,176,131,45,Oceania,20,991.8
04d4cb86d0e748ab90c2fbc1acc47947,94,67,27,Oceania,18,742.4
04d7c729719f413b98b2bac5e548fb70,250,199,51,Africa,18,1067.18
04d7f02481a04d9587675f6c07fed6dd,223,197,26,North America,18,2291.88
04d8987de2fa40639c30a2659b3b8b2a,67,15,52,Oceania,23,296.08
04da4332155049ed837203ff6559be4a,228,180,48,Asia,18,914.24
04daa61303bb46dbac5b6849d329aad2,318,283,35,Oceania,18,2453.93
04dd9273f32d468bb71cac9f8d4855d4,216,175,41,South America,21,1060.48
04de77bc6f634f8b91e421332d2f5ce7,98,69,29,South America,24,817.91
04debe3ec0654c7cb2484c34191ec801,364,330,34,Asia,19,2436.48
04e01aecba6542f1b90ba5ed303fb30b,361,355,6,Africa,15,2457.09
04e271f294c94ed5837efca342d6ce3e,87,36,51,South America,20,415.03
04e2c20135834034a8a7efeb9eeba448,210,172,38,Europe,22,1353.97
04e4120546fd4f0d8bf0e6de41bb606a,122,81,41,Africa,17,778.71
04e4e7b53ee148bc90a540fa255fb3de,365,322,43,South America,21,2170.62
04e60c0822694ae592bd226dd005b126,37,20,17,Oceania,24,139.88
04e9b3a5b8aa4f439196e51ccfc708dc,365,318,47,Oceania,21,1805.91
04ead42676a54c08926c4b175bca1853,363,339,24,Europe,20,2821.35
04eb4b1df3ae49dc8c1d260768a1b81f,248,196,52,Asia,24,1376.85
04ee784667ca461090793750662df74e,113,64,49,South America,18,466.27
04f0cae23c8740658ab6f974142e2e7a,283,249,34,Africa,20,1435.79
04f180f9a0704ed6a1e222f7863a2a09,331,305,26,Oceania,20,1992.86
04f1b5fddbeb418e8d96c6a0d2c6cebb,365,357,8,Asia,20,2154.29
04f30b7d56644f058d42558c0f7a5746,364,338,26,North America,17,1775.95
04f3faf262074fb08904b296404a3da8,69,21,48,North America,18,517.79
04f4400565054f5f9b66f09e2f1d94bd,131,97,34,Europe,23,992.89
04f5224f7e494946bd04f277845160ae,364,363,1,Africa,21,2352.83
04ffa19fbc304a21a5ee3731fb7cb573,245,224,21,Africa,22,1537.24
050115eb773d483f829d138f99a2d722,310,284,26,South America,15,1880.51
0501e28d93494678900d5fd8bbdc8095,138,86,52,Africa,18,926.71
05027a6e2f4d4770bfd0a308b0438c9a,139,121,18,North America,23,960.32
0502dd88bc01498ba10e6f7291f35e9c,161,104,57,Africa,18,967.21
05041fc701064c14b052c46b069da9d4,66,38,28,South America,22,511.67
0504ac637ee04495906d35713be92cf1,188,165,23,Africa,23,1362.11
0505658194664bf1b7354a9d5b754733,365,358,7,South America,22,2352.07
05061f266db14eb8876af70cf6e96f30,66,33,33,Asia,14,232.55
0507865575e84ca194a5c04e8b331af0,79,51,28,Europe,15,954.65
0508f71b9de34ad385393c650c33ce16,363,339,24,Asia,23,3283.41
050915d5f4a649b4b5be619223e28f93,210,183,27,Africa,24,1700.01
050dab0cdf1b469d812f79f7f5885465,153,101,52,Europe,22,550.39
05112178590749c6a703dcf60c943661,115,89,26,North America,19,886.87
0515fce745ad43d1808ff8b45df93cfc,183,156,27,Oceania,21,1010.48
0516b3f418074fccb28b09976174293f,265,231,34,Oceania,16,1657.08
0516cf314e204f3bb32e0a099b434d60,160,123,37,Oceania,15,1559.3
0517cf84297e4de892a87710f0081a59,308,273,35,Asia,24,2685.76
0517e1b619034ff495332ee81a4a02e5,327,268,59,South America,16,1410.4
0518a62cab064c53837701a2c71c07a0,261,232,29,Europe,17,1964.72
0519d6c457fb4fe7b7e4493c1a637cdd,205,185,20,Africa,20,1766.05
0519e9c189604e0cbcdd623757ebef98,169,116,53,North America,24,816.15
051be50b3c94444c87c2b9f6792f0511,258,235,23,Oceania,24,2217.88
051c859ee2004ee99ba8dd49525bd0aa,103,83,20,Europe,18,792.25
051cd68142c64b8ba89d5c4077cec140,213,183,30,South America,13,1545.31
051f5f8add6e4b3c86936a83bf3c62cb,223,201,22,North America,20,1629.38
05203c06c94047ec97f150c1395b6a3e,106,89,17,Europe,24,770.96
0520d8acfcb647928fd6ff1d926f3524,190,160,30,Africa,21,1424.94
05259e8c67f5488eae2010ad50703f90,310,283,27,North America,21,2310.23
0525a110dbd64dbf88b168da96a408e9,276,223,53,Asia,27,1338.91
0525dd2eee5f4480ac04a93b89ba04c3,38,3,35,Asia,19,306.56
052774c8da8944478aa39edcb6703173,275,233,42,North America,18,1820.29
0527969af6714e22b5ec1adb919c69c8,238,210,28,Europe,19,1707.18
05285e3bbefa46efbb1cfc9016851e43,91,55,36,South America,21,479.76
05293e6483f3443599967d75e3d71e31,131,80,51,South America,24,1305.72
05296705816041fe96efdedb4b2cb966,321,266,55,Africa,21,1743.66
052f14f549184081a4e038da547feb7e,324,300,24,Europe,19,2405.84
0530094bbc6d4817b259b63d5b05ddac,364,318,46,Africa,22,1568.27
053095471b074460b77109be5942991c,71,37,34,Asia,24,503.73
0530975dc483471f846af3fbd208255e,347,314,33,North America,19,1846.83
0537279a64ba4a6a97102a696526fafa,255,203,52,South America,20,1490.02
05380c5a974a4f34bf852e3cdbf18c6e,216,168,48,Oceania,21,1352.44
0538189872c04ec7813554ae06a5f062,298,272,26,Oceania,21,2661.52
05392e03c3264bd08b5aa2157512165d,271,239,32,Africa,23,2221.73
053a49ded7df4b54afcb12008d0d5446,190,160,30,Europe,21,1736.76
053a65d1c118491eb3a061bd86255e94,343,308,35,Africa,18,2615.49
053b93574e2f4b0ebf2a03785d767048,232,203,29,South America,20,1653.07
053d553a0f704e82b4acba693eca5083,278,233,45,Asia,21,1818.88
053e9c01f1f64bd786f3ea138e290c52,339,312,27,North America,16,2420.85
05404cdc1b12422a9b826824b013a0d8,198,144,54,Africa,17,982.71
05407b65dfce4a3ba150f182f204c070,125,77,48,Oceania,24,1180.76
0545bf25cbd0418496bb70bd60a31db8,140,101,39,Oceania,22,778.57
054648a5d37f4fcfa3daee37e8c5089d,330,278,52,South America,19,1691.25
054673e1dd444896ba3184022debed95,365,355,10,Asia,19,1820.84
05471ce22eb2430c94b376170b5f8e00,76,31,45,Asia,17,237.95
05482842e4774736b7d6857eb9be4a3c,155,105,50,South America,23,699.51
0549db7ce7a249739824c0dc036af67e,310,286,24,Oceania,18,2136.6
054c5b7f1b4842b2a3240042ec37c3fb,166,115,51,South America,21,1056.23
05539cb06c554ffca18f69ac34fce51c,74,41,33,Europe,20,639.77
0554db8e4e944531b0660b2b0b4f7a63,198,153,45,North America,16,1100.93
05553ea1084c44899caf79e7dbe85c19,330,276,54,South America,23,1378.68
0555a7951e8f45b7915f0837ef45bf79,167,121,46,Asia,14,1208.82
05569fb532c24e2dabea5d6a939900bc,200,170,30,Africa,18,1086.34
0557f9f8b2734ff090c527585b0ec705,50,13,37,South America,24,234.62
0558cc4fb4dc4be3832133e9455de734,70,26,44,Europe,22,542.21
05594e87adeb438c9c90af65efe34f49,310,260,50,North America,14,1328.89
055b130a6b1f484588e1fbac644ce44f,117,56,61,Oceania,20,498.83
055bca1f24d94fa798e1ced0188cf196,157,139,18,North America,18,1246.04
055f52cc2ba14252be6af91921bead2e,159,123,36,Europe,23,1444.72
05618c6cb1ab43a6936113e2db3f6263,365,324,41,Oceania,20,1828.7
0565a1d43f3d4324aa3a13cd9e9c4418,209,186,23,South America,26,1515.45
0568f992f1b341d89220b070a3d19809,364,360,4,North America,21,2402.12
056a7d54ea21465aaec935248992bda5,281,252,29,Europe,20,2463.77
056b762b366b49fb8a93c15478aaced2,257,220,37,South America,21,739.59
056be0817efb4f42918068a17cd2e7fe,130,77,53,Europe,21,383.66
056cec9aaad645b78a5842a71681cd15,363,337,26,Europe,20,2489.96
056cfefa63164054a079ed9f69988d6a,117,66,51,Europe,18,405.2
056da65eafdf4491894abbc389838479,80,55,25,Oceania,23,644.46
056e999b186d445aa72fa785c89cdcfa,94,36,58,South America,16,846.5
05710e4cd33e4064a96624e1e41613d8,277,251,26,Europe,21,1697.58
0571b9171ae146cba33ec23059a270b0,53,5,48,Europe,23,569.23
0571df5a4d694de385be9920be469ce9,147,123,24,Europe,16,1078.59
05723f5223ca4f54a1a33a847746add1,185,160,25,Asia,15,1387.51
0572fbf7645843f4bb48d12fa540ed78,50,30,20,Africa,25,712.12
0574b914e4fd4a90abeaeaa5e14777f6,328,290,38,Oceania,20,2690.66
05756ae9068a4da69f313b481d3961c3,335,296,39,North America,20,2241.64
05770e5b7ca74444829b4f9c1dca091d,363,333,30,North America,25,2814.75
0578f177fe5e40adad8d4b64d79f10f6,105,64,41,South America,18,908.18
057a09c51d874b88bd1cc48ba4b08927,148,123,25,Oceania,15,892.74
057cf19527cb4fec95394c23217ef867,56,28,28,Europe,19,423.53
057d91ab4cd543519b870d98ff267e75,153,136,17,Oceania,17,797.98
0580bd3a293848108b4bb2c5c79e708d,295,264,31,Asia,22,2481.77
05822ce5ab4f42c891a8d89e388de980,360,349,11,South America,17,2287.4
05824d281d054c37a1fdc5ff1f1e2259,309,284,25,Africa,17,1606.22
058352e23cec4c8b8168ef5a42ea6c72,253,223,30,Oceania,21,1674.76
05842bf39ff64d9382fb889a9645e16c,181,157,24,Africa,21,1520.21
05872920d97f4b8297068b45e717bf32,330,309,21,Asia,22,2231.06
0587ca9c37a043738debd55a3699fa9e,130,70,60,Asia,16,428.72
058a2aae293b45238c24970ca7f230b7,261,235,26,North America,20,1783.77
058d75da28bf48bb89ab44048de7c08e,131,95,36,Africa,17,906.11
058de43e302f4cb3904e9acfed96b828,141,107,34,Asia,24,1120.16
05941d266959410685a8df400c6db139,248,233,15,Europe,16,2189.58
05941e0e36a443029539ef50f6e81dae,159,109,50,Asia,18,1119.21
059746f5c7e34a1c9eff2a3eaafb6d51,244,194,50,Africa,17,2188.59
05985dd297aa4be6aa65dc62379f5c3d,256,197,59,North America,21,1206.08
059956de0ef24861912e4d6a9f399e1e,176,141,35,Europe,25,1157.94
059a22876f004b72ad9cb2d0b9329616,206,177,29,South America,21,1290.68
059a90bd48204eaeb4d1cc6f391deae6,77,45,32,Asia,19,659.53
059ac7116e494985a531010e45dac174,95,48,47,Oceania,17,445.01
059c8c103ef74841996c6f19b94b21b9,338,283,55,North America,19,1496.86
059c9bf8067a4ab4b56199b16111edab,106,84,22,North America,23,943.46
059d7873ad5c4655ae054eb542ac7b23,268,220,48,Oceania,20,1659.47
059e4584cf194d4593471a41577618bb,221,178,43,North America,20,1227.21
059f1d8566c340a3b6364740ce42b750,92,69,23,South America,23,764.65
059f85a9aaa8417582c3585f9b6f0065,232,184,48,Africa,22,1046.61
05a193d79e68478eac795a2fa71085e6,307,265,42,Africa,17,2740.77
05a1dea41d944017844ee80b202d67a8,360,329,31,Oceania,25,2662.58
05a2983faaf74a0c86af4b534254e7e2,126,85,41,Africa,20,607.61
05a5cc7c44a54547b57de037c8df97cb,35,9,26,Africa,25,384.26
05a5ddb820d74b0cbeaec8dc257a90e9,177,136,41,South America,20,812.54
05a61bfabf254820b408e434ed293007,118,71,47,South America,23,353.94
05a64ae30ca54806a1998b114867b578,333,283,50,South America,19,1776.36
05a7c9f5f2c544b8b22d9ccbd29fc130,365,333,32,Africa,27,1930.88
05a9e411b07d4be9b501f59ffce79cd8,46,9,37,Africa,23,533.76
05ab54be866841a18fb4daa991bdc398,164,110,54,Africa,18,922.09
05abbb18c46a43e6abfc5f0ac95b5ae8,112,57,55,Africa,22,759.26
05ad16d50050455b8a177d80734f6be7,98,73,25,North America,20,1166.58
05ad88d20cb7490daeec7afd1c6eb7af,365,331,34,Oceania,16,1843.19
05b008031bc245f5aa6c72e9fd6a287f,69,13,56,North America,22,414.59
05b0c567351f487798a2487e996417ea,226,196,30,Europe,21,1905.58
05b0c699915246c085da826772532a34,302,277,25,Europe,19,2353.94
05b1349537ce4807a9ee02d10779a702,328,300,28,Oceania,21,2562.47
05b21394becb4696abd2106c6dd95312,163,124,39,Asia,12,1297.07
05b30ea66f6f45b7a31ca1abd9bf13a3,234,212,22,Oceania,23,1671.17
05b5c588584f452292b264f08edcc5ef,248,224,24,North America,23,2639.07
05b63f9e03d94d1591574d568f18f4f7,34,3,31,Africa,21,482.44
05ba14082c594b669b30c4b45fdfa666,101,56,45,North America,18,519.27
05bb048d61bd4bdb85e36f30887cb6eb,299,246,53,South America,23,1843.57
05bb6bda39504fb7b4a784d8e366b765,113,80,33,Europe,20,371.28
05bcbc5eecf842089172480a65e5a5cd,203,145,58,Africa,22,1015.74
05bdd7d8dad24b01835a0815ec0633e8,186,148,38,Africa,22,1177.13
05bfc871b70b43ca849021b87b698d2e,206,167,39,Europe,21,1355.76
05c0391fc7f14ba8a45bff5edfad89ee,86,39,47,North America,19,389.85
05c0dc28d6bb44d191e7639b755ff687,132,104,28,South America,15,1520.12
05c13309b56b419cbab21c7086e88ef2,364,347,17,North America,18,2239.36
05c39b654b6a4d1d971f723aa53d7628,324,275,49,South America,20,1919.01
05c53c835ab74002ad398484b17ac266,193,156,37,Africa,18,1307.83
05c6dc1aed404b3fa0c2f8ce1f11f3ac,90,57,33,Oceania,23,397.46
05c7780d4a7249ae85e00d2b7ac089ee,329,302,27,Asia,20,2360.19
05c987fd1b5945e198817221f035b92d,131,91,40,North America,20,843.21
05ca216403c44e4e92d52d2e2d02098f,135,103,32,North America,19,708.43
05cde562776a406e93b3979f927b6619,145,93,52,Asia,17,661.23
05ce1d391b6b41719d81adc02bd009a6,312,285,27,South America,22,2244.09
05ce2388e29c49b2bc8c345f8bf841e2,215,170,45,Oceania,23,921.61
05d37c660b4c4630b73cb79d4a6703d0,359,316,43,Africa,16,2977.81
05d7614fd0cd459f87d94004bc989823,123,91,32,Europe,26,1114.96
05da073ad04e4d7da8a5fbffd6818acb,124,63,61,Africa,22,357.86
05da9f72ba6e49b682c6c9b20be81857,168,127,41,Oceania,21,645.93
05daee3150684879974ab7c9cc925fa6,64,49,15,South America,22,451.5
05db90ff544a4b6db3908a08e42a67ac,112,65,47,Africa,25,332.6
05dd1e4eebe74ec1af4575d86cc36d73,277,262,15,Asia,27,2475.34
05de621b6cf94676b4c83c2414c0e689,66,24,42,Asia,22,483.4
05df617966bf487091521a5512ff91f3,360,322,38,Europe,19,2138.38
05dfdb16e48d4fd29b6f914cd83b22ec,52,16,36,Oceania,22,266.11
05e00aaf883a4428a7e6947153feb1ad,286,233,53,South America,18,1279.64
05e10e0795c9431f8677b60de44cdc70,245,213,32,Asia,19,1643.16
05e4cff612264338871e4c6efa85e40a,364,359,5,Asia,20,1893.73
05e526be551542aa8bbefd60003e9541,191,145,46,Europe,21,753.31
05e7594c9b7043ea839d71acb53dc845,70,43,27,Africa,23,222.3
05e7cf32eb134e9fb5649efe9363e7a0,360,330,30,Africa,14,2590.42
05ea1180f1144868adf04c610dc1cb42,65,16,49,Oceania,18,363.16
05ed1820caf24d1fb5dc1e41a9853b31,263,205,58,Oceania,18,1091.13
05f27607b63b475a92ff7ea74b0f2acc,273,216,57,Africa,16,1756.1
05f4907b5760457e936c15d247e1b2a0,55,15,40,Africa,20,595.52
05f678eb7e2842a28ceee14aa15cd059,211,177,34,Africa,20,1539.92
05f78a2158da47b39cb5efc403185bad,215,189,26,Asia,24,1970.07
05f7a9c3662a40899531749d413fe885,365,350,15,North America,20,2166.01
05f8358d10614848bd31a00c91d34dd4,255,229,26,Africa,18,1892.22
05fbfcb04e2940689503937ba615b782,364,349,15,North America,21,1717.07
05fdba3c16e3420b9843c6bfb6d3e2fe,364,342,22,South America,20,2876.93
06005142a5df487d8e08482b98177fd9,316,287,29,Europe,25,2326.02
0601a6eaea39443faf3627d52175a069,237,187,50,Europe,18,1240.68
0601fc2a6f544c5aaf63af05d1fd0c67,363,359,4,Asia,21,1808.19
06035322d46b4a6fb1ebf5e3fe6d5811,321,267,54,Oceania,22,1706.43
0607464e0f964c3db2a3177b65a3d833,322,288,34,North America,25,2696.14
06076b88fb81406f875e34409efbb973,131,70,61,Europe,21,853.35
061016124c08453fbc93326fbbde5135,176,131,45,North America,23,712.38
06146778ed3a4bd78d7988f1072a45af,109,82,27,South America,21,658.69
0614a189706648cd969d7ab445054514,316,269,47,Africa,21,1171.81
06172e0cb3e845c2803bf6aac413a679,191,146,45,Oceania,25,1109.02
0617f285201a458db41be580c614cdee,364,345,19,North America,27,1377.81
0619d9bddb8541d9a20017ca5141bdb6,354,316,38,Asia,22,2611.46
06201dbd3b6c4e0aab42f012efd8145c,269,215,54,Asia,22,1005.16
0622d719eb4b429fa499c3960263fb8b,153,122,31,South America,19,1090.48
0627df5f0ca24638a8f5f2f63977a8b6,33,15,18,Oceania,13,283.8
062c9fda738140f0af53fab974301111,356,302,54,Europe,24,1999.11
062f38b438d04b60bb891b7cb2cb7873,353,307,46,Oceania,18,2037.68
06335e3e0cdf4ce5b78205aeb10aeedb,365,349,16,North America,22,2341.91
0633b2baea1b46d7baa8e09ad0de3d0a,133,74,59,Oceania,21,911.5
063b4a879d894eafb896fc72366dc680,365,357,8,Oceania,25,2330.84
063c891332fb4da19e4575effafb67fb,159,97,62,Asia,24,672.82
063ca80ca7554a168d4c959cc0996253,69,15,54,Africa,25,443.83
063eb06c959a4b93af7fa226dbb25f38,173,145,28,Asia,24,777.73
06417485111f46859208bd9f6337ff2d,102,74,28,Asia,22,522.57
0644eb4c6f73418285aac397e2d97376,353,301,52,Asia,19,1289.46
0645f1969d624d39a8473a19c05df86f,362,343,19,South America,25,2312.03
0649970b96ed4961a0e3177b9b09fa74,363,330,33,South America,26,1699.65
064a8fdb4a31475bb2b15bf663dec16f,72,11,61,Africa,24,301.23
064bfe94d8db4d4b9d249c7671d734a0,247,207,40,Oceania,16,1806.05
064cccff3e4d44e48d7e368b547dddcb,93,35,58,North America,19,583.89
0650ca4816a4486db9699b7f6f2ee8fd,215,171,44,North America,17,1093.27
065149cc60134d318d619944e4ac3cc8,273,258,15,Africa,20,2552.67
06522b6b47ac4392809b07aeef707b4e,276,239,37,North America,22,2392.47
06537e91afda483ba16de9559f3d5f02,207,154,53,Oceania,25,1143.93
0657c9fb6a8a480fa20001442cc53d01,136,105,31,Europe,19,992.9
06592bad48004aa5a8fac5c0e43c77fb,136,107,29,Asia,21,977.48
065a236172344b4aafefc9dd58925e21,121,76,45,South America,26,739.25
065c2a74575d4b4b84ada823353eef72,237,213,24,Africa,17,1172.81
065d113954d945258a17a9cb350558df,105,74,31,South America,18,854.94
065e1ac9d21440a58539346a22dd9c02,100,53,47,Europe,24,821.39
065f3b6f99634f0184847ffda8700629,249,197,52,South America,21,1100.07
066131407b4b4c5fb9211a65e05ab198,277,246,31,Oceania,18,1424.52
0661712a435d4117875a76bdbbce18f7,122,66,56,South America,19,687.64
06623d800efd41a3b899fde14eb1570c,96,63,33,South America,14,812
0662892e91734ebe851ab77dc4651170,184,159,25,Europe,18,1480.78
06629edb2f704ec38c807ee84618a24e,327,275,52,Asia,16,2014.26
0663470bbc1c41c9b6f2547ac45d8a51,153,123,30,South America,21,1171.51
066475209c394ec1908c4fabca664163,67,40,27,South America,19,439.6
0667db0e5e04459eab780b6bf6816dbd,249,234,15,Europe,18,1384.56
066895d186eb4e4298f2e848bedd90e0,363,340,23,Africa,17,3091.84
066b0554976645be8b9599a21cc959af,359,325,34,South America,19,2744.16
066b13e6da84448c8de3d5c2a6733824,207,155,52,Oceania,24,1158.89
066b71e5f7c34ba18cc02be94b72db1d,73,37,36,North America,27,476.93
066bb27121ef4a47b8a9679790d23d08,117,78,39,South America,21,669.29
067025ff5b7446059c7d4c5ff78c3d93,140,110,30,Asia,18,653.82
0672c871d3124302a10ad34d184efbea,298,244,54,Asia,18,1410.71
067467a3501343b383a33fbf36cf381c,286,234,52,North America,20,1544.77
0676d30c94624c9a833f0d6c7aaf25af,365,363,2,South America,20,3074.75
067b1ea0936c4a76939ad165682d5dd0,50,25,25,Africa,21,377.94
067b4b4709044b1d976687019ff63bb4,311,278,33,South America,23,2312.66
067ebbd3e02e4e2d8e6d0da098f89996,120,82,38,Oceania,21,760.15
067f6520172b462b84fec25e914db30f,254,220,34,Africa,21,1360.34
067feef12c424ee39717feed032e1bdd,361,315,46,Oceania,20,2174.81
06811a7e8da040e6803001f1738c1795,331,302,29,North America,22,1789.59
0681cc3706f34daa8b9c3bcb23e958bb,331,298,33,Europe,18,2058.29
0681d520cbaf4d629fe62f65788a66a8,160,106,54,Asia,19,651.76
06849ef36e8044bc9359122121fb4f7c,226,209,17,Africa,20,1612.16
06858bdd8fbd4844b2acd4f0a068cc71,250,229,21,Oceania,22,2206.45
0685c39459e44b6798eb4ccb3d939f85,322,290,32,North America,17,2513.87
0688d4f717944832b0e8aefed4136bad,365,352,13,North America,23,3060.64
068a38f946ff4912bd0c57b354763ce7,307,267,40,South America,21,1900.37
068d2a01ec5940e8b0e8b9c711728b30,294,256,38,Asia,20,1472.18
068f434e38cd44c985134b0fc83ef5d9,184,157,27,South America,23,1526.04
06902dcd20d44cf69822bb851ce33367,73,19,54,Asia,25,438.89
06906e6343144ee2bef85efb02f111fb,242,196,46,North America,21,1314.57
0691e1117bea4f3ea9489f913ce99edd,122,96,26,Oceania,21,893.92
069392a1f3ab4803b69f30fd55bf9f38,148,121,27,Asia,20,1534.62
06943212bbcd4d11b8f4aeee1070d339,244,215,29,Oceania,18,2020.3
0694846ae7e8489cb5aa408573c39350,162,129,33,Europe,26,1433.35
069a6930e470453cb40ff9058d1859c1,365,345,20,Africa,20,1434.41
069b3562e7df4951a0684a1174acdb2f,185,158,27,Oceania,23,1037.49
069d122424ce4e4eb1a1d0f457b93dea,198,157,41,South America,21,1300.04
069dcfbe721e486c8da231e683db5544,121,80,41,North America,18,682.28
069ebf4fbb29431e90b3c89d00fd0fe8,93,70,23,Asia,19,981.33
069fb22f4ca44fa8983afa651dcc5417,329,290,39,South America,21,2430.04
06a01e7bda4343f89f2a4610cbd0290e,40,6,34,North America,15,413.19
06a036a6c6104bfd9d8ddcead54308a1,365,344,21,North America,17,1799.66
06a1c62eec8443969a515a4642f8a2a8,79,37,42,North America,23,620.25
06a27fbb1d6a4f378ceaffb55321868e,134,80,54,Asia,23,708.71
06a3d5bc511a451e97c0d5edee9de7c8,130,106,24,South America,16,767.73
06a69dc3018a4e648e9e299317801ee2,139,85,54,Asia,23,668.59
06a6f1e94ecc429188f60626805784b3,130,84,46,South America,22,420.34
06a7e7aba55c416daa7d198c00eb74ce,337,295,42,Oceania,21,1621.39
06a8eea58238438f80eda66fb9af00bb,324,272,52,Europe,20,1336.93
06abfdf63db1498d871a0cb6eaacc882,216,176,40,Asia,17,1689.98
06af175ac4584709bd188adb72702807,305,253,52,Europe,25,1563.2
06b0fe4966784b5897f5e82bee63b5e0,364,345,19,Oceania,20,2444.47
06b205454c684d7ba9832db3e1f6277f,134,87,47,Africa,17,810.29
06b21303533f4dcf8d2219de510c43f6,84,69,15,South America,19,801.26
06b4ac361ca04b1090f4156d57f8e34f,114,78,36,Asia,20,641.82
06b4bca356c44d34b9b802f8a091d55c,99,42,57,South America,20,571.38
06b7d69778bd4794a1927981ece581df,64,34,30,North America,22,449.88
06b8566215d341c2b92f92a3d9efe250,146,106,40,North America,18,996.27
06b8c3347c2443028dec68b4b34759cf,365,346,19,Oceania,22,1649.48
06b95e2317194051b9ca2f205ed67cf2,342,305,37,Asia,18,2098.33
06b9c138570b42e793f7ac22a6d04d42,365,311,54,South America,21,1863.63
06ba0434b6914ee5a1af4fc7588cc407,40,5,35,North America,22,131.86
06ba899d9fa34fdda3126b60071900ff,152,131,21,Europe,22,1234.08
06bd37bb1d3c45138581e949859233c2,274,254,20,South America,14,2104.23
06bd48cae9614336b577d8b4bf554604,95,48,47,Europe,22,559.1
06beec1056904a0299a015d03745df11,365,345,20,Oceania,20,2805.78
06bf6802f1d34944a6d32f342a31c50b,185,160,25,North America,11,1414.15
06bf730719164ce2a6f5dd1d4d725ee8,132,79,53,South America,23,711.5
06c1e74b4c744ecb8f24da3af05bb061,211,170,41,Africa,18,1841.28
06c1fa47658a4277b7ef39727914725d,345,324,21,South America,26,2183.52
06c3bd15d9d045579baf6a9fab22585b,40,5,35,Asia,19,412.08
06c441ad0b1c4f549fbe7de1e3c1aef1,238,208,30,North America,24,1614.86
06c4de043e0b4d8587f56ee0d9a8fa27,207,163,44,North America,17,1540.66
06c6f7b039a0442091ad3055150f2d4a,205,181,24,North America,21,1578.21
06c6fdfc2e304620ac75ed2ba493d1af,255,213,42,Asia,16,1638.22
06c7cdc11dfd49bea7952211c81fd215,139,113,26,South America,20,1042.68
06c8495534324775901038b902ab7f3d,112,60,52,Asia,23,441.13
06c8a207e98c4e5eae6d8464554f68af,242,203,39,North America,18,1316.4
06c94e4c413b4ce1ad91e06683a267fd,251,210,41,South America,23,2379.71
06c9b97557104254aa469ee5e1b14b6a,327,290,37,Asia,18,1728.63
06caa513bc38435eb2abfa44302dbf6a,63,36,27,Europe,23,775.9
06cb0fd00cb34c7d987426004e121234,284,258,26,Africa,18,1875.19
06cb50ed05374397b6c7b64bf0edab8b,194,156,38,North America,26,1309.79
06cdc10ecf704fc587e2e3c0bd14d8f7,356,317,39,Europe,19,1666.02
06ceb7213f1f4faf8c555f9ce345d655,360,345,15,North America,19,2176.16
06d37d31a3974487a504d18db0f1ef38,83,32,51,North America,27,236.11
06d385ff24194cd6942504bf4f317ef6,292,256,36,Africa,16,1610.69
06d5473fd40645f78e1f3b3e323d79cf,99,54,45,Africa,22,420.27
06da066b5d244ef298d126f04304611b,178,162,16,Africa,16,1646.35
06dc1d5e9bec4e16a9fa4719d12121ab,364,349,15,Asia,25,2029.41
06dc60ccd9c24f8c8f4a2140d63fab8e,365,361,4,Asia,20,2892.12
06debe41cb3e49ea83da924a95a35439,161,116,45,North America,18,1389.89
06e2fade59834dc5a716767cbc2d1eba,200,149,51,Asia,14,1181.76
06e395a97a0d4594baa000024d78edb2,333,292,41,Europe,19,2492.25
06e83b1af7014ee48eeedb2f5f705472,143,97,46,Africa,22,894.93
06ea2cffad8547488b0eb912935990e0,232,195,37,Africa,14,1380.2
06ea58b099e6447cabf658bacd477c9a,347,305,42,Europe,25,1610.49
06ea642d9de74907a06391a0104238a7,83,58,25,Oceania,22,252.87
06ed44255b5e44c7a6c1bc5f6080ad39,42,15,27,Oceania,23,422.86
06ed4641133842099572ad4b34763dcf,231,177,54,South America,21,1597.41
06ed821867cb4ae7974b8a13cb7da36c,355,303,52,Europe,21,2190.55
06ee06a2f3934b22a614f429445d10c4,222,203,19,South America,22,1798.69
06ee907e31d243b0a136347adacff6f8,239,198,41,Oceania,20,2092.07
06f0514282264607966090de258694c2,166,126,40,South America,20,1246.98
06f0521bb13346ff942f85417a719981,68,23,45,North America,24,327.09
06f282079931472c93e64f1eb5e9dc68,175,126,49,South America,18,792.31
06f421a9bd8d4850881eb46c28ce1734,335,287,48,North America,24,1603.38
06f61214abca4b89a908e41256058c1e,120,81,39,Africa,26,1081.83
06f63c55b0d84528b8e1723f89665d93,98,66,32,Africa,20,835.07
06f927871c4d4de3bb392d3eb2cc1984,132,93,39,Europe,28,736.61
06f99f68720d4cbc9db6ab674565fe50,202,165,37,Oceania,21,1257.99
06fa2261cb424cc38c60f11d11a6b9a3,74,32,42,South America,23,701.58
06fcba0dc0a74839aa67df6dcc34fb54,340,289,51,Asia,18,1355.47
06ff7ea54c564ba98e06b9434bf27f04,228,203,25,Europe,20,1509.5
07029d9e72f1475f9e65c969cde6c9ff,301,272,29,South America,22,2378.68
0705a7fab44f4bc1920a8057a455d8e8,365,364,1,North America,21,2329.46
0706f1830d594ee287615ddd8092db45,231,173,58,Asia,22,1302.13
070702d6955d4e7a8212a35eeeed202b,336,292,44,Europe,17,1583.62
07088475d1ff45a6b794c780d51c9fa8,332,286,46,Europe,17,1488.32
0708ab3b5a574f8bb3b020da9cf799fe,176,118,58,North America,19,789.1
0709ffc7438f4f70a854c005c212d5fa,110,83,27,Africa,21,762.57
070a6aab8e604ab483d5791eaf9f0efb,238,198,40,Africa,18,1181.69
070a6e86c74b44b98b4741886ac51bd5,365,356,9,South America,16,2385.53
070ae6681c764e1a885cbdc04eb3bf1d,244,213,31,South America,22,1275.48
070b548a665a40dbaceffd03dba98187,92,69,23,Africa,23,684.91
070c2c28b55049a99f05ba9c82f2b7d4,224,181,43,Europe,22,1506.57
070cf2d556304772a3cfc6165dd45a16,58,32,26,South America,18,542.16
070d1f5014f1442a95a7ef16b05f76ee,278,244,34,South America,18,1898.1
070e013e7ae2454799785d9bfeb64eb0,364,348,16,Oceania,23,2551.17
070eeee22de640a7bb16a8a7f2ca3df7,171,135,36,Europe,20,1368.55
070f452721a74d47b03b7aa71da22989,264,233,31,North America,19,2066.91
071064c339754e758a742ca0990a6015,198,145,53,Europe,22,802.6
0710a2ad9a8547cd9820d0bf3d226d08,256,208,48,Oceania,28,1736.29
0710bb9fdf01406fb94e295961cc7069,364,351,13,South America,23,1276.6
0710c18a7f4942eaa1dfb758fa3fb4bb,101,46,55,North America,18,206.51
0710e14c8e394b0fbc0554cebf39aab5,132,99,33,North America,18,937.37
0711a4a97a7541279e3c704c3c9e6dbe,351,317,34,Africa,23,2329.85
07121169bbee46b89c29c63991fd7b8f,331,307,24,Europe,20,1423.51
07124457f4d142fbab740c14461ed531,49,17,32,Africa,19,98.65
0713708d2d8c43d6b68cd8137bde9fdd,344,286,58,Asia,19,1755.67
0713c385fa44468294d30423dcd7cfcd,150,94,56,Oceania,15,868.27
0714b6644ee34d439893b91152aabb37,348,299,49,South America,16,2109.59
071773fd3af9470b8b2b7f453f912cbd,62,24,38,Africa,23,534.15
07177a08790643218449bef25c229295,221,179,42,Oceania,23,1420.18
07185061432f44849b619d593f37a84d,237,208,29,North America,21,1738.42
07188715e4cd423b9a2894b4f8a1656d,329,298,31,Asia,31,2483.04
071c63dd698341d593d95c9705a9da87,233,186,47,Africa,24,1999.95
071cb92b5b3d40ccb587fc2d26404605,196,151,45,Asia,17,1231.13
071d0109fb1445169cef391b316f95e1,61,33,28,Oceania,27,320.55
071dd48bd0364bcf8616309491801b53,166,145,21,Africa,21,1018.08
071e2dbe4d964960b96bf3c0ebd98e51,112,88,24,Oceania,20,685.79
071e7cc8504d4c4a90008e3ae0a761a3,229,192,37,Oceania,19,1141.09
0720346383094d78a8e46e5f5aad5831,242,188,54,North America,20,1264.27
07219e47adfc4d3c84a60468786185dd,347,328,19,South America,20,2525.03
07225f168b6a4e779753cadac170cdf6,193,135,58,Africa,18,608.62
0722b3595ba1430c838920b18b4b9892,128,94,34,North America,18,908.62
072581ba1d7c4141a81f292e32a80f89,347,303,44,Asia,18,1902.75
0728251d2a3e4673b6e02fa72def47d4,169,153,16,Africa,22,1461.72
07303808454c47e0868950eba8a59d2a,365,356,9,Oceania,21,2188.2
073702a1d4a842ce8526445029980d43,287,243,44,South America,18,936.47
07370dc7734c4b749de391bb8d96e2a7,278,231,47,Africa,20,1409.35
073902cd62fe40b381f713db4cb559a7,163,134,29,Africa,18,1030.72
073bdb8b1f19422ba3dcb5ca5f997469,150,105,45,Africa,22,955.1
073cefd3f0354695b8ebf032d8e81a75,361,328,33,South America,23,2744.79
073d14d1482142f0a9f02e996682cc12,309,263,46,North America,21,1682.88
073d4cd150094f688ad9736478fa7f71,280,242,38,South America,19,1382.91
073e226425a147bf9c85df95d956426e,292,263,29,Asia,20,2248.31
073fda0da86e4e2cbfd05cb42b93a59c,329,279,50,North America,19,1314.38
0741b266e91747a28af7ea42f98a318e,216,173,43,South America,19,1333.19
0742161f2f70470b87ac644e323560ad,269,225,44,Asia,18,1280.24
0744d18e9c894f92bd3563a3a77b6bc5,283,240,43,Oceania,23,1976.77
07460d27e03a4f1ebf53e165336bc6cc,364,353,11,Africa,23,3069
074749637fce42ac869e6d14e59bc565,277,239,38,Asia,22,1939.52
074f6573fa9e4b7792233f66b1a8f8dd,76,28,48,Oceania,21,110.31
074f919f1e7b49e4b56c2e75234e5c8a,184,124,60,Europe,13,1247.41
074fe5dfe1e94e33b9ad8ef47b1fe578,250,227,23,South America,18,1780.06
075b1fb7bf9d41198672122e55dcfcf8,289,267,22,Oceania,17,1870.63
075d2f1df00c4b31989272556383e9ab,365,349,16,Oceania,16,2189.65
0761306768fb4e4e9f186f65b63fc0f7,197,157,40,Oceania,20,1002.26
07619b52c5da4f4ca4c394207c5071ca,347,318,29,South America,22,1704.07
076227210cf2448a91bb0b9d9d446bce,156,106,50,South America,19,658.07
07628acd11d846cfaa78355f46edab65,63,32,31,Oceania,18,635.8
076539a718ca477b92e22311240ad52e,332,305,27,Europe,17,2870.14
076547c486ae46c0912e85d30a50a2e7,45,22,23,Europe,18,307.84
0766a7895865454ab3943a4562023acd,349,324,25,Europe,25,2062.29
07693ead964643149a78862e7b0b4310,253,204,49,Asia,23,1121.33
07697dd2553d4515b7c5a0e0f0357044,67,33,34,Oceania,21,413.67
076d39564a734ccd9bfc79741587a5f2,196,151,45,Oceania,22,1022.3
076ddee87a6d42179929e9283bc5c59a,45,16,29,Europe,18,304.24
076e30e4b70340a38cec3ae4df50f1a9,151,120,31,Oceania,14,664.74
0773691eb3df4584818daa9aa5e1e9cd,54,9,45,Africa,26,152.14
07739bcc22e7497e82e95ed386716bbc,193,152,41,Europe,21,699.47
077408e59ab34e65b287caae13f2f333,231,180,51,Asia,17,1437.79
0776408fe725499fa7383ffef758099a,300,246,54,Europe,20,1452.63
0779b47d16ec48caa1aa399db3c31582,211,164,47,Asia,20,1279.92
077d18638dc34c3bb4947d0268d1eddf,83,36,47,Oceania,24,380.04
077d649d48d74bf5af7879e01f8da6da,127,80,47,Europe,20,802.67
077decd94ca5441c8cfefd09c73ff051,346,307,39,Asia,15,1617.76
077f23da321842e3b568f1605e3f8a71,214,161,53,Oceania,24,1893.53
077f7bd90e63414b9cea7a051e99f90b,294,244,50,Asia,22,1326.87
0782be415fef4971a115b028ce7c15d3,58,15,43,Asia,15,175.33
0786ec46a62c4bd3824efabb9d8a82b8,338,293,45,Europe,16,2405.04
0788f715ba004299a831106bc4a57538,77,34,43,Africa,24,583.38
0789c5ec11d440ed81d9aced12fba011,221,189,32,Asia,23,1571.76
078a64b3dc2844bdb7e1e0e0ad625664,265,230,35,Africa,24,1675.45
078aa37d368f46c5864a08a0b2398fe8,364,345,19,Asia,23,2375.16
078b39fa289b49d5817706166d61bb6f,126,89,37,Oceania,22,917.52
078e2faba6934e1590006e1c402a1345,309,265,44,Oceania,20,2226.75
078ea6bac3c8409281d87e3cc68f9d50,334,313,21,Africa,21,3064.67
07928575baa34dfaa85da1891024a464,309,259,50,Oceania,19,1421.06
079445ce414648ac8f54841fa1a83b96,198,144,54,Oceania,20,1028.35
0794d5d696cb440ca211553c2616aab0,363,361,2,North America,21,3040.78
07950a716bad40b5b8f078aedbb4b3a3,199,178,21,Africa,24,1610.47
07996ee03585418da38ecb6d0de62321,279,235,44,Oceania,16,1545.59
079ea5fa865e4bc58bee28f5a9ec42c7,81,40,41,Africa,19,638.67
07a14920d0eb4b199c4a9a05d0ab5632,102,45,57,North America,17,886.68
07a1b731008243bab87927fb11eb7316,123,94,29,North America,16,954.36
07a2e54f41eb44519fba90a91377a1c2,203,161,42,North America,17,1569.71
07a43496153d496395d279a9c69bb0b8,55,37,18,North America,24,303.79
07a52c8aacbc403587e5c64bfbd63165,364,359,5,Oceania,21,1630.94
07a6d6bc77734ef6b58c1fdcb7ef2301,360,335,25,South America,15,2300.25
07a961c556164dffaf10dac3f346c151,112,82,30,Europe,22,1000.75
07ae3988b3fb4ea09eb45eb73609163a,365,362,3,North America,18,2968.51
07ae729f762349998546d236be169bac,199,178,21,Asia,21,1478.7
07af04a7327448ceb432cbca57215c19,86,41,45,Europe,15,571.19
07afe69ddadb4d2c80ddf24f25dec4fc,280,245,35,Asia,18,1618.87
07b25c84584843e18c72eaf477a99db4,278,250,28,Asia,28,2281.41
07b2b39ac7ae485b80860428062a8c4e,63,50,13,North America,19,717.87
07b3b8a936424de7b751e712f201e290,204,180,24,South America,27,1562.08
07b41e61fbbe44b1b53e564315003c7f,147,108,39,Oceania,20,1070.32
07b4c62ddb41489ea163c251dffcf062,129,101,28,Europe,26,1162.5
07b5ed7fa098406e8d16ab4fc66a4078,192,156,36,Oceania,17,1653.42
07b79d52d16e4c3c904348d5741994e6,93,62,31,South America,23,913.76
07bacedd75f44c1d80ff8893fdf16977,181,152,29,Africa,30,1072.91
07bba04b0b4b43f6939dd928a5db9b17,364,334,30,Oceania,15,1526.97
07be9433fce849879a2e6cd3582f8f88,163,140,23,Asia,20,1428.64
07beb8cf0e024cb5b47891af314b676d,188,172,16,South America,18,1395.75
07c0452b32bc46d6b35084a74819ffce,108,63,45,North America,17,408.76
07c1f793d33d4569b722ed67d4e4a56c,151,125,26,Asia,22,1304.72
07c2ce233ee141f58d568feb5c3c084a,266,232,34,Oceania,14,1513.24
07c49d54e2594e9db148631a9678263b,182,131,51,North America,19,1181.97
07c4a50ce47448778ba622180a5d0b4a,174,139,35,North America,22,1143.18
07c541dc351f41208f6af5f06642c7dd,298,278,20,South America,23,2393.73
07c5ca19d1384c8da0302853c4cb4608,212,165,47,Oceania,15,1296.39
07c62b5fb9d5478695b434a0b683b58f,352,319,33,Europe,27,1993.98
07c885410de24bacad8e743ef4e2713e,266,215,51,Asia,21,1221.73
07cb03dc72134fda920db976feb5d3b5,211,173,38,Africa,25,1050.09
07cb45c81d934841b390b7c5ae359ad4,364,322,42,Africa,13,2417.79
07cdc6d2570e4e1fa8320af31a04fcd6,108,65,43,Europe,14,825.85
07cf797059bc4a238683d523b96d0214,105,80,25,South America,25,724.59
07d01b01c1a04363a124e6a18ddce770,299,250,49,South America,17,1614.28
07d17b65d306462e9874bba307a6da32,356,315,41,Oceania,25,2099.85
07d2ba95da344c70ba17f84f3dbbf899,296,251,45,South America,23,1304
07d3ea81aeb54e9fa838674efc62dbca,65,27,38,Oceania,21,524.98
07d9aed9f7dd4d898cacafc6d6893502,363,343,20,North America,23,3355.72
07daec41fc694af593dbfc1661a76a08,364,357,7,North America,16,3063.19
07db2bde0ee749be998c6bcc4ba44c4e,289,232,57,Africa,13,1882.43
07dc59e9805b45d2a05c0f407f82fe59,338,302,36,North America,22,1785.36
07e0370c67444ffdb8257b47d91a88b1,227,200,27,North America,19,1849.04
07e074a345c8492c8fe23ef504f5f9ff,329,298,31,Europe,16,2410.7
07e29c113432477393d8bbde15392567,267,233,34,Africa,20,1600.78
07e320cd1aef4c8d981d11bc1c89b28e,306,287,19,Oceania,17,2252.9
07e3f506f5b044b0bf40842d63ce08d7,77,50,27,North America,18,571.44
07e6388444874ed1ae3f66f518ec5693,335,311,24,Europe,18,3007.6
07eb28769fc049e1828d7e6299fec0e2,358,322,36,North America,18,2345.44
07ec324196904567bb3d0f074d367e02,221,184,37,Europe,26,2032.28
07ecaff9871c401db976e126dd609616,202,175,27,North America,19,1325.34
07ee09a5054f4992b60f0505048e7733,234,181,53,Oceania,19,1111.61
07f035083f0c4fb1a96baf8e777cd331,252,214,38,North America,17,1344.55
07f37eb6bc81447a800f47808d5beff2,365,345,20,Asia,16,1599.96
07f39f5f7d46405f94143f3175062d58,345,293,52,Africa,25,1578.52
07f8fd9b50af4d8cb46e61cbb11b3e55,340,319,21,Oceania,29,2573.6
07fab05bfa2f45d8bb5797a2cc1f2848,344,298,46,Europe,17,1428.61
07fabcc78d684909b128b21ff5108f23,283,253,30,Africa,18,2175
07fbbdf10f5448aeaabcd30654eb48b8,105,56,49,South America,17,241.11
07fc2242c8f349d6997c85635842f87f,225,175,50,South America,20,962.35
07fd526c4f954f8a93eb5c66e6e96c07,349,296,53,South America,19,1775.01
07fe654f6ee74da299b08c2d5af29692,338,304,34,Asia,23,2571.73
0805f24c61154a19ad2bdaebd7df6218,363,351,12,North America,22,1419.47
080713f69cd24206a8d5af182d0c9ca8,153,111,42,North America,19,863.39
0808272d132746a0babf38180859cfc8,187,158,29,North America,23,1302.43
0808b3705e404fefaa45676825f8d210,161,134,27,Africa,20,1490.23
080b7711bdc9464ea49499542fbc092a,170,131,39,South America,15,1179.46
080c882486f94af8ad3c12db209ab5a9,365,360,5,Oceania,22,2155.85
080d2fb33b7c42a7ae9134b0191c44e2,297,258,39,Africa,14,966.37
080f7cd978d24e15ad2d8fb3051b9217,291,249,42,Asia,19,1810.55
081199c0b7e14346887522b129a0dc09,84,56,28,Oceania,24,727.02
0814525951064f13a9d8087521170418,180,143,37,Africa,26,906.48
0815b557862649ac868c3b172f36d15f,273,252,21,Asia,22,2461.72
0817880d9f6a4357bf86530d9fa48845,66,37,29,Oceania,17,208.84
081828283eb14c3ca904c197e146a1f4,169,121,48,Europe,20,1155.07
08196191989f4660a67efa8741383118,176,131,45,Oceania,27,646.45
0819c4d28b804f398408f3f55d5700c0,135,82,53,South America,22,706.86
081ca6cb955044089dfec2ea9b581060,104,55,49,Europe,21,799.6
081cd07ce9644333a1896f70a0ee91c7,111,65,46,North America,22,679.68
081f3d2df53446a99b576815b2fe3f37,336,290,46,Africa,16,1620.18
081fc74fe24247d59375c82366aaf510,325,275,50,Asia,18,1842.95
0820ba71f851444aa5b797c59965eb7a,250,201,49,South America,14,812.88
082295f1b91f4074bff80b8ef4ddec5e,364,335,29,Oceania,19,2432.78
082418d742984cdca42b0cc7361c928e,180,149,31,Africa,18,536.06
0824efba1eb74b41a1030b5580d2c8e3,365,339,26,Europe,17,2007.29
082511890a8c4e86b96c2312816d7771,256,228,28,Asia,18,1968.1
0829250f7c854daea5641ba2d45c7924,39,21,18,Asia,27,68.23
082bc2e4352e48539f92adc9da162260,267,213,54,North America,17,1919.03
082f52ff96384b208856cf3e3dbea981,160,132,28,Africa,21,1106.31
082f78329df74a9db63dd79fde853c6e,98,64,34,North America,24,1226.94
0832397a8f2644dfb57fa4cb7934e136,348,323,25,North America,23,2199.89
08335578f3314a79a0545109a7c18c9a,146,106,40,North America,24,1104.1
0834293fd2c745a59cf05c71988b4f88,95,40,55,South America,19,503.6
08355211f6004270bc11cf42e81ca6c6,152,96,56,North America,15,1093.6
083bee55f68642ac9f76198ea945630b,145,92,53,Europe,13,856.74
083ce9d049044449a32fb10f51e6a47c,236,206,30,South America,20,1946.72
083d1342aec245a180c8da36bdc7279f,363,323,40,Oceania,21,2065.7
083d4b51e0b84288a0d962a6d3d737fc,364,318,46,Europe,20,1982.21
084139ad07fc4c11b9d5c81db1dd2ea4,132,105,27,North America,21,598.61
08429b8bc0e846b2a95eecb8cde46aca,143,114,29,North America,24,674.87
0844547edd7c455d80486a0d497ec7ff,278,249,29,Europe,24,1711.28
0844958c57024cbeaec02595a3376f62,50,13,37,Africa,18,285.32
0846201c27a04c6e957843d2f4a6b5d5,78,27,51,North America,20,315.7
08462179103342f682f5bbd1e40f0ed0,165,131,34,Africa,25,1158.46
084a0cedb1854e1786cc4c4814e5e9fc,175,130,45,Oceania,18,930.03
084a1bc89c5f453bb0965abfa43dae8e,40,6,34,Europe,20,110.47
084af8454fc84085a14424e087007f01,94,74,20,Asia,15,955.65
084b83f45a084ae799ea2d0e65b6b589,36,12,24,North America,19,282.1
084c064215bd43f6b4c5ba55ad3ec3f1,283,269,14,South America,23,2292.39
084cce8824594b7dbf0e09677a77f7d4,360,318,42,Asia,19,1112.8
084ecd6620e249a39368cf627f752218,296,252,44,North America,21,1786.48
084f7d9d036a4a23801ef8443cb1ad8d,272,252,20,Oceania,16,1923.24
08517efb6f064f54b274703241ed3346,254,224,30,Africa,23,2001.55
0857bc51fa9d4b64985669d2b02b6146,353,323,30,South America,23,1735.48
0857ce6f54044f789d0f0835673b8480,317,277,40,Africa,22,1628.44
0857e5b686664e2782e44f3d73355e73,254,206,48,South America,20,1455.46
0858b9af5e92431292e10754d3d2c7a1,364,311,53,South America,25,1716.56
0858ef0eb372465286d2aa074129c2f3,243,212,31,North America,26,1117.31
08596312ca7648b0a13bb3ebd01d01a3,117,78,39,Europe,18,605.31
085f82e9dc694210a28c1f4a15c2fe51,213,164,49,South America,22,1462.75
0860162cd3c94a77bf7d679205302371,277,255,22,North America,20,2405.25
0860eac2f2944206be471c5f74643a61,350,318,32,Europe,22,2393.49
086462fea6a34ce9a57a88ab37f90025,49,31,18,South America,16,404.62
0866f0d300b24db5822496be954178dc,229,198,31,Europe,22,1661.68
0869273a66b74215b2d0af688ef0e1e3,365,365,0,Asia,23,3098.33
0869803be3654dfeab1a62b63b92e493,364,339,25,North America,21,2096.12
086a47a5b7da4888af8fb1cf87af25f7,197,161,36,Africa,19,1440.31
086d901659e7405c8db483f4a54f5604,338,292,46,South America,23,1933.8
086f695fddd94658b6172cf3905a7e0e,114,76,38,North America,16,521.51
0871807108a1498c817e7dbe78036d6c,68,40,28,Oceania,21,678.03
08740ac89d364652b5156b3646313c3d,302,281,21,Africa,20,2252.21
0874dc827f804b52a6d2ff94f873f8ef,259,237,22,Africa,21,1592.75
0876be9a46c8441fa7e90fa662f88d3b,365,354,11,Europe,25,1890.07
0878078ea6934239ba8d7bebe53571ea,105,68,37,Oceania,18,550.51
0878806ea8034f27954e917ede6fea10,113,94,19,North America,14,701.2
087b35714b4645998b26174ed5658d20,148,105,43,Europe,18,458.11
087c6a19454b40c6ac46a287e65982b2,56,9,47,Asia,17,167.76
087dd5df58e8473d9d6952fa53de86f2,91,39,52,Africa,16,589.14
087ffce706ea4a089a836d36046aea38,43,15,28,Europe,24,481.34
0883b79721294d899428ecf407959280,261,225,36,North America,14,1106.73
0883ea9133484fecbef833478167a38c,161,111,50,Oceania,26,784.09
0888514891224ca79f97986466324123,155,119,36,Africa,21,1520.51
088bff759c6b4c7f96afe075aa03887f,365,352,13,Oceania,19,1738.03
088ecc73a3b64b29a0e9654b46e0b9ad,60,11,49,North America,17,443.45
088f3de370af48b097f1cb89234b0ef3,302,269,33,Asia,19,2345.35
088f61d4e86b4b93bd758a75ed4378f0,70,32,38,North America,20,418.38
0892554e61bb48b084679c6a0d627439,252,232,20,Europe,15,1952.66
089387af95394bbfbe7216227fb41e1d,332,301,31,Africa,23,2695.21
0893b65b8685405caf8a6fda9a5c7ae7,204,148,56,Oceania,18,1625.83
08953cc13b7d4eb1b6412c892339a1b2,165,135,30,Africa,20,1081.25
0895c1f1683d4f28a5a9a2968fedf899,365,331,34,Oceania,15,2395.42
08965d5491374c4885d763026621d1b9,118,69,49,North America,17,391.8
0896c94d64c24235afa41de06d39f234,363,315,48,South America,24,1803.47
0897cc93921a401cb61c6d0a6c5fea67,238,194,44,South America,20,1984.58
089882f279c943b6aec9fbe83f36f440,104,63,41,North America,21,670.55
089896a5c72c437282539a89965aa787,259,230,29,Asia,25,2419.6
089927912d664327984746a5ff793e05,327,308,19,Africa,20,2764.81
089f117a364b4f07a4e1eb9558b0aed2,358,322,36,Oceania,22,2210.13
08a43fc750a34fc294ca3952e28aef24,281,232,49,Oceania,25,1197.36
08a4fba49d79457d96ec24941b9ad1df,278,243,35,North America,19,1912.63
08a62e28b30647838d64b2352d5b272c,214,178,36,South America,19,1379.93
08a880519e594d88bad0c0c08da085ce,303,258,45,Europe,22,1597.84
08ac2ac269e74d37936a094927fc947c,214,193,21,Africa,20,1880.82
08ac4bffaa8b435b86f9f43bee2aa6bd,364,331,33,Africa,22,1816.8
08acdc9158d94cc1b36af9a6bcbaf18c,179,140,39,South America,22,1544.54
08ae1cd9b1bb4fa9a2bea68336bc0c67,79,35,44,Europe,22,512.04
08aef9b3262a433f96d11663106446ed,237,204,33,North America,18,1206.79
08afebd9e4814bd7870a9df3cc8a5c97,344,304,40,North America,17,1411.07
08b5e169ff594153a2b7a28b84032e9e,348,301,47,Europe,20,2697.88
08b6561ab634406ba05788da5a8455b9,365,342,23,Asia,22,3235.05
08b6fecabb204602abb2ad9d105735d4,100,75,25,Europe,22,785.21
08b7e6ec044349f68832e5dbf3b660df,191,165,26,Africa,20,1406.35
08ba44de7f1340c4b02c9592b906ed50,362,324,38,Africa,20,2665.96
08bcbee8a68f433ca91c951a8af539a1,364,363,1,South America,28,2505.69
08bd0bb8849d4136a42071897abe1443,296,270,26,Europe,20,2457.51
08bd2d78f3e0403580df59fdcd72d632,196,184,12,Africa,21,2214.51
08bf3e32d6f3481a964c85cf7bcd6ce9,126,82,44,Oceania,18,752.98
08c2f2c5261f476593b211540d84d1ba,49,15,34,Africa,22,858.21
08c441a59d864b23ba379426f11b0f1a,82,44,38,Europe,18,526.7
08c4a68ebf1d4beeb764fd9969354bf3,158,118,40,Africa,18,1502.14
08cca738b008417e81b48dbe4c1287cb,359,350,9,North America,19,2413.77
08ccae045649404b944cb7dc21fba992,141,103,38,Africa,18,1026.55
08cd62dfbbfe42d7b765a89bfb7cb097,310,263,47,North America,16,2095.62
08ce83f609bd4c9289a3cc253ffa522c,271,220,51,Asia,21,1381.63
08d05c69e77f49bcae347093a60956f0,59,20,39,Europe,20,338.34
08d2d2f0390d4220af2e3f132c0decce,122,91,31,Europe,23,1037.51
08d322b9555349f1abfdf9679c93f557,126,87,39,Oceania,20,803.48
08d3543dc3cb48faaeac60113864cd62,109,65,44,Europe,29,417.17
08d7744204dd43858cfc511542b80098,155,115,40,South America,22,663.18
08d900ff9ff7422aa49668b4e3adf938,365,343,22,South America,17,2191.2
08d9e55cfe094ceab29519592bb18694,365,353,12,North America,21,2638.96
08db1fde562b4b07805bcd0dab0ec550,313,279,34,Asia,18,2333.77
08dcd1188bc8463f9f25e586dd6775ba,22,6,16,South America,26,232.44
08dda686dc3949a2973d3fad8522fc5e,183,150,33,Asia,17,1233.38
08e04eb5d7584d5a9a759c480d285c75,83,45,38,Africa,18,592.42
08e2c3baf5ed42fcabb7a41954d9f3a9,205,179,26,Asia,20,1404.79
08e37bc9f2ba4356aa84563f33b341e2,290,252,38,Asia,26,2264.17
08e3cfc614a84002bfcfe4032089c2bd,364,362,2,Oceania,18,1983.34
08e42cb1c39b4450810bc8f0b75a9fa5,359,343,16,Africa,21,1823.13
08e4384f84984326808f5450db170a7c,218,183,35,North America,20,1302.92
08e4b53e6a054ec3a36e901c61f07d67,300,274,26,North America,17,2322.09
08e80246f0e4422881b5acc8dcd399a3,180,152,28,Africa,23,1401.12
08e83f9aa1bb4e9282b8a8a70c8c34b6,339,296,43,Oceania,22,1898.7
08ea249f65984c0aa880a701de8e7477,359,326,33,Africa,18,2814.63
08ea68015a344fe5b7b20e87676e478a,135,113,22,Asia,16,817.06
08eaec1f8f5d49a985ab5742ab263f0c,290,253,37,Asia,24,2540.85
08ec15f7c2f54a93a3692c00ee844682,137,109,28,Oceania,21,725.98
08ec3dde9b87482bae3a0abf71252291,214,165,49,Oceania,18,1269.54
08ee142b1e1142ec8ea0b203a9364084,118,95,23,North America,19,581.67
08efc2714df04297b3d81fa485e12a4e,355,301,54,Oceania,22,1624.4
08f18b42316b4a3a9e998c789b72a2e5,131,79,52,Asia,19,703.29
08f3081010884d91b2f0bab0f0e54f3d,364,351,13,South America,18,2509.23
08f577ac7357496db95e4131e0fe4069,114,79,35,Europe,20,484.68
08f625a28d1d45a5bfd9b670f670330b,342,307,35,North America,20,2446.14
08f9ed73c9fc457d997b7cfaa53bcc01,183,154,29,Europe,21,1596.55
08fa875f89e2475990d67f5b5215757c,55,33,22,Oceania,18,459.25
08fb64c6bff74a3daf7868a6bdbc943d,82,41,41,Oceania,15,277.09
08fc7487dd614e80996f74f9894cc803,227,184,43,Europe,20,2236.15
08fcfe0abbf74e9d9dc0acd6d286d402,166,112,54,Africa,23,843.88
08fd579514ce459aa8e4f90c62ff9eea,50,14,36,Africa,17,265.17
08fdcb83f3ae437ea457f2c417291042,222,196,26,Europe,22,1949.23
08ff7ec9f48140cfbccf74eab9183c30,180,135,45,Asia,21,808.35
090077755a574d6d8cc4c62e12a49c15,346,322,24,Africa,24,3148.57
0902cb93b0464026947db31278f7b649,187,140,47,Africa,25,439.57
09037fb44f4f4fae948325113f599ac3,197,146,51,South America,23,554.55
0904fdd60cd44cdcaec3154792d7aa7a,233,198,35,Oceania,21,1820.54
090548acd6fe4fb3bfa8617dd957c851,35,11,24,Africa,20,89.41
0905bcf79a334cdabdacf7e62de2268f,260,222,38,Asia,20,1390.04
09065cb176d74fb1b8cc6f0a8c6e490a,68,32,36,Oceania,20,417.62
090664978eab4310a410133e063d818f,122,94,28,Oceania,19,1468.1
09078bce28434eeca8a7d69468410347,299,250,49,Europe,18,1469.43
0907c382a61b4e8f963ba8deff5ad7ab,82,26,56,Oceania,21,842.12
0909faecae73421c8ba3f03386a167f3,288,237,51,Asia,19,1698.75
090cd7775c55470dad4bae002f13e5ac,110,69,41,Europe,16,710.07
09100c6bf8cd4845836444e05ddc4cf3,186,147,39,Asia,25,732.98
091094f1a0054a909ac0cdcd8197104d,59,29,30,South America,18,354.29
0910ba59d97141c3a8456617ea01a9b1,294,239,55,Europe,20,1692.94
0911cfa34b9f4628aede3f8975bea51f,313,264,49,South America,17,1469.8
09131e173a05462f9e0a893f20c86c1b,163,130,33,Africa,19,860.53
09132a41099f4bbe9f205c484a8740c0,362,325,37,Africa,19,2627.76
0913fad9a8ba436d887bc4eec74d71f9,219,194,25,Europe,19,780.87
0914002c34fa474cbfd300881b989672,314,259,55,Africa,21,2086.97
09176c2b519e46898c0efb02da86f335,63,27,36,Europe,23,335.22
091caf44d6ac4a15a093675f9e401e53,210,174,36,Oceania,18,1165.35
091d3b6d0bb94a52a12dbfc8807165ad,365,331,34,Africa,22,1804.94
091f3ae4c91848ec9fd36327c75e5273,236,207,29,South America,20,2121.4
091fa5e0e16840e891a31e8e54a70a64,364,317,47,North America,22,2085.64
092332dbf9fd4cdf92239286d3360566,231,192,39,Europe,19,844.34
09237a18a39a468b8aa3159abf8b4509,174,147,27,Africa,20,1335.36
09264db336254df582e052b3c21b597f,365,347,18,Asia,19,2866.18
092736df721f4e60983fab0760923a4d,137,88,49,Oceania,21,250.6
0927e3d9329c4a67a858ef08d3425008,301,286,15,North America,17,2596.75
09298b8a7a7943b4a4df27629faf1a57,325,290,35,North America,20,2288.79
092a97b763e24043a5e45cf09ad2adf6,340,303,37,Oceania,15,2773.55
092aaced197942ad88af58865da9bac3,123,69,54,North America,15,480.67
092af68295a943d8a511e176e820f5cf,330,291,39,Europe,18,2234.42
092bc3c71e0a4d6e8c1689fb3152ff03,210,170,40,Asia,22,1025.16
092e464006dd4aab9f9cfb281c4747bf,115,71,44,Europe,20,806.93
092e76bcc4e94a3ea08d49e83cb0d535,137,82,55,North America,21,735.65
092e7aa227c74d93a08e32be116b42dd,74,32,42,South America,18,271.58
092e7f8140b643a3b5dd541a213ee78c,234,214,20,Europe,23,1520.99
093054d54d5c480a8aecc4535b87d511,76,23,53,Oceania,24,259.78
0935d187af204657bb78e56697cf65c7,307,262,45,Africa,22,1450.35
09373b0bac744f9da9d7cbe3a4d70055,323,278,45,Africa,22,790.47
0937467884154e2b978e1ee5eb45a7a5,50,13,37,Asia,17,12.39
0937ff4183a34d7185ab57e5cac86c0a,99,46,53,South America,24,618.22
093af6f6ceff422d9a27064158cb44b3,198,153,45,Europe,23,1070.51
093b417d18144cd284826a2da429ad40,237,218,19,Europe,21,1990.08
093f44903e1b41378bf9898d26ef4efa,69,15,54,Europe,22,474.07
0940e289bfa34603baeeb061a379fe1b,299,271,28,Oceania,18,2404.97
09438e3d9a2a437697fce4f5428b339f,174,143,31,Africa,15,1076.93
0943e93caad24c47adac1473ba308a6b,201,146,55,South America,17,993.78
094400e1b5b642a2a637b579343f2e1b,208,182,26,Europe,24,1722.1
09446bfb70e242329154bab9af7d0f80,59,32,27,North America,18,539.23
0944712d3ca3446aa23c31136993d715,39,10,29,Europe,22,176.62
09454b33a3694aaba2672b9c1a08b423,209,171,38,Asia,22,1214.06
094616ac4e5342089f5baa0927d25084,365,324,41,North America,16,1635.2
09463e92101c42528b5659dd8e478c01,363,360,3,Europe,23,3081.21
09465450a3154059befd39a6e5368f94,184,162,22,Africa,23,1632.55
09466baa558b47d1bc3160773f6d86df,365,329,36,Africa,25,1911.63
0946fecfb07542a391aeae4c9300ae51,30,6,24,North America,23,286.1
09472df58a484ac78c4bec5e6da14464,244,212,32,Asia,22,1816.96
09475a63b3a14f1e877f769b999e537a,142,84,58,North America,18,881.85
09476c82614941ee90db903e65162d91,180,153,27,South America,18,1826.99
094a202aa96e4ef89e0e4532ef3998e5,363,316,47,Africa,27,2309.79
094acf10ea204a30a4b4b11e55780ebe,151,128,23,Oceania,13,935.4
094c1a9c3c3e418fb5a0d7f586767a1e,193,161,32,Europe,19,1647.33
094d8c0c51e54c44ab5a1978d76d0252,108,71,37,Europe,16,563.67
094e5f000a8d4944b1336172aff8fbaf,191,143,48,Europe,23,772.47
094f59f647a94ed48d5dacf881df8cef,253,205,48,Asia,25,824.05
094fc628597c4cacb0b6a42454c26d5d,347,321,26,Africa,20,1952.64
0951f579caf14fde844f94fe7d62e42d,284,245,39,Asia,20,2392.33
0954bc44dd6c4801aa857c137a283295,300,250,50,North America,20,1515.16
095a4df63f7f446ab4aecfd28a7fe21c,109,55,54,Asia,19,457.39
095d15c1313a4cce9845e690d664e536,70,31,39,Africa,12,300.32
095d5413d2454d2f89f978ae4220beda,112,85,27,Oceania,24,877.24
095e0f8f0d744b6e9bc4c1b780755a53,365,333,32,South America,16,1605.32
095e995e252b41909540b6d8997f46a8,216,167,49,Asia,18,1166.18
095ee568d29d40aaa801dd3e7b5dd83e,331,316,15,Africa,24,2929.27
096743bbf20d49ad82b9e1c079769bde,230,208,22,Europe,19,1879.5
0967c19b7d8f404c8110cfe113007d46,56,33,23,South America,22,845.34
0968a6e280b2442593add10abd30c0ba,365,358,7,Oceania,26,2730.82
096bb99f013542d3bbb6a43700ee6093,104,69,35,South America,21,848.21
096c47562ee04a20b7706ecc00692a7a,362,332,30,Asia,25,1996.3
096d0ca3fbdd43f5a4583564f13fa887,152,131,21,North America,22,793.14
096f30e7bf58423b917c59b37d41deb1,79,42,37,Asia,22,594.03
09735cb5ba2f4b1fbc90e6ac1e989cb6,78,26,52,Africa,20,223.81
09740e4121de431881464c357b032774,356,319,37,South America,22,2706.2
0974288164ce4fb685922f5650a8bd38,323,286,37,Asia,21,2320.2
0975157d09ae46389b02c2951374acac,236,190,46,Europe,17,846.51
09771d4122484576ab1ede2eadd43e2d,353,317,36,Africa,21,2481
09774c842d0d40e3a8f56b53bf08c08d,83,41,42,Africa,13,762.98
09789787d72c4a6cbecc22ec6c6975a6,243,216,27,Asia,21,1961.45
0979f1fc3eea43749eb3cf8f07104c58,165,118,47,Asia,19,1000.29
097ad98ba73849abbddd9ad841d7d088,199,173,26,South America,23,1640.29
097b91d7fe11494789c369893daf2403,233,198,35,North America,21,1343.96
097c5bd98ad943669f2726dc2eae760c,358,329,29,Asia,17,2803.24
097cffd9a31b41daa556100d01d400ed,321,275,46,South America,19,1793.92
097da43b00c1473cb260605398a75029,157,137,20,South America,20,1408.53
097ddb3402634988b6ef40def1e4ce8e,211,172,39,Europe,24,1387.4
097dff08822949d2938b46509dcc5fd5,252,234,18,South America,20,1888.81
098297385eae40dcacbe2ef84d350e75,341,301,40,Asia,22,2393.41
098310e88c2a42edade93b9b8083ea09,84,57,27,North America,24,588.14
098589dab8b547a2bdf23f23327ab9dd,193,163,30,South America,24,1294.87
09860e42350542c59dd8589318670e2e,119,65,54,Europe,15,689.99
09876ba3f6934224aef126b11a68503a,365,333,32,South America,19,1972.04
0989f7c7840645a4a8bb48eb2c75b0a2,127,99,28,Europe,26,808.64
098bff43ee0a400e9651fefddfe26fc1,316,259,57,South America,21,1478.67
098ca08af3ef4c5aa67b8170f5911704,266,221,45,Africa,18,1287.63
098d30aad1a34e7e92297e53d642f381,228,190,38,South America,19,1622.07
098f54ed40074631918f25fd761ae809,40,15,25,Asia,18,164.67
098f87c535b0449499bb6f960bbedcb6,34,2,32,South America,20,209
0992e9b8c1c248d6ae41afdc84f10f94,322,281,41,Africa,27,1638.25
09931287ff3f4a2eb882fa2a796dc09c,64,12,52,Oceania,18,299.22
0994abd0b9a74c39b6729d18446d7bb3,320,267,53,South America,15,1961.46
0994e4c8050f49b987895fa3e9a73546,221,201,20,South America,18,2007.63
09951766af0541deab98cc9819d6ae7c,63,11,52,Africa,19,402.59
09956ef3bb9848459e9110aafcfb317a,364,350,14,Oceania,21,2407.59
0995c30d9f304fd8be1357ce6a69c754,289,246,43,South America,17,1478.56
09963abc1ae340018c46d6cdf3bfb5c7,361,326,35,Asia,20,2394.25
09974250150d41408b69200f8e8a5739,289,247,42,Europe,21,1417.91
099b9e765bae4b4d887f5b7c86776af7,72,31,41,North America,18,295.88
099c0c71a0864a95a98de233572eb801,131,105,26,Oceania,26,1359.19
099d6088008246488e856cc6fdd6c3ea,351,307,44,South America,15,2065.58
09a0ed81f668437599a1505883d5a482,153,134,19,Oceania,14,1054.48
09a0fafdb50648d48a0a15fdfe2eb982,352,327,25,Europe,23,2404.32
09a4ca4f45c148c9b033aa4360f38e91,144,106,38,Asia,10,1147.65
09a4ebefc0d44d84988deb194521949d,329,277,52,Europe,21,2083.31
09a91a9b3c3444f0894c0fbc9cc57c28,165,118,47,Oceania,20,1092.81
09aa1ea65f9a4289bcb7a712e1d81199,337,312,25,North America,20,2677.2
09aa7256642a41faae72c6cb29e0b6bc,84,31,53,Africa,24,429.4
09ac2429e9ad4f9592dbdacde4827978,181,132,49,Europe,21,1176.75
09ac6f64a13044c5a525c4700e9813c7,343,304,39,Oceania,17,2012.26
09ae6d5ae8284d03aeee9edce31c7f3a,115,84,31,North America,20,525.53
09aea0feb1fb45b6828d7ef6e89f4b27,149,100,49,Europe,20,448.16
09aedfca0ffb4dea8fd5d7a5a1dbe47b,91,33,58,Europe,13,329.57
09af77fd2b134359af0e70df25cf6fc0,312,277,35,North America,19,2522.94
09b17b457b5a4b19a5dca1499399aedf,215,170,45,Europe,19,1308.62
09b3963cf3684b8d837e22e1ecea58a7,101,63,38,Oceania,15,869.42
09b4ef3cce644faea1a3bba1680b8fea,45,19,26,Africa,24,119.16
09b513d7499c4c528c0b9067146940d1,206,164,42,Oceania,21,1355.62
09b51c3dc803477e8975805d809d2936,365,319,46,South America,19,2009.03
09b5a63324e54a3a8b0c7174dba79459,353,299,54,South America,24,1408.66
09b621b8284d4a3d810c6b3f82c65334,323,293,30,Africa,17,3107.38
09b94fda3fb942449f60edeb3f65d699,274,220,54,Asia,22,1273.67
09b9afc13c424a0884dca5d9076a6b72,304,260,44,South America,21,759.59
09b9e70507d348ef8ece1f2841c2440a,143,92,51,Oceania,18,969.65
09ba0192c6844a09b17ba0c81573c402,295,248,47,North America,22,1109.89
09ba17fdc41a4fb585faa2831266978c,121,79,42,North America,17,388.11
09baa28ca92442efb48bc4564c72f675,337,311,26,North America,19,2887.8
09bac36590be4c3fb7b6596289b2297c,116,81,35,Africa,19,589.29
09bba78074284a8e8efe350c196ce2ef,305,258,47,Oceania,22,1757.85
09bbf2ebc45d4a7780f5e0b3394a4f53,364,355,9,Asia,16,2935.19
09bdb94daed64924abdb9054cd576944,40,1,39,North America,23,96.44
09be86b913784cacb34ef7b8b1a2a2e0,334,293,41,Europe,20,2215.67
09be872e9d4f43e6b1ef8b38d8e8bf59,165,132,33,North America,24,1351.62
09bed5cb244f45fda23a59864d445408,63,23,40,Oceania,23,564
09bf673fe0594352bf28a2f9c0b59fe3,152,122,30,Asia,20,582.87
09c06647a2b74fdbb502f97e79ded1e6,136,86,50,Asia,19,993.21
09c35d544a634535a989df5c9b60056e,93,72,21,Oceania,16,1063.67
09caad86284c4c27bf6ba91c81aee5d8,363,357,6,Africa,20,2723.47
09cbca431e934174a418c7d6124552b5,68,23,45,Africa,18,739.91
09cc3175824a4577b5d363b0a03d28e6,365,355,10,Europe,15,2357.76
09cc47d9f0ed41e290f9ebaf5527a855,151,99,52,North America,21,746.67
09cc7c8463894c219784c63c9d5b135e,180,155,25,Africa,19,1387.65
09d015c6a15643c09ae0ebc977146713,336,283,53,Europe,25,1463.9
09d306d7c88b44bca90afd3ec43cd476,77,21,56,Oceania,25,277.21
09d38f0de3a54900b3ca2defb3634aa0,64,22,42,Africa,22,667
09d3b799a3fb499db4fc34d3a7120769,226,176,50,Europe,20,1271
09d3f0e464524a409829f307a3192c19,243,206,37,South America,23,1725.84
09d66d129c8448a09b23fea65f91f099,323,299,24,North America,22,2435.63
09d751b44e2e4120b02666af86b690d9,282,257,25,Africa,21,2903.37
09d7e9db7d194eb99566bd3ecfe19f0f,48,16,32,Europe,13,512.09
09d7ea2a6dcf4ed39532393bfd7d09f9,338,292,46,Africa,24,1592.95
09d83f6bded8422f832d3b3ca3a554c5,118,87,31,Asia,16,1266.19
09d8807d77d84a0290dbbc78fcbd97a4,365,364,1,North America,24,3121.61
09d8fa454a2440ffba3862e9d38fbe14,96,54,42,Africa,22,640.19
09dac693e1ec4d5ab506a8fe117615aa,50,36,14,Africa,22,334.62
09dec353f58c4227a4835133833dac6c,196,166,30,Oceania,19,1676.83
09e01a0ce6c64c15b23b5470f48074ca,133,109,24,North America,20,897.96
09e1a28a35db4a2fb04170acda513c62,337,277,60,South America,23,1950.71
09e1b47b79694b77963ed62d4cb5388f,104,52,52,North America,18,565.61
09e268200966470ebd2e2f5667b90cdd,116,79,37,Africa,22,918.01
09e4ec68af8e40519952653aad844c35,295,270,25,Europe,26,2091.19
09e638f4571d49abaec0691fd26ec930,137,86,51,North America,21,655.77
09e6df6cc9104ea7960780e3304968d5,271,246,25,North America,18,1844.73
09e7131b2c4a4f38a5d83331f33eb26d,144,91,53,North America,24,693.7
09e789f80819473bbd2467243079a940,77,36,41,North America,22,1011.84
09ea6c2bbca346be85d0a0b2ead3e60c,212,162,50,North America,20,774.65
09eba69a0c40486a956778ea3898c4cc,209,161,48,North America,23,946.42
09ecd3428d684611abe31fbe8d30715c,86,49,37,Oceania,18,457.07
09ecf677d9154e8fad10d562719ac530,83,30,53,North America,22,440.88
09ee502099db4729901cb69c88aadd1f,363,354,9,Asia,19,1943.23
09eeefe5b4364a9181ec16634ea056dd,275,245,30,Africa,18,1906.91
09f0829da84644388990f2c1afa53372,107,52,55,North America,19,376.17
09f17283dc124a0ca8ed96d66eb1c97e,315,265,50,Asia,17,1984.63
09f4d523679e46a5855320daee7796af,294,244,50,Europe,21,1153.92
09f4e53af0ef440da3bca8aaaa0b0c30,300,274,26,North America,19,2192.49
09f5ee02757846c0a7db3225f301b2cd,108,50,58,Asia,18,226.56
09f7fc53e7ee4b72ad4c55f91822a285,38,2,36,Africa,24,35.27
09f8deebdec2468abb932330ad93cd2e,296,257,39,North America,24,1835.53
0a00989a26194d4c92e5e609740e4131,192,167,25,Africa,20,1192.11
0a039e5f72894ecda1c94314b1cf4225,81,63,18,Africa,19,599.68
0a05f9ad5f654be797741e0c8098ecbc,139,101,38,Europe,23,1197.05
0a06ab67f13f478f8ac2d6574138d2a9,114,89,25,Asia,21,793.52
0a06cd5239784103a33444d1a1b4c1fc,67,18,49,Asia,23,294.41
0a084a10fafc43d49d4047b0b181e41e,119,67,52,North America,18,537.79
0a0c3e726d0d47379d073fb2b553c2b5,64,18,46,North America,24,374.1
0a0c5c686db84e6a9762d7a0bd71b6d1,151,110,41,South America,20,1158.92
0a0c6ba5f2644094b83891edfc75d21a,113,55,58,South America,15,251.23
0a0d10b99b33446499dce0c152cd2d9d,138,105,33,Asia,21,653.24
0a0faf457ef3468db892d79de17b57de,123,81,42,North America,25,728.03
0a10b91271d34bebb404f4b9c2aa868c,352,315,37,Africa,18,2229.86
0a14829de50d4d9e92d70d82470f4ac0,44,23,21,Africa,21,301.32
0a14a7ed7fb44387a83e22ea8e524cd2,206,179,27,Europe,15,1532.12
0a16b13900fd41a6a158c1dd06ed2f34,289,268,21,North America,25,2028.89
0a18018afd3441e3a07b2d822bda92be,356,332,24,Oceania,13,2562.67
0a1b9e31b3fd428e856c905036fedf14,195,172,23,Asia,19,1319.18
0a1be8c184fb4bd8a1c46d5379e49688,276,232,44,North America,17,2218.4
0a1e8019d7f7426586fbbf1b4558d911,279,254,25,Europe,15,1815.17
0a20004621e54bd8b1d743089c86ff67,294,250,44,Asia,19,1494.89
0a20c497d9ca417d9fa3df535beaddab,365,360,5,Asia,20,2423.55
0a23775b098340e7bfd3dbc18a9f7106,78,52,26,Oceania,21,697.57
0a245e7561c8428f80c19bec9337f63b,246,220,26,South America,20,2058.35
0a24caf67497470286cc5284e63f4e32,38,14,24,South America,21,392.17
0a278d9bdded40b7b88a6b3cbd014168,230,186,44,Oceania,14,905.88
0a287341c8fd43269c1f0b14744a6359,279,250,29,Oceania,16,1792.01
0a29bedb5d4b4677825e5dfb5433d126,245,221,24,Europe,23,1631.07
0a2bfd524e224f2394727064f826967a,55,1,54,South America,24,255.48
0a2ca7c1581646bd896a0f0b33cd92fb,181,136,45,North America,24,931.52
0a2dd464866b495d8f0af9c16d7ea7ba,275,239,36,Africa,21,1923.15
0a30ec09f2a14aed8bc9ea73d594fbc7,153,112,41,North America,17,449.49
0a319a19018e40eda4fcf4ffc0e7b4cf,46,16,30,Asia,19,329.26
0a34d3fd535f42909923b0fd9378ac64,58,11,47,South America,21,329.57
0a389f1347a949988826f58fe6648b5f,330,277,53,South America,20,1518.6
0a390c12287747f58dcafe8c164b6c84,307,283,24,Europe,22,1871.67
0a3994196a5b4c32a21d043ebcdb595b,52,2,50,South America,23,236.73
0a3cb2ed48424ead8d5087fe46170b9b,163,137,26,Europe,16,1761
0a3d61d4c59f4f61b59aa7c744ed39ef,54,26,28,Asia,19,319.36
0a408ca2401c443cba5c3434cfff6b2a,147,123,24,North America,17,983.31
0a40fee2052d463e86709f7992163c9a,35,11,24,Oceania,16,204
0a41ae6abd244becb366489436badeb4,365,339,26,Europe,18,2745.38
0a43c7f2f9b74dc5b2fa1bbbd0862914,117,78,39,Africa,21,668.13
0a43d380dc724e4dafc280f554ad791f,178,143,35,Africa,12,1240.84
0a46ac7ba035402fb8c998f316081b23,364,360,4,Africa,21,2088.13
0a4833c2103946a791289e7f2bae7088,235,218,17,North America,17,1685.24
0a490b1ddcfe4518a3b1fc9859139a8a,229,181,48,North America,16,1036.09
0a4928ac05f140a08af851503b9b2aa6,180,143,37,Europe,19,1167.58
0a49c46e457a433cadcbd97d157885be,361,321,40,South America,21,1778.54
0a4b5ae50694406f9a9c901dd51ce0a2,331,306,25,Oceania,18,2405.46
0a4b60b4f4614d1c9a1b2cf983afce4c,153,117,36,North America,17,880.02
0a4b60d543df4d718c309e5160b658bd,71,48,23,North America,23,420.98
0a4d6010f4144f359c60c5607321456f,364,324,40,Africa,16,1877.69
0a51bb9b1f794b1bb03c98bb7239bab5,235,203,32,South America,30,2755.42
0a51d3cf34ae497eb82c1d3c9b9e07c9,69,29,40,Asia,18,595.02
0a521db1ba3843a7939942d3a810f0ed,359,305,54,North America,28,2672.13
0a527e8427484bf59b2e85e906e9f23c,196,160,36,South America,22,1580.99
0a55f83230d6443db692e1648d0957fa,166,124,42,Asia,19,1258.28
0a5710ed389243828fed14303fa21145,87,48,39,North America,19,748.15
0a58c872366141a481e63355ec4e9f82,79,52,27,Asia,24,515.98
0a58f4d124d04edbabceb1f1ba732838,316,272,44,North America,22,1385.99
0a5a049879484a6495fe3572f7cfab90,274,232,42,North America,19,2571.85
0a5bb6a5a4e444ec96af3c07578ab953,361,354,7,South America,13,1863.31
0a5db49e21454f9fa9bd3464fb163e9a,291,238,53,South America,19,1285.24
0a5e8fa74cfb47d9b1bee4df4c314887,326,283,43,North America,21,1550.56
0a60ad21a61544ea9e74c1a99ff2b5f5,207,161,46,South America,15,971.32
0a6215b0e4ec4607bd9134e4ac652950,90,49,41,Europe,23,475.8
0a629cb183f5443f99f5cdf5b253219a,211,195,16,North America,21,1593.5
0a63e0ba17bf4180b5a1974097c27301,323,280,43,South America,21,1917.07
0a661e8ba64845dd99fee8a46a295619,360,336,24,Asia,16,2895.9
0a6644124d954d2f97ae534f942e1a9c,363,342,21,Asia,17,2044.77
0a672f85e5e54a569e4700df7a810c9b,290,242,48,North America,19,1035.63
0a67ce44cc8b45fba4292d4ed9265d1c,55,32,23,Europe,22,306.87
0a680f5297024afe908765265e8dcfab,294,262,32,South America,21,2851.7
0a69a37f7c064eabb5e275c9306d0cd8,178,164,14,Asia,25,1888.46
0a6b09de54a840c3ac5e13c5d49e60d4,184,148,36,South America,17,975.93
0a6b8f6100c24fd5aac08f54c2fe70e4,227,183,44,Europe,20,1795.49
0a6c56d4e2944deda9200fb065405a0e,110,63,47,Africa,18,645.2
0a6ca7ca57974974b450b00709da94cd,106,58,48,Asia,20,830.16
0a6e1831135e4806803d9b0979c573ab,213,180,33,South America,23,1746.88
0a6e5bdef1464a3ca6b6481642c381a5,93,71,22,Africa,20,676
0a6f7d4b7a964688bcc3a107258f3b96,45,2,43,Europe,19,245.53
0a70d957cc184b608af5df06ac71d6c8,255,224,31,North America,18,2621.52
0a715ac2dc4b41718495444e8bad4575,70,18,52,Oceania,23,376.67
0a73825dece842e481d11ed1a468e826,266,223,43,South America,20,1538.23
0a748b65a242409a96a217aea45ba638,313,273,40,Europe,22,1861.56
0a7701e8efa64d388c2b7967c2db729e,313,279,34,Europe,24,2110.16
0a777670e8d64bd2b094466919cbfd39,164,113,51,South America,17,961.39
0a7829ef0acf4868b28e0e861f62c94e,256,209,47,Oceania,19,2155.2
0a7a11eadd054396a27cfd4bf4740cda,313,266,47,Oceania,22,1982.57
0a7a72d616a942c892009fb1a35268ab,185,148,37,South America,19,1101.21
0a7aa607316844499a99146fa5f38d19,174,150,24,North America,23,1394.13
0a7b90dc3982447a95dda620ef6a3f3c,364,354,10,South America,27,2912.24
0a7c853f27fe46ab9abc96ca126561e3,290,266,24,South America,19,2423.43
0a7c987b9fd749cfa12744c70583f326,259,226,33,Oceania,20,2234.17
0a7e21e3e2bc4ea4b5c56403da23aa07,361,357,4,Asia,20,1742.93
0a801ad730bf4a44a8ab5aee985c4b21,260,240,20,Africa,16,1955.57
0a849da34ef24292a6d3ca81bda5298b,85,51,34,Asia,19,550.49
0a86f5006ce3465da3f612107e06e47f,110,78,32,South America,14,580.31
0a871616f84b4c2c819c0885f4690ef2,335,300,35,Africa,21,2665.13
0a8742b64f9747ffb405656cbcfc3ce8,323,268,55,Africa,23,1588.73
0a8c7fe7e7064d43a186598e9c42c489,246,212,34,North America,24,2302.8
0a8e52c4e9364d3fb045e4bed626f33e,284,251,33,Oceania,22,1439.36
0a8e59d373d545cf9bdf57f5f8774930,279,247,32,Asia,22,2607.16
0a8e99c67b4141aa80a1a9da3a9e9954,347,318,29,South America,17,2891.36
0a8ef7c41ef044d0b07b3919c05f9c0d,273,233,40,Oceania,18,1202.37
0a9019a762114cebb89ea2a820fe8f88,361,349,12,Europe,18,2132.13
0a91a1bbc22943caa8c785e586f67e9c,213,179,34,Europe,22,851.97
0a92a52284974a36b0577f4a2c11f179,353,307,46,Asia,23,1595.49
0a92fe538ae34909a396144affee269a,365,335,30,South America,18,2315.25
0a959e057c5445bd8f098725cdb82452,79,52,27,Europe,19,1083.88
0a97258c79b4433395a10d93542c4ce2,321,301,20,North America,19,1987.67
0a99b36294b84fd886024823ebc48058,219,171,48,Oceania,15,1136.35
0a99c8c0ddf749c99db0f65f11f981cf,363,335,28,Africa,17,2954.97
0a9aa4f08e3f44a3aab318714bf4c05a,105,73,32,South America,25,489.99
0a9c03725f21420f8875d29fa2af14dc,217,171,46,Oceania,21,1711.83
0a9dfbf2587643b789216f6ba457de2d,106,76,30,Europe,22,931.06
0aa1e22ec7a246e38b76eae5d1c38df9,32,4,28,Oceania,15,340.52
0aa3802df2ce465c94fd2532f215963b,268,245,23,North America,19,1992.56
0aa38df4c0594c6b89691c7fd38f5303,190,139,51,Africa,16,1053.09
0aa515f05bf8422e91c9b9b62a2f44e6,336,313,23,Africa,19,3042.18
0aa6b0e43c004084b42bd76ba6981e24,148,91,57,Asia,27,734.97
0aa6e778b9694c22a97e1c292444c624,53,16,37,Africa,18,424.72
0aa712dd3e174bb88fb56efca85c4c54,36,5,31,North America,18,217.58
0aae4f787ea948f49b55207aaef0f68b,263,236,27,Africa,17,2261.27
0aaefcd019584fa68e24e491e97d037d,361,325,36,Asia,26,1789.14
0ab21a76c9984ceb91cbee25d20eaba2,195,156,39,Africa,17,1019.36
0ab2271959454b46bf86cbe146e579e7,179,163,16,Oceania,22,1095.57
0ab54623ee574be384f3a610046dfee9,352,319,33,Europe,24,1758.98
0ab621150e054cd59b93dff910c1576a,362,328,34,Africa,23,2538.64
0ab6d035912846ddb2035733bf8f9d36,365,315,50,North America,22,1734.64
0ab8896698224449a5065083a8f9b961,196,157,39,South America,22,1126.03
0ab8b5e9261641dc984b06a4cb880db1,258,212,46,Europe,25,1107.29
0abc20a509e444c983e37d1902bf7847,272,222,50,Africa,20,1129.42
0abc5a1a14e3463ca00aeb9b04bb473e,311,270,41,Europe,14,1595.93
0abcec15747e4a1ab1f675c5954a6dbb,133,95,38,Oceania,22,1053.15
0abe7e839dfa4b95926c6b138958cb1a,104,86,18,Africa,21,844.7
0abf888c13034e43bd50e678f73d3a59,121,99,22,Asia,17,1061.63
0ac2b436630546d8a779687a1c31c6c1,48,21,27,South America,20,474.27
0ac33321bccb48b08412fe45e7b3d97e,356,330,26,Africa,22,2274.76
0ac3c6f64fe3479a8e302b7df9dca34b,197,156,41,South America,20,1256.36
0ac6129ff6b542328d61341156c59eee,363,349,14,Oceania,21,3101.97
0acb4b8fb9c34f07a9d0c75254f17f5f,133,91,42,Asia,22,236.86
0acb581ee09e4abfb682eece58fff2d8,119,92,27,Europe,22,958.71
0acd79665c5648d3b6ab180944d04516,118,69,49,Asia,24,498.14
0acde86afd434c6e98af40924a8c25df,116,82,34,North America,20,731.06
0ace906e045d489c893a1b8b0b090f62,32,5,27,Africa,22,293.3
0acead8396ac43b0b0e9b39d69c89be6,250,201,49,North America,23,1520.22
0acf20c945d84e9fb4daeca7f0b50816,38,5,33,Africa,17,520.59
0ad020124ac547209126b0fc28e89d20,132,86,46,North America,18,905.83
0ad5502a99bc4b51a8d193b25432fc4a,321,271,50,North America,22,1597.57
0ad58841fd4445788b7cd7e115f45542,106,78,28,Oceania,21,775.55
0ad98772ee7b4a799e1ae7a3acc8a3c2,257,228,29,Asia,15,2306.38
0ada3a29f4004129847c0d85009fab47,122,87,35,Europe,22,897.08
0adb014d22324a79b2fe286df9fb6b67,119,65,54,Europe,18,419.5
0adbee45544a46f5b127bdc18b62c269,170,118,52,Europe,16,749.5
0addb14a486b427db7dc41633fdd8b2e,332,314,18,North America,20,2333.57
0ade526b91d14eb8a5565ca30b7df1cf,359,326,33,Europe,17,2621.59
0adfaa80dcb64e61b8e949b13aadb0a3,74,43,31,Europe,27,447.48
0ae1a6e5e55e477f9d632bf71914dbfd,365,343,22,North America,20,2162.88
0ae216cac85447289c95192f1dfecf6d,311,261,50,North America,19,1901.45
0ae51ff04ae9496fa0f4d08bbceb4bb2,155,105,50,Oceania,22,494.21
0ae547b6438249de98dc6187f9e85218,349,321,28,Asia,20,3153.05
0ae55fcefdbe476899f9b16348ba947c,221,175,46,South America,16,1371.85
0ae7cd1d2a884fb999f9d1551d9ddda2,245,206,39,Europe,22,1498.46
0ae8cdda2a32419ea64cf412421a34bb,243,220,23,Asia,23,1717.26
0ae9274fad144811a35041f076e7be90,229,203,26,Europe,18,1331.75
0ae9c0e195c647e0948f81432a1feaec,136,107,29,South America,21,976.58
0aeaf848de3b4e9db16c52095446fc8f,200,180,20,Africa,21,1506.16
0aec6d2a551d4a0980f6797d29282e6c,212,179,33,Africa,23,1614.97
0aecc44fbf3a48b292e5141f5f6fffe5,197,147,50,North America,16,968.71
0af358aff1fa4999962f82cfe521be53,148,111,37,Asia,27,953.93
0af3bbebcf324f849679a97a53d1c0ae,302,261,41,Asia,20,2308.96
0af3f757f3f74de39a19d644d20f5e0a,60,36,24,South America,19,227.67
0af446750acc4877b228f62b78e638cf,346,323,23,Europe,23,2115.66
0af4f0dd660545e69605afacca0608a7,74,33,41,Asia,22,909.84
0af674664ce84b1b9f522bf0eb4019fd,186,156,30,Oceania,20,1345.86
0af7546eae00482da9fe2f672eca9397,329,284,45,Asia,18,2609.16
0af806d8a2c0450799c3cf5ca28c0087,365,355,10,Africa,21,1909.38
0afbc35f581a4e00b7dcb95e2cfc5922,203,148,55,South America,22,1481.53
0afca9e9df184b5080128ce0fc1a308b,112,67,45,Europe,14,462.39
0b0018ec772742fc8903a2a7ab5ab9a0,148,112,36,South America,20,876.19
0b01e6219d074ecdac27287837ce45d9,351,332,19,North America,24,3206.05
0b03476328634a48a313cc1bdbf0a75b,348,324,24,Europe,27,2173.8
0b049fd04d984727816abdd6bb924d0e,72,25,47,South America,17,361.99
0b051aeb9b3845bab7afdfd85b3c9d9f,98,70,28,Europe,23,491.95
0b056d2a2a5b465fa72cbc315e7acb54,65,22,43,Africa,20,529
0b05b65b09d641db93a9759e12c780ee,52,13,39,Europe,14,531.63
0b0789b55d33481cbabe4633d47c065a,311,290,21,South America,24,2013.97
0b096a1782f042afbfdc233a5e3efb5e,332,306,26,North America,21,2386.57
0b09c8c13ab5423391ebfc5318f2c287,40,12,28,Asia,24,373.93
0b0a55f516d941f9b8a89efd00f4e4c9,329,309,20,Europe,21,2343.01
0b0c5d1c4ac94b2ea35c3245d62c47f1,66,19,47,South America,19,260.62
0b0c6fdfbc224ed6a933f0e563d5c8fb,282,248,34,Africa,20,1758.58
0b0d3d07f9ae4c349082ec9e3cc6cc3e,293,246,47,Oceania,24,1183.54
0b0da3993ed042e49a8cec47cc2a9c80,109,79,30,South America,25,993.38
0b0ee0efd6b642cd903b71b6f093fe36,212,166,46,North America,18,1374.57
0b163753579546f9baf5d1e7c04e4f00,55,30,25,South America,17,378.95
0b1644a2bab14d28b19a44fe61a31808,120,71,49,South America,25,482.51
0b177a624e7a4d179f1bac310b235791,148,104,44,North America,20,618.8
0b1b813bde8f49c68eea50634284a052,329,283,46,Europe,19,2290.23
0b1be271073a4697be7973478f4eaf21,357,329,28,Oceania,21,2442.16
0b1c0ac486d1438bb92aae3263399b76,197,176,21,Africa,18,1068.37
0b1c8eff2dda4336b89440024659431d,365,325,40,North America,21,1912.64
0b1e39c3e5fc45d289f2399e6818d66c,244,200,44,South America,14,1286.26
0b21e3d68f1045ba81bd3eb3ec79c358,114,81,33,Asia,27,443.43
0b23b88428854cea8481f436c893b6d0,172,134,38,Africa,24,1333.24
0b2460d7306641409c543b24e05bb3ed,318,281,37,Europe,16,2396.48
0b24d83ff1404756934e40d0cbb366a5,89,50,39,Africa,20,882.67
0b26640ecba14a3c9d65a69ea4659091,141,101,40,North America,19,1182.72
0b28724a1a4e48d9a06729c7a4a9d097,319,284,35,Asia,24,2082
0b288cc542664e4ea11660c563d0d9b7,134,82,52,Africa,20,526.2
0b29dfd73e7b42ba97ad73d121b0a121,219,163,56,North America,21,689.7
0b2ace2cbb4949519d5d3bff0a09e809,296,260,36,North America,21,2024.9
0b2b8d9764e648acbf19123f9f3f5b21,362,353,9,Asia,21,2074.09
0b2df1ceea5345a798fab6d1c662ef06,94,44,50,South America,21,194.45
0b2fc718f4ba4df7ac5197b39bf47562,334,310,24,North America,22,2376.19
0b3025ffdb8047b69feb32a04bcfbba4,200,174,26,Europe,22,1599.73
0b3055f2666e42cb9cdc04712fee93b7,180,136,44,Asia,24,1164.7
0b30b923f3e04579ad4c6007287135bd,342,292,50,South America,16,1667.89
0b329a00d29c4bfda838cec01946a036,286,256,30,South America,17,1695.49
0b349751fcc64f83be65a1226c45ae52,302,277,25,Africa,18,2795.53
0b382a13322445dfa2bab6244be0a52e,90,37,53,North America,17,835.54
0b3834b336af4dce9c0a963d375e673d,164,138,26,Oceania,24,1710.48
0b3a52733ffd424d8847b21f38e0b562,159,125,34,Africa,19,1748.64
0b3a8842534441c98600982d7bf82658,83,48,35,Oceania,19,742.45
0b3bfab2cbb74a4c8cf968b225e49c4b,337,310,27,North America,16,3693.76
0b3e55996b044579b85cff48a7047639,132,112,20,Oceania,19,880.62
0b424dcea36b4fbfba47e3ee450d5372,114,60,54,North America,18,833.03
0b42ddc8c7294ac387f8aface742ca4d,149,116,33,Asia,19,1442.04
0b44539aa8004b9d87f15560faca6d44,112,79,33,North America,20,797.91
0b45545da87744ebacc87ca89bbf0ddc,264,237,27,South America,22,1608.73
0b46042eabde40beb312feb453e40b2d,48,12,36,Africa,21,237.51
0b46855730164bb4af3f3055aed5b8c1,91,44,47,Asia,22,404.26
0b4777d76fe840b0b7465937451578b1,104,58,46,Europe,21,446.23
0b477aef0c90495f977c030207a79e3a,295,244,51,North America,20,755.71
0b5000cbe89b456e81aef7811f7496aa,355,326,29,North America,17,2652.24
0b50b88e85fe44759a2f3b177366ffa1,236,209,27,South America,18,2528.49
0b55904b944b4c3197bd8564bdeb342e,180,126,54,Oceania,21,1098.96
0b562d4cfd0a43d29ee2e34abc9a9111,364,323,41,Oceania,20,2553.94
0b56fff9cd68444590dbcee9c4c632c3,312,286,26,North America,19,2948.58
0b5981f21d3c4e2b9075c9ed56ba8169,104,82,22,Oceania,22,570.05
0b59ed417f7c4c51a7a2b5c5ac23fadf,362,337,25,South America,24,3035.97
0b5a88dd14814f328459a39a85276d2f,355,305,50,Asia,19,1937.64
0b5ae945efb94cbb8cbbe9fbc1f8fdc4,364,360,4,Asia,20,2002.31
0b5c388f86d743598c33056c920b3d6d,81,54,27,Asia,21,526.5
0b5dc70ab8aa41afb856e1bc4ec31458,364,337,27,Africa,19,2059.98
0b5e50f5408542c6afa9f327125d4106,170,124,46,Asia,19,1104.36
0b6050dad7e64d37824c39af4c668e08,116,76,40,Europe,20,744.66
0b609c1759854c60ae51812785d7fb71,309,280,29,Africa,20,1771.68
0b6313135f664588a7098f3b1db47bc3,364,353,11,Europe,21,2175.91
0b68150343f34cd6a483f18bbfaafe16,69,34,35,Asia,24,358.22
0b6815c5fe494f9595c6c0b975ef058c,111,79,32,Asia,18,707.89
0b68adc6be04452b938db5534995e822,324,298,26,Europe,22,2269.29
0b6bfa9b35584d98beaf073dbd239e7f,243,219,24,Europe,21,2184.38
0b6c83423db2435a99bcbcfa37fb8747,58,22,36,Europe,14,503.76
0b6cf5a73b054ff9a61acac98f24bc7b,89,44,45,Africa,25,631.01
0b6d52ed1d834083ac8a160c62625536,200,150,50,Europe,24,684.06
0b6e465e417c4b4a851ac99c823af2ba,217,190,27,South America,20,1152.82
0b6fca3cadf14c758d8b4856ae427047,56,22,34,Asia,22,209.61
0b6fe10319384587a0e758e5ed03a659,256,215,41,South America,15,1598.93
0b705af49ddd43aaa5f96d442bbde8af,212,197,15,South America,19,1326.02
0b707287d24041f9aeadc1eff64970ec,32,15,17,Asia,15,302.67
0b70a55e69f647a199fbaf0d43e31878,262,217,45,Asia,22,1481.11
0b712c0f3e924fa8a6844a37e7d4946c,365,345,20,Africa,21,2521.01
0b7291adaf1745ea89c0fb1588b40eb5,118,91,27,Europe,23,995.92
0b766df49d6441beb68fbe0549dd3f45,335,313,22,Oceania,19,2892.53
0b76d05477ef4536b9c2f822bfd338ca,175,123,52,North America,21,1357.94
0b780f77e4a94818ab5c0097a44d37b6,241,206,35,South America,20,2077.73
0b7872da823445f397569937b345d699,363,346,17,North America,18,1506.82
0b7a718e41904e189e62abfc0e83f1fb,72,53,19,Oceania,18,644.08
0b7c95394f6a4fbf83d7c2d84e37e89b,90,41,49,Africa,19,364.01
0b7f9813a57244808fdfdd8528e96ae7,365,318,47,South America,19,1958.66
0b8047b0f8654e05b831a823ab858a44,61,30,31,South America,23,355.77
0b80f0dc45a0440688f0696a6ee8f342,135,94,41,South America,16,930.27
0b82266d4bc4484b89d4abb1773b51f6,323,275,48,Asia,19,1926.2
0b839c9607044e48b267f6647ad2a8b2,58,32,26,Oceania,21,359.87
0b846f621a874cd4aa6944d37fb11e28,193,144,49,Europe,23,1100.51
0b85a93ee16e4314a1ce789d78efb780,56,31,25,Europe,21,275.61
0b86b43581504da59551f696d2a3f686,365,351,14,Europe,17,2167.6
0b877efeead3494db996232f44e49e15,109,70,39,South America,18,359.29
0b884efc27e1486aa74698f717792a27,57,27,30,Oceania,22,345.23
0b886346357b45df83d2ae0586db96d2,365,340,25,North America,19,2194.31
0b88fb42dc4a4a4e9fd0700c42bf0846,364,345,19,Oceania,16,2313.98
0b890d67034545d59ffaeac3bcf57159,351,308,43,Oceania,18,1882.56
0b89bd33c33445b18a2672d558c0db63,289,257,32,Europe,24,1607.87
0b8b127a69bd46de847f3e7cbd82858d,362,347,15,South America,19,2382.03
0b8b5633cf754c138def05d19908f8f0,364,349,15,Asia,21,2412.18
0b8e9ae9126d4d45b4ea36b920752948,213,191,22,Asia,16,1497.73
0b8fe32810e2448caba6b8167cd1f87c,364,363,1,Oceania,18,1247.71
0b9235e5460c474d875f14ffc5add6d8,285,241,44,Asia,16,1547.74
0b9338cc6d494fc3ba0d7cdd15efd492,365,361,4,Oceania,22,2735.66
0b94a98c1d16462fb90a0354ba408bd1,214,182,32,South America,14,1542.53
0b9517746d7c41f9b374ad2b714c6b87,339,298,41,Africa,21,1960.25
0b9757db02fd4139b38fa1466dcd8a20,66,16,50,Asia,18,330.2
0b9794c7ce1c458fac52bd2b1889cbc5,314,264,50,South America,22,1506.51
0b998ca13cd64495bdb13444f5706e41,169,132,37,Oceania,20,1366.59
0b9af11620c1499bbba138ee7e79c2f0,264,212,52,Africa,19,1236.75
0b9ba75fd093494fbe2571052b279f7a,121,74,47,Africa,20,367.17
0b9d4ec5214647fda21cf3c66b89d0a8,81,40,41,Asia,22,576.51
0b9e52bbef1a44d4b0bc15f1940d675d,42,18,24,North America,19,188.54
0b9ec5272d3f4875abe70170493f34ba,351,316,35,Asia,17,2206.17
0b9ee549e2ae47f7b5c57bea06989521,162,105,57,Europe,22,520.89
0ba0468f35b64662afa5b017d6668a50,109,65,44,North America,24,508.64
0ba0df16c47e4df1be61db38a05515a4,94,76,18,Europe,16,821.23
0ba1c66c39e2484fbad65ddef3b43420,364,324,40,Africa,23,1909.71
0ba29e5dbd934ab5b251bdf0f0296539,330,286,44,Oceania,23,2000.86
0ba43c10175a4e00826647ce16ad32c8,57,17,40,Oceania,21,349.44
0ba49b49e19d47879d945c38826c31e3,96,57,39,Asia,21,915.82
0ba53f37b83d4cd99792f81193882110,295,247,48,Oceania,17,1692.93
0ba5a294d255465d8846a9cc1175f5df,110,80,30,North America,16,760.19
0ba8b14595414de3a7c15e1c2b4b000e,198,151,47,Oceania,22,806.04
0bacdb2f40dc47a7aacaaed2837caabf,153,97,56,North America,28,791.81
0badbebed73d4d8b96edca0352477153,345,321,24,Europe,26,2100.72
0baf0dbf1f484617b2e635319bf47cad,223,194,29,North America,20,1556
0bafdd55825049fd82ad848daf8e3bae,242,226,16,Africa,20,1488.49
0bafe8c090cd45e4bc0fff954de9c4ad,306,253,53,Europe,22,1668.51
0bb04c7cd66e46a09a6d38d3d7dd4f98,330,287,43,Oceania,19,2510.18
0bb0bdfb35794e8d8dbee1c5daf1c0d7,257,212,45,North America,18,1661.17
0bb56e2693c641c9901cd15e83d7509f,357,321,36,North America,14,2254.81
0bb7fcd234614a85954a2598ed3a0806,116,82,34,Africa,22,766.02
0bb8e218d9694288a386f2f742aea48f,335,290,45,South America,15,2108.44
0bb957a3e4c646a682bb90abdd0b570c,342,324,18,Europe,21,2373.24
0bbc7984dd6e4d0b92a90bab0f1e0a4d,104,74,30,Asia,23,834.58
0bbd8bd369dd463b86e39189a3f93c0f,139,109,30,Africa,21,710.26
0bbfb17ef0f94259ab1bfd8c4e310f91,103,77,26,North America,16,700.24
0bc124b357e14e09940ee596711b5af3,365,348,17,Africa,23,2319.93
0bc20d773d504df49727f6e518ff6f26,56,12,44,North America,22,206.07
0bc3a058806c4f1f8b79eaab2196655e,184,148,36,Africa,12,1675.67
0bc3ceed0ee64974bc3e2a1f85036ea1,162,117,45,North America,19,317.09
0bc3ff3afdd94d0a86ef717d87a1d9d5,363,348,15,Africa,19,2288.51
0bc4cceb8da54857b340eaf0613c5e50,347,318,29,Asia,24,2379.53
0bc60b0e928d4900984dbb0990cd4d9c,73,52,21,Africa,20,814.99
0bc93cb128f7437b8ce5efeccc000634,73,30,43,North America,20,684.69
0bc970401f00494f9c33da6b751d5101,182,160,22,North America,20,1611.96
0bcafa6008ff4620bb07cbcb0f9ab077,86,57,29,South America,18,888.61
0bcc021ebe3342de8fce77debaa0b54c,128,87,41,Africa,22,872.75
0bd1e330ac364d2dbadf3fe21994718b,264,230,34,Asia,20,2356.09
0bd3dcd2511b4cac9aa1a9f9164be544,167,137,30,Asia,20,1356.29
0bd5ba788a734caebad0e942df49d749,194,139,55,Africa,27,1495.92
0bd67d51fc2d416488344c510480735a,196,158,38,Europe,27,1478.9
0bd74eea94694e37ae9007bab1a84bb9,291,261,30,South America,22,2552.36
0bd88064bead41f99989426c610cdae1,116,66,50,South America,18,493.45
0bdc1d8715fd44a7b4f4ada6a90c4946,105,73,32,Europe,18,850.89
0bdc54e524e445e8ab6b7727af4c04f0,118,91,27,Europe,21,689.51
0bdc857d563c40f3b317551c45ca6043,132,113,19,Asia,22,1301.74
0bdd4d742fbd453e980db20162f0f03b,365,348,17,Asia,23,2248.62
0bdd63e8e1764079b9f50f21f6b7a58c,304,275,29,Oceania,25,2707.83
0be023f2f2c84ca28d714f3428843059,48,17,31,North America,20,841.48
0be1ec4bbb984373b673785ff56ca01b,188,136,52,Africa,15,1416.15
0be4ed58bb0d4aaa8604b96fa2d88ecf,251,210,41,Europe,21,1799.8
0be5c55b9d3e49ceb9bb85c4ef9790e6,107,53,54,Africa,24,461.78
0be906a671b1418bb0912cebafede685,220,190,30,Oceania,19,1461.3
0be96f0b3a264515bd815804aed91289,125,90,35,Oceania,22,1080.17
0bea35c76531472f8dc7cdab9fe2e734,146,123,23,North America,23,1124.65
0bead333112740a392b9883e0273f60b,283,241,42,Africa,22,1777.31
0beb7fbf02ea400d8aa852626377bd99,196,150,46,Asia,17,1524.73
0beb9b8b64bd42e98dd7c8aa8f733f86,76,38,38,North America,21,215.05
0bed694d5f2e4715a585918042aa923c,365,329,36,Africa,14,2019.73
0beddfbafa164b149c505b9e7e18d335,354,299,55,Africa,20,2348.7
0beec7266f1b4edc8b52c3b11a70139e,336,311,25,South America,21,2898.27
0bef5d3c0f5d4bac91608b07fdb36d0d,329,290,39,Oceania,20,2516.3
0bf0e8035e62484ba1068de89546f5a9,201,179,22,Oceania,24,1057.8
0bf3ad30ab6a47fe8e0147698f3e3dd3,157,132,25,North America,19,1367.44
0bf403e3172b482e944869ebc6474705,364,360,4,South America,26,2329.89
0bf515f811564707a013f45b274ac8d0,364,323,41,North America,22,2022.73
0bf5e6fd32624c24a7cb3d13f1dbeb1a,359,308,51,North America,24,1773.97
0bfa4de9897c41eb9ba8f9bdb4ca3473,362,362,0,Asia,21,2304.34
0bfa93c2c8f24fb9b5f01b4bb4e50a0c,95,70,25,South America,18,879.07
0bfb93df923f4ce2b07eb0beff6bd0d8,78,47,31,Africa,17,731.27
0bfc411b5e4e436d88481c7d0410bffa,269,231,38,South America,21,1546.31
0bfef5cc7f8d4e81837600a6d15d89d6,274,247,27,Europe,21,1858.81
0c012eb17a894ef683c064aa2c38996f,108,59,49,South America,23,553.46
0c01b3c4811a445c900da66b6c925f61,133,83,50,Europe,16,1276.84
0c01cc490990420bbd75f60b651361d7,195,157,38,Africa,20,1062.58
0c02e15a9b5f421a99254e2be7aa4d3f,205,177,28,Europe,18,1452.22
0c08ec13f8c34306943fa31290588bdf,274,252,22,Asia,25,2223.45
0c09cd3b367244b88a709637168494f9,74,63,11,Africa,21,631.93
0c0c2035a1c74819b1e6961884374b5c,59,20,39,Oceania,19,619.4
0c0c3c67759a4dd484aa8994735ca4dc,63,2,61,Europe,21,335.61
0c0ccce8f9aa4b318138523efc035746,238,220,18,Africa,18,1330.9
0c0ee6a058c84545a9fab5fe5517a577,136,105,31,South America,17,888.75
0c103c6c0d084dc19992f8b0f20f9ed9,349,298,51,Africa,23,1391.38
0c1265854e014c45b1375a8f34887ac4,315,265,50,Africa,17,2026.64
0c13f926c78d42da8e9f471dbca0f72b,66,21,45,Asia,22,427.03
0c1489a424894381bc82863a26997f50,291,260,31,Asia,25,2080.05
0c14cabe40a0481c8e700d9aa239ffc5,99,71,28,Asia,19,753.83
0c15c28d5e8e40338d1a1b4de13fbc7f,365,323,42,Oceania,18,2766.98
0c15f2d19c3c4f52a54c00d8f37d9aaa,174,129,45,Africa,23,543.75
0c164a701e5e4df59f0ec3205f567a72,99,60,39,Africa,13,784.44
0c16cc4f0aa143499dbc006857f17fcd,76,15,61,Africa,20,447.91
0c17810ae3ad4126bd4825452fa58612,228,171,57,Asia,16,725.23
0c1a4a2759ef4fae92d07d95ad96c685,363,361,2,Europe,22,2333.24
0c1b7e761e8f44f9b03fe64b4513c633,217,190,27,North America,20,1336.07
0c1c644aa72d4af88180e77af6b79066,365,343,22,North America,20,3171.78
0c1d05c6a0a54c51ab98f616faccd7b1,56,31,25,North America,17,408.29
0c1d06c432814dee9880a3c06c6b5535,260,222,38,Asia,18,1989.4
0c2143dbe58c4581b65ed2714ae99036,84,46,38,South America,20,624.29
0c251a04ea054342bc74e57e1cc59b5f,365,359,6,South America,23,2095.37
0c2708d1030f4bba9b6ca3d2200bc4e1,46,21,25,Oceania,19,327.69
0c27ca7e085847e986476ea293638632,319,277,42,North America,20,2183.66
0c29583e0dd14f199b6150a6a1b97e54,365,352,13,North America,22,3211.44
0c29b35c647c4128a4ed342d803eb4a2,120,86,34,North America,17,883.57
0c2a713962ec47579547a1dc394afd24,309,262,47,Europe,19,1871.28
0c2da686923d4bc9848beb88c99206d4,211,168,43,Oceania,21,1331.21
0c3187b8368946cda4b2c15252bc944f,281,239,42,Asia,19,1429.14
0c3421663a5f40ff98d6eb5ed601e67c,49,32,17,Europe,23,424.68
0c349f3ab3ff4b6a8bb5185dfe799111,33,8,25,North America,27,155.87
0c35cf999d804c18a99ec4179ea334e8,319,260,59,Asia,22,1527.55
0c36b137b0c346689063a348918233f1,352,300,52,Africa,22,1932.78
0c38764f4b154ea29f75fe51a0910335,192,153,39,North America,20,1474.7
0c3b4497561c4f47b1df8b4259c6bc00,280,236,44,Europe,22,2209.51
0c3d51c7954b4ddfae63260eda6b1d58,365,359,6,Oceania,19,2853.02
0c3edc9ea46d41dfbae4de2c9989898e,363,326,37,South America,19,2500.18
0c437095d24f46ee8c1d12081fa27226,297,263,34,Africa,20,1909.43
0c46b246c50d4298861b056b36da1dd5,299,240,59,Europe,15,1468.22
0c48b8f672ba45ca989e49923dde6598,250,204,46,Africa,14,1014.52
0c48ec9d16da42faa93f7b22116e9c6d,209,183,26,Europe,20,1927.4
0c4a3421fa8649fb8b0653c25214edd8,238,191,47,Asia,16,1709.82
0c4ac992a4a447ca9df42c153b29bde6,190,168,22,Asia,19,1649.06
0c4b35d5db4d4adfbc245208763b983b,42,20,22,Europe,21,258.94
0c4c006b8bbe49798f50e1ab579ee478,121,88,33,Asia,19,666.46
0c4ea602d8d242338ac84865f001e62c,330,285,45,Oceania,15,1836.38
0c4fcd35a5544837af6cea612078e802,183,133,50,Asia,22,1233.61
0c5748688e83477c970bd722bd04cb89,258,208,50,Oceania,20,1745.18
0c5851e91d364c6eb341a1c8ab035712,321,293,28,North America,17,2058.59
0c5b19b1b1304583b4fb538ea5191d10,93,68,25,South America,20,1250.21
0c5b4973f4824ed2af71a0ea92aa53c1,31,6,25,Africa,21,261.01
0c5c26346a5d403a9c7ef5467bda73f1,122,94,28,North America,23,1211.46
0c6115aef7af4e4e8cfb28f55a95c412,277,245,32,Europe,22,2619.7
0c62678c33ab43bb9e7b61e1675bdf83,88,64,24,North America,20,725.7
0c636710c3014631b11dcb6293abee48,172,125,47,Oceania,17,1018.03
0c65252a69994d13ab635f3d8f85a7c3,317,296,21,Africa,23,2219.4
0c663f716e1949049ae0842626868eaa,105,74,31,Asia,17,837.07
0c673d9c47a94271ba41725994c4c09a,91,48,43,North America,23,314.49
0c6884c6b2e343caa93c8be0d8128f37,43,27,16,North America,20,356.83
0c6931fff7de4f02995e9f6df5476c23,259,212,47,Europe,16,841.03
0c6aa1b467a6481fa4b660b2f5ae1fa1,27,4,23,Oceania,18,205.37
0c6d9aaed9b44149a0094e9849d6d53b,340,313,27,North America,19,2133.07
0c6ecb7ca2f64d9db3aa7a253e969429,364,323,41,Europe,20,2657.57
0c6f0cbdac54479981899f88851bed9b,150,110,40,Africa,19,1186.6
0c6ff82098e849be80a9f4865008214b,312,274,38,Oceania,21,1722.29
0c703d8c79d149b6ac68d079cdf4af10,365,361,4,Asia,22,1629.67
0c74218eaad14a66bbc98a72b3cf604d,249,215,34,North America,19,1638.34
0c748862263044b6a206c71e42b02dbb,96,70,26,Asia,19,504.84
0c75eba691b04f62bcde5948b17bb31f,361,327,34,South America,17,2816.26
0c76181569fb45e382fb1d72be178674,350,316,34,Asia,20,2544.64
0c77a311726a4defbd80a70b68af1c6f,66,17,49,South America,16,328.41
0c782c80e2b94977a164394eeb9ca790,363,311,52,Oceania,14,2103.68
0c786dcf1ee548ad9c614fe972569fdb,365,320,45,North America,18,2579.81
0c78a2601084475db8493ae56ccc2e61,126,85,41,Europe,23,1287.23
0c79b30395d74a2f9dd6093d5d68263f,365,333,32,South America,23,1396.87
0c7bee9792d64c439073221c25683a0c,55,5,50,Oceania,19,299.89
0c7c644ad5474184a003f8c603d902e1,74,42,32,North America,22,864.67
0c7d46801b1548c0a8bcd3a3891ce815,364,345,19,Oceania,18,2668.82
0c7edeb88b6e41b4a930541324c79128,112,58,54,South America,22,933.15
0c804b5193a64517add4cb63a55acf23,318,264,54,South America,20,1816.92
0c834877f8f6421d924f303bb161cf69,262,237,25,South America,17,2312.46
0c83ae114e034b319f16541192cc2738,283,252,31,Asia,19,1920.71
0c83b082fd28417ca4dffc6f46295a29,168,119,49,Europe,24,977.33
0c855e6b20db4bac876b026fa0baa4dc,186,130,56,South America,19,955.26
0c8616f6597e4e9b850b175cc6c69ffa,58,13,45,North America,17,359.17
0c86adfb42e9444ab38d834e17049cef,351,305,46,South America,16,2527.95
0c8a6088143b462194a0c7b42e667a60,365,337,28,Asia,21,1682.95
0c8c44cc516f46f88e31c2b359039ee0,221,170,51,Europe,19,868.06
0c8f2dd7d98e4812a01a1f934bebf9c5,95,56,39,Asia,24,729.89
0c904d652b514461b195c00c07b324c0,204,163,41,Africa,21,1279.35
0c9255633e0b4a04a9b49f5720d9d946,258,231,27,North America,21,2244.53
0c92ad7b7d604bf69662c3218b02fbd1,169,136,33,Oceania,21,913.36
0c92af1ad63b4f67bc3eb5feea452105,162,102,60,North America,15,553.8
0c959a8fd2544813ada773e4baa0a9fe,311,277,34,Africa,24,1891.64
0c99587d28f249b6a04841329521daea,365,328,37,Oceania,25,2508.12
0c9a5082bba54235bfd2a5f1d0735733,94,54,40,Africa,19,515.58
0c9be5e78e9349139fb507b807e75df7,165,139,26,North America,23,1113.38
0c9c770ce6f14410af69a7747746197a,365,333,32,Africa,18,2827.94
0c9e33a2fbeb42c4b6d82853e1634ec5,185,148,37,Oceania,24,983.41
0c9eb786e8c6462797d1184ddf02e452,258,218,40,North America,19,2024.97
0c9ecbca22f14daa824ad30580e1b4fa,191,162,29,Asia,22,1432.48
0ca0752403ec492b90a4b8e3137a639f,154,109,45,North America,17,696.54
0ca093f6fc8d4a76ae435e8179f9ff48,323,273,50,North America,18,1887
0ca1093d400f49e2871d7c265afe712d,213,175,38,Oceania,18,470.97
0ca37efad3ab4fc6b0041a33963e1661,311,260,51,South America,15,1440.83
0ca3b10684d74319905a1d3744302715,124,87,37,North America,22,848.62
0ca5efd4e83945d6b9d88e29aad558a4,204,141,63,Asia,18,1136.1
0ca6be4734be42ae8d660dc448a11ea0,162,150,12,Africa,19,1312.82
0ca9da26ba6049adb31384d3173b7bca,276,228,48,Oceania,23,1881.2
0caa34df0a2e40baa01380b46f075630,364,347,17,Asia,23,2756.62
0cab1b62e1ad4b99ab49625630f860ae,119,72,47,Asia,19,741.18
0cac9bef15d147e58e0b783969c0cbad,92,44,48,Africa,16,420.82
0cae12d295aa4a9da84d9d5221ee69a0,38,7,31,Oceania,19,427.34
0cae950a9b574200b383ec0d09f264c0,349,316,33,Europe,17,2871.81
0cb082451d68467f9751a5c0e184d008,82,59,23,North America,18,813.17
0cb183c17cc24b2db798f8c383b42423,321,288,33,North America,18,1806.44
0cb28a5be31c4a00a8d7b2eda3b47aac,362,335,27,South America,27,2440.52
0cb3a72c4e5b47aabcec409f3c12a237,85,48,37,South America,18,363.09
0cb57121f0f84104abd029a2a444851f,340,292,48,South America,20,2420.46
0cb7dde7144d4fb7b2e0db228b4c82f4,157,125,32,Africa,21,977.65
0cbf6f5ead9d4f4e942c84a52904a4dc,100,62,38,Europe,18,835.13
0cc4f93005eb4596a2300065584820e4,180,137,43,Africa,24,1442.8
0cc52ecacbb149c28b9c1259e38a1ae8,74,46,28,South America,21,671.1
0cc5f30fb68449aea7a59614be828113,166,118,48,Africa,20,1590.76
0cc6c5c8db7c441eb35b13722168ba2c,271,243,28,Asia,17,1892.09
0cc96993ad97473e8ac0405b328c35be,286,247,39,Africa,15,1822.08
0cca380728f64698ac7f87cfcd21e018,115,88,27,South America,19,1157.85
0ccafa5f894a47ecb104b2076118f835,362,337,25,Africa,17,2838.79
0ccc7d8a1b35459aba135cb91bd8c174,69,12,57,Africa,20,407.93
0ccc857b39b548eb84db795aae7b033b,126,76,50,South America,14,746.11
0ccc9e4f05084cafa78156c84fcdb61f,365,338,27,Oceania,20,1986.91
0ccd01d770d94cd8bfae331528f2abc7,291,250,41,North America,16,1657.95
0ccd881141fc4ea3876a267ac95e6e38,98,70,28,South America,18,731.59
0cce7b89593e4ed6b668b27234658100,365,361,4,South America,19,2459.41
0cd0fbb7605a4157af863da8c587dcd8,364,340,24,Asia,26,3172.04
0cd1dad95d80493a93a2dcb6fbe66d61,168,111,57,South America,17,797.05
0cd2ef3c32c64791a3dbc5240b61718f,139,87,52,Africa,18,472.42
0cd4da2062614edc99cfe0343576da26,190,176,14,Europe,22,1503.29
0cd76f3b41d94043afa1d629087f94fe,289,252,37,Asia,23,2102.65
0cd780560efc47b987cc8abb38c7741f,282,260,22,Oceania,25,2604.21
0cdda4343a434557b298b176a470e7e6,291,260,31,Europe,20,2035.12
0cdf10c349f548ec8a26daf68e848643,137,89,48,Asia,19,211
0cdf70f5fa06433a85d5029dc5abf10a,324,273,51,South America,15,1089.19
0cdfbb2c89af4fc0af8dcce92459c091,334,291,43,Asia,22,2137.21
0ce6cabcf26645238fc343fa5984afa1,279,258,21,North America,23,2593.71
0ce7c88fa7b649519d85d1423ea4653f,328,278,50,Europe,21,1471.71
0cea71e5505e4a0d9168901ec963e8f4,343,295,48,Europe,22,2005.37
0ceb4146f49f4b3cbb7453552c8f556e,161,134,27,Africa,23,1752.39
0cec8279f0ed426283020e2ba17da8b2,346,328,18,Africa,18,2109.54
0ced79c03a4345a882c759736e211d63,159,122,37,North America,15,695.86
0ceddd4155414182b7cf38ab0f6d2888,81,43,38,Oceania,21,494.92
0ceeadc17e9f4b68b7fe9fa196847112,48,3,45,Asia,22,236.86
0cef01abec3947dd8443482ba16914ba,174,140,34,Africa,19,1363.94
0cef453d3cc547ee87f0cf7ccdcd601d,342,322,20,North America,20,2798.13
0cf1436ab6f64923a6db23154a2c9463,40,5,35,Africa,24,250.96
0cf1868e08f24add8a61e7ac7bf76c9f,364,350,14,South America,22,1878.54
0cf6a8208cd4429fb9a05f1829cb0eb5,267,210,57,North America,20,1098.9
0cf719e98b274a1ca33ff91a86b1cfc7,287,236,51,Africa,20,1564.12
0cf754b9ab4e46e5b0f76a584e266899,70,31,39,Africa,26,402.84
0cf7b8dab0bf4d11859f091eb226cf20,337,307,30,Asia,18,3009.15
0cf954708f674765adc5d889b64edeaf,93,68,25,South America,13,989.53
0cfaf64d6a9f4503be6b8b1a50b93911,273,237,36,Europe,18,2032.61
0cfbcbdab8da4df2946580d5a1fb74fc,182,136,46,Africa,20,931.1
0cfbccd5561642ccab73379f1ec94ff8,177,143,34,Africa,17,1386.72
0d0098e586a64b73a9fd37fc12e3ee70,314,260,54,Asia,15,962.98
0d00d383280543e080c4cafae452c3ba,266,225,41,Europe,22,2031.85
0d039f5f17ef4cf8829fc404c26b32b8,56,12,44,Asia,19,252.34
0d03b805a40e474cb6366379dfa59f66,325,273,52,Oceania,17,1494.25
0d0495a09df344d6a3402d921b346fd2,247,209,38,Africa,20,1687.36
0d08325366294293a3def04f095b5166,208,182,26,North America,18,1652.33
0d0959bd05fe46258a868c366d84bd90,311,253,58,North America,21,1724.27
0d0d66349e0e4b70a1b41278f54ab638,354,307,47,North America,19,1866.77
0d0e2581771d4775ac30860dfbabec39,86,52,34,Europe,23,807.09
0d0efb084f49492ab67d237c0fede4aa,265,219,46,Oceania,22,1186.74
0d115fda2388499fa09b4133f749569e,361,326,35,Oceania,20,2429.34
0d1a11dd6c09490ab025b117b817e8b4,362,306,56,Europe,19,1273.71
0d1a1f7e041f458c8df205cc78391545,270,222,48,South America,17,2214.29
0d1a597652184e389dd6f6c29e8ed933,194,149,45,Europe,21,1425.32
0d1c1e7411d941d487776775404b4f4c,89,33,56,Africa,20,542.17
0d1c9e01defd4dc6aad39099f646f53b,363,342,21,Africa,17,2613.35
0d1cd12100074948a5c50105f47ef150,142,119,23,Asia,18,1126.54
0d23364beac54781b30e4949beb45547,83,33,50,Asia,19,496.54
0d24132690b94022b3b98bb542784377,210,155,55,Oceania,22,1220.72
0d2467fba4ee4c4890a591cd431f592b,141,116,25,Africa,22,947.57
0d2743bec43943118658ddab18cf95cb,113,80,33,Oceania,21,724.21
0d2966695c99452d8c23ea415972415a,164,113,51,Europe,18,1391.37
0d2c22e07a3e4c2bacd5a51eb5d60e6f,364,327,37,Asia,18,1705.41
0d2d68803b274ed09a32088fe2118656,141,93,48,Europe,17,1091.23
0d30a20e5b6e4efa9f3e646dfc76e907,177,135,42,Asia,23,954.58
0d313697c9bb4b9f84adfa57b7519a82,99,52,47,North America,24,649.62
0d359a45180c457080ce857401a08eba,365,340,25,Europe,14,2549.45
0d35de0d34bf44d98201100c7a2a3145,278,250,28,Asia,21,2233.12
0d36750d1be6406d90ef14c3de8aaaf0,140,91,49,Africa,21,920.94
0d391a220ff34c6a802c405df91cf717,357,332,25,North America,25,2903.16
0d39e0933d64488e8afb261522562db5,279,252,27,North America,23,2640.29
0d3c068c63ec4b1bab8b18c3a7a997d8,40,6,34,Asia,19,210.34
0d3c4fbbaa8247f6b01ac5ca21ff8f9d,362,337,25,Oceania,22,2411.96
0d3e2100b5f7483cbd9a1882ae04703a,214,185,29,Africa,28,1672.48
0d3eca5c25114617943eb30c0bb285ee,190,142,48,Europe,15,1029.51
0d3fe963347048968c1cfeba7377f1c3,53,23,30,North America,24,624.47
0d403d19b08d4006b2291f33e55454b9,365,332,33,South America,23,1735.52
0d406c95b168481487f40820a6ad213c,244,209,35,Africa,25,1154.5
0d43eda6c2514f1cb75145380137245d,119,98,21,Africa,14,1342.18
0d47942bd1ad4fc0af54771adde5c2fa,364,328,36,Oceania,14,1637.99
0d47c2a6f0d540b7ac3e632e31411d44,363,349,14,South America,22,1994.24
0d4a3a6d7e7542d798873dafc4637a17,160,130,30,Asia,18,1488.33
0d4cccd93c6141eda10a4645bd0ade91,333,307,26,North America,16,2458.94
0d4d58f7dfd34f5abf7e4053aaaf7652,208,163,45,Africa,23,1474.26
0d4f1f7a7b99405c8a03b393e19a3971,304,257,47,Oceania,23,1397.1
0d4f4c27f07640739f4141351c09ca0f,116,88,28,Asia,28,757.07
0d4f7affcb094faba0621ce0031c7356,123,100,23,North America,19,852.18
0d51435d5a7d4e66bf06b6d2c0be0e41,66,31,35,Asia,23,735.56
0d518c5098464e68b3f397ca252c6a8c,128,91,37,South America,15,1296.74
0d529cea88e14aa69846a9ff5d08e738,192,162,30,Asia,15,2016.14
0d5363fbb5e74f9b93a08d2cff44b3eb,360,319,41,Asia,26,1747.52
0d53967faaf94c44b38b152fcb29e634,158,113,45,South America,24,716.98
0d554c1fc54941d19bf3a6299ca6b221,34,26,8,South America,24,223.84
0d55d3cc79684d059216afff83bb85c3,55,5,50,North America,19,139.23
0d5c379f71f64e49b557fabf0f53b3d9,165,125,40,Asia,14,995.52
0d5cc835827e4516b500ed51243715c2,164,145,19,Africa,22,756.6
0d5def00ffb6448d9fd0ff7739b73a1a,192,147,45,Europe,22,779.55
0d5e76b8328f46aba473b0fa5e19b187,84,46,38,Africa,25,436.28
0d5fa12f496446c4b6f7fd402c934e50,71,40,31,Asia,19,341.24
0d60d6b9609445bfbd7ceeb6234c0208,323,304,19,Africa,22,2647.92
0d6179f823b440bc9644e5f8b6321fd9,59,42,17,Asia,21,462.96
0d62b86bcd3c48e9977d7bb3e8582d54,266,217,49,Oceania,20,1774.95
0d637dd9abf74506adfe7fb702574029,50,21,29,Oceania,15,335.18
0d64b6ec8e784151b012142021d70297,172,129,43,Asia,23,1074.59
0d6790d8103342458e0cad4401c52c69,364,337,27,Africa,19,2160.45
0d68b7f46fce4685b2d6a3bb3e889b44,20,3,17,North America,20,73.94
0d6b6e3ae618401f95b2bd117d4f8eec,250,229,21,Oceania,20,2599.59
0d6d7849132b4bee83eff511bcb00964,365,340,25,North America,18,2687.93
0d6efc07a0964b6aba660d7a7d4dea0f,273,229,44,Asia,16,2041.31
0d710197d64b4e7bad99272614603d52,169,136,33,North America,22,1372.75
0d71040516c04e17b974892f75730f4a,365,331,34,Asia,19,1463.3
0d71beb38c874b5786b964097c6bc279,179,135,44,Europe,18,1127.13
0d742e55361545509cf6769f81ad476b,86,37,49,Africa,21,434.38
0d749eb38a444ab49d745acfd0e03baf,47,7,40,Asia,19,348.68
0d7537cb5e444ea895a5043eacf70975,198,179,19,North America,18,1616.44
0d76135e88a2409f98c41a563491753b,153,113,40,Oceania,17,881.07
0d768970629d45028696950dfc77bce3,363,336,27,Oceania,19,2171.97
0d769028e7224612bb72894e220f2ba2,337,306,31,South America,23,2634.52
0d78e530d7484dedb146029ae36d8579,316,283,33,Oceania,20,2359.65
0d7f2bf5396d49418aa09d8bba4ed66c,105,55,50,Asia,18,761.4
0d82cffcfad2498285a382240b8a4a01,365,348,17,Oceania,19,1889.01
0d8618e4d41443a0b0296fed07871013,166,138,28,Asia,25,883.43
0d8653e8a3f34d6094cb2c2f6d84efb6,249,203,46,South America,15,1345.99
0d87387828d84794ba78109c9c70b98a,306,280,26,Oceania,21,2665.38
0d8b8769bd1348d29b0a33b20f743894,357,300,57,Africa,18,1709.36
0d8ca75e9958456d9c8ea33b106946e7,296,266,30,South America,25,2715.3
0d8f4e310f00494ca4b636d8a1a1e932,196,155,41,Europe,16,1376.34
0d9495a479fa4253b0fb949cc52898fa,341,311,30,Europe,17,1934.87
0d95324c438241ad9dc3113d937141c4,90,50,40,Oceania,16,458.43
0d955d8388b540e89c0e8b6586c21925,159,136,23,Asia,19,1228.05
0d98b083cd8d48c580f27e02fee6a354,307,279,28,South America,20,2519.43
0d9b7530caf547fabf058b13579efebd,312,271,41,North America,22,2645.56
0d9ceff15f13492abec92078d234bcc9,365,338,27,North America,20,1804.93
0d9ec2b88a5c4b8285f0e4a4068a150b,154,103,51,North America,19,1001.7
0da2735ba2ee4126ac2a1ce2a41aaf44,295,243,52,North America,21,1760.17
0da69c67d2a44e188c1e0e452af8910c,63,30,33,North America,19,633.16
0da7b2434f4342b39b2b10e636614805,248,218,30,Oceania,22,1892.43
0da7f5547638416d9807ffca42ed19e0,215,198,17,North America,20,1078.51
0da8168b5b8e4107ae69cbb927c46366,361,328,33,Oceania,23,1738.44
0da82be19146496690bfd00a13084b90,98,83,15,Oceania,26,602.6
0da8a623330b40abba99939bded0e699,192,154,38,Africa,17,851.05
0daac0c740c2401d87e194832706760a,228,202,26,North America,23,1723.65
0dab1d22c2dc4703814012bacb4a2fe3,365,353,12,South America,20,2374.54
0dac490b666c4b369a70e16f0cd9ddf3,185,162,23,South America,21,1226.41
0daeb23ec7894f4dad63fb9299cb42e0,200,167,33,North America,22,1296.09
0daf3642be0d4830b3a1ef19c92d273e,129,88,41,Oceania,23,877.86
0dafc11edf114048a137c72ce2a87f55,86,67,19,South America,19,541.85
0db0a7e8155a48f381e43457dd52f3bc,334,297,37,Africa,18,2230.82
0db1075322104d36bedb2c174b257b23,80,54,26,Oceania,25,314.79
0db241460d294f46ba2bbb46c26d603a,220,185,35,South America,19,1847.18
0db2460b4c2d4b5289a261ad707091ba,365,309,56,South America,17,2307.06
0db3ca248c1a433fb83bcf8d57fdbea9,283,246,37,Europe,23,2203.68
0db85443837a48e6960048fc61b84120,284,253,31,Europe,17,1874.34
0dbc5763611c4f73bff3320bf5dc5249,127,100,27,Oceania,16,689.24
0dbcf967f4e7430fb4531ef9389fcc87,48,4,44,North America,22,90.15
0dbf633460684d3492e58bb656b1e648,60,16,44,Oceania,17,433
0dbfdb686ca9482aa391f0b42330c0cd,164,132,32,Africa,19,1270.59
0dc2a130eee84fa3a9db1ff52ac4f656,315,296,19,Asia,18,2741.57
0dc4351d606e45b38af2f3bb2bededb6,192,160,32,Africa,21,1273.3
0dc5f8d30ceb410da01013d2e4b61c3d,347,328,19,Asia,19,2949.46
0dc8e48ec43b407297901b3e2e12d031,283,235,48,Oceania,20,1835.81
0dc8f29dba704d8397c311efb4ef3747,266,205,61,North America,22,1004.84
0dca3b2ed0b947a0817cd79522a8484b,363,314,49,South America,15,2226.66
0dcafd29d78247b48e4c47a112314fba,364,336,28,South America,24,2876.07
0dccaed225e145beb09d629b5bd3a5e5,303,282,21,Africa,21,2701.04
0dce622ec5874f0ca8b3a3dbe74c953e,179,152,27,Africa,19,1985.31
0dd518adcaf2458091e5544924c12347,113,60,53,Oceania,21,267
0dd5c87ea1004a4eaaba124688647c7e,200,171,29,South America,16,1859.4
0dd8d628440c4a4c9b19776b0fea4e8e,281,222,59,Europe,16,1550.81
0dd8ec50ea7b448c9c3767c400d29f46,257,219,38,South America,18,1243.98
0dd90e6b6485483f99161b97d038cf87,39,17,22,Oceania,24,214.32
0dd999ca9c7349c2822d3b971094dbac,170,132,38,South America,23,1087.09
0dda908d2b9b41f4ab8300d7431a4d10,48,21,27,Africa,25,525.37
0ddd0fd9ece24c4db8dba03524839593,365,363,2,Africa,21,2434.8
0ddd3d8f791e41d6bc45b3e3fa1f2e10,362,332,30,Asia,25,2477.08
0ddd593c5eca4ed2ae6aadf2db211018,101,68,33,Africa,17,857.86
0dddff0433fb45deb282cceccf424e2e,95,71,24,Oceania,16,907.23
0dde3003c6684c99bf8c2dc1ebefb7b2,83,47,36,Oceania,19,546.39
0dde6b2476f64e0c89af35455b0b8965,330,306,24,North America,22,1958.7
0de1c8e747e04593892dcdf7f4c60874,348,305,43,Asia,25,2770.07
0de7f14e4191436c8eb77fb2700a0222,86,29,57,Europe,21,600.16
0de84218405e4adfb07c5dbc3b07a633,362,343,19,Asia,14,2082.74
0de8486c2e8a4e02a5966a277e1e9bdb,157,113,44,North America,18,633.59
0de8a255ffbd48ba841507506412135f,358,309,49,Oceania,23,1909.37
0dec50c38ce64971b2c5af1e5f353478,322,264,58,North America,20,1427.56
0decf9e3801243b09d1f4135bd74dfea,88,43,45,Africa,16,432.94
0def43f3cb0e474f967d31974e1ca2c4,200,147,53,Asia,27,1051.56
0defa57a08084a3b946d50728b40f563,362,348,14,North America,24,2763.63
0df1057d20be44db8f76db4c0ed2b609,271,250,21,South America,20,2290.42
0df11dc6b3794d26985eb6979db6c4ca,131,93,38,Europe,24,878.49
0df348dac024440cad9a64f4831e0253,176,129,47,Europe,23,825.89
0df38e7adf29463793ed488efc2d85cc,311,282,29,Europe,17,1997.69
0df3af6f2b794778878ab1b038958e42,181,141,40,Asia,19,1237.12
0df5acd5aa2f4f3b900dc653dfb91c70,344,288,56,North America,23,1932.29
0df5b6bf58f440efba2f5396ebdc0ffa,128,78,50,Asia,16,771.71
0df5f081ca0447748ccd0743d0ae2024,253,209,44,Africa,18,1817.51
0dfce15a124f43d89e8b6e135a734183,274,251,23,North America,18,2269.25
0e01dc824f534f4093b76a0ef34e1358,279,255,24,Oceania,16,2030.69
0e0233d3591b4f5c9f9045100f3f50dd,273,232,41,Oceania,23,2407.07
0e06064a3e3840f79594d0f44b6d0f15,144,100,44,Oceania,20,542.3
0e081ffdc4404367b6d0b47d861fe995,338,311,27,Africa,16,2544.88
0e0a3bf5b4aa40af92092dbec39da3ab,364,353,11,Africa,15,1456.79
0e0baba4bfb8403ea9dd15e8a3e24e7d,361,318,43,South America,25,1251.67
0e0c34430a644eb5901e6419c1ac044a,283,254,29,Africa,22,1840.66
0e0dd90ac8ba467e88fd1cc0cba8928e,309,271,38,Europe,23,2195.2
0e10366159e64f09bd7666b41b93f0cf,154,123,31,Oceania,21,1195.81
0e1566b62fc545c19f13bbeb1b20bc94,182,144,38,Europe,21,1084.04
0e19e5c6273f49319923f8d704ed5c0c,103,70,33,South America,24,722.89
0e1a663857254293a2f195b3a4c28af1,268,211,57,North America,20,1649.07
0e1b08ea3227437eada0dc7ea2d6c5b1,68,44,24,Oceania,21,469.92
0e1b1f6663e647baa7980b529b9c84c3,143,91,52,Europe,20,882.47
0e1ba290643d400bbd93e731e910e7e4,326,301,25,North America,19,2743.3
0e1d2612e61243519e52b7952a19ae6e,103,81,22,Asia,17,832.54
0e1f95387d394520a6ff89802b2aa169,359,329,30,Oceania,20,2287.12
0e20c48bef024994951adc808ba5096b,226,177,49,Europe,17,744.37
0e2103942d754c60a9ee34dc1342c560,148,122,26,South America,28,1020.7
0e22780a507d4017ba6ef103c7ddcd70,65,39,26,Oceania,17,512.83
0e23a9802d1449e5994196643f3ce602,309,290,19,North America,18,2642.92
0e23af8e01c34f3595d9374b6eaaef08,209,175,34,South America,19,1755.61
0e251ffc60d04bc5b43fe13b15ab7f10,365,363,2,Europe,16,1951.17
0e265478acc74cf3bbb839374a65597d,224,195,29,South America,23,1631.89
0e265574d69b4e15b4dee05d5e7a3b3f,130,88,42,Africa,18,773.13
0e26b44dc5a74133b435e6a883586d0b,335,309,26,North America,21,2098.24
0e2a1eafb1fe4513aaca2514ec250b79,221,177,44,South America,20,602.02
0e2cddf3057343a28ae56cf653b3769e,357,301,56,Asia,22,1599.3
0e2ed08a76b642699bda3e00a348a005,203,170,33,Asia,17,1007.24
0e30a4acdb5d4a13a530833855bd5676,237,190,47,Oceania,21,1834.78
0e3143cf830f4a93b6792161e3f82611,363,320,43,Europe,17,1398.21
0e31ad9f97b1411fbff9e0d0d3d283ec,280,236,44,Europe,25,1451.29
0e3266edc608411baca44665f8380728,262,206,56,South America,20,1806.05
0e333ed2ba4e4450b8e362591de3632f,290,260,30,Europe,20,1783.49
0e36ce30129540cfb6f01c59948471c0,205,157,48,South America,25,1790.95
0e36cf756db64e3cadbcbc4703e575b6,177,147,30,Europe,26,1626.65
0e3938681c4a4794b946e4a93eac9cc1,258,201,57,South America,19,1612.82
0e39524b0058408b9b41084223755011,57,26,31,Oceania,15,440.75
0e3964b3829e41e996c51e4cd814744c,263,226,37,Europe,25,2127.75
0e3db45cc8c244489b2aa5cecfbd7de4,323,282,41,North America,23,3133.28
0e416facbff147c787f2dd62b47f0891,271,225,46,South America,15,1870.16
0e4352e70a4149ba94fc7fc38d027c91,281,234,47,Oceania,16,1413.81
0e44923f768047c4b0cf1ec1e88296aa,93,70,23,Asia,23,615.9
0e46b92d18054c6d969f4fa44cf5fbec,253,203,50,South America,23,2029.28
0e47c08ef4e34f90be18989c1bbbeaf5,181,158,23,Europe,14,1095.21
0e4ab45cedd246b39214c825807f604c,90,62,28,North America,14,1038.87
0e4b36c5be5f42f6bed00d971680cc42,211,185,26,Asia,22,1801.09
0e4de88081cf4458a3850723c95e51c7,197,181,16,Europe,19,1493.56
0e4ef78be8944163af680849e8ed7cf9,211,188,23,Oceania,20,1163.5
0e4f7841d99f431c857dc34e81ed4b4e,98,50,48,Oceania,19,553.98
0e4f84d8d8964adcb2a847fc9845ba5d,365,325,40,Oceania,22,1616.06
0e4fcb074f064a1c81f001dc2fd52233,119,83,36,Europe,17,927.17
0e51fa25a28e486a8e2522d9de430b52,152,108,44,Europe,24,1077.83
0e52908f7343444cb5e6f7faa6eb4d18,186,158,28,Asia,17,1479.88
0e53dfcc21c64e03a9cbf1fd3bd2271a,288,241,47,Europe,22,2008
0e5417783f1b4a8699e15d387ce09653,309,264,45,South America,22,1702.97
0e5960c7a9f04af79c17bd550c281846,44,8,36,Asia,19,395.73
0e59d395444a4cd380d98a6618e77d15,326,283,43,Africa,17,2132.44
0e5ae076b6804dadaf5a4d7212cbac67,185,142,43,North America,10,1035.32
0e5b21c184bd4ccb87ffd2f229b6ca2e,148,97,51,Oceania,22,1333.99
0e5b4116e6794c30875de66359b14ccf,275,234,41,South America,23,1775.84
0e5bc84d97d5421398de3b145c675836,187,133,54,Africa,24,1051.53
0e5d5387289a4db7a128fc65f926b534,152,116,36,Oceania,22,961.78
0e5e8660a7ce48dda5a8bba813b2e789,264,214,50,Oceania,19,929.21
0e5ea7b301374c3d942a7ac1814ef364,295,259,36,Oceania,23,1579.67
0e6026ff4b754e09894702ab35320952,255,210,45,Africa,25,1432
0e623fbd3e1543d5b1039127206b7456,171,121,50,Asia,18,803.9
0e6329b17e0b48abbaad9e32d2d1d69a,307,271,36,Oceania,22,1931.71
0e640612810c4c9cac612c80301d6c44,360,319,41,South America,21,2703.46
0e666bf89c944ef2be51077931144eca,75,36,39,Oceania,18,579.13
0e66d033d8a54482a9f251b1052719f5,305,266,39,Europe,17,2694.43
0e68c77f1c944cff86d75ec842ef977a,294,256,38,Asia,17,2038.04
0e6978f58cb44028ac87eb8e06cd7415,104,67,37,Asia,22,635.84
0e6d90248c7a4bb4a06796c2f5d37efb,217,162,55,Africa,19,912.99
0e6ee76c23f348feb213d00e5a741a93,91,47,44,Africa,23,136.18
0e6f91b3b7024716b1a429d50819fd19,191,147,44,Europe,18,1009.63
0e7034a4202c4fc4bccc125bb288d9d2,277,250,27,Europe,21,1598.58
0e71fd8c9a96417b9779344db56a21d8,201,171,30,Asia,21,1423.07
0e73c6eda9f04b7791f6240f8664dcfc,161,111,50,South America,18,510.98
0e75cda11d9b41ab80d5bd4d5668e4e4,317,289,28,Europe,21,1965.83
0e7947bd0f694483a907b2200ac35ee3,123,95,28,Africa,25,778.49
0e7a7c07127e4ab09a8db3a90279837f,355,329,26,Europe,20,2836.49
0e7a7f8fe3fb49b58bdbbf8d1fd9ebe7,34,7,27,South America,17,307.43
0e7f0b89407349029828a2d10f83dd4d,42,11,31,Africa,21,180.87
0e7f602c85374d99ad78a388af18f998,364,330,34,Asia,22,3083.19
0e7f6e8334a04be08ea1df4944f0717e,325,278,47,North America,18,1524.42
0e7fd94fe24e4304bed7b7a3fb37da3c,84,51,33,Africa,19,755.05
0e86a5440c344af7936c78c02af4c25d,235,209,26,North America,12,1505.48
0e8731e643bf44048298aa0320f7e1b3,354,298,56,Asia,17,1598.84
0e87da18ded34030a9d1e03ce903375b,364,345,19,Africa,19,2215.14
0e881a88e2094fbdbd0690f3c6f11bcb,124,99,25,Africa,15,831.11
0e892987e2b54641ade9db96f4a9b185,59,11,48,Europe,18,533.38
0e8c6efbed2d4ca796252caf98e668a0,190,147,43,Oceania,15,1563
0e8d75151a844d308a4a043a5d62f5a2,359,327,32,Asia,22,2238.37
0e8dbb45ff57476f8fb565923ace20c7,56,5,51,South America,19,351.72
0e91e3b91e244e6c80dfd6189fa1a4dc,364,330,34,South America,17,1881.05
0e92a76570ef458c8fc69582c0e8fcf8,127,96,31,Europe,26,711.59
0e930fe0eb91445bbadd849e15eaea40,106,65,41,South America,22,599.47
0e934f24b7024fbeb435052ba7ab6eb2,258,224,34,South America,17,2089.76
0e93671a084644b5815e9d635c15b081,259,219,40,Asia,18,1330.53
0e958ed415e94268806b8e4344b9a6c2,213,153,60,Oceania,21,863.76
0e970ac906254ab08b4b980e0b7fa28a,255,229,26,Africa,23,2612.1
0e97f7fefa5a4baab46d0c8dbf20c186,303,274,29,Africa,24,2535.21
0e986e5968874e0488247e3433d5bcce,130,100,30,Africa,21,1122.4
0e9a60ec4bac43bab3e8f6a4247110d5,224,196,28,South America,18,1330.48
0e9ce9b4520642fab91d1f0d25a985ac,64,40,24,South America,20,358.65
0e9de48adba64c9b9dfe0c3db58956d5,263,214,49,Asia,19,1571.26
0ea04f43334a46f9bca791a3f8ec9815,357,315,42,Oceania,25,1316.75
0ea60a4f6af54763aa3abf1f5c8ebd88,58,27,31,Oceania,23,272.29
0ea64ca2baaf4351bab3e03d7945893d,127,91,36,North America,19,919.96
0ea6878b7d0441c2a516df061786a1a0,141,87,54,Europe,19,1242.75
0ea7961ba1724301a212ec6d07539057,320,273,47,Asia,15,1451.87
0ea79a71347b41e289a141ab5281fbd8,83,34,49,South America,18,255.62
0ea84cb26d3f412d9218ec84cf61682e,303,267,36,North America,21,2166.28
0eab40c758814ebfb22369e726320844,108,82,26,Europe,18,660.83
0eabf569276042298709a3cb569eb571,196,138,58,South America,17,1515.09
0eadb59cf4f842febe443d78f2b238b7,84,72,12,Africa,17,480.1
0eaec2d27e2f49e492fe1079ecb00b59,365,345,20,North America,16,1936.2
0eaf240a5571450483109fc776aec24a,312,282,30,North America,27,2820.71
0eafdebe5e1c437bb5b6be639a8048ba,81,33,48,South America,18,331.44
0eb2bd34c75b42ce8373c339f2510e57,168,145,23,Oceania,19,1435.88
0eb2c7cdb7134fa7a2e865869a8873e1,359,313,46,Africa,15,1888.48
0eba4a31347643bab939bd904f05024f,84,51,33,South America,18,774.64
0ebb284c9dd34387805592f3c1c192d8,365,324,41,North America,22,1765.52
0ebd6e8bbcf24fa7a99ff3c3773bbce2,196,177,19,Oceania,12,1905.47
0ec04a9cbefc4f80a90ce62915c2a0f9,109,59,50,Europe,15,330.12
0ec147427c6b49d0b4b6a52c844a77d2,126,98,28,Oceania,19,922.81
0ec38303d5bc4fcca5afedafd585f63c,103,80,23,Oceania,20,696.89
0ec679a109d34fb099d18af11b0392ad,124,101,23,Oceania,25,866.43
0ec6e6f678eb4a49bf8374bd91f08d0f,130,97,33,Africa,17,1257.54
0ec7f07153f74d7f94da1f58781cc3f3,213,173,40,Africa,21,1135.39
0ec872befaf2402da7c7b05a468b3675,214,175,39,South America,18,1372.99
0ec8901331c941798d187581cbf214c8,44,3,41,Asia,19,333.82
0ec932ce48d34773b69aaa5b0f1d1a1b,365,308,57,South America,18,2122.67
0ec9a9be92c8476b8e1f72abc40a8404,288,240,48,Oceania,21,2060.26
0eccccb450a14ab687969032d3f5eb2e,46,8,38,North America,22,621.76
0ecd777eb27f47799e659cca49c4270f,318,294,24,Africa,16,2514.14
0ecf92d83b0b4012b9cb7a9fdef1bdbb,339,288,51,Asia,22,1928.19
0ed074ed2c84416aaef5f952c9bceba0,94,58,36,Europe,19,529.05
0ed320f06dcd47f08f943373ab8172de,274,224,50,Europe,20,1199.53
0ed3c4fe67274690af71d51ebf440452,298,277,21,Asia,22,2202.78
0ed4d41f362a484aac04ff269c660783,88,39,49,South America,20,319.69
0ed6a17409ce4f54bac0f3db8a319520,180,142,38,Asia,22,1281.44
0ed8524ad4e04591b2d78b895e4ba026,89,55,34,Africa,15,412.36
0ed93dc1e92d4addb73a0e2175724fa3,163,102,61,South America,20,813.5
0ed94389d6f441928db437c3a9198c29,90,48,42,Oceania,22,392.79
0eda1b37bbef487fb915db062ce59154,177,136,41,Oceania,21,1207.71
0edb96e18ab04c08af9c5a4dd44fde21,304,247,57,North America,19,1514.22
0edb9e42cccd41889245d3577e1d9561,281,259,22,South America,24,1703.92
0edc695f5b8543bea46712910fe6031a,303,266,37,Africa,27,1887.53
0edd7d1a343449c5a5971b4a8eadb5db,217,184,33,North America,18,1832.5
0ee02d4f83884075bddf7b8c7db22b98,195,174,21,Europe,22,1577.66
0eea8a612009436c86e7b594a87b20fa,180,131,49,North America,22,639.4
0eea8f5d217047ad8241e7ddc30833eb,77,34,43,North America,21,334.16
0eece4ba9d914e658933d5de8784bd39,68,37,31,North America,20,126.85
0eedb7af417740b6af1c4e0429167293,84,58,26,Oceania,18,773.47
0ef11a2a07ba4bd6b60443726d25423e,45,19,26,Asia,19,234.38
0ef157c84d9f49449a58eaa8ca92c489,81,22,59,Asia,18,383.8
0ef25f5b5270413aa471b799ca1246b4,88,56,32,Asia,16,525.16
0ef321b0844c4e22ae28d2caa0cb5132,69,23,46,Oceania,24,293.74
0ef6a3212f8b4f3ab2dcb14527afad0a,223,182,41,South America,23,1808.09
0ef70e75d2954b3991023d66a9e66980,185,136,49,Oceania,20,857.96
0ef970f6eb9a4bcf8cad02b6c45cfbf0,177,145,32,Europe,22,1192.73
0ef9b0d981a54585bc734edf8b5b7f2e,153,112,41,Africa,20,1046.02
0ef9f6a948bb42818319b4c439d1f42e,361,346,15,South America,19,2114.82
0efa13aaae7543abaf94b706f647d4de,161,136,25,Africa,18,1023.41
0efc92fc24a647439883319c48e8e8ab,327,300,27,Oceania,27,2584.75
0efdaf3e98214cee83fdc582b4edbb30,91,55,36,Asia,19,517.93
0f01e457a47143d49f5b6a1743ac7eb6,271,228,43,Europe,17,2373.13
0f0278209afe4501918899f1127eb77f,209,160,49,South America,15,1000.16
0f03a6891f2a4cffb3ebbc8a1a35f346,312,284,28,North America,20,2254.6
0f06e6a8f0494de6a1d9a29100848f0e,193,162,31,Oceania,15,1155.25
0f0909f15fea4421a4e2cb9568561e56,363,343,20,North America,19,2567.79
0f09c32c2a324e4d837470a1c34796b6,234,181,53,Europe,19,1736.06
0f0b8fc3403d4a229df421f4cebcc814,217,195,22,Europe,20,1563.02
0f0be117994d411188290efb7c231ed0,112,71,41,Asia,24,911.23
0f0f3d9b1db94c18a81d684120b163ca,100,52,48,North America,19,430.42
0f0fa199325d415eab802c2882953264,260,231,29,North America,24,2279.28
0f111d24490d4c3db43716a434c26da2,290,250,40,South America,17,1704.92
0f1472bbf47b470eb034b4dfa13266e6,134,104,30,North America,18,964.56
0f17fa11e9814b61b18cdd264bdaff99,151,101,50,Asia,18,374.54
0f18e95f1d9a40abac5bae020821f78d,364,338,26,North America,23,2056.06
0f19107381ff4f85b02356409b14a404,294,267,27,Asia,21,1526.02
0f1b0d3dd125445ea905188cde91e04f,196,159,37,South America,24,815.23
0f1c8040d0ec429aadb5f154385ccc96,127,73,54,South America,20,824.15
0f1cb8c920bf437ba47e2eebbef5a52e,290,268,22,North America,16,2248.21
0f1fd0ccf0bc472fa80a9cd458c1910b,220,196,24,North America,20,1884.81
0f22557d46ff48439b2af4f5d6f2c443,149,98,51,Oceania,22,966.92
0f23170b029a4898852a963e37341ef8,218,184,34,Oceania,17,1499.69
0f238411151a45039710c39cb50b8544,241,195,46,South America,19,1827.33
0f243fafd1a24a1781a99758258b466d,353,336,17,Asia,16,2939.73
0f26d85ed0684885ad53a4d5026da1c5,72,29,43,Asia,26,304.42
0f290e8db8b540a4a5ec762a0e40eb79,311,285,26,Africa,15,3040.38
0f2a9bd1d2374966adee5838e388c447,209,170,39,Oceania,15,1447.82
0f2cde6ad6fa4663b6d0cd7780c297df,177,126,51,Asia,20,923.57
0f2d0d8f74324ff88582bae44e9f6a1a,303,279,24,Africa,23,2059.33
0f2dcc1e7e4c4a95b0f317c6e7f16644,296,244,52,Europe,20,1336.75
0f2dd15f94884c11b4217f9edcf0f58b,186,129,57,Oceania,18,629.27
0f2e1493609743608af1bebc300f9c1e,216,178,38,Oceania,21,1586.45
0f2e675a549b412a8d650e9e0cc6d6a4,49,19,30,Africa,19,187.49
0f2f0ce9e4d64199abf5e912aac801fc,65,47,18,South America,19,488.66
0f3059601bf54ca9be521b4941ddd2c4,247,198,49,Asia,21,1317.03
0f3383222ca740a3bc03a4bb7eac6b71,174,125,49,North America,21,735.79
0f360c02240442f8807f77d12dd61332,180,134,46,South America,21,444.13
0f37ee656d52465392115fd729b99776,226,196,30,Africa,23,1552.44
0f37ef8761414662825006d1a5cc45ac,46,8,38,Africa,20,421.18
0f3851548d5747dc87f98593a1a2b4f9,362,321,41,Africa,22,1971.06
0f38e68dd29045b590ca2f6d418eeb23,109,82,27,South America,21,530.01
0f3a86559c30471a90bc9cf7c2cf7c3f,250,198,52,Africa,21,806.08
0f3ac3a29f0343e1b95eb2414938cbe4,270,244,26,Africa,16,2256.37
0f3b2199aa154173b2d1ffeba5c4b5e8,153,111,42,Africa,21,931.5
0f3c366fb2b34e1883f88c384bdc1af0,192,169,23,Oceania,20,1674.37
0f3d20a3b8a94e118030f2d47abc0731,309,256,53,North America,20,2074.42
0f3d587beb86460db3557ec8cdbeda7b,360,350,10,Oceania,22,2830.36
0f3e7f0df35c45c1a3c58d00b69c5d7e,300,250,50,Oceania,15,1666.16
0f3f2f053923439b80a647a0c672c134,241,208,33,Oceania,19,1609.85
0f3fd583884349e1af1f48bb54be9df2,246,189,57,North America,24,980.05
0f3fdbe882c24804a60adb34062a6268,203,155,48,Africa,18,825.08
0f406529f94b4e7bb60c95ac250c2032,290,267,23,Europe,19,1990.85
0f41a832e1e1437aab274aa42e137f7c,357,308,49,Asia,19,2148.02
0f432aac7a0340ae89097f105bc31cbe,254,220,34,North America,26,1775.12
0f459c9402ba403daed139ad8c002c28,220,171,49,Europe,26,1265.55
0f4b38ade787462e837d7ee8c965469e,267,232,35,Europe,18,2102.78
0f4b39e9907e4f17b1fbb4feb356aa0c,365,364,1,Asia,17,2087.55
0f4d4dfcb97645a69fc1b172ec70216f,365,322,43,Africa,20,2252.02
0f4da8aeaf7b47559f26a920869d7078,76,34,42,Europe,19,394.95
0f4e26bd417c46dbb9abb274a5fb7a90,169,125,44,Africa,23,946.73
0f4f321eea6c45f3b6d239b7ecd3aaad,65,30,35,Asia,24,342.83
0f4fcf35844d47fdb3f07b0cd2b911ff,224,198,26,Oceania,22,2163.4
0f517c2c34da4dd388e3a0c58bc9b301,290,233,57,South America,20,1097.38
0f52f355c75c4cc99564fed29704b588,222,173,49,Europe,23,838.91
0f563bcacba342e3adcc0a1807a0e90b,106,87,19,Africa,16,757.01
0f59203a46894f89b5180f0bd464f353,194,157,37,Oceania,16,1085.41
0f5adfce005e475a8be4a8dc3565d8e4,362,355,7,Asia,23,2016.37
0f5d584758454a7d965a36cf323baf51,202,151,51,Asia,16,568.79
0f5d699c41764d7f8fd82dc684e60cb7,218,170,48,Africa,19,1314.49
0f5f347a51c648e28ca6ddf74fec031d,186,146,40,Africa,20,1645.3
0f6048f7b29a4d6da7f2d1328a72b3f5,40,4,36,Asia,19,454.94
0f6141077cac4d529b8a4c0e64655bcd,267,224,43,Europe,23,1720.91
0f62110f26c44bf0981fd17cafe16c44,364,349,15,North America,17,3452.56
0f64704163bf4e10a340aa5f861b6030,284,257,27,Oceania,17,2380.38
0f65b919e00c4df5a12fff82ec84f851,100,79,21,South America,24,921.93
0f6744262fb54909b27a45dc393d8c45,168,145,23,North America,18,847.22
0f678522b34c4631bdce026352a369a6,364,324,40,South America,24,2149.21
0f6bf95569b74174acab1c5b117ea54e,131,86,45,Oceania,24,461.08
0f6c3476ee3445d192f5a6caf93f3b17,363,329,34,Europe,16,2518.8
0f6c61cb28cc42ec9dbb6b0258399d7d,144,106,38,Africa,19,686.55
0f6d9f9ba016499fbb24b508d6dfd2f2,232,207,25,Europe,19,1527.31
0f6fc544d680412397dc6b66fc113f94,193,167,26,Europe,16,1101.08
0f7135c1868a4facb3c65c312be82e32,358,358,0,South America,21,2606.82
0f7154d29702484f9285c801da0174f6,314,282,32,South America,21,2288.64
0f71c963bd6147cd9a82227901a1de56,197,147,50,North America,18,887.54
0f74400dd3d7451c99b513c0b909c8f5,345,296,49,Africa,20,1876.66
0f75eca1f79c4dd28ee47ee7dbb15231,35,19,16,Europe,19,58.95
0f778419b4634692b1cec27b70757d94,351,316,35,Europe,16,2593.7
0f780a234c524528b7036aa7ac705786,326,298,28,Europe,17,2214.61
0f78eaaf00f047fe8c16d3d3cd7699d2,179,141,38,Africa,20,1156.58
0f7ed9f2c8fe4f29ae1dade861eaa358,365,360,5,Oceania,20,2880.38
0f8227ac4c89476bbc2daf0627ea1408,66,44,22,Asia,29,433.9
0f835a1c8686471ca5ee5e62806e9158,79,58,21,Europe,21,724.22
0f84ad49e5c24d8cbb83cd06334bb618,99,58,41,Europe,21,489.43
0f853caadd754a819724d761fe218ac8,306,257,49,North America,21,1670.35
0f86341ed6a24294a3683f630c0dbe9b,293,257,36,North America,19,2382.65
0f86e1aec6d74066a22e349298e60f7c,137,109,28,Africa,19,1366.29
0f86f44cb12143dbb716b4d967b0feed,221,196,25,Asia,16,1108.49
0f88a4b4c697415a9b2ccb60e75c58dc,275,249,26,Europe,20,1642.3
0f8a448947f34fc085e58eaf269e53c9,37,16,21,Europe,20,327.26
0f8a5549de5a4ff6bd2f5bede728f911,171,122,49,South America,16,958.6
0f8f76a065ab4078a39deb0fc005a02b,232,205,27,North America,18,1485.18
0f90f9369874429a8f664329173b684c,365,339,26,Oceania,20,1346.71
0f918c53ecca4d6487d9c534da0be25a,310,274,36,Oceania,19,1563.81
0f97a2eb66e7431db69af07d9b4d429f,240,199,41,South America,25,2106.08
0f9c67c8e1b64a3abeed18eb2ca1d3db,160,122,38,South America,16,410.6
0fa07e699aa74a708523ca4edad16aab,71,37,34,Africa,21,215.62
0fa1206ee893475786b735d7c9b8dd57,365,313,52,Asia,23,1581.72
0fa2635ebf534a7eb1531d9f23f837c3,270,241,29,South America,19,2095.26
0fa47f0c8d8a4e189dba48d943796543,349,315,34,Asia,17,2773.77
0fa76153635a4d619144d33682012f67,280,230,50,Oceania,25,2391.99
0fa777adda214408a43990fa877f58b2,227,192,35,South America,17,1321.06
0fa8e1af655a4ebe9b28b2021403686c,258,234,24,South America,18,2348.52
0faa5b1e35184c4a9e7fee1b94ccf480,245,224,21,Oceania,18,1801.14
0fad03f37fed4469844a8a805296f3ba,57,10,47,South America,17,347.7
0faee953bafa49d6978bb4a8635ac83d,230,193,37,North America,26,1283.32
0faf261d08ea4f968147801007a1d4ae,358,304,54,North America,24,1714.49
0faf58bb647849bb8a1bb16d8d215d25,61,17,44,Europe,27,278.33
0fb102e6ddc84d2886921005fb7c97f2,334,309,25,Africa,20,2234.98
0fb118fdf2174224afd84d61fa045e54,118,73,45,North America,18,983.59
0fb2953ed6954bf6866306c2fe535cad,153,111,42,South America,22,715.48
0fb4c22a18874e7abf6329ced352362e,291,251,40,Europe,19,2235.36
0fb7503de062438f9a7bcce2bbd8947b,365,325,40,South America,18,2032.61
0fb7525b8ec74bb69755d199f41df67d,257,231,26,Asia,23,1882
0fb81dcbe0324eb99d2b476a3efb37dc,362,322,40,Asia,11,2753.66
0fb90c1660424f609a7c0da9425e97de,109,59,50,Europe,19,413.31
0fbe499901714e90bd140df8f4e4c7d0,325,296,29,Europe,21,2150.58
0fc257b73d614a12908715018b0963ca,242,218,24,Europe,20,1596.68
0fc41c31806d4531a0b17084838edb1b,117,65,52,North America,21,351.79
0fc438d6a47345b7a28374c05ac6470b,36,15,21,South America,17,305.34
0fc483eea3c343aea73a61d38911d3f8,365,335,30,Oceania,19,2205.56
0fc5358383104422b5d6f2591329c543,230,189,41,Africa,26,1054.48
0fc60eb040da40068171dea3fbf41a57,268,219,49,Africa,23,1612.85
0fc616b6578a40e4bad08ed61d120b95,215,178,37,Africa,18,1746.46
0fc72eb70c374af0a37cdfdb21e271d6,105,89,16,Oceania,19,934.29
0fc76fc01cf3426097c51f75095155a9,232,193,39,Europe,20,1349.47
0fc9f000abee4d4b8d711defa59ab6be,196,144,52,Africa,16,1167.69
0fca3a8c934146219fdcfb87cc3c90e6,284,260,24,South America,20,2036.52
0fcc3bb77e0e4e369e506cfdb37043f6,212,197,15,Europe,15,1214.75
0fcce6942427411e8a5b843e9f5e4a1a,120,83,37,North America,20,1152.56
0fce7d391b254b5da3a63e6b30408940,135,87,48,Africa,20,742.3
0fd00918cf4a46a2a88ed42e8e38ce03,203,171,32,North America,21,1803.82
0fd0691069ea42d49d36fef3edcf9aac,233,196,37,North America,25,999.23
0fd310915741420cbcb5c5071f8d7f9d,360,348,12,North America,16,2609.79
0fd3d01540a348ec949505e6f748ad0f,335,307,28,Oceania,20,2419.06
0fd5adf0a7344c0b9c87509bf807f37e,50,11,39,South America,17,364.35
0fd6086068b04a27b6f89d9acfc5719e,365,318,47,Europe,20,1446
0fd63621267047768445d36c930d6548,19,2,17,Africa,25,72.61
0fdb09d7002142f79b9e6fdfe1e04336,131,102,29,Europe,18,1368.77
0fdee4685a6c4bd69db63d45ecf5c6d0,363,343,20,Oceania,21,2099.29
0fdfbf18abb54c50b0c66d7af9a10310,89,65,24,North America,20,1082.69
0fdfd11b766c4687aeea32a2a1f4386e,209,168,41,Asia,24,984.58
0fe2b9f58068473193c364cf6ce21d3b,34,5,29,Europe,28,194.08
0fe2e6e40a164ba88c2287bb99aad49d,56,10,46,Asia,17,258.6
0fe335e726bb40839b8df1a5b8ea276f,201,166,35,Asia,21,1387.67
0fe444cf2ba1482a82ce9b540f64ffd6,282,233,49,Oceania,22,929.11
0fe5a905fb784567bf3424442348df3d,232,183,49,North America,14,887.15
0fe7498846a7435a9de927f3825b715a,334,282,52,Asia,20,1709.75
0fe7cde6d5044f1396dfbb550d291420,48,39,9,Africa,15,272.21
0fe8edc10a1c4fc3893a94e77846cc00,321,297,24,Asia,25,2639.57
0fe97253238e40639c88bb014fde7b28,171,149,22,North America,20,1098.12
0fec3a412501440b82ef902769c9dd34,108,57,51,South America,17,659.52
0fed2c33bfbd4eea977fab1a504b797f,128,98,30,South America,22,982.88
0fee57edc8944ec58e2aead45338f56e,359,307,52,Asia,21,1543.23
0fef2564f1894c03a033765106a92819,236,190,46,Africa,18,1519.1
0fefcd707d054283a161f88ebbbc7a21,121,90,31,North America,15,478.99
0ff33817e31d4030b6ac7f5c9e8fa59f,160,113,47,Africa,16,971.75
0ff5284fa88b405b944701f16be04c1e,362,341,21,Europe,16,2807.87
0ff7ad23d68143ad90509b0f3847b46d,95,62,33,Africa,14,372.99
0ff970830d9244f9b861d5a914818949,110,90,20,Africa,27,994.47
0ffb8d763cbf46ee9077e838f352135a,291,262,29,Asia,27,1859.32
0ffc2fe17b4d443c8f13ef37989095fb,54,1,53,South America,15,294.91
0ffdde4fe8ad48e881ff925b633db446,96,54,42,Europe,25,690.09
0fffa4105e824f33b2ea3c8eed0743de,365,355,10,Europe,19,2308.5
100012f98542493ca3345cb1aff0bdc1,76,19,57,Europe,20,204.78
1002f0ec22c14598a135fc1e038b7c92,255,228,27,South America,23,1752.91
1006c1b5fb964f7cb20c2d0878433852,126,96,30,Africa,21,730.25
10089fb0a6ab4031a6b06b441a9d1dba,131,96,35,Oceania,21,646.92
100995bd046343f598a2869e3343bf13,201,159,42,Europe,19,1647.6
100a910e9e9941df8f69423f7e17f672,363,345,18,Africa,18,2614.78
100b114f8d9a4528b8d2691fe6f095ba,364,329,35,South America,18,2757.73
100b50a826f14bf9bf855728249fce6a,230,202,28,Oceania,22,2054.62
100c9e1198cc4cbda03799966b57440f,363,333,30,Oceania,11,1632.27
100f35b7d28942c399d5b8133594626f,204,156,48,North America,26,1436.99
1010c40d37bb44dc8b52d5d348ea6008,365,360,5,Europe,17,2847.8
1010da70f8df4a5da826d95d4f35dcb0,295,239,56,Africa,16,1797.26
1013e2436c89407d8300b735f1f22dd6,247,228,19,Asia,23,2248.15
10193024d7a9460b8f711b1a9a1bed49,159,115,44,South America,14,1497.34
101b493d623f434a94b570d27af9b0e3,97,50,47,Asia,16,509.88
101f946cfbf341ccaaeb11dcf1e6f57b,122,105,17,North America,19,741.86
102156fb5845436caeaefc10d6241e61,354,305,49,Europe,21,1612.31
10232644db1c4d3cb68d6537af8991a8,200,161,39,Africa,16,953.49
1023c97cf06e4c21a402e1872b6f1ca8,72,44,28,Africa,23,568.75
1023dce07cd046709b9a7ee1e8fbae37,168,140,28,Asia,22,771.52
10268909adf74a17ae00c914a80c45dd,182,153,29,South America,15,1517.9
1028e5bb77c446368247cb4c5d36ba84,90,50,40,Europe,17,863.36
1029a81a7318454bad1e521fa001e359,365,359,6,Asia,20,2752.92
1029c2a9d9ed49efb8c76207769ab7f9,198,173,25,Europe,16,1737.15
102bd76abe434878bccc923308247a7c,127,108,19,Europe,16,1005.84
102caecafd21495bb994b4efea0dfa05,258,210,48,South America,26,1120.92
102e5636b6384b09b16b934a44539dae,198,172,26,Africa,19,1408.73
103064d4969c4626a8948897c8d14f83,308,260,48,Asia,21,1286.46
1036261c0b1e49518f27441978057844,162,110,52,Oceania,17,805.46
1036a1d23da848b3a42947db817a0a99,265,225,40,North America,22,1693.93
1039d66e50c142f39b4e89773c46db26,335,285,50,Asia,16,1149.01
103b0c30613e45a8854a8d9a4a82feae,219,167,52,North America,18,1048.18
103c42970540462fbc0840c658249df5,350,338,12,Asia,23,2415.16
103cad6e42f741398df9af526052f0b5,195,155,40,Oceania,17,1574.98
103dd12c85df490fb0350dc249c41938,335,299,36,Oceania,16,1877.81
103dffdea1464ed58e3c180749aa4ae0,324,284,40,Europe,15,2271.43
103ed68528824456984df5223e67ba12,78,30,48,Oceania,18,360.95
1041358d5eb547df83c96af2a0595456,143,124,19,Oceania,19,1283.16
10436c5e72ed4c4c94f444cc330258b5,365,349,16,North America,17,2054.68
1048eafb6a8d45a0b57228f97895b72a,318,273,45,Europe,10,1753.12
104ae94672eb45ae8c16ace3d35abe94,233,188,45,South America,17,1079.84
104d9f99b5f6464ab3704a6b27ea191d,114,85,29,Africa,17,983.4
104dea772d1b467ca90702738cf593e1,133,91,42,Oceania,23,570.26
104e19bcd14948f1b574c16d0bc0acc2,140,89,51,Africa,23,622.82
1055bd881dfc4b4bafec2ea22e06bda2,201,177,24,South America,21,1361.02
1055c6a7c9574199bf2bd2ad5bca1020,268,233,35,Oceania,21,2001.08
10568d960040435996d53a49f553587f,364,357,7,Oceania,22,2722.7
1057eb8eb5f74b5bac05d6b9b8d966c7,48,19,29,North America,25,613.99
10593188d57b4797bd1162d0ab63b331,99,83,16,Asia,21,448.05
105c01a82324486c8be35fd9ea396d19,146,117,29,Europe,19,1189.42
105c7b04199d46ec815583a6fa432676,177,156,21,South America,22,1493.22
105e391713474099a1eb8f4a32b84d8c,300,268,32,North America,17,2620.17
105ec4bad998432c9d8c44d18093adec,77,57,20,North America,19,765.19
105f60dc48c445179d7d3d87a70eb92f,79,54,25,Europe,21,507.09
105f9007117b4fc498856460cd2ac7c2,123,95,28,Europe,24,875.98
1061102aff3e4ac2803b09530b0b68b5,91,38,53,Oceania,20,642.19
106223badf4747ee9ba642bdff3e97f8,349,327,22,Oceania,19,2920.95
10629032277a4b51b3d4558fd2ea2a2d,160,107,53,North America,17,958.15
106311759c2b44158a3c68c9ab844053,72,43,29,North America,24,274.72
1063a3dc4d034a1989d77ac78c326b91,52,25,27,Asia,20,212.34
1064fe855a4d474ba47321345ff0ef0a,95,63,32,North America,25,897.35
1067548ed02440958df5f92a8c88c72c,312,275,37,Asia,21,2545.58
1068c2696f564afcb1ec0f57396b44c1,214,163,51,North America,19,1194.76
10695fa5869a41f7ba6772989b330d90,73,27,46,Europe,21,596.83
10697cae1ab1422c92bb08626ea6d7d8,365,343,22,Oceania,18,1933.85
106afc576c9b4100b6e285e3f70dc6c2,124,86,38,South America,21,1068.06
106d5afbb886450681e9d54a29b3c00c,160,136,24,Asia,20,926.75
106d9e257f704408a3c7d53fe75dca54,157,118,39,North America,23,1469.74
1071d7a241d642b8986f2b2064ff8e82,364,363,1,Africa,23,2895.16
10730116bec34864a52cb8b1be4d1f61,80,38,42,South America,22,356.44
10763c4bac9d410daea770d128bbbcf6,80,50,30,Oceania,24,573.64
10783c67d06b45368b4e0720726e8745,360,302,58,Oceania,21,1938.96
1078c78374f74013ac90f17f55a3c2dc,235,212,23,Oceania,18,1384.61
1079c2b26c214d98beef815bcc2d4573,231,182,49,North America,22,1101.29
107b163df1564e2baea875717664d793,111,77,34,Asia,19,563.14
107f45baa608469fa8b8e980ce60deb9,312,282,30,Oceania,21,1687.09
1085b64a55b7428bb51aadef5bf8a7f5,161,139,22,Africa,19,1104.73
108b4529f53c46bc9b440499503e5a24,211,158,53,Asia,23,1000.3
108d05daa3314c90b011833873f224b3,38,1,37,South America,19,350.82
109071362fb34ed59dcec2013bc57e4a,206,175,31,North America,23,1621.2
1096b9c77cd648c8b024b54fd6de073c,188,161,27,North America,21,1250.44
10973f47b7ba426b9aa1628e6df1ce4b,360,308,52,Oceania,24,1889.49
109774c86bee438c867ae2003183fa4b,96,74,22,Oceania,16,810.55
109ab790a2774f57b6c25ecc0ce7dbc7,47,9,38,North America,14,322.25
109e8334d3c347b892cb55a960072ba1,213,179,34,Europe,22,1719.57
10a0a877a17e493690f4dd0a6570e814,49,22,27,North America,16,661.04
10a12d85421742a7a2dd52e3bf7e2be3,344,294,50,Oceania,16,1837.99
10a1a62e63a2428bba7879b5b5816954,305,264,41,South America,24,2299.03
10a2aab8a71f4623a81b014afe2d110e,265,231,34,Europe,21,2110.74
10a3ba939bff43d0bc68ffb545a4286f,362,330,32,Oceania,19,1943.18
10a4308ec7ac463a863401d6a65af502,321,272,49,Africa,14,1919.14
10a48238c7ee4d91b2d5b170a8a1419c,133,87,46,Europe,17,1308.69
10a5d07e41af44eb975c9d237a8883d2,76,50,26,North America,21,917.07
10a7d6a98cb740dabf277407335d86ca,179,155,24,South America,27,1364.89
10acb31fddfb43209fe53238f830faa6,314,292,22,Africa,20,2250.75
10ad72436d6a427d9b9a9fce7a70de29,365,363,2,South America,25,1745.29
10ad8812de164adeb221d132428d5e06,133,96,37,South America,22,1093.82
10ae078713a746ef9100146ef963a871,130,111,19,Oceania,20,1187.22
10afb07e030e4ba1a08c207ba4ecec5f,363,339,24,Oceania,18,3313.19
10b0d005af2847158807953636d46429,364,360,4,South America,17,3326
10b1f70fe2fb4ad6b04829d1ec5537df,178,149,29,North America,17,1159.47
10b2c2f2faca470b9a35f86f44f79c18,332,304,28,Asia,18,2782.24
10b438a766e04e3b8098ee1ebb70bb5a,341,300,41,Africa,27,2114.8
10b663a8e44b41899b98e41032d767a7,293,273,20,South America,22,3014.7
10b791e920284592b58ba4d3b0185708,110,79,31,Oceania,19,888.82
10b8bcbd011a49298765152bf44b0141,221,198,23,Asia,25,1678.63
10b8bf9bdbd74fb9a3c6160c910c978c,46,2,44,Oceania,20,125.29
10b92c53e81b48ca907f66e02bc13b7b,335,304,31,Oceania,26,2759.33
10b973d1324d4667a70366afdb144288,274,223,51,Asia,22,1079.7
10b975162d934f2f82883615e1024e12,297,255,42,Africa,14,1457.6
10bbb52e8f734f82980eb60ec83fd85d,348,313,35,South America,21,1629.81
10bd84348f724f968138f922605be7f5,151,112,39,Oceania,20,1261.09
10c06e9548484063a60958ceabd826b5,121,71,50,Europe,20,653.22
10c740b915954494aacda43948eea2d8,131,89,42,Africa,18,666.25
10c806da29f14e25a3d68d2590aa3dd9,217,185,32,Europe,23,937.19
10ca097cb0664d0284fd809088c53ce3,204,170,34,Oceania,26,1857.06
10ca766b45284e1684ec96bc87ff09e6,365,335,30,Europe,21,2591.4
10cac0a5353c4344a19b501cd247e8b8,339,308,31,North America,21,2200.74
10cac694e5b74ac288d99aec9238c307,340,282,58,Africa,18,1963.03
10cb0b35adcc4c6c97bd5d7b2e5e0f98,158,134,24,Oceania,20,1515.49
10ccdd3a60b342d5a95af62e61fcbb20,365,342,23,Asia,22,2096.85
10cfffd294044059837557286b8d7d5f,111,78,33,North America,21,657.24
10d48a6bcdfa4f088d631b812b1fe5a9,345,305,40,Europe,18,2863.22
10d4c3e66e374ff8b8204116de1c2b1a,59,10,49,Asia,21,240.04
10d66b2bf85745b6a6f5076aad0e0436,365,351,14,North America,18,2494.6
10d67369c8044be8a75e3522c62abe6c,80,34,46,North America,21,150.81
10da666286eb4f7e9e90063a8fb82670,314,270,44,Europe,25,2204.98
10da98f913d44c28bdc0f65409587f68,363,355,8,North America,21,3214.96
10deaf24382a4ab9b07474fff08fd643,318,280,38,South America,20,2077.83
10dee248ed034828bda948a1845a2f79,363,360,3,Oceania,21,2821.03
10df128748994556b88ccdd71a97f68a,360,326,34,Europe,17,1250.96
10e2073bb2d14ac6ba3bea29e6ab8e46,363,338,25,Europe,22,2616.25
10e471314cc142feb3d9e756cae26685,269,236,33,North America,18,1579.16
10e71d1bbc4e446d98f015f337a6ad87,265,228,37,Oceania,22,1928.7
10e950b2ec9e4a8092a70cf4f7e8afda,269,225,44,South America,19,1146.12
10e996ba42ad4b12b09725537eca8455,205,192,13,North America,20,1432.7
10eb6a305c004106aee75ad25ffd9ba9,64,41,23,North America,17,657.58
10ebe90bcad445b3a23b5459800c8736,134,82,52,North America,17,464.08
10ec270f2ae84094a39c609441576d01,249,222,27,Asia,22,2723.99
10ed67fb879449a2a5c8cea57cf86e02,360,310,50,North America,21,3025
10f3af47389f423482851c9cb63dedb2,268,229,39,North America,22,1940.02
10f5517ebc7b4c65a5305f0c157e3116,303,285,18,South America,27,2048.16
10f645b0fcf14596ad731dcab7e31673,109,70,39,Oceania,15,595.59
10f6ff25153c4b4ebc6f92bbd2bd1621,165,135,30,Asia,19,927.78
10f7a40a35c4498e90bffe794f452b8e,343,319,24,Africa,15,2484.6
10f7c4311690468089277587bbd793cb,332,277,55,South America,18,1772.91
10f87d341f134fce9fac762f99935011,43,6,37,North America,24,625.12
10fa3f91e744485587e58bcd4c49d578,54,20,34,Oceania,22,400.15
10fa5ef19a924f0188360b4d2426b041,333,308,25,Asia,19,2671.3
10fa71eab4704781ad2ecea4fc7cf982,224,192,32,South America,18,1504.63
10fad01b0f934e1a863982ec8d51ee1a,300,252,48,Europe,14,1383.18
10fc611f8e34427f8cd47c6a20fa3f08,362,327,35,Europe,23,2588.39
10fd73a295a2493b9bd8bbf59d9b67e5,364,342,22,South America,18,2004.16
10fe071804554f73b103a5caeb4a0262,201,169,32,Africa,21,1647.2
10feead2a03d4af79e443a06a024f5cf,177,144,33,Oceania,22,913.22
1100aa5f2ac24723b6f01f70fe071f57,167,122,45,Africa,24,1122.9
110382bd82c44c90a4f128dd0dae074b,231,196,35,Asia,16,1766.4
11044f51acec4637b3e3a6abf2ce6ef0,349,305,44,North America,22,1802.49
110575ac32f54d14a41faf8b6021cfca,90,37,53,North America,18,406.43
110980559f0b4f30ad622e131254de12,207,159,48,Asia,16,1325.2
1110796b97d8452c93528aa9371bf974,146,105,41,North America,13,776.43
11131f527637496683440b57e1518ecd,365,360,5,Europe,21,2730.32
111590f3672941a982678e36b2f6e7f0,239,215,24,Europe,20,1710.64
1116192af0f4465c93d3f8a65dc790f3,128,105,23,North America,17,720.69
111911a9d7294af8a6aa0261a08913cc,207,158,49,Oceania,20,1079.21
111aa1a9a4c3415eaf0a1e003d833f10,312,291,21,Asia,24,2651.28
111aeb6fba444c1da06eaf83f437c1b5,86,52,34,North America,24,363.07
111cd0bd596545d6af1bb6ba53855db6,252,227,25,Africa,17,2111.57
111f552da03248faac280dcea807abbd,135,79,56,Africa,25,555.48
1123f050f623470fae8266cd74f68f13,362,332,30,North America,19,1847.31
1124c0b937814e2ca08246abf139bbca,364,342,22,North America,18,2053.82
1126b2607a524182919a4b530eaddd62,299,267,32,Europe,19,1604.16
11281dcde48c4ac6adcf515fc4408787,190,157,33,Oceania,22,1667.03
11299289420241f8b2ac730deb1d2557,129,94,35,Europe,15,644.27
112a1b064a33497ab2f0126a69b578b1,130,78,52,Europe,20,932.06
112b30a0122345d1b40781f3a53809da,269,244,25,Europe,18,2014.98
112b59c061814645a0902d5efc6b80a0,77,43,34,South America,23,249.91
112bc629116b45c696d9298cc4fa2ba2,365,334,31,Africa,22,1947.11
112e0cbbfff4407aa481d923cb2004e6,290,273,17,Oceania,22,1643.09
112efa370c0d4762947ed4ef34fb5fb3,86,34,52,North America,21,466.77
11316e67dcf54aeeb894f7cf8418f9d3,70,17,53,Europe,18,431.73
11321d9c978043f0873a421cca9114e2,59,20,39,Europe,21,555.91
1132d0e168174bef8d8d5c2cb906154f,130,91,39,Europe,24,838.57
113518cb660a45808a0bf8218955fa88,91,51,40,Europe,18,482.74
1135f9bdeeae4df5b76aad9b27eb5e93,295,233,62,Europe,22,1798.32
11382f4d80424e51b2df6157492312ca,332,295,37,Oceania,17,2504.23
113c1f087d0b418abd5b3e2ea458a17b,68,42,26,North America,21,271.92
113cc512416e45b38bea9859fb492415,109,64,45,Africa,21,694.1
113e1635b1fe46dc80bf79f8bda1a43c,55,30,25,South America,22,248.43
113f081d02104e1ea16fe88cb00b0cbc,143,118,25,South America,21,1289.52
113f0a37953245c29c394d1cea945f1a,204,181,23,Oceania,21,1878.86
113fd9b49a244317b38c63e0c86022a1,91,62,29,Asia,23,467.07
11408dcc85a84cb7b980980629a6f794,87,70,17,Europe,16,1037.25
1140ebb04df84a768710089a7661cab2,153,126,27,Oceania,24,1197.92
11440d3009744a03b8ffda11a09d09f7,304,266,38,Europe,23,1521.08
11472501025b4a6494109b0e5f3d84d4,151,117,34,Oceania,22,810.86
1148c858188b41e4b8636203960ef59d,365,331,34,Africa,19,1868.41
11494e1d083747aba34ae44cc7e50405,287,249,38,Europe,17,2807.56
114d8934bfb646a58b9b081147e9d874,365,360,5,North America,21,2475.23
114dbb7f4b494ae7b4d6c9239ae4473a,290,260,30,Oceania,19,1530.41
11516f46941f47e5b291c74079ea0e46,181,152,29,North America,22,795.61
11519d6dd5cf49dab067eda4c93502fc,310,266,44,North America,11,2672.73
1153d3fe23a1438dbf852e29e5462a2a,313,291,22,Oceania,20,2417.2
1155b9df304349918986e0b53e68010c,352,307,45,Oceania,20,1390.38
11572738d3234f678a1e75a8a6954fa5,250,210,40,Europe,20,1798.61
11588fd2e39a4099a5d69c8267d8ffcb,301,256,45,Asia,17,1593.83
115914e7510044f1b224b4d9e34b5430,141,86,55,Africa,25,291.48
115b2cdcaee74edebf8321ce61beb99f,31,3,28,Europe,20,69.54
115c76fb3a8d4a47a421ec3b2dcd2336,190,167,23,South America,21,1067.52
115c862e79e44d6abe5b2ffd30b3f331,114,72,42,Oceania,18,803.9
115eabb845d5493988a70c6109cb9d66,365,349,16,Africa,9,1469.93
115ebde8e7e244a6bbc999fe2ae7ee11,201,169,32,North America,20,1209.14
115ef502ffd54c39936dcab4b6ace2fd,79,29,50,South America,22,354.69
115f733e0b83499aa57d9840cca995d7,365,349,16,Oceania,17,2099.54
11603116d42d4fb19a6ec5963f268c7c,364,335,29,Oceania,20,2366.33
116222e5f5e6479abe3d07f8a74ae6f1,195,140,55,Oceania,18,737.42
1162b00111cb4005892c4f6b597be835,363,340,23,Africa,20,3083.1
116564a6f13a49ba8e8b42fe9bf988ad,365,364,1,Africa,23,2751.08
1168d81edec042d1b97643ad6f53bf75,153,118,35,North America,19,1016.86
1169767e66a94585929257ef42750ec1,267,244,23,Asia,17,2057.79
116a054af62847478e7301270e96cedd,163,110,53,Europe,17,441.03
116e6f599d2c409d90f583b6986b56d8,350,309,41,Europe,16,1402.97
116faefeebfc4e398b3e9086340a5f43,139,91,48,Europe,19,534.22
1170047b1e0c49d7a32dcfa1e332e6b5,304,248,56,Africa,24,1242.5
1170d58bf1d24b32b4d83693a4e13bf4,219,171,48,South America,22,1247.27
11715c25692f4b0ab1960f2c33879252,241,191,50,Asia,21,1444.27
11732d06248b40b284878b81355289e2,339,312,27,North America,20,2939.24
11756ada1e714cc8b57c9aa9538bba8f,216,198,18,North America,19,1470.77
117b146494b54d55a3759782be8c0083,365,331,34,Africa,21,2409.94
117d5d45f1f24d2e94a392e4bcbfdd82,365,345,20,Europe,18,3329.33
117d88b9c81841febee1f123d763957e,130,84,46,Asia,25,1165.3
117ea2dd40754d68b27f5e53afc296ad,331,281,50,Africa,21,1556.56
117ef250d76849c196bd2ae76c46ede8,148,97,51,South America,19,457.21
117f96ac46d44882b4d58dcc4f06b6df,97,83,14,Europe,17,393.78
118035f2d4724e018e1a12844c210b6e,225,203,22,Oceania,20,1349.61
1180675ad4b4407abcd765e9d61ae07f,314,270,44,South America,21,1802.94
11809d457bcb426481fb59aafaabe82b,134,113,21,Asia,19,886.1
11822d9f628942669321afbdb4a0f9ba,125,96,29,Africa,21,1190.92
11847af2bb09475e9fd59e80f2f0d81b,49,11,38,Asia,22,250.83
118679bbb7eb4200977d704636819ce3,365,322,43,South America,14,1064.56
11867ec01bc14d7da65ec708db5c7fc9,159,138,21,North America,20,1176.46
118720c2574146709b98e36617570109,358,309,49,Africa,21,1916.74
118793f7607641bba998bf3577cf1734,227,200,27,South America,18,1779.35
11885b9896fc41479c9194134cef81bd,343,319,24,Asia,21,2823.39
118d2831279247d6bd6ea104be2903b2,237,182,55,Asia,18,969.87
118df2299166493e89d4d80b2895f9b9,300,261,39,Africa,13,2414.5
118f12a95f984c1a96e8bb280bfe3dab,189,171,18,Europe,17,1935.35
1191656a7bce4bdf8abaa0957e1235bc,159,113,46,South America,14,735.29
119211ad72f9486fb2596d8a9fa7367e,306,266,40,South America,24,1779.11
119213e6ed66423eb35dc8575604c1b3,141,105,36,Oceania,21,1146.38
11955a5a9feb42d49d40230255d56277,169,121,48,Africa,21,969.88
119575487413410b9d51204b98c1776e,292,248,44,Africa,20,2233.05
1195aa0d45e44c0483727df16fa10230,100,55,45,Europe,22,189.26
11969495bfbb43ecb95c73a1b15b231d,237,200,37,Oceania,20,1261.75
1198b90fe75a4387b50d21ae215ce5a1,80,55,25,South America,18,935.59
119b39d0d07c4af4b9a8ee1bf201e1c1,175,116,59,Asia,17,866.26
119dae940acc4d21bb27443410557557,354,308,46,Asia,24,2110.23
119e1991848647398b5fbcae9cd73b34,306,248,58,Oceania,24,1296.78
119fd32fd10848f9a553f853389111c1,185,128,57,Asia,18,1022.99
11a0314c4c034854a8de8caa1898a6f7,138,101,37,Europe,21,1140.54
11a0faebb4434031a4c61aa20d71f1cc,83,39,44,North America,20,557.4
11a16e8e792246cdb49a246af5e20134,142,120,22,Africa,24,954.55
11a69f74b18d41668f79963eca7da4e2,326,284,42,Asia,19,1978.02
11a8a91944bb40a98fc481ddd4b0cfc9,130,93,37,Africa,26,1103.25
11ab170c4f0245d18cb34037bc280a98,294,259,35,South America,18,1975.72
11ab9349467147158c2f71cebad6149a,365,347,18,Africa,19,2838.49
11aba54e6a8a43808d55c05a7fa00847,361,350,11,South America,13,2257.87
11ac344ebb6c4751b0faf5e98898e3ac,128,101,27,Europe,23,633.31
11b018670c4b4f3b8e04cbce55b15483,188,157,31,Europe,20,1213.95
11b0edba53ae4076a1a41d3f04fe8cf4,365,348,17,Asia,25,1985.59
11b0ff1bac1248adbd2983b67f8ddd72,78,42,36,Oceania,22,762.54
11b24ae6fe8f47d8988b6e671622bd16,72,41,31,South America,16,518.28
11b25eb66bfb412ea0c5e471a400746b,205,159,46,North America,21,1071.55
11b2b7fbed9c4dfa9d8990659a2bd7b5,187,135,52,Oceania,24,919.74
11b5084e673140ef96a1425475d23725,97,59,38,Asia,23,716.84
11b50d25be694614be2252b04d132ee4,362,316,46,Oceania,20,1731.17
11b79b29a663465088ffcc6d6ffbf200,234,209,25,Europe,20,2217.83
11b8b596ad3c45d28618fe2a6654c674,202,161,41,Asia,19,1482.03
11bb43a90bbd40ac83e52f8d58a1dde1,120,69,51,Asia,13,787.34
11bd31b2c73b4539b951b1f6d62c3e30,365,332,33,Asia,19,2414.65
11be6f4919394f50969cb8ea216ca4f4,163,135,28,Europe,21,961.71
11beb5070b7141e98246ecd1a11599f8,277,239,38,South America,15,1991.18
11bfebb975bf48d09e375d396e3e0294,346,318,28,Europe,16,2343.49
11c20769f53e43918eee0f2b0d3a40ee,363,353,10,Europe,23,2668.15
11c32dbaa40849428c70a2f32d89abcf,185,165,20,Africa,20,1590.13
11c3ac40e0b8450089ef075b8b73e454,144,102,42,Oceania,26,775.14
11c48072f6de4b11a55116022758ca4e,57,20,37,South America,19,717.69
11c4cb95e6364f739c58d48312b8e086,309,285,24,Oceania,19,2249.25
11c5e3a0a1554fa7b900a8d33eaff25c,111,83,28,South America,23,615.27
11c773db4a1d44f0a4d834483cb5bd39,189,165,24,Asia,24,1324.13
11c95b598a314e6fbe7185af17e6fb87,247,214,33,Oceania,21,1983.7
11c9742f98184d03baa9f4681cdca14b,255,233,22,Oceania,26,1550.74
11ce221bfaac4b38a5e70ec8bb3268f4,92,47,45,Africa,15,435.01
11cf5c2819a045d3be5f8e5ea0935ae4,132,102,30,Asia,17,1522.12
11d04ba6dcf040f586595a99f8ba56c4,247,196,51,North America,19,1352.81
11d4ce5f3faf4e1a9644cbd1154990cf,344,296,48,Europe,19,2184.37
11d7988a4f834bb1942643a73620ecbb,365,357,8,Oceania,20,2641.52
11d970a2d2b745dd8d043ba11c7eb620,109,75,34,North America,26,657.64
11dca17c4f6640b6926734aec45a3498,65,15,50,Asia,22,655.22
11e030f593bc4f1e9b3479daed1ab26f,294,275,19,Oceania,20,1400.1
11e1aab98db944139b70bb3dbe0f2e38,257,224,33,Oceania,15,1387.75
11e366a20a1841afa18ad1fa173d6b0f,97,67,30,Asia,17,967.5
11e3d1ba908e4d99a4fe970a8c5b5478,290,233,57,South America,19,1643
11e453ddedef449f8b612dc26ad1ff02,201,170,31,South America,17,981.96
11e5018bf50540caa773b61ddaa263de,354,316,38,South America,19,2755.9
11e578cced6d4a9286778eb65d9fbc02,52,32,20,Asia,18,330.59
11e712216bd146bb803607e69fb0a526,210,169,41,Asia,16,1102.79
11e71708c39247729ccba6804cbd1436,129,109,20,Europe,27,961.07
11eb91f1107841ba96f180e7cb54c009,146,114,32,Asia,22,1078.09
11ed3e33d5f4447b834139d1dbd7a709,56,8,48,Africa,21,381.14
11eec38897dd4324a90b5718ef18c7c8,364,314,50,Africa,22,1983.74
11f165d2f86f4a6196c2c64d5e8c3ceb,107,62,45,South America,20,594.84
11f2000018904747b83fc3ce8c9656d8,106,71,35,Europe,16,667.42
11f23d913e124d118da399f882a2f3ce,112,69,43,Oceania,24,401.1
11f38216f2cb4076b7b2d46f600a241c,182,128,54,Africa,19,583.48
11f382335029463ab83a8b2d43515b8a,365,360,5,Oceania,20,1165.81
11f4ea9b8e5a436fa7d88204e3201aea,148,103,45,Europe,25,1170.19
11f64803ee664bd9b5de9e47f324dce4,365,343,22,Oceania,20,2446.3
11f65a200f9a44a6971bf9fa211fe40d,41,19,22,South America,20,161.21
11f6cc748f974cb89f623d016ecee1d5,364,324,40,Africa,17,1770.41
11f72af218ec43ccafd18730c3786e31,228,186,42,Oceania,13,2123.49
11f7822403fb4f058592884deff8eae8,316,289,27,North America,22,1924.47
11f8ca903bf0457ab7e8f8b6196c042c,175,124,51,Africa,18,803.02
11fa464de0ed43539a396d3a4e4bc432,143,97,46,Europe,17,849.2
11fe4739df184bd593807ae16368ac9d,105,75,30,Africa,20,920.84
120322e23e634f3ab94b0004f87ccde3,133,106,27,Asia,17,974.1
1205d9b1907643559bbdf536a3bae3f4,226,201,25,Oceania,20,1684.12
12060d0ffa1847bbb4d4c6fe252e1d54,321,275,46,Asia,19,1608.35
1206336f75234bf2b6a2acca248e573e,89,57,32,North America,19,399.45
12073819c344449d9091156069e25994,46,17,29,Oceania,20,245.28
120757e61fec42d2811b19746d924863,134,111,23,Africa,19,1184.9
120cb1cccd2c4067953d2d9823ada13b,129,100,29,Oceania,21,942.25
120f895fae8d480680ad4f79ec62d8e2,192,142,50,South America,20,788.66
12104c1124ca4d6dab2c19be8af11d41,200,161,39,Europe,19,1069.92
121104a23b374affac69287149c65878,123,91,32,Oceania,20,833.71
1211252c191d490f84d696b96fedbb41,226,175,51,Asia,17,1246.58
12122a06ff7c450eabe8c309c5bfd031,365,352,13,Europe,24,2488.51
12140218854c4dc7944a2cd9aa777f65,317,270,47,Oceania,21,1762.22
1217528993d54565a53e34442d663dd1,250,232,18,South America,26,1661.42
12183bf2b09e402fa59d7434cf4ea796,170,149,21,South America,19,1493.31
12185f3971554467823a623a1cd9ab90,176,149,27,Europe,19,1144.34
1218a06f94cd40cfa1955f1773e40f47,124,99,25,South America,20,564.84
12193dcc23da4875bbe1dc3c16b9176e,262,216,46,Oceania,21,812.49
121a62a6a84b497296526307cefa5006,293,233,60,Oceania,24,1432.34
121c482e6c6646b2a72ff1e6ce03a405,88,40,48,Europe,17,375.91
121df5f101c9478095fb54b33a510aed,116,85,31,South America,20,423.25
121ff2d6e7524f0eb52fc15a3f1953c2,294,241,53,Oceania,18,1577.56
1221cd7e1a784bcd957c8e759f2c7995,133,80,53,Asia,24,382.67
1222debc219a4c589162059e17cc38c5,353,295,58,Africa,23,1816.4
122370d02f5c46e19333a4b757b845ba,265,249,16,Europe,19,1707.37
1223799f50ce4d4f86213b2bb36b5e30,81,72,9,Europe,17,1052.05
1225feef085d408fbca4e5ed468883f4,152,115,37,Europe,20,669.29
1227e7a910aa4013b9e740fba4ff522c,344,321,23,South America,23,3047.17
1228bb8d6d904fd78a188a5bde1b858c,197,157,40,North America,16,1565.82
122ae67b5c874dd58a842bcc11334e89,82,37,45,Europe,22,436.08
122f4c0781a243e5a0a322aeda7c6eae,200,153,47,North America,19,718.91
1230c36db07b49d2a5f1d07b04638fac,162,105,57,Africa,24,593.16
1237f825e61645939d09dca8518d427b,73,27,46,Europe,16,275.19
1237fab9ec88455daef42ac970c65464,364,347,17,South America,20,2801.44
123a953c752743b4a2706d4c5de73b25,253,210,43,Africa,16,1531.87
123e05b525bb4a3ab713b5ea9d87ab30,48,18,30,Africa,17,198.63
123e0d3bb94d464fb0d813e2f26bfcc3,354,308,46,Asia,19,2037.28
123f1806989e4e2a93eba4aa7d5c94dc,62,11,51,North America,15,482.92
12401b94b90544cdb6b3639eeaa04070,244,226,18,South America,18,1375.82
12402f0d1a024dc48b2c46540d1a0c2a,208,157,51,Europe,19,1152.13
1241571cec07416f9067558aaeebc8ee,198,170,28,Oceania,18,2044.12
12417bf6de9545a99b665894c38b0641,364,329,35,South America,19,2176.04
1245b1d4ee9543f39206634e77ea2409,363,355,8,South America,19,2894.09
12467687990440e1958e2082a3ae5529,74,46,28,Europe,23,599.88
1247e2e042fb4aa1bd1f466d9b4c77be,191,164,27,South America,15,1540.96
1248edb3f8954fceb196ad76a7793a47,112,60,52,Asia,19,733.56
124a1d671fc04b679e4e5e17b20e0b43,213,188,25,Asia,24,1652.63
124a2bfa03d34db582a4275600137768,200,165,35,Asia,21,1212.3
124abf675e484f39afc0c117b120df79,277,251,26,Asia,19,2066.24
124b07d535d94b7d8e94d02102a4e2cf,183,162,21,North America,19,1466.87
124bfe47f48c4423b3d3b0bd0346b133,110,82,28,South America,20,435.58
124c1dbaa4894cf49e7f0fae08b9faef,363,338,25,Europe,16,2835.05
124c4dc9d2774beab3bc6166f9f083d0,301,256,45,Europe,21,2155.7
124c7107019f49a19342dfd5c5eb597a,100,56,44,Asia,23,409.9
124e8ed0741543e286cf565765fd7be3,364,319,45,Asia,18,1993.48
12501cb31cf04b8187606b8380ffb16c,123,76,47,Europe,23,732.12
1250bdcbc6b64106aecb77cd208198ea,280,251,29,North America,22,2039.67
1251123fd9b7451d89d89e4bdc13012f,204,166,38,Oceania,21,1370.56
12525120037442cdb0f4c37954d2fec1,204,168,36,Africa,18,1043.3
1252ad1ace9046e99ca0c50c6b3bde04,357,314,43,Oceania,25,1938.9
1254250fbb964e9c8471c7b7f2afc839,168,131,37,Africa,23,744.21
125482efaafe473a9d2998d20bb9df4e,206,153,53,Asia,24,1490.18
125663b7350f45a19a1105302b9e9d2f,130,92,38,Oceania,13,1271.97
1256f623f1b4462c8da534cfa848dd67,269,240,29,Europe,21,1683.66
1257824fbfd041b2b8fa8a4e90fe00ca,133,78,55,Asia,20,593.33
1257930e73424a659a62a4e01b37b006,107,71,36,North America,21,591.69
125a1e4236884b2bb57e69c4122b0c30,146,120,26,Africa,20,1488.04
125b1fba806b4e7fbbd356851a72b2af,206,173,33,Asia,22,1371.51
125ccdb0e58b4c2faafffa2787e85df1,279,227,52,Asia,15,1336.37
125d652c3ae6498e8750556006556cad,183,162,21,Africa,20,1928.08
125fe28082f345f6a3801416dfb292d0,112,97,15,Oceania,20,992.03
126079f51eda4a8a9bd83fb3cb7cb074,359,324,35,Africa,22,2662.83
1260a45224e44a218f038b191e528031,189,169,20,Europe,23,1697.21
12623c3d6a2e422fa49b31719abc23b3,214,186,28,South America,15,1600.7
126385abd04e4512aabbd93494f7d50b,206,162,44,South America,24,1412.22
1265b28eea834c64b9ddaebc1958eff1,357,340,17,Africa,26,2419.35
126673ab12534ded9d024edd08d8f44e,249,234,15,Oceania,28,1861.08
12678638d6dc47afbe86198d27492790,131,109,22,Africa,16,660.81
12698939251a447da012fb2cfd09025d,189,162,27,Oceania,19,1138.92
126b001e18c64f15b02d4c4cf0e4b1f2,330,271,59,Africa,21,1704.18
126ef85d864b417c8d0ef534c8059799,209,158,51,North America,18,1130.08
126f4bc738544135848f66f84dcc4ed8,42,16,26,Africa,19,338.38
126f9a438c4d4b729a250175ceaa822b,179,157,22,Africa,16,1364.85
127027a685ba43b0b836ae324388c6fd,128,92,36,Asia,18,544.6
127129e9f870419ab99324406c65ab6e,199,153,46,North America,20,1283.79
1275b3a24b094c698b3b792752c4e3a0,214,165,49,Africa,24,1007.27
127602b179cd4e3a90257f648521864e,245,204,41,Africa,19,1293.21
1277341f79af4741932a62b7664d47cf,315,296,19,Asia,13,2640.62
127749761ba2468ebd74538bf9e38d11,102,69,33,Europe,17,748.6
12777d2b1cf6457c9aff6c7ebdb39ed6,301,274,27,Asia,23,2861.5
12778b4449214793bf82a6bafdc56453,284,261,23,Europe,22,1996.95
1277ce6c543f49498a0f00e8d9dcd5dd,104,78,26,Europe,18,784.34
12798c500aa14e41a8e0ad7fed086ae5,353,316,37,Europe,20,2282.55
127b00e54c054fd6ac2a8b5feeb5b752,54,19,35,Africa,18,140.89
127fa8a50b614280bc12671f50c7bbd4,351,319,32,Asia,19,1783.66
1280082438a44580b8384f1068da8d02,365,320,45,Asia,21,1932.27
12811906819044e38bbe819c9b2cded8,276,238,38,North America,22,1282.96
1281584072b7415cb4d609f566120cde,74,26,48,Asia,19,552.48
128538cb884d48e7915b4b16b933fc5f,248,199,49,Asia,24,1379
12871861f014468e8eb36a42524a7532,242,189,53,Europe,19,1329.37
1287268de983435481a0b53c2392daa2,233,178,55,South America,17,907.31
1288325289d34e4d9557c91d2271508d,365,354,11,Oceania,20,1921.54
1289e72d891841ee8af5e104f77ead8e,71,29,42,North America,17,345.26
128a8bc0204544cab6e05672cf19137e,228,202,26,Oceania,16,2348.97
128d0e2136b24013a93dc6970df92037,350,299,51,Africa,25,1377.41
1290b22e19c3482c8ddca5bd0e19d4cf,363,345,18,South America,20,2088.5
1292790b46d14e1abef19683d5471ad9,126,94,32,Oceania,16,1542.35
1292f85a0fd84fff8b6e66e10ce08831,188,147,41,North America,18,1396.63
129600b2a0484c2b85ce70355801476c,220,170,50,Oceania,17,842.03
12963b42b14048fdb2c461e78d6b681a,260,244,16,Europe,20,1666.2
12977104d1c74ac88bbb87d6398c6c7d,365,359,6,Asia,21,2373.19
1299a53d4d854391bd48a2f2b37e7f14,334,310,24,Europe,23,2454.81
1299d19bc9cc49598cc497f228d86f10,107,68,39,Asia,20,877.24
129a13cf51da460584e1714a296e013e,329,283,46,Africa,19,1723.96
129a8f2b0ab1436b80e4f929d27486ce,55,31,24,Oceania,17,434.94
129aeabd651d41988e160fc9b0241572,209,191,18,Africa,23,1306.75
129c9c3e542e47f49026ba1b3277609e,347,315,32,Europe,20,2752.83
129cc76164de42268edb6f07facbd7cf,112,65,47,Africa,15,518.47
129d2903225e4b0b84500a59e6b008ae,242,206,36,Oceania,24,1635.02
129ed201f3414d85842f67a6c874904e,365,333,32,Africa,19,1528.61
129f119d61e34e48a3b7eae9632fbfd5,314,273,41,North America,16,2073.81
12a00b4983dd4249b18062783b0a52a5,349,304,45,Oceania,17,1624.88
12a1302435764b6ba5a5dcc9b3e1d7f6,331,284,47,Europe,23,1903.9
12a24f83fbb84c3b95f5e4bcfdf9ac97,63,7,56,Oceania,22,204.45
12a5479b2f5246cebd177b0c390b167f,92,63,29,Europe,18,894.2
12a61faa010849c7aa4265ddb9e89d08,251,203,48,South America,19,1772.04
12abd6f7d7fe45d285a6d84038beef7b,212,150,62,Africa,18,1308.07
12ad850272c14691a62f0bd566647064,203,182,21,North America,22,1315.02
12aee6248453446280a6ea14645a5936,139,91,48,Asia,25,827.11
12b0f0324e20458bb4ab02bf10220da5,152,121,31,Asia,16,1251.8
12b11dfd480d4c2887218b887f9e04de,108,91,17,North America,19,905.1
12b30a3784914b28964074e8b79d911a,323,295,28,North America,22,3534.38
12b4036cd6d54381a186dfc13a4a6ee2,84,59,25,Oceania,19,760.1
12b4acbd07d84514aaf45d2c443b8ec7,263,211,52,North America,19,1260.95
12b4b490903a48f9b5a2988f16c81d4b,365,355,10,Asia,16,2579.36
12b5cbe547444edeb444febbb6754ff2,296,274,22,Europe,20,2055.49
12b74409aeb54b2195efeaca7a52381b,216,181,35,Europe,21,1350.03
12b826c4b69e4d12bf594f875599dbb2,190,148,42,Africa,22,1343.76
12c4649d16e546b993cdbe7e3e123a1c,73,26,47,North America,22,187.77
12c86a78b22a4f00b1a1a159cd3b8bee,143,106,37,Africa,15,861.75
12ca1250be30479685bd0da198acfe8e,355,327,28,Africa,19,2547.74
12caaa0b70e145da8db6279e4a2d3bcc,302,276,26,Asia,14,3137.41
12d2a589d09443829bc5ec760e505664,40,22,18,South America,18,291.43
12d85c92fe18409985fd7f600cf9ed7b,158,134,24,North America,20,1160.82
12dacabcab154050adcfda526612e8d9,225,191,34,North America,16,1708.52
12dc75fe414f4c239eded4a2445a1dcd,268,244,24,Oceania,17,1907.02
12e3b86af34f441a8ec9282c507ab532,365,346,19,South America,22,1982.5
12e9392d2e644d808a84c3152a542a48,54,17,37,North America,19,322.89
12e9ce903b644b4d9c61e09e5a814c54,266,216,50,Asia,16,1139.32
12ea4b9d8200451d8a0c9479bb70761d,299,260,39,South America,23,2029.27
12eb3f6212d74b0cbf608781b2705cee,364,350,14,North America,16,1945.68
12ee0317430640798f74daa2a79efa5c,76,32,44,South America,14,433.11
12ef92b2ba104ee2b5cb7ac9b17b6b8a,100,79,21,Asia,21,882.05
12f1f416f7d642caba284d951701a195,144,103,41,North America,16,883.93
12f3a01d13a2445c816752c4527eee7d,199,147,52,Europe,22,857.83
12f96f90ad27487cb7730b930a386d44,247,206,41,North America,23,961.98
12f98a9dfe2845c8994f46e3d4807eb2,110,83,27,North America,17,553.51
12fa3ee09d104d0fa29b9be4e47ef472,237,196,41,Europe,16,2588.39
12fa5534d0f94a309b7f0a44e80b60ea,124,98,26,North America,22,751.78
12fb8f5c82c543449034662c021e6214,119,92,27,North America,23,1060.92
12fbfe5f03494c229fe22f46e7a16b16,364,316,48,Europe,23,1898.04
12fc22fbd99c4d29b69a84955440312c,89,64,25,North America,20,320.02
130188d6412545eda9bea7a325222a1a,80,55,25,North America,19,697.04
1301cf7c389c4478b8bce431f84298fc,318,280,38,Europe,17,1790.58
13028c02f31648cdba12fe88351cebba,187,134,53,Europe,22,1194.3
1302bc5028634798baaad331c5d0ed42,195,175,20,Africa,20,1481.85
1303bcfb10d44b6084637ac5f45a7501,321,268,53,Asia,18,1486.21
130431b9d4bc4182a070bf65bace0596,158,131,27,Asia,20,1648.6
1305cc8192bc41beb79a5b77d169ce6f,204,168,36,South America,15,1437.33
1306f3cdb6ac4b6299ca151ab2a8b354,365,346,19,Africa,15,2506.41
1307ce061ad24186b339aeed88cfbefb,365,358,7,Africa,21,2176.55
130ac2c05d7a4061859a449354f8a95f,344,291,53,North America,18,2264.46
130b1430c26e43a5aae6cdc6caf3492a,162,133,29,Europe,17,1478.55
130c235a881b4fea97a64156392cc2cc,258,219,39,Oceania,14,1483.12
13163e5276fb4436890124e456e19229,364,313,51,Oceania,18,2329.03
1318337a56c44f8c8ea3b13de294e26e,327,273,54,Europe,21,1510.06
13195f064c2d4b148498f846ddafccf9,288,267,21,Asia,24,2642.58
131ad7f5b27f45d084695345ece31ba9,116,77,39,South America,19,992.29
131e75f88cbb4dd69807cd6744dbae1e,318,262,56,South America,19,1172.41
1320bc47a4ae45d7b65c7079c35d27a6,86,57,29,Europe,25,714.43
132286f609474720a02b56b9dfa61f81,50,4,46,North America,20,221.96
132674dbfb274668a55d0618ee8bd933,227,188,39,North America,19,1288.25
1326cab8544f4bbbb02da455dbfed186,287,255,32,North America,23,1728.67
132947083e5c48288340a13ac908cda1,363,324,39,Europe,22,2847.32
1329a8de4ab8497aad08470347214901,213,176,37,North America,21,2009.69
132abaa5de83489ebd726e1db93bb28f,140,87,53,North America,21,842.97
132c4260d51845948a8fdff7c9985684,364,340,24,South America,22,2889.02
132d2e5cc87b483cb9dbdb0b0f02e38f,198,150,48,North America,20,838.33
13302e23dddd42929429bb6dd1da222b,365,346,19,Europe,22,2976.89
1330aa52238749268771b100cdb2697f,267,218,49,Europe,23,1677.77
13322d2861e64e0ab96bb737346a013a,309,262,47,Europe,19,1712.53
1332e536fd3c4c7fa5d0553fc2da494a,154,125,29,Asia,21,829
1333b92ba3be4f669d4d63147b4113e3,365,328,37,Asia,22,1525.88
1336286779dd43b78e5edba656d7ecfd,159,118,41,Oceania,18,1016.57
133a77f2925a4d5fbaecbf64805f0ff9,257,212,45,Asia,21,1465.99
133c3e857693454eb56fa9cf9539fd4f,117,89,28,Oceania,22,1077.51
133caf3faa3248fbac643c4794d8f162,144,124,20,South America,18,1043.22
133e23a7ca714dcaa150831b3b119b41,79,25,54,South America,17,218.44
133ea75f43cf4f6d997e3a208fbd7601,127,92,35,Europe,20,1055.61
133fcd3683e8402c97f9869b3b9d6687,363,325,38,Oceania,17,1340.72
1340bff70aff48d58487790ba1fd423d,315,262,53,Oceania,21,1754.58
1341d6a1424f4dcca356fb9d1535b73b,365,362,3,Asia,15,1988.41
134208138e5744b0bee4d181bed6a5ab,302,278,24,Europe,22,1636.62
13444792a2d64115aea26ed11c48be1d,345,310,35,South America,21,1736.28
13460411b010458c9523354474f338ed,88,37,51,South America,23,502.03
1346246fc020414685e4a72820b2e8e7,111,56,55,Europe,20,348.23
134702a99afa44dc89d1d7606b16fec7,182,161,21,North America,21,1167.77
1347e3905a3f4a849c5dab6a4e76919a,243,181,62,North America,24,1186.19
13487ee75dfb484f89a15626151be9e6,279,247,32,Asia,22,1849.89
1348c190ae754a9ab15a6d6f167a9ff3,365,363,2,Asia,24,3233.6
1349ff7559544d5d97192b1c9fa63b4f,269,216,53,South America,20,1099.06
134a4cc1b0874244b5a6ca76dd85302b,330,277,53,Europe,20,1835.58
134d1441a54d4308a57421d27e859969,174,134,40,Africa,19,592.49
13501ae47e444b8b812efe04a2cb36c3,58,20,38,Oceania,18,397.38
1351fdf15d0e432c859411edac455dd5,365,354,11,Europe,22,2946.3
135212face1e4b4dbf8ef608a020d611,365,353,12,Africa,16,2877.9
13528ec4ce3243edb6ef0f07461ebd3c,329,293,36,South America,15,2689.37
1352e904d47d4480b15b9f5e59d4860f,328,295,33,North America,24,1965.53
1353aa2131e44791b1e1db90a087d4b2,91,42,49,South America,15,712.77
135491dbb7804f7097fe717460b25f7e,363,347,16,Oceania,17,2066.76
1354d9ea6f9c4b0baa16ccf5a718d0bf,91,62,29,North America,25,517.53
1355b81dc40641d4b6329c3d7a8ed0a3,349,302,47,Europe,24,1483.53
1355f06e67db46d2a68dfe0051cb275c,110,87,23,North America,23,530.6
13560392071e4caaa5dc770228d9c4b9,349,335,14,Oceania,20,2068.07
13567d0d781d4d5f9d982cd20a27601c,364,361,3,Africa,24,3441.75
1357cbd0877947e89ae70cbd1a917f42,336,304,32,South America,20,2403.79
13584087adb64da6a6f88db2690e77c4,256,235,21,North America,19,1491.36
135857d93a674e6781438d9da26ca9b0,274,232,42,South America,21,2143.91
13593ddd8654491794849396434babb6,282,237,45,Africa,21,1557.3
1362d80491a843c19f4b95e5578d8546,107,80,27,North America,21,909.81
13632dc11d7049ee96f60284ddca3691,109,70,39,Asia,21,613.57
13649ca858e64c1f8ee11c23e8c7a664,174,127,47,Asia,19,735.55
13674a6d8deb480bb2a5e3e7d6d71d73,232,185,47,South America,13,1506.4
136b111ef8d54c9e9bcafb6414524515,218,180,38,Oceania,17,1262.65
136cfb48e65f4658a5f3b6fb0355fbab,339,287,52,Asia,15,2035.75
136d9a56d9f84799b1a9741e63166b97,269,229,40,Oceania,19,2028.3
136dc930fb684661bbd981d06a806f3b,97,48,49,Asia,20,456.06
136ed4a6fe71451ebd5f8bdda0539272,127,82,45,Asia,14,835.81
1373ad357e9d4c4eb599838f5b81a745,219,171,48,Europe,16,1046.23
137446a078b748cb96631b71668038b1,289,240,49,Asia,20,1637.46
13744a6a407f444fb940968545113761,243,220,23,Asia,19,1670.27
13774597fe9e4d60af1b1ea4a08bcf86,76,46,30,North America,23,744.97
1377b83ae02b4ad3a57992364da694f2,161,107,54,North America,21,1127.53
137a4757f9bc4eaead469b06c462e82b,226,192,34,Asia,13,2055.46
137bc1bf735b44e7bb91f10c52e68d89,72,43,29,Europe,22,335.77
137c0f3ce9a64f83b9a49998791e6e9a,186,164,22,North America,13,1314.25
13800f71c1244000aafe859ebb1e531e,329,290,39,Asia,22,1591.93
13831e663af14ac7acaf78a5c1290c7f,304,264,40,North America,28,1815.72
138913364a76472dbabec7c91017be24,356,322,34,Europe,19,2229.67
138a131872c84fbca4f6de19b0821f31,327,301,26,South America,19,2278.15
138b99c0a56e4f3a98c3385d8ab18bb3,352,324,28,Europe,17,2617.02
138de57ffdd9419bbd2dc40339adee91,279,235,44,South America,18,1228.39
139198364ab4425ba984ed656f07a02c,51,19,32,North America,19,196.88
139326d4ef6c474abba5eb994b65e182,141,90,51,Asia,22,929.68
1399d20699f94e2ab3559a9c30ee1f11,330,306,24,South America,21,2483.53
139aadb9b3d84e5bb18cccbe8ccda3b3,312,263,49,Asia,24,1723.72
139ad3424d6346d1838c80a63aeb318f,126,75,51,Asia,20,625.58
139c5dc0a4d84aefa18645371abafb2f,125,76,49,Africa,24,388.72
139d8288e5d044d6be77f02179be463e,365,341,24,North America,20,3280.33
139dc435670542b9ac80773b5a7c7016,286,250,36,Europe,19,1306.48
139fac1a8c16441984278de07697ce4f,340,314,26,Africa,19,2094.44
13a081c6f7984a579f9aaa2727471551,208,175,33,Oceania,21,1913.38
13a1af843620459bac48a84de97293c8,362,337,25,Europe,17,2222.87
13a33a8231104f778834474b948b822a,75,34,41,Europe,18,338.2
13a3b9642efe4271be450d1f90be3ade,362,346,16,South America,22,1895.85
13a58ff5082349999928c3db0a877541,231,212,19,Oceania,24,1487.29
13a5e86f8f5845c889b30a859703f31c,152,139,13,Asia,27,1238.58
13a6f93a525e45ee8725438d36cd5bba,351,305,46,Asia,25,1592.21
13a927745cfe4972bcb1060aa4a56ea9,176,136,40,Europe,20,1010.31
13aa658e309c4c32969e56019fa0a992,200,150,50,Oceania,15,1119.87
13ae397b8911468b8cd347b60a60d250,220,173,47,Oceania,20,1102.69
13b21b78ec894d3491447f40c4ba86db,198,184,14,Asia,20,1703.98
13b2d5a9645442688a888840a2576e0d,342,298,44,Africa,19,1631.16
13b2fdefafa7407c9493073da675eb94,328,286,42,Asia,17,1929.11
13b68f126f46465698df2f1175601b69,125,86,39,Asia,22,1036.51
13b8d9f0de834d3e89a0ffbfc52709fd,309,286,23,North America,22,2706.48
13b919c949d34f448ceefb0088c636a4,359,315,44,Africa,18,2186.33
13baa06f98fe4af3bb6eab1eea5ae25b,309,285,24,Oceania,20,2123.89
13bb32593049450593c36fad8e1c81b3,171,138,33,Oceania,20,1331.59
13bb97b1ec044851b2f5577f75127887,365,348,17,Africa,20,2358.9
13c9eac02de04bba8779c6fa5bc74761,309,262,47,Europe,17,1549.56
13cac56cf16d49f5940bd00e13ff0e28,259,226,33,Asia,15,1347.94
13cb614f91cc4d378de2d39e339fa1c9,41,13,28,South America,20,39.25
13cb6df5d6fd49379714d5a5e57a8a56,354,316,38,Europe,13,2944.73
13cdeebb0b9640d7b855961fb0d6b9dd,97,56,41,Africa,19,605.26
13ce357aea9a403eb0827349b5b1ab9c,293,240,53,North America,20,1027.71
13cf8d19cf484d6da192d80e2aa27269,104,65,39,South America,17,681.99
13d03a5e92c24a6f9e1b36a89d6c6910,363,324,39,Asia,23,2396.19
13d2e264ca0f47879329c5e45053c0e8,178,135,43,Europe,22,906.56
13d3d09c989a4db68aa5aaeca1667575,185,136,49,Oceania,22,1156.56
13d3d362c58e4a0783fbd516c3ab2b5b,239,192,47,Asia,17,1228.42
13d4bf87fb56439f898ed9290b2e20f8,352,317,35,North America,23,2404.8
13d81e204697498baf0e58e676ec7508,89,65,24,North America,21,567.43
13d96a3d254740caa3cb4e1400dcdd0a,277,248,29,South America,18,1507.14
13da17e508f74242bbe9d00f1a57fdb8,328,294,34,South America,24,2207.76
13dc231b443b47ceaa1524b2c10b9685,243,198,45,South America,17,1534.36
13dc7140e9844111a27849708830a45d,215,191,24,South America,15,1516.01
13dd20f48fcf49fd8120100dd1f48130,43,5,38,Asia,18,280.58
13e076164993466db85f7ae9e0f9eb82,330,296,34,Africa,20,2749.03
13e334b66ccb4b0582a961a4d7236e11,344,299,45,South America,19,1864.42
13e33f3e75b446fea5c8b253ab806ad0,364,337,27,Asia,17,2870.13
13e3886bbc104bbba11b7b8401dd7a89,93,57,36,Africa,22,283.33
13e498780f8641078166dfad1433e718,75,47,28,South America,18,549.12
13e4a9fae00549dab3aaa83f85a28027,199,170,29,North America,25,1680.09
13e923da66f0428b9bfb0b678c5d654f,144,89,55,Europe,21,905.13
13e92d6e0d384b4fb9c25215d41d9f37,92,45,47,Asia,20,432.21
13f20b7af90f4294934462b14e748355,140,100,40,South America,21,781.79
13f2535a36d34df9af673975e2cf150e,317,278,39,Europe,24,1745.18
13f3afe4bb2a4e11b6ddd56c43a5a40f,365,354,11,South America,21,2583.01
13f4a2823e0e4a57bfb647f6545a0db6,269,249,20,Oceania,22,2807.6
13fb51d5d3d748d8b914d6b1e71c0ac1,304,270,34,Asia,20,2939.35
13fd54b4d0fc4070b620ee6e3bffbe05,202,148,54,North America,21,909.86
13fd877c294949ccb88f9934a7fbe542,181,132,49,Oceania,20,832.81
13fdb669320a42e88e78f4458f98954b,83,43,40,Oceania,20,519.71
13ffa933226d446d9eaff4c5d209f0a7,236,196,40,Africa,13,1581.34
14029a093460427f85640bd915848cbe,69,39,30,Europe,23,372.52
14033ca4cc1c4d1b94ce8d5a4c2b1417,302,271,31,South America,15,2880.8
1403db43af0640bea29810988af775eb,74,23,51,North America,23,164.89
14047430150c4bbf8c9b1255ae032321,164,122,42,North America,21,1128.6
1404cda8d3974ded937d8791917b0cbd,237,191,46,Asia,22,1353.33
1404f92c84884b4795638da20f938a76,65,38,27,Europe,19,642.04
1405efec59d3421b872fa2b7db97341c,250,217,33,Oceania,14,1451.39
14062c344fd14e2a8338434f84c8b131,365,359,6,South America,20,2231.38
140664dbcd2f4f03b6c0a8e1281a3499,73,46,27,Oceania,21,700.06
140738910b24441caaefaacaeda2a4bd,91,58,33,North America,22,830.96
140858d840a841cb85cbbeec3652fd99,178,130,48,Oceania,20,448.76
1409b690b27c4b66af62f7ffc9e1cbf8,324,287,37,Africa,16,2779.27
1409f8057dbf41b895fcc41abca72c15,354,318,36,South America,16,1181.53
140aa20caf9b4070a26baabf7d13b9e4,160,115,45,Asia,19,627.4
140b12e4b5234bc8a095bc1b53bfe552,154,102,52,South America,16,983.16
140b8e0800a14b74846a96199466127c,212,173,39,Oceania,20,1317.83
140cff80310c44c598f1b2fc15d1625e,37,14,23,Oceania,21,323.76
140d7daa43e44f289a6bc829ce08620f,61,28,33,Africa,16,525.16
140f28443ffa45a1a5e08f0d4cf24325,284,251,33,Oceania,21,2062.26
140fdd142dd84f5faa2ee335b7a9b9f7,257,204,53,South America,15,1246.06
1419c055f0d14505a831efc01b00bace,157,114,43,Europe,23,937.87
141a7adee35b48d1b0a4a27c333e6f15,137,115,22,South America,19,894.54
141c354519304cffad786101daf5956e,238,213,25,Europe,19,1630.77
142210a3d339433f900e16d415dc077e,64,44,20,North America,21,494.92
1424f60c01224862a8efe71d0b675b27,237,200,37,Asia,22,1505.84
14254317d6674f639710efb397405e4d,63,34,29,South America,22,609.13
14279be05fa549e1b58c20489bf1dde9,149,115,34,North America,26,1375.19
1427b6bf2fa0424dadec672f68c115e5,318,267,51,Europe,17,1211.69
1428acc32df14005b745cc3225f2f3a5,303,274,29,South America,19,1822.23
1428bde8f77e49f8afb061de76d3eaf2,354,326,28,Africa,21,3025.12
1428db68d99d48d383fc6c8e089b9d01,364,344,20,Europe,18,1639.04
14307f6205fd4bd28dec881a47657774,233,207,26,Africa,21,1481.1
143096573c8144e3891aaf4882eff65a,156,120,36,South America,24,382.5
1430cc15c4ae4b2f9c5f86256d388005,289,236,53,South America,24,1587.71
1433017610ff4b5da1564048284216ec,84,55,29,Africa,22,663.48
14349b8c3b50471cac0573f37ec24fd9,365,320,45,Asia,21,1987.71
1435379979b74e7ebce41082764d975d,175,154,21,Africa,22,960.13
1435e68eb96146cba6082446cf04ff80,358,310,48,Africa,16,1934.38
1438032acbe6410ea2e334a84d4a7d03,363,332,31,Europe,22,3505.89
14386d205ae941eeae1715a21dfe9413,365,326,39,Europe,20,2108.33
1438c7671df9486b969075c3c10f603e,337,307,30,Africa,14,2770.29
143b68bff5cb4672b239c66a68f7a265,218,179,39,Africa,22,1429.97
143b77d269a5483db56dcd1c1de820a6,357,323,34,Asia,15,2538.37
143bde438d47481b93098f9f7f0ea5ef,347,323,24,Europe,19,2674.05
143d820b7f864b618fb991fdc9e68948,238,184,54,Europe,21,1339.59
143e6690140f4db3954704e7360f6e5d,272,247,25,Europe,20,2079.95
143e74ed639446fa930571545ee73861,309,277,32,Africa,21,2258.2
14446df1dc4d48aeb8466a8e9d6dbbf8,365,331,34,Asia,21,1650.37
144703d36f224704adcc9cb160c61d8d,127,78,49,Asia,14,962.47
14483ed42841456a94b74abdd55cf4aa,233,206,27,Africa,25,1957.7
1448f4b871bb4a18b0aba3b2c5941338,214,187,27,Asia,23,2154.02
144a69af2c5340dab2f02a3cb79a34c2,58,20,38,South America,14,700.8
144c64a5f9d1409d9222fcf3c340049c,231,195,36,Asia,19,1549.54
144cf9d4f817446a9d0efce75c761c2d,192,147,45,Africa,25,1320.41
144d0d6f5955497b9b8b248fd3a0914f,307,281,26,Oceania,21,2823.79
144d36519d784ee780a54f44e490edfa,59,33,26,North America,24,161.16
144dbf32033b42ef8f701ecbe55089c4,302,273,29,North America,22,2073.81
144f4ad7f870476ba8b71af4c7b05808,291,259,32,North America,21,2071.53
144f7a8ce47945d7b68198cc43d671f5,140,104,36,North America,18,949.32
144f84a19c56422daf8d021ed76b7fa8,302,264,38,North America,21,1832.36
1452a84f967a420fbbe9216f241ae2a0,130,98,32,Oceania,24,1006.87
1452eac854124bcfae7c5eb067c0f56d,364,337,27,Asia,24,1021.2
145a5908b994466fb4eb5e82a2cdab29,317,275,42,North America,25,2164.3
145abe3a2a2949f89e3b34f3673b49c6,365,344,21,Oceania,19,2173.47
145e0737ccdb49cfbfd078e6ed4d8668,193,157,36,Oceania,21,1490.58
145e82406bc442318d816c7b33a5e0e8,58,5,53,Oceania,24,281.42
1461220057754871948a981889597ab7,352,328,24,Asia,22,3199.56
146125d3861a4bf7b1e607600bf5fe28,40,23,17,Africa,16,364.73
1461dafea8d040d483ebf07a6082a04b,54,21,33,North America,17,344.89
146370ea99b749f5a30ef466dea8cc68,182,141,41,South America,17,814.93
1463e2cd1e4c462e941daf73dca4a52c,59,23,36,South America,30,527.78
14657dd9826443bab650b63a0dde5cc8,75,50,25,Europe,21,629.5
1466716ba90d40ee9a960a8c5034b661,363,317,46,Europe,23,1935.04
146679531d0a4d93bb8743199e572146,82,51,31,South America,20,573.48
1466ae1f9add430abfb97ae797c211ba,102,47,55,South America,17,386.88
146a1298428645e7a16748f38c70f3dd,141,89,52,Oceania,24,832.12
146a3c08550d422496394dbcdbe3ecb9,214,183,31,Europe,18,1963.22
146c2a01245b4152a7577bc280b286b5,164,122,42,Oceania,21,949.65
14724dde8d5b4b41a019c8578562ec24,365,361,4,Europe,21,3235.28
1475ed79d0f846009b85d0a85acbc00f,37,4,33,Europe,18,343.86
1476726a445f4e92bf6b1efefab213db,166,140,26,Oceania,22,1289.42
1479c84a24c049058f00d4c5866fdc78,364,317,47,Africa,25,1797.52
147ad153992d4de984673d11b486f6be,97,54,43,Europe,21,474.05
147adb56619b4703baef3f8424e17d0d,145,104,41,Europe,20,937.54
147be4cc7b8c4f19b486d0f2e9027f0a,63,33,30,Oceania,24,518.45
147c40f3bcb44349a22c8423534af950,342,299,43,Oceania,23,1711.8
147db7584d0349a2bf9673ed744efac8,177,125,52,South America,19,661.53
147f20b9391a40a9ab490a564f390c1c,128,101,27,Oceania,22,994.3
147fb009b2e144239e7b77e96691cc18,43,12,31,Asia,19,262.87
14809eb111d548468f9246092ae7c3de,222,170,52,Oceania,19,1216.29
148211da6df446d3ac9c9151e34a2731,72,15,57,Europe,20,361.02
1485b2a568244eee84a6ddd25d56eb09,225,176,49,Africa,21,1128.08
14865ac37b944527859b4b13fe7b3e13,189,153,36,Oceania,17,1479.66
148916b4c8c540a2965f33a10ccd6b4e,130,92,38,Asia,20,895.93
148cdcf199c0440ca8b60bddaa58e6ef,233,189,44,Asia,20,1454.7
148ce525edf14c9aae811f9186a69361,360,317,43,Africa,22,2267.88
148fd64386e14f6c8155cdc5a7fde6a4,221,197,24,Oceania,16,1838.43
149040f7048640e5bcf6be8c17c23e60,85,52,33,Oceania,19,960.51
1490d7126c7c45d192289fa12e567f49,244,196,48,Oceania,21,1283.31
1492dcdf393748918c225836d74563aa,279,249,30,Asia,20,2318.77
14935f366cf7440bb5b1bdfd28cedcf4,244,194,50,South America,23,847.48
149470d369e64661860494f844457cd9,205,152,53,Africa,16,1151.41
149573b3b484467f810578860028a411,256,237,19,North America,17,1681.07
14957aaa9a5d4d179a578f23b8c3eb64,215,168,47,Oceania,19,833.32
149799a9d5e44d77842370a214891582,137,87,50,Oceania,19,561.37
1497d8bf51ab47e7ae1457a6a035224e,190,159,31,Asia,23,1207.6
149826afbbd347759a01588e096ebc3e,206,155,51,Africa,20,1352.62
1499b0e78c5a453280c6737194258847,156,123,33,Asia,24,1322.21
149a7e8dc0a04d07aeeaa418aec74910,284,265,19,Europe,21,2110.63
149aa207d676421f8cfed563e685240f,360,338,22,Europe,24,2657.25
149c6d8289c04d7ebdc842e4f9d33cab,129,97,32,Asia,23,1189.92
14a3c27876cf4469ab5a7dc9ea24d9a6,163,134,29,Africa,15,1197.13
14a552c03a4f484691b6d1ac7f95a60b,280,231,49,Oceania,16,1671.61
14a5d51d32d84b9389b0b0949daf2838,40,4,36,Africa,19,177.5
14a6bb1966124309acb97424de764fe1,82,30,52,Africa,20,617.51
14a7a922499f4838b2ce6c5802ec8223,364,355,9,Europe,16,1649.9
14a9cb2a3b7346ba831b942bb2732684,297,246,51,South America,20,1760.4
14aa98cef32f46cba42d2ce809f915f5,317,270,47,North America,21,1687.62
14aac18ffebf49a6961b63e9c997f515,35,4,31,Europe,20,405.3
14ab79d917604e41a3fab9dd7b88b747,311,259,52,Europe,21,1394.44
14ad6ed0a735415cae7017c4cc1dd51e,259,225,34,Oceania,20,2466.86
14adb9c247274ab3add3352a2eeea714,325,289,36,North America,19,2000.07
14ae94068a3a4c61ad00bb3a24b54dac,326,289,37,Europe,12,1869.34
14ae9de0622a4628b4e76342ad683e07,270,229,41,Europe,20,2146.77
14b011115fad4c43a73c89196d8c7db8,270,221,49,Europe,19,1369.43
14b1269155df492088801e2eb78294b1,295,260,35,Oceania,22,2398.4
14b207ec35c14e8ca24ecf7094044a93,199,147,52,Europe,19,840.34
14b21a34977844e78e06cd0ecd6e58b6,55,30,25,Europe,20,362.36
14b2468e52c9460f9c68a0cd6a5dfd46,115,96,19,South America,22,1062.3
14b38e14bae044b98bab96984e995378,122,93,29,North America,23,1120.57
14b446a65cf1465490f2199bb6e428a2,172,130,42,Africa,23,1352.56
14b83ec68a84411c86fa147beb0f3cea,279,236,43,South America,23,1626.5
14bb2708271f4a66a40b2497245604b1,168,122,46,South America,18,996.85
14bb68c7a38049e8be3fdddf26434a4c,149,92,57,North America,19,445.42
14bce7d4aac946a3aded693b2e67e279,77,52,25,South America,16,482.87
14bd5ce938f74a77bbfbaa88bab21b64,343,304,39,Asia,24,2002.53
14bf21711eb546a4a5f81780e3054a2a,346,300,46,Oceania,19,1731.46
14bf968298a348098c79488b2294a4a7,364,352,12,South America,14,2460.13
14c059cfc91c4e3e912177af3036fec1,37,8,29,South America,20,329.43
14c0be32d6db47a38e63a452dbb79416,300,254,46,South America,19,1736.87
14c0cdd490c6442daefc073b5ef6bbb1,138,97,41,Africa,17,612.02
14c2fc205572433ba04a244ccf03bb5a,218,183,35,Asia,22,1257.44
14c463d79734453d8b551f4740198723,67,32,35,Oceania,19,669.19
14c6bdcbea7f4b5aa2eda41772140db5,108,57,51,Oceania,16,343.87
14c914f453ec4097adb38f964393dcff,308,278,30,Oceania,21,1963.57
14c94326db7841379d6400c725cfabbb,363,316,47,Africa,16,2415.77
14cb42a0e68f446da710fd38c72d5492,251,216,35,Europe,16,1872.58
14cc15c8ad194fa7bfdd879071bd7c53,75,38,37,Europe,21,706.53
14d1e480aec24ed88ae7870aa945c6b6,211,183,28,South America,22,1681
14d3a3c536f546dcac80de00890dbe22,241,212,29,Oceania,22,1008.55
14d83e9e419f4acaacdb7387e3671144,297,251,46,Europe,19,2180.57
14d91be654b84ae5b1585b0cab171889,294,260,34,Oceania,22,1424.44
14da783036854877b83105785f424374,330,299,31,Europe,17,2331.42
14dac1b26b96444eac7e31ffc53e0a5b,124,86,38,Oceania,18,1078.33
14dbc04ea363480db304302e006fa6aa,120,74,46,Asia,15,827.72
14dc0ecc71b64c6a97735a94997d3eb3,175,139,36,Asia,18,1744.45
14dd89a5eda741589cd9463ae61f10bd,267,210,57,Asia,18,1524.26
14dee1b4d37c4b32bf552eac99092ed6,242,213,29,North America,22,2063.89
14e130f9886140d49acf77cb46029c4d,302,260,42,Europe,19,2032.51
14e1768861ee4d5c9edcfc595000f244,364,335,29,Africa,25,2954.01
14e2c03cea3444769dcdbabb1b5db1ad,118,78,40,Oceania,16,754.82
14e6861c9622406ba6e336bed1f6fc96,193,141,52,South America,17,684.35
14e852c8ab8d488783c048ab28fb2fed,350,326,24,North America,23,2889.97
14ea07b5016041bb9b5fabfc3bc3de37,214,171,43,Europe,20,915.3
14ed9e6f87fd4f4f9c3837729dcfcd2c,52,19,33,Asia,19,361.56
14efdf79bb9c4890b6c2c2c386d439cc,67,45,22,North America,17,599.2
14f02418819e48edaa39a8b094a46bac,365,363,2,North America,18,2589.71
14f0af3d6c264994a6bb1fa0f28011d6,215,163,52,Africa,17,1327.08
14f1fbf70b57428a8d3d5957f3574acb,325,307,18,Africa,25,2410.96
14f2a30b7e3f499a943bd96043547c40,315,283,32,Europe,19,2222.3
14f3a2ad0cd2427184cbd8c42a9e04e5,363,348,15,South America,22,2151.38
14f5b9c69c684ad887b36a77d034a0c4,258,222,36,Europe,18,1318.94
14f7eae9d1744e7e862d34ac67fcf736,211,158,53,Asia,17,581.59
14f7ed1602824109a327170a88ad9525,163,137,26,Africa,18,1313.81
14fa8475ef2c4651918a85a80828dee4,75,35,40,Europe,16,283.54
14fd6161367b4debafc40722ef598a97,241,209,32,South America,21,1684.11
150077c542d14d45a28742a54bd90c65,294,251,43,Asia,21,1981.87
1500ea389d2347d2b4a947717549e64c,274,248,26,Asia,19,2272.75
1504ae67d96d4ddc9a4fa61ae1a2cf22,63,38,25,Africa,15,422.06
1504dc81e01a4a8eb71565d4aa2323fc,359,321,38,Europe,23,3033.23
15053b653e2846388b955e5182897c88,72,31,41,North America,17,396.11
1506b65894a4440da9a3ff9a3218eb9f,332,290,42,Europe,20,1333.91
15074e9b04de4364989f160bb544fd04,120,74,46,Europe,19,635.81
15087d2725ec4245a185b12cf414f128,59,12,47,North America,16,180.95
1508a5f663014435b13ffe5eaf1b07ca,197,159,38,Africa,18,1669.41
15090cb0b0cc4a1eacb623b6d2b1fc2c,314,271,43,North America,17,2367.02
1509298eeb714548b233f4bbbc9902e9,132,81,51,Asia,18,971.98
150adb832024466db9c538b1962f42a0,307,272,35,Oceania,19,1742.95
150d8255b563443da4fff84d72497291,95,65,30,Europe,21,1123.52
150eee702907467eb005cccbea67d298,351,311,40,Asia,25,2193
150f64ca7ade426ba9e918b7f74dcfd8,275,224,51,Europe,20,1281.4
150f940adf754d9db4c1a91527a9dc38,279,234,45,South America,18,2060.79
15109785d379431180107b4654c29a4a,131,86,45,Oceania,17,915.92
1512827c652e43638c4cde447cc26312,91,41,50,Oceania,21,49.34
15151259bcbe475db4534ee0e9617bc4,115,74,41,North America,25,865.73
151716aafefd4a3c9362ee8bbb88b4cb,51,31,20,Asia,17,269.48
15188032f2c24a56889dfb6e87def009,356,328,28,North America,27,2132.21
15193a40546e48a7a10a251ba84e3b85,307,257,50,Europe,21,1753.18
1519bb4d0e3a4429bb20a31056bed6fc,197,161,36,Asia,17,1460.49
1519d8c5dd3f44c9a6470085358f5d69,45,29,16,South America,14,388.82
151b5525a2a6463baa90093e43886c41,210,188,22,Oceania,21,1554.83
151d070de5094ee0940aef8e15809cdb,210,162,48,Europe,19,1144.07
151d4fb1c46246a9b847a9a5f23c2f45,102,72,30,Oceania,18,1070.3
151e430b141d4aed9470132d35b247e8,364,346,18,North America,18,1854.77
1520f5dde987426880c63aa7ba309267,333,300,33,North America,16,2573.03
1521d2315dc940409d7c4066d8856160,52,9,43,Asia,21,466.2
1522f57096db48f9ab42c21d8148c6a2,338,289,49,Asia,22,1979.67
1523e142d6fd463fa6f1fc6d891c9cd0,207,190,17,Oceania,27,1161.62
152631f18a994d79a9c89b636ccd25e2,107,70,37,Africa,21,583.64
1526ce3be346479f8856af76ea5a4dba,315,300,15,South America,19,2313.92
15275e0fa8514aa78d28b1355341cbd0,364,346,18,Africa,18,2372.03
1527d3d4162f47b490cf2c7c585c3200,154,133,21,South America,17,1554.61
152b3df3835647068057236133f9aa98,65,39,26,Europe,20,56.7
152bae7362284ef6b206d906ecb0c5d3,148,94,54,Asia,23,672.8
152bff8d45eb4ec1863bf62d34512661,101,71,30,Asia,19,1247.96
152c37d00ed844698d6dbdb002940335,308,278,30,Oceania,19,1947.72
152d04d877b1407db145261fd5b43532,301,255,46,Asia,18,1592.53
152d13ddf21447a4bf5741cd914ad173,262,213,49,Africa,19,1354.56
152d6152c4144c28919b975836f82ddb,235,213,22,Africa,30,2015.6
152e5fbe5df54f09942a59cf28a964a3,293,246,47,Africa,22,1159.06
152ed37d15fb46de8b69cf012f022c85,365,347,18,Oceania,15,1692.98
152ed71b59f642d2896daf74f5791d02,194,135,59,Europe,17,761.05
152f3fea7926413f92385c22659eef76,340,307,33,Europe,20,2451.85
1532af1d6e9449e49cafc8376fef3a99,311,284,27,South America,20,2707.92
1535222dd6e14c89bd295e23709bfe2b,345,298,47,South America,23,1626.36
15353fcd9c60455ab33715c7e0416b94,283,267,16,Oceania,21,2763.92
153579763d0d482e827ef5421f4be024,253,217,36,Europe,20,1502.61
1535f30e0bdd4f91a80c6364500ccd97,177,144,33,Oceania,23,1706.52
153693bebe6a4714af5c79448fa5c9cf,138,84,54,Oceania,28,1321.62
1537eea6afdc49d3bd2e98fa814febb3,108,61,47,South America,24,240.12
1541583b18b2484884aac22f8283c48e,265,233,32,North America,20,1386
1541dce218b9447ab97a4e04ff7c85d5,365,327,38,Africa,24,1657.88
1545815a59124ea2a8807a5458795912,326,305,21,North America,17,2763.32
1546166824c54cf5ad9784f7f123492c,157,132,25,Europe,19,1298.35
1546a53c624447c299c10c76e340f599,364,324,40,Europe,20,2366
15495178d4e04c2f89a76e2eccc31a42,269,217,52,Oceania,16,1988.95
1549e4442f644114b1116f292e670c39,290,270,20,North America,13,2113.42
154d0c31960e4f06b748e70e0ceb12b5,136,94,42,Africa,17,983.29
154e31c18aa84bed8b5bf7570f8b9acf,43,21,22,Africa,21,282.69
154e616071a84d13b014cbcadc83bf7c,338,302,36,South America,24,2355.49
154fbc12e4ba4aec9eddb5bed8d04a5c,338,288,50,South America,18,1861.41
1552539b6bc948f08468423bfa975ee5,321,276,45,Africa,19,1751.12
15537c932809405bb31c727e2766397e,227,181,46,Oceania,16,1144.91
1553dd4272cd4d37a13ac0c127af2244,308,290,18,Europe,15,2736.81
1555375395974688af68758221317b4a,364,342,22,Europe,18,2014.03
1555c71194964ed2842cd519778f3aaa,123,90,33,Asia,15,840.53
155724f7bee44502a022c2b0a7a60113,289,240,49,North America,21,2042.43
1558e96e693d444eab740966c45b4122,365,343,22,Africa,21,1741.95
1559cbc6325e4968a50f4f321ef4ff24,300,257,43,Asia,16,1481.79
155cff2e8cd541fabbf59bd9f2e7939c,338,312,26,Africa,19,2969.21
155ec40a46c14e719ee9c87855956574,55,21,34,North America,20,246.28
155f4a392bdd4069806a02f2b6ae1fea,365,343,22,North America,17,2091.93
15603c170e684a409348e3d6db083972,308,251,57,North America,30,2064.99
1560ab0ca58d40128b21b21c36cad6f5,256,232,24,Oceania,19,1832.01
15633f8b8281466b9040420244f19087,261,218,43,Africa,25,1050.14
15648b50e8504e67844f9f7b7bfb4312,55,35,20,Asia,15,396.78
1567038d8a904d048c746d36089d38ec,266,231,35,Asia,19,1736.87
15685d8b5c614c0881d7755e4ba4b490,320,283,37,North America,22,2377.11
15696dad42e24812b0dce8a4e7e21c13,364,361,3,Asia,23,2319.43
156a20049fd84eeab416e2df0f5443f0,170,143,27,Asia,20,1100.62
156c49c7ce9344a8ac97abd2b9219ff2,131,82,49,North America,20,520.97
156f76b651b44a71950e72137cc25e9b,70,26,44,Africa,20,101.27
157031e90bc14ae5a42e03a9968fe61f,250,226,24,Asia,17,1684.64
1570610f781e486fb62e4b0867cc7bf1,270,247,23,Asia,21,2464.07
1572848cb9024d4d94d1ba9a72ae1bd5,303,250,53,Asia,23,1527.84
15739946b8f34fb49902adb9292356e5,365,353,12,North America,25,1774.62
1577f37027ba4c8e9172d909a98c6fbe,363,339,24,Europe,20,2447.69
1578af3e174c406fb10dba535974c631,340,296,44,Africa,21,1997.28
157941d46ed84ffe8f453810e4a40b81,82,53,29,Europe,24,803.96
157d45762bad4e718c1327d75e67091e,358,321,37,North America,15,1791.61
157d6c1c1c4c4bc6b47498266b9b3a76,151,131,20,Asia,22,1097.35
157f345b78f14dbf8b3d80c34592a36f,365,354,11,North America,20,2750.18
1580f92aef694574b1b7c136a93182e0,140,96,44,Oceania,23,1046.12
1581caf3685142b6ac49a70bf013c15d,352,312,40,Europe,17,1923.08
15842836612442efa8642de7006dae4e,365,364,1,Oceania,22,1915.84
158630d6d5be448abfc47fe21f87f25e,147,101,46,Europe,24,1242.54
15864900b69943328bf34ca15b8e94e0,261,238,23,Africa,20,1936.73
1586e9291d3b493fba2361506ac338ba,127,85,42,North America,25,420.48
1587e2c98f824530bf6d0370ff42eaf0,243,216,27,Asia,24,2069.65
158a0e254a6848e7a96aebe017db6eca,364,363,1,Europe,18,3292.88
158a141e1fd3467baf609905807b011a,67,26,41,Oceania,24,358.02
158a4d4739404b4795a9092aca71e33d,216,177,39,North America,22,1517.47
158ad9f3fd79443f96675b1a422385a5,167,114,53,Europe,22,1283.85
158b4570dabb4240b2a9073377effd69,354,316,38,Oceania,16,2613.84
158bb7b6e9f242159d804cbd67a2bf1d,360,318,42,North America,14,2111.04
158c61a23c1041d899a3103ea58fa069,256,220,36,Africa,20,1902.61
158d3b73673945969ab0f82030948063,54,13,41,Europe,18,250.34
1593faf5f7554f52ab4fdb120522a98b,325,271,54,Europe,20,1791.04
159486cc59674673837d7283d06ac777,187,151,36,Asia,24,1200.47
1597c10ab88f4583ba11d7849c151179,315,273,42,South America,19,2361.21
159cf3e9acf240d5aad07051fd73c76e,155,134,21,South America,20,835.94
159d3ec94591443ea4d5a3964cd03c8b,355,308,47,Europe,25,1473.2
159f78aeb059446080253276b86c6277,207,158,49,Oceania,22,1256.71
159fda7140f444249ffd0d672e74e8b8,127,90,37,Asia,12,1186.14
15a05d73bf464093962d7866b5860c96,307,277,30,South America,17,2042.13
15a07122fad348da85e33609207cf26c,115,71,44,Asia,21,779.81
15a18e29361d4540919c053db7397550,113,68,45,Africa,21,380.45
15a20869743147f994ba5b17351fbb26,175,146,29,Oceania,21,1202.49
15a37a9146024c9db8b2b9720ea2fe4e,323,284,39,Africa,18,2144.92
15a57b61e69a4c8f9a4f8935561f6a2b,111,80,31,Oceania,23,1066.59
15a5f6ca55f0498c83f4bfa48013958f,289,263,26,South America,24,2430.92
15a73476f37d4302bcb9dcf0b683f7c0,204,156,48,Asia,21,1706.75
15a7655bf4544e1c9401f89f55a2f6ca,244,219,25,South America,19,1721.67
15aab613c12646d0b7f244c4e4e9eb43,359,338,21,Oceania,15,2986.39
15ac3904a5e44331838e393a7cb86384,364,343,21,Oceania,20,2044.67
15acf8c0910b4d2ba433ecb2cf870801,143,115,28,Asia,21,1046.19
15af5e398ac946608d653e45c608a6c1,200,178,22,North America,20,1609.52
15b17ab345084234a9f18f8b831c08dc,76,22,54,Oceania,18,146.87
15b277bc71b84568b6a6eeeab7accb09,116,74,42,South America,16,1073.3
15b2aabac9f2441daac546d8b2389d2d,93,59,34,Oceania,16,615.03
15b2f5a369c842f294af036013433779,224,204,20,Asia,18,1822.22
15b40f5764c947e588cf106d90334ab9,106,79,27,Oceania,18,774.74
15b77ae165a14244bac3a3b59cacf207,179,161,18,Africa,21,1059.52
15ba99ae44404a01b867932d7f6f318e,147,96,51,North America,21,641.05
15baecae47204cc982ddf93d0dfef355,215,172,43,Africa,19,1947.82
15bba59e91964f2d8c9181ed8bed7097,289,257,32,South America,19,2461.88
15bc3562851642549291f57ff03ed3c1,205,182,23,South America,25,1629.94
15c4c8413cf8404088565ed30ece7303,329,305,24,Oceania,25,2727.98
15c9a32a2282402b93070c79b36e1a02,207,165,42,North America,16,1263.65
15cbe8e59e5047a1b8714249e60b83bc,182,151,31,Europe,16,1600.2
15ce66484dfc4fbe84ae24a5d633cb6c,364,310,54,Asia,18,1660.86
15cfc612c9934efdb4d797bc9e238929,319,288,31,North America,20,2233.22
15d268882969458baaadb7db50db9470,116,93,23,North America,20,1127.81
15d3e9fa62074906a5262f5a7319459a,125,74,51,Asia,21,936.05
15d4a6e40bf64894bad559a859152880,149,124,25,Europe,22,974.38
15d6b2d88a06479b956c33c80be2c198,278,221,57,Asia,17,1257.72
15d7de045f5d49d0b9deb89ae2b815be,221,200,21,Africa,25,1600.67
15d7ebdd3d0a4e22a1d984df29de0f9f,149,125,24,Asia,22,1002.28
15d8db57b89d4ea08e83c49c211fb367,178,141,37,North America,16,1150
15d8e4c1976f43968d5140562a1f35b0,88,57,31,Europe,19,577.86
15da8eeab81740bc96b697e6a04721b6,79,39,40,Asia,14,306.67
15daa146a0124f6bb3c745eaf40cf56c,77,53,24,Europe,25,838.72
15dac6663b804698ae05afb899f8eda7,154,99,55,Europe,20,474.17
15db23e657ac4249809f220b13f28e0c,178,143,35,Europe,23,1590.85
15dc7ee6e71c4d61b47ff24445b71427,312,261,51,North America,21,1703.52
15dd3370ab2c4c788976b8ab0403185a,220,200,20,Africa,22,1434.98
15dd487bc0314e429e8061ff0f5b0606,53,11,42,Asia,17,384.24
15e0ea3b2d0c471cb0ecf714cd719fea,55,10,45,North America,25,255.16
15e4b4526e2b48eea586fd978c7e4b7f,221,170,51,North America,19,1436.2
15e76cf6086643799b377c675d14448d,40,11,29,Asia,18,46.8
15e8c059e3cd43809934469e7cd338cb,363,362,1,Oceania,19,3242.4
15e8f93df11a481c86a2ab84b52081f8,70,15,55,Oceania,18,296.07
15e937c697dd42e9900483165a3542a0,258,223,35,Africa,20,1336.53
15ea24983eff4e24bc7c52d96c7564f5,355,330,25,Oceania,17,2548.57
15ee562d269b401a93f7c98b6d77bdd7,319,280,39,Oceania,19,1914.46
15eef51ece6349abaff0a44fc8c71307,111,92,19,North America,20,999.06
15f0d34e968e4caf94d81a36e49f8a87,365,347,18,Asia,21,2401.13
15f1891ab8cc45af81b71306e71beab0,30,6,24,Africa,14,280.1
15f56e1aec264c3eb73106fdd64f5f77,347,293,54,Asia,23,1713.87
15f5cc3b78bf4eab9089e6981b67ea60,239,220,19,Europe,25,1783.79
15f7c30026a0419ab6159030cac76f38,205,169,36,North America,15,1080.35
15fb6e54dbcb4416856101de5de1b1a3,249,206,43,Europe,18,2223.55
15fb8c4aaef74fd1a2a92776a33e7e7b,107,60,47,North America,14,387.44
15fd66cc414d40c8b6c38fd8258f6664,279,249,30,North America,23,1795.66
15fe5545b09c4508ac5e4d389dd2fa18,174,130,44,Asia,16,998.88
160549107565476596390b29bf43c49f,45,2,43,Oceania,18,258.54
1607e54daa8646bab8817ed1a2f48676,179,151,28,South America,22,1228.97
1609accccbda49f1aa6885c20ba5fc0a,281,242,39,Africa,22,1439.34
160badade82f411eb71a3b1463fabcff,117,99,18,Oceania,23,1018.96
160c89af67d9407883f0c18e3487572a,206,163,43,North America,19,1447.75
160cdd773ddf446c80296b573bda9245,164,140,24,North America,19,1057.36
160ce501c2a74468b3c4ff8969c558c7,280,252,28,North America,27,1884.74
161019a731d54f65b4d7f02bb791200a,334,290,44,South America,16,1596.72
161155375fd1437f8cf40e811f72c058,287,271,16,Oceania,18,1874.12
1612704d13914d33ac1c69bfc95d15fe,310,278,32,North America,13,1787.17
1616aed4022a4308934ab71927e9d8b8,241,212,29,Africa,21,2484.94
161740c636b440038e8cac77ba5d65df,119,84,35,Europe,22,1013.54
1618ccc0922c466fac419a1da5bcb162,193,154,39,Asia,18,1495.57
1619f32b2cd44f1192fdbfbbd9b85290,83,40,43,Africa,22,945.5
161afa808aca4f1a9c2644cbe58cd4e7,64,27,37,North America,20,966.02
161c3e26cd06429bb9bc932bade7fcee,66,10,56,Africa,25,284.45
161fbe34c8b44ba69ecae657526081fd,161,129,32,Oceania,20,891.66
162051c56e1940ad99b33a1956f73e75,331,289,42,North America,17,1195.3
16227e4beb104913a96005088cb43c73,339,290,49,South America,15,1707.07
1624f6b798c840bcb35c0462d693d3ba,101,82,19,Asia,19,1251.73
162637215ec4461abbbd2827a4dbde73,365,340,25,Oceania,22,1926.49
1628a1c2ec3f4af1ae928d09620ced0a,299,248,51,South America,23,1655.35
1629a03c704545bdbee89314a656d029,45,21,24,Oceania,19,437.94
1629dc0d57fd4088ac9bbb06ae1796b9,144,105,39,Oceania,23,889.39
162bc3aca65d45e59311f88ce3e595c5,355,312,43,South America,21,2466.81
162d5f5c202b4398a2ba48cf255935e6,193,164,29,Asia,18,1504.65
16305f2508454772b337a68c338734b3,37,11,26,North America,18,446.82
1631911c2fa04f2680e53d4ac35383a3,130,93,37,Africa,23,1133.71
1632d33a514c4636b32850dfb790ab7b,228,198,30,Africa,16,1517.43
1633206a8b9a4873b0f6d98b3d2302e6,161,137,24,South America,18,989.46
163382a3bebe490bb6b02eb99094bfaf,56,7,49,North America,20,300.8
1633f7a836aa4c2098e97a41d542b3f2,76,37,39,Africa,23,679.36
1635351b58af402cb0b7475758d81d1a,41,13,28,North America,19,360.16
1635794910844245bca1275f66ade472,219,197,22,Europe,18,1180.79
1635c0ac904d46b0b2cd5f4479e7ab13,165,117,48,Oceania,24,1173.64
16382b40fbd34370b33844e1dd753d1b,181,131,50,South America,20,940.5
163a65fdb70a4c77b231d9245a025fd2,92,67,25,Oceania,20,366.48
163e7cbe95124723aef440cbb1ad7d17,198,176,22,Oceania,16,1777.77
16417257780f4866903384431347781c,85,53,32,Asia,19,922.82
1641a402aa1d400e892110975c985bd3,200,165,35,Oceania,20,1444.15
164242a1f616458b9e82fb13a4503312,199,155,44,Asia,24,1691.13
1642b647d83e4e98b7740ffc3b173efc,331,285,46,Africa,16,1858.79
16479c9534a04f9f86e69848e6931dff,63,27,36,Africa,18,302.2
16485015b3aa4631b89d276019ca2cc1,212,155,57,Oceania,21,942.97
16486d5de7f64fbc84c12ee7c216e4ba,289,238,51,Europe,20,1203.39
164ac9b5e44f4e789b44e8cc77b58b9d,149,96,53,South America,19,848.95
164aeb1617174739846f16f34f78f886,276,244,32,Oceania,25,1911.47
164c0b2a99dc49049081c67826167434,216,189,27,Oceania,16,1377.8
164e3a2b530248998b22da8e6b9e4552,69,23,46,Oceania,22,456.32
164eba4af8974c3a93085b19ebacce46,365,330,35,Oceania,23,1820.06
164efbc7570f4f96b53cf95cd31411f1,36,12,24,Oceania,21,294.79
1651f7c38c4d4ae49b1f3a3ac1418bbb,365,356,9,South America,21,2305.75
1652ac8c3c3c47719302171306b232e6,365,336,29,Africa,19,2035.85
16555cb15ed74e21b295c61e6244cd39,210,178,32,Africa,16,1779.94
16589e89a5e44923860d8b84a403b700,247,222,25,Africa,19,1988.57
1658c43a2cb7448eb8a712ba7442bf9f,277,244,33,Europe,18,1846.22
16596045a957446db42dd1b39759f9e4,96,55,41,Africa,18,460.03
165a7bd23fc541e79f30cb99d092efd5,358,322,36,Oceania,20,1780.81
165b39b71241419e9546f63e3761287f,203,163,40,Asia,18,761.07
165b5ab1f8894d6f94addcdad25c2d17,214,167,47,Europe,21,1765.2
165ba2caf235499ab77ef6cacd6be813,60,2,58,Africa,23,50.8
165c41e3859f46beaef8ebb5a9459e50,85,36,49,South America,17,214.69
165c6f013c9c4eef821aa8931e229be6,145,114,31,North America,15,1236.13
165d9c2e4ed6478f8702f4f9c7210ebe,74,47,27,North America,24,749.83
165e9bd5c1674768958606e59a41f518,329,310,19,Asia,17,2817.12
1662a1cca5e1454586158740678b25f2,230,191,39,South America,19,1400.8
1663addaf5a848878f818f7f7685a7c7,99,80,19,Asia,18,766.64
1665543cc5524cee868b7061728c03a9,302,278,24,Africa,23,1998.6
1666fbd3170f42b1a8ab71a5d9988173,343,290,53,Asia,18,1384.22
166975a7445241a59f2940c9f9bdad95,186,136,50,Europe,22,881.01
166a01c135d24424b4b53b0d66924673,364,344,20,Asia,26,1486.41
166a83ff1e3d43c1ab1a248784ab267a,330,285,45,Europe,18,2322.7
166ba4694f3e4dccbc182b96ba2f9c1d,59,27,32,North America,18,471
166bf78efef1494c8a151652557a7687,144,108,36,Oceania,19,716.14
166c4afd86074882ba663dba0f8bb4ee,252,218,34,Asia,23,1720.06
166e8f1732c2400ea0d9b3e799d3bf14,344,314,30,Asia,22,2708.37
1672e852b65343a995bf8c2fe80955e3,182,169,13,Africa,14,1344.31
1673da31b1c64c97be4c1b10957c07f8,173,144,29,North America,26,1520.69
16747a7a63154146b94a10ec73ad903a,67,21,46,North America,19,384.97
16748e45bd85449e9a0ec85a69fc7736,225,200,25,North America,23,1662.38
16771c2d832b42a5b58057471b88af98,283,264,19,Europe,22,2414.08
167a33caaedc440e9e857df70474f4e5,226,194,32,Europe,18,1059.89
167a74dc55e245d2b6c8e5ceacdf4d5f,101,68,33,Europe,25,793.83
167b6b7d47e649109f07800d39692b70,73,32,41,South America,23,263.28
1680390d616e49fa9d36b8ea7d343924,354,311,43,South America,21,2822.44
1680a394fce24a5cadd82f635ec7b4b8,120,94,26,North America,18,1053.22
168235f33e004791930f9114d1411d94,313,270,43,Africa,20,1245.77
1682a9251ef34698b20cb8cfc024c2c2,202,163,39,Asia,24,721.81
1683bdcf4a5547ef97505447aff6f987,260,230,30,Oceania,26,1662.07
1687a6ef1cfb4276ae0fbe8a88f92c5b,70,44,26,North America,15,483.64
1687f5d2278a44c6b1a77ddb92337c35,198,154,44,North America,20,1479.49
168a23adb31942149d85b350d2efbd38,362,356,6,Europe,23,1474.05
168cac4588b04c8d9e93ff14c94f6fa7,325,299,26,North America,22,1990.47
168e8c92437a4819b42ad49aeb0c5130,365,347,18,Europe,21,2464.44
16907c8627ac4bce99ff7fb55ea16e77,287,266,21,Asia,21,1928.4
1693b58e7a294ec5b903f858e009881b,351,327,24,Europe,21,2577.84
16946724a04b414d8d9dfe9af69b1d6c,112,77,35,North America,25,1330.98
1697a2c07ffd4e17beb27e954531620e,170,150,20,North America,23,1355.86
1698e8b6e11f4fdcbc7405472fb20a27,155,111,44,Oceania,21,904.59
169b8a57203d4253b80ea53d638d2677,240,207,33,Europe,17,1467.66
169bfb6b55cb4be2aedf264d74ddbb68,65,18,47,Oceania,21,568.73
169c684560ab4bad9d3b8edd12b8675a,295,264,31,Europe,14,2488.08
169cb0161748445eaeed522e1d902ccf,60,19,41,South America,20,514.19
169eae62787d41b596e4713b15a38061,234,206,28,North America,19,1603.18
16a00d6b777f43918fc3a9e73ce99b8f,172,131,41,Africa,23,1328.4
16a022b0950e41ac9d5c89befa1c1cff,219,193,26,Oceania,25,1890.96
16a37bb1298a4b1e883cfc565ba55838,171,144,27,Asia,22,1551.07
16a38d1fe54149f4a10ca6f82311c330,230,201,29,Oceania,19,1813.33
16a3e1e1a8ad4f8b9db58b2017f83979,362,331,31,Africa,21,1692.82
16a427efbd94433da266036e224870cc,296,265,31,Oceania,22,1881.38
16a6d4330d2e41f98b9dcecec49ce97d,128,91,37,Oceania,24,940.37
16a739f3cde744d5ad8b5d33c345d941,363,321,42,South America,20,2062.57
16a75805b6fd461fa7b9dbd37212187c,206,159,47,Europe,21,1028.08
16a7be5170924aff993e90c0cfb02917,362,312,50,Europe,17,2119.13
16a864fb1fd042b18a9f75c5aa65465b,342,315,27,Europe,17,2123.55
16a9a7189cdf4ab392ab16d8cdefaf55,352,318,34,Asia,16,2318.42
16aaeca7dbd940149f1176d95cc9df25,185,151,34,Europe,26,1069.78
16ab1327206643b2a12c3200e7783846,70,22,48,Europe,19,427.46
16ad1addcc8545b2be905d84a027da42,63,32,31,North America,21,209.21
16aedc3b82d34e98b99ce957e50ce562,360,328,32,South America,19,2496.07
16b066ba7a144430a051ba417ae500da,311,278,33,Europe,19,1675.83
16b0d70dcf1d4393a4442eaa91bc36a4,300,275,25,Asia,20,1985.21
16b0f2d3f2614bdf93168acf12371388,132,109,23,Asia,17,1117.45
16b1ce27dea34527b7b524fedfcd1315,62,26,36,Asia,18,312.43
16b2ff5af216424ba6b527b699942b23,92,33,59,South America,23,276.79
16b5a4bd9eda4b88bf44ccb7126ad94d,77,37,40,North America,18,562.99
16b7c2cd7ac84ffc95a7973ec9b273a4,259,226,33,North America,19,2445.8
16b8c93edb774b82af3bf25af2bf87fd,361,327,34,South America,24,2858.22
16bd56e7360848f4ab9ee80cf6741396,141,107,34,Africa,22,1309.65
16be98326f844423a851e1393ae35b08,125,89,36,Oceania,22,625.86
16beaffa1dcc4ec9b06d2482e6fbaaa4,285,253,32,South America,17,1929.46
16c1850cd14446ed8a8a15ffae50e7b3,175,139,36,North America,22,1558.95
16c1e02746944585b3d35b4524259638,98,67,31,Oceania,16,961.91
16c6e2dc3d8c4f1c9208df9225254cb2,143,115,28,Africa,18,1085.85
16cbddc56fde418caede266ba3e4a33b,254,230,24,South America,24,2270.64
16cc333de9dc4b1d96b5252dc9584622,321,290,31,Oceania,17,2151.04
16ceba805dd944f88a9f21bbb5901df8,274,223,51,Europe,25,1493.81
16d0f40bb5b046bdb00ed6837c33d127,205,177,28,Oceania,15,1968.59
16d23164a3c744838fe64eac615937df,77,25,52,South America,18,193.89
16d6618976a544208008454b5f9efad3,228,198,30,South America,16,2019.26
16d6db73c7c845ea97e27cf6ba53c95c,363,338,25,Oceania,19,2713.16
16d71daafd73472aaabe6e64c2ca76dc,364,325,39,Asia,18,2466.42
16e00f5c081f463ea00b413ff1ced9c0,190,165,25,South America,21,1769.19
16e657025b4345098b8ea6cba6eabfb3,231,210,21,North America,19,1690.12
16e69023c4be4e23be59ef2dfcbcfaf0,176,156,20,Oceania,15,1038.47
16e6e054eff24626b80a5fbf749b9eb6,264,239,25,North America,18,2513.55
16e80a7b463f4239bf22a46ed56a0cd6,90,31,59,Oceania,18,537.97
16e8855d0ba04443883178f9ce78d4bd,78,55,23,Africa,23,603.36
16e99f205e884e9bad2068ce5648df18,337,302,35,Asia,19,1964.74
16eb2ae77bf74e1f8afb893c33a4b9ec,364,323,41,Asia,25,2906.17
16ebc38fb5b444388e4512216b13797d,132,83,49,Africa,21,832.22
16ecbe26a1414c1f8e1d9352b3f04f4a,162,122,40,Europe,19,1281.09
16f19c5481634a7884e802d5bb2fb45d,159,142,17,Oceania,23,1102.56
16f1c09e317f47b2bb90e004ea679a25,183,143,40,North America,15,845.8
16f3f87a0d2841c6a16fbdc5886df5d5,157,125,32,Africa,23,1139.49
16fb1e0618594ebbbe9ff38026d295bf,204,177,27,North America,16,1449.5
16fb70340e184f66bad5b0375cc8ea09,254,204,50,Africa,23,1191.33
16fc6a2c6ab04b5d966c40f740d1e3ce,94,62,32,Europe,21,913.51
16fd90500ff44956b02c1f7ba8b2c3d4,95,51,44,South America,20,276.73
16fdf49c68724f65a13de2fb4cfb000b,286,239,47,South America,23,1873.19
1700e316b8e942fe921a30563215166e,88,49,39,South America,17,663.33
17026b97d2ec49adbaffac2a57af1c6f,191,140,51,South America,24,944.12
1702cb77925047568a21c4c3093eec1e,299,246,53,Oceania,23,1285.49
17046ac5843947a7baced6e68c42e2ae,365,332,33,South America,27,1623.36
1704f6a5262e4ac79700e09461b60121,178,148,30,Africa,21,1856.81
1705153136ec4652be0259982b63fc1c,363,328,35,Asia,22,2059.36
170679767e434faf8d603e4fccf1872d,227,189,38,Oceania,22,1323.83
1708062011a846d4a184e51d324e2c2b,292,249,43,Europe,17,2209.94
17080b0af77c4c2c9759ed1895b5b65b,275,235,40,Asia,21,1928.07
17093a9d553443b3bed13dde24995eec,303,261,42,North America,22,1310.64
170abd2438aa4eea9653e3f0b8fb581a,348,307,41,Asia,17,2530.91
170d4964feca4e84a89b78deb9afb83d,286,260,26,North America,19,1902.38
170e9cae6ecd45e8958b28f31ba14fa1,28,2,26,Asia,27,329.22
170f18fa92514ac88d775f2ee2865109,64,44,20,Oceania,19,305.13
171384f456684404a2cd07d200acc227,98,52,46,Oceania,21,193.42
171485d1b1ed49a68e7375b6d878cdb4,207,176,31,Africa,18,1722.76
171531079d024bcfa50fc0dc56949f6d,71,20,51,Oceania,24,145.32
1717a3072c754ca6800d270a447635da,354,328,26,Asia,28,2443.44
172810e6b71643de981f03d2ac753a4e,195,141,54,North America,23,819.31
1729f3b38f5549349e3e44c95e1a3788,295,247,48,Europe,16,1537.02
172a05e4884c4b06b56936dd837b33ae,260,208,52,Asia,17,1306.89
172a3ca2b07a4774a22e99332569efcd,194,137,57,Asia,21,885.57
172d9e695b8f423db8a1b6366ea0da5d,55,17,38,Asia,19,452.22
172db413a24941a2b83611019f432737,217,191,26,Oceania,23,1214.61
172dcbab0c924cf99ce2600a969690d5,254,233,21,North America,22,1733.05
172f6455e2d643d9bd5c433448682267,225,194,31,South America,16,1380.36
172f99d7c636496da62e97b95b8b8f4e,136,110,26,North America,24,1552.4
172fe223fc8a47f48be3cb1bfa2b3f4c,293,242,51,South America,21,889.08
1731816d93524f90937f105d635dbefd,124,70,54,North America,20,692.13
17341500d0a446f6b2eec065642873f4,293,238,55,North America,18,1315.94
17346eb0672542d7ac4cf652160957c1,217,169,48,Oceania,26,1213.98
173818e462214f0989247bfdf6d8ab21,305,275,30,Africa,15,1966.31
17382db129c548a0a8911fd635a07d27,97,45,52,Oceania,20,348.98
173b642c5bfa49fa9beb32b29315fb69,363,351,12,South America,23,3090.37
173d18d8ca5845b78b064c8715769b62,125,106,19,Asia,19,964.3
174578a9a35b4abbb99d176248c4e761,193,153,40,Africa,21,1109.62
174599f7b5f74062a664e062264872e8,196,153,43,Asia,23,1392.9
1745f5676e714c9997bbad6dd5845098,362,339,23,Asia,16,3273.81
1747f4ddad5f4cc9a12c5da4b41118a2,110,70,40,Oceania,18,510
17497033a6e54c81a8977476683f4e75,337,292,45,South America,23,1886.06
174a5325634b48729a332e6e3934c2e0,260,232,28,Europe,20,1835.46
174d4b86df2f45d9ad3541c27b146ce1,173,128,45,South America,21,995.78
174e5b48c11c4c7ebf8286fa8d039505,346,296,50,Oceania,18,1064.93
1753f488d3504ddfba1374e738b4ee60,227,205,22,North America,20,2026.78
17565cc824e444faa8d54b254546c2d9,362,332,30,Asia,26,3143.65
1756c0d46bcd461fbf49b4f52d1c3933,74,51,23,South America,23,1134.94
1757d29c4c31441a809a87eb046ad85a,339,322,17,Oceania,21,2228
1758263a028b4b28bc92dcae58d3f88c,148,97,51,North America,23,874.06
17599c472abb42118081f9c898db697d,335,289,46,South America,22,1772.7
1759c24448ff4f2dbf58e06be2cf3310,59,18,41,Africa,23,368.53
1759f8213e534ce09d0411a20fdf5596,147,119,28,Asia,20,872.2
175a281d48724aafa6fefba807be63d2,255,224,31,South America,13,2053.4
175cc893ac3649c5baf0442317f4a49f,291,240,51,Europe,18,1607.01
175ea8b98dd0455aba8a66c0b9b9f193,256,214,42,Oceania,21,1255.43
175eb6f606ee45eea79838c3e07dff92,250,200,50,Africa,16,850.81
1760e3cbefd64279a001aa8641b31fa0,138,96,42,Asia,21,912.43
176178b69903468abbc5e6013254d392,145,118,27,Asia,21,1162.21
1763b71e585f42a281316876c0cb151c,319,297,22,South America,21,2149
176792c8e1f94650b5fed7cc0fcd980d,243,216,27,Europe,19,1611.93
176863181e054ae182ba918722bc0094,364,328,36,Africa,21,1757.25
1768a644179e4cdc9dc255ce3924c03b,364,332,32,Asia,21,2306.32
1768d539eee4473da8a70c2beea9a8cf,168,151,17,Africa,21,1156.4
176980c851e74ae7aab4731c9e96d0e8,365,337,28,Oceania,21,3021.31
176a544fb02c441c970f39ff2b55638a,364,343,21,Europe,20,2438.35
176ad48fa0ae45a59e17ce66fbd2e2f4,312,265,47,Oceania,19,2515.29
176c836d3db9416fbbdd9975b444140c,267,250,17,Africa,25,1613.1
176ea03c593d4ba39a3703eeacc8bea3,339,288,51,Europe,18,1567.77
176f9a31e07c4e8fa3398821a15add91,245,229,16,North America,16,2160.75
177109a95c9c4b7aa9c838a91a111853,150,103,47,South America,11,1629.03
1771ea3fd8d1457380f115faf8dc20a5,311,284,27,Oceania,20,3072.97
177341bd70214fa3b296576a2f1e2adb,277,233,44,Africa,17,2098.17
1773477d729c478c8ad2292c631ad181,153,96,57,North America,24,802.03
17757a8730dd4768b14bb84e633cce63,355,326,29,Europe,22,1854.15
1777d9d02707475db74955d873d6a4b8,133,86,47,Africa,15,531.86
177a1ac8213a4c3c8a1e6af019588f54,196,136,60,Oceania,16,1441.88
177a27b5409e41bc9069da78cd48da36,340,304,36,Oceania,19,1471.04
177ac19fdcb4414e95ca65e33ef53af2,254,204,50,Europe,17,1108.93
177b25e294ed430884910123035d0061,110,78,32,Asia,20,809.74
177b839a49f64adc9649749e73eba505,317,279,38,Europe,21,2059.39
177cd61858234cb2af98cb75a09a53c3,108,63,45,Africa,16,262.81
1780f5cb0fae4fac9b43dabadb389847,262,224,38,South America,21,2214.69
17833e9efe3d4ffd845f4a87efb79312,361,357,4,Europe,16,2687.42
1786e0b75d2f47c1829eeb75194f5350,204,172,32,Asia,23,1089.94
178713e6c99649eba2ecb91b60c37607,333,296,37,Europe,19,2188.28
17873d2b7a904261af4c1a87f4a06419,286,253,33,Europe,16,2520.73
17879ce32fa243978a20805881a6ba91,363,311,52,Europe,19,2144.31
178d654fb2b54b3aa438d1a93b211916,304,269,35,Europe,20,2440.73
178d6cdbd44c4a2f8d5f2c8448eeb0b4,139,119,20,Oceania,27,799.75
178ed769091243118bbe0a5325e0c01f,66,19,47,South America,24,266.49
1793ccc010384cd9895f23f94df99f6f,292,267,25,North America,24,2054.1
179987d2a78c4caca34243e9ad05a947,231,204,27,South America,20,2100.28
179b3059693241ef9c84543f78e2a41d,49,15,34,South America,26,158.71
179c645679fd4c659f420e09d3024517,363,334,29,Europe,19,1751.53
179cf94305d649738def17be1a442bc6,254,210,44,Africa,23,1650.92
179dc84d2cf940ca9e01c9e128ce0b65,305,252,53,North America,17,1176.79
17a06d4d6b9945c4b6f66313c39dba99,291,262,29,Oceania,23,2763.08
17a120152dc045fa916d238122f844bf,85,54,31,Europe,25,852.96
17a19eb433d34ff9b1f47800549b8042,364,320,44,Europe,21,1783.28
17a25fa6111b4f928f98d56459bd5848,169,112,57,Asia,22,570.86
17a4f832408448ae93283e9da7b82f8d,349,329,20,Africa,19,2793.89
17a75d01acdf4ac7852ce254b4a26a0c,76,37,39,South America,23,581.41
17aa3aa2ead142ee99746a29985ebd9d,363,350,13,Oceania,18,1861.37
17ab6e4179a143fb9dd00150a261475d,255,223,32,Oceania,18,2083.25
17ad8b63563949f4ba1efadfab50f815,113,68,45,South America,21,979.36
17b0f5d61393480a91cad60613834981,224,188,36,South America,21,1682.2
17b1c65330d84a6889d5df592519316b,57,25,32,Africa,24,665.58
17b2c40f700a426c9b6c4e95e43a100d,250,199,51,Africa,22,917.53
17b3064383874d38ac27861156f89ba0,266,224,42,South America,22,1485.71
17b7092bf1084ccbac0b7750e210ea29,120,73,47,Europe,20,716.44
17b76e5675b24e3c9dfcf2a49e421119,322,283,39,North America,21,2007.74
17b88825d3fd402aadde9679c9dd244d,93,70,23,North America,22,751.15
17bb9331073f48c3ac1fa24d5a859919,146,124,22,Asia,18,1280.72
17bc60e1fc7a4a14b8d81248bb3ac446,46,3,43,Oceania,24,93.18
17bd4ded9b5b479aa08e8f8601b0b276,128,98,30,Asia,22,916.13
17bf5d94167a42559dfa26670ab82953,151,134,17,Oceania,21,1193.36
17c01de2a603476ca49c77b47ad298fb,272,224,48,North America,24,800.75
17c0c9e5823f4501ae50ff004dfcafd5,302,265,37,Europe,20,2110.63
17c48b99114f4720a5ebacea1a68e3c3,136,92,44,South America,16,509.21
17c709fa1dc54818b38a77e7912e117c,252,207,45,Oceania,25,1954.66
17c7c10cb428438b82b8e7a3671db065,291,255,36,Oceania,16,2162.2
17c828db00874169a1a19464122c934e,240,194,46,North America,20,672.9
17cb6f5f6dbc475a8863399d2ecfee88,272,231,41,Europe,19,2256.03
17cbfab257bb4c7686b04bc97f02da39,274,235,39,South America,19,1612.92
17cc46ccd49a4d5e9b0afd6e68fe9563,87,32,55,South America,22,917.39
17cc684e86234c078a3273ede1e8baf2,88,49,39,North America,24,461.97
17cd586c6825445889759fc32b75d1c3,212,175,37,Oceania,20,1048.77
17cdcc38884a44098b092e766b88e013,48,22,26,Oceania,14,469.11
17cf08bd85be4433a91fc5843031841b,160,132,28,Asia,21,1144.75
17cff1b03e56445bae8d7608b3a434c2,45,18,27,North America,20,133.84
17d2571fee8a434793938745a81cce10,235,192,43,Europe,21,1701.18
17d459f6bd214427a1b062b614dc7d0b,327,301,26,Oceania,20,3059.8
17d87cf8d87c4d78b44d0e18ba78fc42,89,40,49,Asia,17,460.29
17db0cf090c94727a6cbe22a6eeef2ba,310,254,56,Africa,14,1282.58
17dbb2e189fb4399aea5dd4c8d890644,79,57,22,Asia,22,587.03
17dc3c34734c4ea490f8bcaac227206d,80,30,50,Oceania,15,279.79
17dcb68854dd4973a08163c8e396263a,124,82,42,Europe,22,698.54
17ddc8ee970e46d289abcc4a3f796b8a,183,145,38,North America,20,1459.6
17e26802f0674923b4e6cbe1f8244c57,163,122,41,Europe,23,598.56
17e5d75404b245cba6fd994ede45f822,318,281,37,Europe,19,2076.38
17e607e0da544ce4ab42fa5cb74b02a2,155,104,51,North America,27,1178.88
17e87f5d59914298a60550dbcc7288d5,280,240,40,Africa,23,2038.6
17ea7bf25fc444dcaafe682e3098c2e9,115,66,49,North America,20,1103.18
17ed028602b543e59c9319844cd3e57b,264,231,33,North America,17,2196.84
17ed5e8cb36241aab25b7718d7805656,46,1,45,Oceania,17,592.73
17edf00e7e7c44ba8e51e423725f4580,146,92,54,South America,22,792.26
17ee2388ea1f4c4cbd6ae06b6eb894a4,283,236,47,Asia,18,1827.35
17ef6598a2944c66a53cdd865b48571f,50,30,20,Asia,22,543.89
17f3117ef8274a209a0cf9711eeedd73,193,156,37,Oceania,23,1262.58
17f3e4054a17456884f6e708bce8f054,82,57,25,Oceania,20,661.18
17f4602abbfd4f60a9a3a33cf25ecddf,300,280,20,Oceania,20,2410.49
17f66771c2014d5691705017e6749c81,162,112,50,Europe,22,705.09
17f855be10364fd5acacff83b75a1a9c,365,349,16,Oceania,26,1662.73
17f8ada79749484597aae3289047f3e4,202,170,32,Oceania,22,1571.88
17fa018e6fc542228d9d9d96bc082920,158,136,22,Africa,23,1373.87
17fbbd82c8274a42b0fb0c67cdb38fc3,365,340,25,South America,16,2403.6
17fc0da11ca5410480ec93ea19d88d0f,220,190,30,North America,23,1286.28
17fd19ac16d4412c8a93d6da73fa0766,272,224,48,Asia,22,1516.48
17fe430a44154b759fad9a6509398bc9,187,148,39,South America,17,669.53
17fef29c85374a3fbc5113292df9903c,166,143,23,North America,19,1473.92
18010f6a37994fe4a8aac8d25b4278ff,109,73,36,Asia,18,791.38
1802b61a5e924d3fb2f82964a22a80e0,338,289,49,Asia,22,1824.13
18073aefb08b4d1296f0464032540211,363,322,41,Europe,26,2198.39
18073b69b4d2422db55ffb3a8cbcc368,288,266,22,South America,23,2413.94
1807eb070fd64d909959c41deb82fbc0,325,300,25,Asia,22,2255.03
180b1b31d3a142a68011520af7296edc,282,243,39,South America,19,2448.46
18102d9ed806482cbc1bed012c191e7a,202,157,45,South America,17,1402.83
18142fa9b2cc4e31b95511d496df91a4,180,137,43,North America,18,769.13
181688585dee453797968a357b3ceab8,324,272,52,Oceania,16,1879.65
1817b9e2644d43e184ca8537c984df34,145,87,58,Africa,24,420.59
1817ebc782ed428183f7db4d5f8bcd99,162,106,56,Europe,23,412.22
1817ee7e90bc474fa39d973838d11a8b,268,239,29,Asia,17,2421.36
181877b68fc540c1ad4fa2da7e3f9da7,306,255,51,North America,18,1562.19
18198564dd284d63acded6a79c495842,266,250,16,Europe,14,1855.5
1819c14983e3402f84f6fe0c9c30c349,104,50,54,Africa,22,529.42
181b5128703a490dbaf9c31fb02c19fe,232,206,26,North America,18,1617.94
181b645191134fbcaf025b98556a230c,86,57,29,Europe,19,195.2
181ba0f7d3c7483198e48820902c2d70,365,323,42,Africa,18,1631.66
181bf884e9fd41688bedc88e1cb78587,365,343,22,Europe,18,2409.04
181c6abd38cd4f59a4b7d1c1cb85ade6,365,344,21,Africa,19,3270.08
181d036a8b4043b88b9e245f5fc01706,99,61,38,Oceania,19,895.85
1820230d473149efb3dcc90a66893a6c,85,64,21,Asia,17,904.65
1821eea6c7594234b8eb9524a1a28236,357,320,37,South America,12,2667.05
182547213a714d508c67c5e9c46c4956,59,8,51,Africa,18,580.65
182a729aa2cc4dbd847f3b95af54cf0f,315,277,38,Africa,24,1940.5
182ae1c3d41f48e3a3c9754c584e448e,105,68,37,North America,20,408.51
182b36a7a7ec42119d7f753b2fd1f18a,193,165,28,Asia,25,1242.23
182edb165b934626921c3f1cfce68091,114,82,32,North America,20,1566.14
182f554715df458da75d21baf91f03e5,158,112,46,Europe,18,969.07
182f9f257a4e4a1395e2ba91a15dc02b,215,167,48,Europe,20,1144.06
1832de261fac4c01bebbbc3db80a4bd2,212,165,47,Asia,13,1205.33
1835dd23b0a74895bd4fe05f1c103b45,255,224,31,Africa,23,2103.63
183601dea9334092beb4fb157327a7c4,363,329,34,Europe,20,1426.91
18367eeffe444e39a80faca2dfce1e7e,104,50,54,Oceania,24,313.52
18382208f4ea4c24a9f97069e4020f32,273,238,35,Oceania,18,2027.09
183885bc77e446a59a30b695b0d0187b,206,173,33,Europe,21,1043.21
1838f03aae184a2ba1bb53a8e4b5121f,133,111,22,Africa,17,822.26
183d4f341e544593bc3b5f8f28af79c8,235,185,50,Asia,18,852.35
183da5d6e3744015ae46ee783a3e54a8,191,156,35,Africa,21,1283.42
184064ecb77f4cbcb1e3126ccf43f077,180,136,44,South America,18,1173.57
1841242014674ef3a3a56992d802d0d7,179,154,25,Asia,20,1751.13
1841c9b5a7524429a9118ceaac721503,53,32,21,North America,21,194.05
1842edea85b14dcdafeddfca0887ae89,283,266,17,Africa,23,1830.29
18450b7935c1423eafd73a78e5c84c16,351,314,37,Oceania,10,2432.68
184598db34024c80982f7ae2f4972b4e,365,358,7,Europe,16,2572.09
184936710b3847b4a7941a7dc0e0797d,80,58,22,Africa,22,442.6
1849688f7e314adca4c22074c67c917d,236,202,34,Europe,18,1719.89
184ba49324bf4389850639de59a34e12,348,309,39,Europe,23,1930.15
1850e3d1f8b746f0a8bbc5f1d33fe5b2,276,241,35,Oceania,21,2206.58
18515ec74aa54960854733b22e3e6de0,193,151,42,Africa,19,908.6
1851655dd5804ba1905b44addba489c0,135,82,53,Oceania,19,546.52
1852112f7e0c40b7bee11f7b3e290b81,365,337,28,Africa,20,1754.88
18541b81b9074df28da8f57329c6cb0b,305,269,36,South America,16,2304.15
18549877e52945d698d8585fcc91e804,220,173,47,Europe,24,916.21
1856c3fabfb64400a2d3d9321ae00356,363,357,6,Europe,24,3343.05
185935a9891b47f7a2604b977d55ead5,57,3,54,Africa,22,244.98
1859db19643444668378d68bb207892a,363,349,14,North America,17,1789.56
1859e46d62e948d1986e058501826c8c,85,57,28,Africa,20,611.93
185a8b1daa1a4f759d8e6b48c65a3058,73,40,33,South America,19,560.32
185cfc50d69b4aba8f53b5219784e560,364,359,5,Africa,18,1535.44
185fe5175e31400ea4b4636f8ca1e1e7,55,25,30,Oceania,17,484.35
18606b739280412e989a50fc9761d285,69,16,53,South America,21,366.88
186277feb0bf48ff9ea80ab63a8f0e17,165,128,37,Oceania,15,918.56
1862e50bb4d541baaf474828a8c9c057,68,31,37,Asia,18,471.44
1862e7dbabe74acc9ad54de0a1b4732b,192,163,29,South America,17,1123.11
18631be4cd094c51afb7b1ea739ebd8e,303,261,42,North America,18,1880.06
18649cd157394c8580987b3e06f65f39,268,216,52,Europe,23,1673.47
18658388ee2b40579071d65718705ea8,138,113,25,Europe,21,1056.99
186cb72baede4386b7a94e7cb331c940,65,27,38,Europe,19,274.81
186f07e10d2e4ff0afcc330977c06e72,75,43,32,Oceania,16,341.45
186f7e16c6054cfeb6671aa94426790f,35,11,24,South America,22,384.31
1872acbc8a114904997e293f8510a61a,279,230,49,North America,20,1849.01
187394d45a024d1cb7ae50230002095c,270,227,43,North America,20,2510.85
18753c4fb3cc4f76b9c19b41ee8b1372,162,111,51,South America,12,1150.19
1876b5b114204910b1fccff3f5b7ce6e,90,61,29,North America,13,850.08
187717f56b3a4b6c9fb65e7efd2d3c03,114,74,40,North America,21,881.83
187763a8b9444cc69bb332aa95297520,184,137,47,Oceania,25,872.04
187a7d50167e47bc88aadfcf97dfcfd4,365,332,33,North America,19,1529.87
187c25cfe5e747ebbee1aaf6504c7b62,79,48,31,Oceania,21,561.49
187cc2d4fcc34582a30a7d87d2e15953,359,325,34,Oceania,21,2046.15
187d56dced624c75a3ad8df9c7e93561,248,213,35,South America,23,1564.7
187d85f32849406dbdfe5ee748731d8c,263,216,47,Asia,21,1178.16
188201bc49fa47fc8c2d240b831be173,259,220,39,Asia,20,2087.14
18832cd6ce94461496830fd33659bddf,186,128,58,North America,21,894.71
1883377defc64986bee42589802dd721,365,359,6,Africa,20,2284.47
18843d7625de4f9ca9d2dfcea7080ba7,59,9,50,Africa,15,322.03
18847074d6ad409883b331e19979b72a,107,51,56,Europe,19,508.16
188646762615469a8582252f683001c1,266,210,56,North America,15,955.24
18895cb4469d43a5817aa7ee9a5bebe5,69,18,51,Asia,17,310.96
188adb48780f4944b8b13c167f8481df,295,272,23,North America,23,2594.55
188f37e2ab81459faa906811535ff0e1,45,25,20,Africa,22,235.7
188f56773c70497f9da3c35c20fec155,266,241,25,Oceania,17,1184.41
18930559121b4ef3a73df58d6922ffeb,202,152,50,North America,14,1312.24
18933398ef334c2a86fde5796f0fe768,29,6,23,Oceania,14,128.58
18957de3ec734d25a4c374ab99ab4beb,311,272,39,Europe,20,1875.83
1896689bf30e4fbf949bf68f5b8f2e87,265,230,35,North America,22,1986.88
189677dc33e34a36a56f25a80cea694b,210,184,26,North America,19,1797.19
189755782f304465a900b1413ca5dbcc,192,171,21,Oceania,21,1207.17
189886d1db924982bde6776315b2e96a,364,346,18,Asia,19,2971.22
18999a715d174777a20cd92a3d90ca2b,156,135,21,Europe,24,1160.62
1899e8b4742c4445abcc928536e72865,192,164,28,Oceania,17,1316.57
189b76d445a244a78cf6fbad2437930b,213,190,23,Asia,25,1373.91
189c1b39a1cd46339bd8bc6d8f7f7de0,191,176,15,Europe,15,922.59
189daa3b24a44f89aaea2735a6c087db,335,290,45,Oceania,21,1770.73
189e8cf765264e2f92a31832ebb42dbf,39,5,34,Africa,25,417.87
189f02a88d2543dca7d6f852553dc2f0,319,297,22,Europe,18,2308.13
18a1147c31454ae78c73f0885bc65656,104,64,40,Asia,22,502.18
18a222f5080d489f9d64f2ab50d3d464,331,288,43,Asia,22,1589.6
18a25b3ddc6947cc85ff28269c0b762d,107,58,49,Asia,21,362.99
18a4b7b7d9a94ef79af93f81c2f5a26a,234,183,51,Europe,19,603.13
18a63ba33ee44a718d448cd260fb8e6e,172,146,26,Europe,20,1424.01
18aa3ca42f3549f99370dc5a91e78606,234,178,56,Asia,26,1130.91
18aac9894ac14d9b85c1dd24643be3d6,354,307,47,Asia,25,1259.16
18ab9eb2aa9c409f82b38590e71c2dd1,186,143,43,North America,19,908.09
18ac111f08f84f21b58f0b8014d28222,231,190,41,Oceania,25,1865.26
18acc266ed31482093e6e8bc89745e71,281,248,33,South America,19,2486.02
18adc2e105124ddfa5c7a041fa62f387,284,253,31,Asia,23,1795.09
18aef23187af4885a4089109fc951914,152,126,26,Europe,16,835.93
18b3a55f4deb46e98653e8240f3a7f95,263,225,38,North America,15,1915.92
18b3bb7380084dd6b35f47017cac2279,227,206,21,South America,20,1813.4
18b4e16d53e944979e36d52564c6436e,27,1,26,Asia,17,111.33
18b59626e5c7418bab78c920e90a42bc,100,59,41,North America,23,552.7
18b7d681a1d84b0db591203a9c5c026c,111,67,44,South America,20,1204.56
18b854af010b4d8ca098625d7e44f8aa,46,10,36,Europe,19,65.66
18c44b878b2141f4b2ae5ef2ab3a476c,364,310,54,Asia,18,1712.52
18c59101209f444ab4f99c483859ba69,294,257,37,Africa,21,1962.75
18c623ea839f4aab868f1c8627c964cb,362,347,15,Asia,20,1955.17
18c6324dfb8c4f3caa75d27ce22ff661,191,146,45,Asia,20,1510.27
18c8ebfb34cd4a7db069208195798352,249,198,51,Asia,20,1164.88
18ca0df55e7b442aaba40cc958a82ef8,285,245,40,North America,16,2107.54
18cd52c2fbd24e7fa1e226955e4247f1,256,214,42,Europe,19,1365.9
18cdce41f5224f4c98dce9c289c67bb2,305,279,26,North America,25,2539.66
18ce9250371a4589a0476caa34242954,215,178,37,Oceania,21,1324.87
18d012cade6b4f33bae39fba4dde05ad,363,356,7,North America,18,2592.38
18d35265d66c4cecb65c0f914b810de7,327,273,54,Europe,20,1512.07
18d4a76ec5d3426e871561e7fd4c3b25,322,276,46,Oceania,16,1638.58
18d4e3e1bc7448c4abba8488f8a084f0,136,107,29,Africa,13,716.15
18d5bbb8fc2845fc8193ea66d9bfbe5e,349,294,55,South America,17,2193.35
18d9e52dc799495ba8d0c1487f9fd296,80,51,29,North America,15,822
18da9f89d7694172af71d3533250dfdc,182,156,26,Europe,24,1262.22
18dd98a7ba214f64921c3e3ffa29dbb8,81,19,62,North America,14,606.45
18e33030e3c14f7a91ca10e6a7931484,137,111,26,North America,23,1574.3
18e3cae533bb41b68a196164489682b0,93,56,37,South America,22,464.95
18e409954a8a455e8c617f1dd5ea6ff1,354,333,21,Oceania,19,3178.11
18e4d58fded648a487ea7f6dba4e168c,363,324,39,South America,18,1967.36
18e8625fd4b5484cb1ac04a2cd41ab51,198,168,30,North America,21,1201.32
18ea890b0e1a435eb3427fb4ff539fbc,267,215,52,Oceania,22,1145.54
18ebe7d18cd741469357c3a2220c53bf,231,190,41,Oceania,13,1105.55
18eff2e392cd46f8bbe5d0b07b1e7a10,364,356,8,South America,23,2564.77
18f3418338b64173bb091b345483f92e,362,338,24,Africa,16,2502.22
18f7638261e344e68de22fda262ebdce,338,315,23,Asia,16,2359.15
18f7e06dc2944e0d912659a61e5c192d,190,145,45,Africa,24,1230.01
18fedd8f099241568f8a682b083751a4,361,339,22,North America,18,1884.99
18fef5d44dbe48a1ab9373dbc67c14f9,274,253,21,South America,21,1564.86
1900f3ca3e4941f69e9310d138341217,301,261,40,North America,26,1417.97
19015b09cc164a74848e9ed96a04fe1c,107,71,36,South America,17,544.17
1902bf407e3445459499d66e7170c456,365,339,26,North America,17,2830.47
1904ac8568ea49e4bee52e189269262c,144,116,28,Asia,23,1088.19
19050608f3d940d19e340ebcf7052482,128,76,52,Europe,19,566.38
1905befde32d48a79ed0a2474db8547c,38,5,33,South America,17,169.21
1905cece0d6340e6ac6eee42e63eb2ea,220,192,28,Europe,19,1534.29
1905e2cab9ad449fb67724da48789ee9,349,318,31,Europe,18,2107.23
190a55e11f8a4be1af27ce0488435240,327,282,45,Europe,15,1808.77
190a8c5a78d343c38ef4bb48fe3164e6,365,356,9,North America,22,3617.95
190ec52484cb456dad98ae6a22db8494,221,195,26,South America,23,1534.53
19112cbb1e1649d7ad12f4023cec7854,264,235,29,Africa,21,2064.55
1911537fb0c5419d8e00e8da15edafcc,254,228,26,South America,14,2100.33
191173a6dd5a4f04be10676cb1230e24,209,176,33,South America,15,1640.91
1912a22e1a7f4d1a95e5fed0208a9dd5,52,18,34,Africa,23,468.42
19134359db5c47a0b704419b8fe1a3e9,177,145,32,Asia,22,1084.41
1913509d444840b7ae16d41d17e4f1d9,364,321,43,North America,17,2666.43
1913736631c84de4a47a11aff7590f80,365,330,35,North America,18,2458
1913cb79ea2b4d96858d58957f4d202f,164,129,35,South America,18,1374.86
19148266dd7c4411a20de3932462193d,58,18,40,Europe,22,293.84
1914baa9089b45dea370fdf473bbc0de,242,220,22,Oceania,19,1234.61
19151e7a5b604d5791343ad9d691d936,113,83,30,Africa,17,994.24
1916927fd42c4bf882e9b691df855781,36,2,34,Oceania,19,138.21
19183d8ead734ecb83fd43fd2ed77b0f,360,320,40,South America,25,2710.11
191a8a86646e4189ba9f708b2346a185,53,26,27,South America,19,239.02
191d1e180349467eaf651a67ccb8329f,141,110,31,Oceania,23,868.49
191f2dc14e61490e800f67aae260e5a0,362,337,25,Europe,24,2034.88
192058d5fcf8418880e7846f82b4056b,110,64,46,Asia,22,531.88
1922a99bf3f94ae4958182671c757a21,168,139,29,Oceania,23,1508.72
1923af5851d54444936403ab9bc9da0e,54,21,33,Oceania,15,279.25
19251bb5a69a4f4094d5a3408daead7c,224,183,41,Asia,18,890.2
1925d417391049398e3b34d1e85f0da0,202,163,39,North America,17,997.76
19269dbe74084d36a352f924bcb79021,265,218,47,Africa,23,1079.53
1926db9376e54b1dac50c536f71b19e6,361,339,22,Europe,15,2266.8
19284ffc9ccf475b9fa5a384578defc0,247,197,50,North America,24,794.08
192af287839140cd9355d530ac90719c,126,98,28,Africa,17,672.95
192c46a2410b44378c1e4b5e2aab87de,110,77,33,Europe,26,626.1
192c693746b94f30923757feffe1ae94,102,80,22,North America,24,1189.28
192d0b11d13746f2b79074ba9fb7932e,165,124,41,Africa,16,1267.62
192d96d814a944df8d9ac6bde717c67d,133,103,30,North America,16,994.94
192f848ccd5a4deb8f3912c28c31e5a7,358,328,30,Africa,12,2976.54
192fd057984641af8b0c12055c5df242,189,152,37,Oceania,24,1679.38
193203a6647841ad9b728f177d1cc457,364,364,0,Europe,19,2465.05
193207051f2847808fc3bab117cda4a6,154,130,24,Africa,21,760.64
19323bb0aa094f009b174516afa9597b,313,270,43,Asia,26,2016.7
1933e5cc10e64e2f82b4f2483360dea5,328,295,33,Europe,21,1797.26
193426acd0324644ab828af8d7ee4df0,303,272,31,Africa,18,1788.5
19365ab02afb45a6a09dd25ea8bb8950,199,176,23,Oceania,20,1336.79
1937b1b7b99b489bb39fd80d94631b9a,141,88,53,North America,20,624.37
1937db96bf0e4260ad2c74d37a12d7d6,295,252,43,Africa,19,1644.43
19382d16755148308a357355779bd80c,50,19,31,North America,22,292.99
1938b18991c34c80bdbd4307eefa619e,60,14,46,North America,20,325.43
19392ecfa43a40a1b237ad3d6f39e5b5,292,263,29,Oceania,27,1995.63
1939fb20a81e4ffab4bf496bf1675fe5,58,10,48,Oceania,20,117.58
193d1c8bf81c4b69a30cb1916e17c75e,329,295,34,Oceania,22,1759.46
193f5c09730544c7b42b0b7e80142b2c,92,43,49,North America,19,497.93
193f9865493044f9950f3ebcd04fc07f,206,164,42,South America,20,1218.29
1942535489c74158be27e471e8d29879,221,205,16,Asia,17,1547.23
1944cfd581304661912998543c022a77,200,163,37,South America,20,1553.04
19471c61431e40b78a4ff2e47fed6d02,358,338,20,Europe,26,2213.01
1947363e83034702b7ad21f30b477ee6,196,177,19,Asia,19,1207.65
19474cf09394459e87f79ac208cbaebe,61,26,35,North America,20,491.55
1947b2b9b7524ad4a7fdd65b1830901c,172,132,40,Oceania,17,1264.11
194b6de1c2364315a66063bf3c3e3b49,312,283,29,North America,20,2053.71
194bd4207c874f779de304ccb268a3c5,132,100,32,Asia,16,631.88
194fda6565694d3fbef40b6ce1b6bbe3,303,278,25,Oceania,21,2258.76
1950873412a641e19f8e1ce7cdcf9f52,61,10,51,Africa,17,183.18
195188b9679146aa875ae60d23e22fc2,254,210,44,Africa,22,1564.11
19532058b0384407b0fcb5947592be92,99,74,25,Asia,24,529.17
195446eb30864152b0eab830f85a7786,257,237,20,North America,19,1789.56
1955203f3af844069c9115aa86dceeb7,96,71,25,South America,19,1003.3
1958b781fb534f2ab95d15deb87ce97b,363,359,4,South America,19,1975.98
1959c62ffc4e4cf4af143541b471409d,234,199,35,Asia,22,1748.34
195b8c9bbe1a4498901e383802c79dac,365,365,0,North America,17,1688.95
195d69fb7792439e8f5d7c3c4112e6ba,201,173,28,Oceania,22,1391.74
195e8adfffdf4f44a6d227a64f6f3d3d,105,79,26,Oceania,22,1096.68
195f9c907d434200a3d83043b77d49eb,281,235,46,Asia,23,1772.43
1963e6a6f8404e219670d83d4358fff3,308,265,43,Africa,26,2409.96
1964bbc13ca24882ab19670eacf37bee,364,354,10,Oceania,16,1689.76
196546619aa340688fdc35b4d48df5b5,365,352,13,North America,20,1923.59
1965ca9a3d8a41479f940dba7ea54fc7,51,13,38,South America,22,297.97
1967dc5ae2914757ba524f86ea562d49,287,236,51,Europe,14,1432.77
19686d844a6d454db973335d20d69d37,77,50,27,South America,14,409.22
1969d9d1dff94e259b2d150177d56ac9,123,73,50,Europe,23,408.85
196a6db44cda40d8abd60fbd5ae5a3ae,319,293,26,Oceania,24,2377.2
196b31b5d8314d44b59ba545ad536614,149,97,52,Europe,24,594.8
196bffa4574c433b9bd0dd8cab018565,307,257,50,Africa,21,1637.1
196cf2871bf54b09928bf76beeca6adc,360,317,43,Oceania,28,2673.14
196d9be8bf6c45ea9fb1b0745a110849,204,159,45,South America,22,1111.9
196e9d45146c4dd4b0da720dd8684cbc,75,32,43,Asia,22,374.7
196fdb4b32014e35a572abb79d484706,262,214,48,Asia,22,2028.84
197069decb6043a9bdca3d5e47cf429f,244,221,23,Asia,15,2711
19715bcb018c444889d9ab970ff267a2,299,266,33,South America,23,2323.88
1972a9d0270947f6b7d95dd2839682b1,89,68,21,Europe,20,813.77
1973f7144163477cb8cc3475494eb855,241,216,25,South America,13,2423.65
197421d3829d477faf6f1baa1f3ed07f,97,44,53,North America,21,877.75
1974ed8c8e414d259b07f3f72df734a6,329,295,34,Asia,21,1296.4
1976b97248bb442abd20d752becd261d,214,168,46,Asia,20,1440.25
19771cfd0b524ffa995f6fc5d1247a0b,177,147,30,Europe,26,1374.58
1978335a00154aaa9aadb7f0e29ff0ba,136,87,49,Oceania,25,386.48
1978c9f15e5f4c858ed721538dfdca43,218,169,49,Oceania,25,1570.09
197d52ee1754495baf7d4fd5ef814981,215,174,41,Europe,20,1622.25
197e293d05a942f98a33856cb5a128d6,339,318,21,Europe,21,2356.39
197f494576e0426ba0a84ea51e5ceda6,64,19,45,Africa,20,536.33
197fc2f90c9d42abae819006d371dcb2,81,42,39,North America,22,466.29
1980a4ad90514869a151c5ae923bf051,186,126,60,Oceania,19,1361.56
198576229dbc434f9c1aec2907a4f525,365,361,4,Oceania,17,2479.37
19859568d8ea43fd9cb6fc41bdc2a8f3,45,18,27,Africa,14,827.92
1989fb512d29482b91105a837e2c8dee,363,353,10,Asia,26,3694.48
198a808bcbaf4ece8c7540f4ac532f4e,231,180,51,North America,18,1473.9
198c088a0ba04ffb8cefd6ae18d65307,181,137,44,Asia,15,908.1
198ca5f8d3264c39973622a86ba49331,149,100,49,Oceania,14,605.58
19905a0e43024af6b076618e136f0ff4,231,189,42,Oceania,23,1530.11
1990b8b074d44a08a718a60e1332fab5,270,233,37,Asia,16,2023.72
19941fa032774285869a39a1ebab23f2,365,343,22,North America,21,3523.73
1994487c6b8547f18822936fd933829e,332,288,44,Europe,12,1817.95
1994895d5ba74c7894461826dfe0118d,331,282,49,Africa,19,1752.37
1995cf256c294eec9ac5efc4c2509911,309,258,51,Asia,25,946.28
1996c7f7f60643cfbc7fb02d742d650b,70,18,52,Oceania,12,184.8
199a24d14e984e4fafb13fed1d6199ce,365,341,24,Africa,18,2992.92
199aa5f6d1334dabaa7839fd19749b27,195,152,43,South America,26,987.39
199e6908aeb447749da464f01e2ae414,148,124,24,South America,23,1605.76
199e9eeff3ba4b54a3c743bbf9656a09,272,256,16,Asia,22,2482.74
19a046904f33461891a3b952611a7ac9,54,18,36,North America,20,570.23
19a18d41d21448c487d9fec85a3b22af,86,61,25,Oceania,20,551.89
19a1ec8cc12f495d9b01a138d36689bc,202,148,54,Asia,23,932.2
19a31cc17ede4ed3a9db614361a1632b,365,330,35,Asia,14,1825.56
19a456c4295a4f67bc749dcf8f5d0d0f,128,106,22,North America,22,1115.57
19a4cf35fc0e40d99f042a6930929daf,310,272,38,Oceania,17,1971.78
19a63fabcdf2457d89a69f02f261d1d7,365,342,23,Europe,20,1852.03
19a6fd201ae54b5aa9f03f3633d723d7,345,289,56,Africa,21,1583.9
19a76cfebcf349b5af401bca49e06ff7,172,122,50,Asia,20,532.63
19a7963560fa4b5c8f8fac4b4f150c1f,241,210,31,Europe,22,1634.43
19a98215c50c480d8a996cda61e4c24b,60,18,42,North America,24,636.73
19a9f02d535e48c8af9919bb1e206d0f,271,238,33,Asia,21,1667.58
19aa3b9a329f47fa87d183ce086e5335,131,106,25,North America,21,1139.74
19aa63540cc34f57b3b7d94bd55b29bc,306,264,42,Africa,22,1953.08
19aab7d9453449db872dd302f55ba186,365,325,40,Africa,21,2099.25
19ab685ebd54423683dc9e59692aee93,302,276,26,Oceania,20,2706.95
19ac0804e4884c0fb75beb11aa5973ec,305,282,23,South America,22,2316.51
19b11a340af540139e70a773f9344c4b,277,254,23,Oceania,19,2157.57
19b13fc7a9594ea69362e9042a44bb8b,57,26,31,South America,23,476.94
19b1adb35ef744beae1e792f9105488a,66,12,54,Oceania,21,473.57
19b264ae6ed8437ba8717f13ddc59b53,219,193,26,Oceania,18,1281.58
19b33a7e7e6846188c5f1e8f0d5933f4,67,28,39,Europe,20,510.96
19b46c7751af45de89ceb96d83a915d0,344,323,21,Asia,14,2329.65
19b5acd8c24a427b9e6eef164aeff2e4,94,63,31,Europe,21,975.47
19ba0a29bf1943c2bd00e8b195204766,182,136,46,South America,21,1116.66
19bd579ea843420fbc9671f20d8df5d2,312,277,35,Africa,14,2117.68
19bdaf2209424dc5b686049400bd5405,286,252,34,North America,22,2337.99
19bef145570346c1b6fa8da8f84b7c56,259,234,25,Oceania,21,1479.82
19bf245c9b8f4363b9d2f7198f7d0340,349,325,24,South America,18,2484.19
19c0e8f4c8d54a1599b0517d496eab97,51,14,37,Oceania,16,293.41
19c473288aad4af280e29d251cdda3f7,108,61,47,South America,21,427.15
19c5c5f79f204ef3a7b14b6c31c319aa,215,163,52,Asia,24,1446
19c9745462dd4d7991577e149fd91828,365,359,6,Asia,25,2553.42
19cb44a111e44800b4043ba79bbe1083,234,202,32,North America,20,1665.27
19ccc2ecad0a4b23ac1eec4dc3b74f13,342,316,26,North America,24,2619.93
19cce1b9e0a0497385ed7a176f086718,160,112,48,Europe,21,792.19
19ce1ba834ad4bf9ba4ec6888be63cc5,188,141,47,South America,18,1078.08
19ce593ca61b48608f78d1d90bf39731,82,55,27,Oceania,21,865.22
19cf0349f77145b8b85eb582d71b87ca,116,90,26,South America,20,645.21
19cf9f8910f3469395199a71a3c4bf7a,365,360,5,Asia,21,2140.44
19d05f9b09ad4261ae63d6c154bf92d0,198,163,35,South America,13,1538.61
19d1a13a47ee4929bd5c8ff40f617a60,159,112,47,North America,17,767.2
19d1ce61208b4ba0a8420fd450403b31,121,88,33,Asia,22,811.87
19d268f539b44a84aa3f5632bd122628,290,259,31,Asia,26,2282.56
19d2e3d28c664fa1a431790c436f6e62,322,299,23,Europe,17,2252.44
19d554dc320a4a64b0a7c7d891a3e44e,221,200,21,South America,18,1987.44
19d55916c40f4c589836b6790993980c,218,177,41,North America,26,993.09
19d60fc4d292483283c765073ec32962,364,351,13,Asia,24,2425.07
19da23b4de244da9bce3cb9cc52c71b4,233,191,42,North America,19,1239.96
19daa270d41546198ac305514cb9f336,226,197,29,North America,21,1111.11
19dc2092dc2244bb9d2eaa1afb5394ed,296,258,38,North America,18,2005.35
19dd2d0097534e1b8777be030a01daee,148,113,35,Oceania,13,1391.11
19df23e8384b427db8b5456dd52c2624,357,311,46,South America,20,1657.53
19e140b615d74a61bdfb3078e2b1e2c4,299,269,30,North America,16,2493.46
19e1578606e24dcca9bfc48d072ef1c0,288,242,46,Oceania,19,1179.45
19e17b1040894d389941fb8ca5fcbe9f,50,30,20,Oceania,23,736.96
19e3edb4929143b2b3d147b2d7da86b1,254,233,21,Africa,19,2332.64
19e5e88847e143abae4a00294367ecdc,136,110,26,Asia,22,1183.39
19e6c2da92634d238ac1fb4bdd6902cc,189,157,32,Europe,15,809.02
19e7a4810d144299a98cdff96e3d7e32,80,27,53,Europe,23,347.44
19e7f430a0af4e63ad5c05294ee9b4e6,94,32,62,South America,21,392.71
19e890e8a5534b8183cc4d0418ea31f6,208,160,48,Oceania,19,1237.52
19e8a80a718b45d8a102d72474580038,138,93,45,Africa,19,1019.33
19e943e7c1644ddcb1082c42651e3da4,150,116,34,Asia,20,1280.13
19ebc73b478e4e94a31f98343aa8f9df,148,100,48,North America,21,835.37
19eca37a33ea4cd29607d0b2152f723c,134,104,30,Africa,25,993.63
19ed6caf3863475d917000cdbe936db1,201,153,48,South America,19,898.07
19f0f8c16de9459a92bd41ca11011e10,248,224,24,North America,22,2338.57
19f11aea20db486884f575b0dc76c5d0,353,319,34,Europe,26,2768.46
19f4e507ef0441568c251276260bdb76,203,177,26,Africa,21,1580.02
19f56ab980ab40e18e3d2e01514d1b83,187,163,24,Asia,24,2003.21
19f7c5c898074b5a9e9076b698ee442a,62,20,42,South America,24,163.95
19f89a528d54440388e1d42690b344dd,145,100,45,South America,14,935.49
19f97c1c56784718808a3cfe5778a9e8,364,337,27,Oceania,19,2098.32
19fa17612424422d874ee52578f742f2,141,92,49,South America,22,737.67
19fa38fc64974364a49832eaebe98fe7,291,257,34,Europe,19,1907.49
19fcbdf6383c46098fe6e6732f555a25,336,292,44,Asia,18,2257.28
1a03417da8cf4a49b5a8b5cb202cffb1,118,73,45,North America,20,651.26
1a04eb34fcaf4cb5adf5556cdf622f0a,274,227,47,North America,18,1636.94
1a063226eb984934a0f871e06720022c,160,129,31,South America,23,1358.18
1a07b90568504c8c8da1db53f9e81a1e,260,219,41,North America,20,2099.37
1a08b30d3e9c4f36aba762067ad6918d,150,118,32,Europe,21,1030.2
1a0b31e7acea4bc38b9eb906d1785412,151,103,48,Africa,22,754.84
1a0bba123d5f469c81bbd9e3b0587475,162,119,43,Europe,23,1095.88
1a0d0c722c274779afdd476ca4923be5,183,132,51,North America,16,895.67
1a0d2f865fdd4fc2a232387e94ae3051,265,226,39,Oceania,16,1094.14
1a11c7c817ab4a96abe1844d85454d60,365,335,30,Europe,15,2637.88
1a12129404014a8381a272eebd488445,64,46,18,North America,19,528.11
1a12d674315e4bc9bab00ad9312e149c,263,220,43,North America,22,1357.16
1a136d049d764728b1aeb8424170b028,145,105,40,Asia,22,1289.49
1a160bdfbdb445aca7bbb11c44e76874,178,140,38,Africa,26,1287.54
1a168112d21049958cdc930675df986f,362,355,7,Asia,18,3172.62
1a17dd6f6cf0438fba8df659cd6cd6e8,178,153,25,Asia,19,1366.75
1a18003c80014763ad3bdbe916dabff9,365,340,25,Oceania,16,2462.72
1a19ac4e2b16418581696ee43937b41c,323,301,22,Asia,23,2418.07
1a19d6675e194e0993575caa944c1209,364,360,4,South America,17,1066.18
1a1a365f2fc64dfb95cac431ef869403,301,241,60,Asia,21,1768.78
1a1b09b67a6641b0afc945358a227ef9,365,323,42,North America,15,1374.08
1a1ce62b25584c90905b86014539a4b7,186,162,24,Asia,17,1266.53
1a1d1e0cb3534b5e81585072f7fd39cc,215,192,23,Africa,24,1594.01
1a1fc69c1d32443cbef20548f7210784,364,353,11,Asia,17,1490.01
1a2366d18cab46169a21688cb07377cd,363,324,39,Africa,22,2463.71
1a2473b8f13b4104ad94bfd2269a87e8,275,233,42,Oceania,23,1700.77
1a248be139ee416a8ce6f000ee318d4a,311,264,47,Africa,15,1266.27
1a24970ff7e2469687a1a480d48c032d,363,350,13,Asia,19,1712.25
1a24d73da6604ab2b6612ce9afd9d809,208,161,47,Africa,19,1333.38
1a2969cf346d48539632c07d7d16cb46,157,133,24,Africa,21,1496.64
1a2a0f4fdc3441859a16a1e97e4fbd65,101,76,25,Europe,19,1157.11
1a2a2a3bfe154b72a6bf9147192b407f,56,33,23,Oceania,24,174.44
1a2b58c606ee4b2ea3f410b70abe21b4,65,19,46,Europe,22,243.18
1a2cb024ccd74d329bfa4e65c259c55c,363,363,0,Africa,13,1484
1a2d93c26b04448196fdced5321eab16,40,4,36,Europe,21,297.47
1a2dee5bb8de448b93c869ee8a77ca5b,150,99,51,Africa,20,595.91
1a30bc633532422b82cf3c883c46a23f,348,294,54,Oceania,23,1752.3
1a30ebcb611b459fbeddaa20445ca56d,80,52,28,Europe,21,720.6
1a31bf0317504fc6894cc39764d1237b,70,20,50,South America,18,551.99
1a322524feac4dd69f19c034bfc76796,301,248,53,Oceania,17,1259.93
1a326714857f4eaf99b73813ea31ef7c,122,88,34,Oceania,24,770.38
1a3458f1df1347999b8d07788024a411,140,110,30,Asia,18,618.83
1a34f80596ea4463b1a01bcb174ea969,144,107,37,Asia,22,736.78
1a35e478e4c24e2bbd5cafa15d943e4f,126,89,37,Europe,19,985.87
1a3606c4b33e4e3b8c60bf367eb852aa,211,168,43,Africa,19,1323.14
1a3a02f2cedf4f90b3e9246593cf9abd,46,25,21,South America,27,190.23
1a3be343b58e441495870a5c60452fc0,167,132,35,Europe,23,962.33
1a3c709f9e12447f9afcca068f8c0f02,93,62,31,Europe,17,678.77
1a3cc5d1a8d04fa988c7ca6c762de925,362,350,12,North America,23,2395.3
1a3dfdfcb7a644099959a0da11893d11,194,157,37,Africa,17,1448.18
1a4032af63364375ba74965f43ef4e8e,362,359,3,North America,18,2443.95
1a406d82de9941c2a8912fa66b02a07f,144,120,24,South America,15,1885.63
1a407632ddf54329a64093900d2b11ef,106,54,52,South America,16,625.91
1a40b0fdd630418190234279224ac4d7,363,332,31,Europe,21,2546.89
1a4127e901ca4620aa52e970fbd75e5a,299,268,31,South America,20,2719.47
1a41425491474b69b84b2b81bde92f52,362,329,33,Europe,20,2615.24
1a42b409cf4b43c8afa54d79ae4f338d,72,31,41,Europe,20,265.29
1a432979eb3749c09790126b6baea65b,294,253,41,Asia,18,2464.62
1a44c39d5ba248f68ff83995d202e6c4,344,295,49,South America,22,1933.31
1a4525fa049347de9153956d26b9f2f2,319,268,51,Oceania,21,1013.84
1a45c35babc841e78e36653f0fbdbd18,365,343,22,Oceania,23,3125.45
1a4677b6b4de43d983689e06beaba057,298,277,21,Africa,23,2340.57
1a4792d5d1e644f3b72714b5aa709b10,303,262,41,Europe,17,2122.23
1a48208f0d0943189062977b48a97a14,358,328,30,South America,30,1954.82
1a485b67caf4441c9faa653d4f5a4c30,199,151,48,Oceania,22,825.89
1a486f8dc05f43ac8b2ac52854a6bdce,238,213,25,Africa,24,1307.53
1a492f79340640b8be97df1a41b73c9f,197,151,46,North America,19,964.44
1a4a8ef5d21542a7808fe5d508aa647b,336,318,18,Africa,25,2947.93
1a4ae8fef30043d294b6ad6cd5fad787,59,14,45,Africa,26,485.06
1a4ca75a771b4a42a90b71a9a26e3c6e,109,73,36,Europe,20,1408.65
1a4cf4cd03904b4c8fc65cc473ebf02b,363,345,18,South America,24,1438.57
1a4d0598665e4367a685fcb468f61e16,100,63,37,North America,24,525.52
1a4f9076240e4a75a123494a74f1bdda,364,321,43,South America,23,2439.98
1a522d4eaebc4b54a4ab74e035a1a182,49,1,48,North America,20,198.17
1a525f8723a94c4ebeaafca91eae5378,345,324,21,South America,21,2292.14
1a5292ad5d8741218ce65470c68d887a,46,6,40,Europe,15,306.3
1a52f4b5d10b4f6bba494e45aa54d01a,193,161,32,North America,20,837.62
1a53a10b588547bba843f8496e00be98,365,325,40,Europe,21,1879.96
1a54ace2363143338b3fdfa1798fbbf0,144,81,63,Africa,18,827.6
1a55c9f54dd44409bc0fd1cb3a48de36,94,65,29,Europe,18,963.9
1a5616c11e5b424bae4f391e7ad86a4a,312,288,24,Asia,19,2190.23
1a59d82546294af99f145f964e3b2664,130,85,45,North America,25,673.16
1a5c74511e354a7ea0db4a5344890588,256,202,54,South America,20,1122.03
1a5ca36d39bd468dba50fad3314299a5,153,107,46,Asia,26,790.95
1a5ff3543cb8434a92b4ce6e46929469,261,236,25,Asia,20,1766.87
1a65ece350f14ec49fee7ee93ed5b84d,329,280,49,Europe,21,1226.65
1a68a64451134f51bed859bb68e6e0c4,241,206,35,North America,24,1601.7
1a69690f5a5f44cf8dfc2faaade8e239,206,172,34,North America,21,928.41
1a70d6aa47614574ab8ef9e87a270110,96,73,23,Africa,18,701.22
1a71acc7f14741618e24855bbcec99fb,167,119,48,Africa,21,1005.09
1a72cc566e5c49ef982b0b5ab946d470,340,286,54,Oceania,21,1706.89
1a73106d8f274c5c9b6f008131343898,363,327,36,Oceania,26,2943.04
1a737cb61e304ba692cf06a4dc89d1d1,94,38,56,Asia,22,523.3
1a74d3f9ed964425b4b6757001e507fa,164,142,22,Africa,25,1250.24
1a751879e05c498b8c197e332d3b0b30,365,344,21,Europe,19,3180.69
1a782e9e9bbc441d8cd4bb7fe7f59e14,96,60,36,South America,19,370.21
1a7d8e6afdaf43d79b02465a512b94e7,364,351,13,Africa,19,2553.85
1a7e145aaacc4b538945e73f45db966f,222,176,46,North America,16,1393.72
1a7e7b36c94248bb9ca2fca1319ef137,67,33,34,South America,22,321.23
1a826639dd6042a98660bf476117c97c,218,182,36,South America,20,1597.18
1a858b93f43b4303a7a0378625e2daf0,113,94,19,North America,15,1139.69
1a87e7827837484dbc18d47ec75dcfb1,188,152,36,Asia,22,1237.68
1a8921f4866c4ecaa27679baf2c16653,135,90,45,Asia,23,588.47
1a8b845f61f8466ab33f0f69124062c8,67,20,47,Africa,19,317.54
1a8e8c0f2ad74c9c987630f26d33c31a,95,48,47,North America,17,659.46
1a8f2ddf93304996a86c685afa5d8325,365,330,35,Oceania,15,1288.02
1a8ff174c30c49a7bf47bce24fb00168,93,58,35,Oceania,22,661.38
1a90389dd08d4c1babbecc5cb66bc10a,318,274,44,Asia,17,2380.41
1a92540a6dc04720868b37ae40ffdb2e,123,96,27,Oceania,17,739.49
1a93dad0d7914914bff6eae219933228,365,363,2,South America,18,1304.54
1a9500e11f8743908919b1bf890a8b16,156,104,52,Africa,19,776.42
1a96899afbc6401da5c8887c8ed16652,323,276,47,South America,19,1362.78
1a97d63e7df34629a4bf4e70d24cb5ad,326,290,36,Oceania,21,2138.91
1a99644e13be483a92112b225f90d83f,97,73,24,Oceania,26,1058.27
1a9b17c98457465e8d993cc44ddf2b69,116,69,47,North America,19,658.86
1a9b3f01e0694bb78d3eb6033e139cd7,226,201,25,North America,24,1273.81
1a9b6db50490468891dbaa84e9d9fc9a,365,344,21,North America,18,2307.5
1a9e4e0ebf0a471ab3048e2fcf47f9ea,168,145,23,Oceania,16,1017.26
1aa4dd2bbfdc4f78a4c939ac7d62b33a,292,260,32,Asia,20,1852.41
1aa5393d20f8484ebd4a98f1b15c2506,83,39,44,North America,24,374.45
1aa5647213c34eab9d8796c01c9eb4cb,311,261,50,Oceania,18,1545.35
1aa5dc961f48404f8da615bb1cdcefb3,305,277,28,South America,24,2674.83
1aaa15203e344bf3b5689da774f41998,244,220,24,Europe,21,1861
1aacf12105d1497bbf3b39e09cfdbbc0,118,80,38,Asia,26,502.85
1aae013d5f5d4ce3bcd55168b046a900,40,14,26,North America,22,307.43
1aae51a8367f4a8d9b88e318004adce5,259,232,27,Oceania,20,1649.34
1ab0cee1f49c44759104b77368dcfdc3,213,170,43,North America,21,973.49
1ab2208fb1af47db8e815099642cd199,300,277,23,Europe,19,2437.35
1ab70324036d4186914e0266da2fe8f9,88,38,50,Europe,18,160.59
1ab70cd0b98d492b90e223f40a361ff5,266,218,48,North America,18,1536.1
1ab7e08e2fbd4779b8bb329cd4be6e96,259,239,20,South America,19,2465.89
1abdf9d59f06469cbcb5d652e97760ed,178,132,46,Oceania,23,943.88
1ac065e4ae504c39b151842fba884889,139,106,33,South America,22,1496.26
1ac3a8c8efbe41cd94e876b304b22a62,80,60,20,Africa,14,643.59
1ac50a57e712445696bd0619904950c3,68,39,29,South America,17,357.21
1ac617d09d834d1d817e11225cea26df,93,47,46,Oceania,21,626.05
1ac6959ff7b640b0acdaab3c0961839c,365,363,2,North America,24,2326.32
1ac72a082fa14dc5a83e247c9c1fd18c,353,317,36,North America,20,2210.96
1ac7fadd951d417abd2a3d3c8adca39c,362,323,39,Africa,21,1931.22
1ac84b715df34f5fb8d451d511a7374c,329,305,24,Asia,15,2488.89
1ac873bdb6e34fb9a277e53d12ddb0f8,365,356,9,Asia,20,2230.54
1acb67cd8e92424d879de87999dd5184,81,52,29,Africa,20,423.93
1acc1cb1adad4c33b08ab0ac91518af4,217,179,38,Africa,23,1674.33
1acc5f1b2eec4af1b80d78319c5951cf,62,40,22,Europe,21,580.76
1acda0c8104a462ca7aa0b030fd60ae0,215,167,48,North America,16,1326.9
1ace8617239044a4b0c1ec11ca4c6e81,144,115,29,Asia,17,1743.86
1ad0aa428388421aa5a2109f7531dab0,97,73,24,Asia,23,988.46
1ad1bf0cb33a44558771c63eb8bdf374,280,255,25,North America,23,1788.38
1ad277a7c96f4a0081e1586a13547661,131,88,43,North America,22,1167.79
1ad4724462f844bab15e5a88caa4dea5,365,317,48,Europe,18,1746.95
1ad6eba023754870b02989a934257246,95,52,43,North America,18,499.36
1ad6ebdde8f340fab9d48d03b28de01a,292,265,27,North America,23,1985.69
1ad7a42ac7dc4c82aaf06bb95f9325fb,152,116,36,North America,24,731.2
1ad898e39c8e4e998eae114546d4b9ef,196,146,50,North America,18,1231.61
1ade4ca7c95d4f94a1331bc10878787c,237,187,50,North America,21,1441.65
1adfd3c56a9d46a6be420d95fe15c36c,155,118,37,Europe,21,676.34
1ae097b922a1498a80213ace47c9edef,203,149,54,Oceania,18,1205.67
1ae1a4d1885240ee8bd9d2641bd1db56,141,85,56,Africa,19,686.57
1ae4b0a624f842b3b690f38381de6fe6,154,132,22,South America,15,1042.61
1ae59de38d6c4d9bb60e566be458a0da,201,167,34,South America,18,2317.95
1ae6670aca6f45cda8d32f0ebc3faa4a,364,363,1,Africa,19,1944.33
1ae679d41fea4f29b5b3fb0bfa85935d,365,343,22,Asia,19,2953.47
1ae70adb589f47649aec8dff10565a6c,45,4,41,Oceania,22,370.47
1aeae448bf2248f3975cfa68a2029c19,123,90,33,Asia,18,1158.47
1aeebbff3648413d949f011c39a90871,49,31,18,North America,21,500.31
1aef90e41673407b90bc564909dc3a66,74,24,50,Africa,16,389.92
1af1b998b52f4e029a1d6d62937baace,210,185,25,Africa,21,1916.58
1af3dfda49c7477c91edccc95b6ed874,319,266,53,Africa,18,1740.4
1af7f72c332e42cfbd94f184f39bf22d,228,204,24,South America,18,1601.09
1af9757b0c65461a871db513a5cc0a70,327,290,37,Africa,14,3242.21
1afa0ca9dad749fd91257d9bbc1da287,245,212,33,Europe,24,1890.56
1afa43db80cf4dc89a3346c438b65850,105,54,51,Europe,26,270.43
1afcfc5334db496a9b716787ae72163a,92,66,26,Africa,28,881.82
1afd92356d4b495f9865d8abe70d299a,126,70,56,South America,19,948.76
1afd963876a643d98ba64c2b0ca160c2,114,61,53,Asia,18,903.42
1b0028dda84b4978b48fc2a496bce485,365,311,54,North America,25,1523.96
1b00a0264f224709bd441ef673bb957c,297,253,44,Oceania,19,1687.72
1b01afdff2e3435689f370830e1dc212,273,244,29,Oceania,23,1925.36
1b0249a23cf44020a0e16a2b4c105f78,124,74,50,Asia,21,294.86
1b039908a36b42aaa42e17d86e5cc342,166,130,36,Europe,19,1137.14
1b044c0461a548b3a630524c836beb14,362,353,9,Asia,21,2796.86
1b0466fd3673476ab3fae253c5f4950b,128,81,47,North America,20,481.28
1b04a73085b044ae85e40b05e56adfd2,57,39,18,Europe,21,443.2
1b07ec3d289841ef930ec398595b9988,164,129,35,Africa,22,1230.95
1b08983e0258413ebfd0023c4ce4526b,250,233,17,Europe,20,1459.24
1b0efd05d9d242ee8ec66e374a4a2fec,207,165,42,Europe,24,1439.43
1b0fcd99a6a748c2bdb95944d123c337,201,149,52,South America,20,995.37
1b1082b1d3f64da19fd7897c5560c355,365,352,13,Africa,23,3256.31
1b10f70c6bc348dc9967f70046c80721,32,3,29,Oceania,21,174.03
1b14b161e0f7435f93a67de32c8cb711,291,261,30,Africa,27,2342.45
1b161b8fc3774c73943fb724946bf78b,202,179,23,Oceania,19,1848.91
1b18b0a810e24c4c96ec4a75f212e74c,365,329,36,Africa,19,1480.08
1b18ef6e73cb45a28b5bbb9339238b7e,361,313,48,North America,21,1466.62
1b1b7cd5aca44d589a794f49c117d42a,97,73,24,South America,23,1082.11
1b1badf1918a4758b8b6f4f603d19471,281,239,42,Europe,20,1622.25
1b1be9987e33440eb8faf96ab6b70d8d,365,348,17,Europe,13,3537.69
1b1fce5e84f3429bb9232507b0f265a3,77,53,24,North America,18,970.56
1b220f10889d4efcb060448510ea13b5,50,26,24,Africa,21,114.96
1b23235b408e4416990f3ff6e598265a,82,48,34,Europe,20,692.09
1b23e4db3ba34f469a0b78115dabefb4,364,360,4,Africa,17,2706.92
1b242de667d74e5fa8ed3170955ad799,211,163,48,North America,20,1345.47
1b250e60b5894c939e6f85ebfc45323c,176,136,40,Africa,25,1420.46
1b25139adf454ea7bf1c5c88b44d449c,345,305,40,Asia,23,2011.06
1b25934d9cae464ab5dd70c43ff9102f,317,298,19,Oceania,20,2027.79
1b26737971014a76b7a9439065558b85,197,174,23,Europe,19,1176.48
1b274dc0b8e24d43bd4ca57e97468000,88,58,30,South America,17,919.1
1b28829fa95e4be7a456564865eaef2d,362,326,36,South America,22,1941.55
1b29477effb848f7a038aeacfe7fc2ce,227,184,43,North America,31,1943.87
1b2bd92c1db040e585835fb4814766fb,328,273,55,North America,19,1823.22
1b2cf59c4185415488b31a6d187f51ad,28,7,21,Asia,13,153.35
1b2dbc744970417babdb403d2cb84ebf,77,23,54,South America,23,390.28
1b30b3aa6ff94275ac2d692d416f01bd,193,142,51,Europe,20,1202.15
1b3146fc04874a53b71a5d4d9800fac1,118,95,23,Africa,21,1091.03
1b32cd076f5449efbb999957a6f739d9,114,74,40,Asia,25,806.62
1b330d03a3da4ad3a74f5087d32cfba5,49,2,47,South America,19,107.14
1b336ef74f9748b5a71005d56e8b3dae,254,206,48,Asia,21,1229.4
1b33db0c86cc48f0862dca8f387bd1bf,44,5,39,Asia,21,322.65
1b35171f6d3c442fb9f8d613565fc5b0,364,326,38,North America,20,2041.55
1b359877dc914e25bad716c3033ca20c,238,214,24,North America,17,2187.07
1b369adb0b8c45abb2e1b5a064f3e12c,364,363,1,South America,25,2810.64
1b397e51b43442e8bfa476b4aab08ae5,181,146,35,South America,16,1342.3
1b3abde4ac8a4e51ba0bb7ab8f0bc8a2,104,48,56,Asia,16,334.43
1b3ae4495a1541d9ba0e5733f4f46f65,363,357,6,Asia,17,3212.73
1b3d4e7057b345c2bf3cf6a0f44a956a,245,207,38,South America,23,2063.44
1b4136dc1dd14d97a2e675a0550a249a,362,321,41,Asia,19,2468.04
1b42bc0e47d441648e4362d1734d44eb,248,219,29,North America,24,1376.44
1b443b018c354c81afe79230c02fdac8,27,5,22,Oceania,17,110.31
1b47c14fa07342e6b5add6ee3c29c9ac,190,153,37,South America,19,1081.63
1b4bfda05aa1471f8e2c39d68aac5eb9,219,198,21,Asia,19,1960.37
1b4f26844f0c4eb7a9087f9e345ef8d5,56,8,48,South America,16,147.99
1b4f9b3645284613ad451b45fe569972,247,207,40,South America,22,1150.35
1b53bbee94d3462db7d4b85c926eba34,335,278,57,Africa,25,1834.7
1b541fb209f640c9a2f408c04971ca7c,359,327,32,North America,22,2781.4
1b54e2a059884380b5e26ffa3cb9b5c7,266,246,20,North America,27,1588.83
1b573b1a47ad4dd7856493c9eaae0364,224,193,31,Europe,17,1806.62
1b57e38172594334a2e25408d599e9e9,160,117,43,South America,23,897.44
1b594fb8c950445197667834a05cec28,112,73,39,North America,17,806.47
1b5960ec830d44ac82ce07b3b3d7a34e,173,150,23,South America,24,1602.52
1b5a125e1a844e36ba0afed128c9bcda,165,144,21,North America,21,990.26
1b5c998b65884115aa1f31c8c96ca0bc,343,325,18,Europe,21,2460.66
1b5cc56a69be44738363f3255f6ad30b,58,16,42,North America,17,136.19
1b5cd4cc421c45f7afb1a34653fa8800,231,200,31,North America,17,1709.62
1b5d9a5bded4400db7790aeca8dd2ca1,158,106,52,Europe,22,753.42
1b5dd9d35a224f1c878037bf19b7459a,68,37,31,Europe,20,809.48
1b5e5d2898de4ea69fad15f081351b44,363,306,57,Africa,24,1499.1
1b5e85448b7147e495d159d8cf6629f5,331,315,16,South America,21,2112.29
1b5fb97adde04856baea850d584488c0,132,87,45,Africa,22,814.29
1b62fe783f6e45cea93df4467310a920,218,168,50,Asia,18,868.44
1b63f852f13748aa8cbab0501af4e549,123,71,52,Oceania,22,603.27
1b64b2d96dd549d1bb9a358f9b487d21,195,163,32,North America,21,620.13
1b65cd068965496883ca23f31407432b,365,347,18,North America,19,1267.34
1b6a381912dd425fa1e738333a2479a6,200,178,22,South America,17,2054.31
1b6bf146fae3495e900429a063e4baa1,301,268,33,Europe,21,2085.18
1b71baecf28d4c55beade518d7ece525,205,174,31,South America,31,1710
1b749e4fa5b942a6ae85deeeb64e6c80,201,166,35,Oceania,21,1919.2
1b751354f3504427ace2706767b211aa,345,322,23,Africa,17,2578.74
1b7555263f1a4688886cefe64f2defb8,189,165,24,Africa,20,1684.08
1b77b9e474294ee3952efe43cd829111,123,69,54,North America,14,676.39
1b77f0c925d34e3eb07f7483be792931,69,45,24,South America,19,658.53
1b7c4193692d4f5fb28dd1f05ff161bd,313,282,31,North America,21,2539.74
1b7cb0b634ef4c69a934a12b31b5cd08,101,59,42,Oceania,24,340.48
1b7d713802584f5486d527138a1edab8,116,94,22,Oceania,28,1262.55
1b7d73a5e39244e4a1e665ea79c82185,365,359,6,North America,19,2563.11
1b7de97c6f874283b1d3965f2d8b8338,191,148,43,Europe,24,933.06
1b7e2e55c36a457183639338b36969f6,79,28,51,South America,25,325.93
1b7f929ea763489bb2267864ad4aab2b,363,329,34,South America,20,3224.61
1b80661db3a14f0b8995ffe70e4cb89a,357,321,36,Europe,18,2836.75
1b8095bba20545c8877428fde3edac0e,315,269,46,Africa,17,1344.79
1b80aae43555489b88f66cd5ed85113a,48,5,43,Africa,22,258.26
1b83980a1ad6401cbf8ce76f27b22aea,365,331,34,North America,22,2117.89
1b8684ec943f42d09288caa2b36cdb11,361,333,28,Africa,22,3014.84
1b8725fb21dd4179a91d07775f89cd7a,184,161,23,Africa,24,1026.9
1b885bf0c4064b988ecea5fb9e9299e4,100,76,24,Oceania,21,863.88
1b8c3f8b5aee46b7b99d75c1469d0b7a,288,259,29,Europe,20,2649.4
1b8cf3f7c96241b585fbe7eb39ed9152,364,337,27,South America,23,3215.53
1b8e763f18b642d58f283cc70d8d7631,127,107,20,South America,22,1252.72
1b8ed79a16a64055acbcedc8f138bb83,253,220,33,North America,19,1646.43
1b9027f5e40f4032a7a95fdf730c2dc9,291,240,51,South America,20,2210.52
1b90c56e09f342c0bc312f99e1480b2f,95,42,53,North America,22,304.01
1b91e5aab3414a1dacd56ffab83ee5fe,322,289,33,North America,23,2457.64
1b96f86d19384bd58cb5b842761c3407,360,321,39,North America,17,2123.57
1b970f945f3744c3a50e9db9ff7ed3a6,74,24,50,Europe,21,559.82
1b9887121e32465f9c3d63fa03bae8a3,57,23,34,South America,20,196.17
1b9992b21b06496ebab7dfcfd7d723b9,364,359,5,Asia,22,2007.56
1b99d28a0b554319950854bcd2f5a704,333,277,56,Oceania,20,2037.66
1b9a5140154c4d23a6d3e304c8871539,98,40,58,Africa,21,653.17
1b9afda02368458c97abbbf64b257f62,250,211,39,Europe,19,2067.81
1b9cf72f91374eaca4df2c5345ef85d9,346,299,47,South America,24,1785.82
1b9d0a867a6d4dbe907672bbc5316991,365,364,1,Asia,24,2166.14
1b9fdfb087e74c9fbc100c599fa175e9,231,182,49,South America,19,1621.35
1ba1b316a07948c18a4811e14a092a5d,265,246,19,Asia,21,1900.12
1ba2caedab484b93b8d0a5780c9b8cdc,93,60,33,North America,19,602.33
1ba2da413f044c9f8dbefad0f3aadf1b,365,337,28,Asia,24,1834
1ba2e395702f4b61ac423bb1d0fc4fc7,313,294,19,Asia,15,2776.74
1ba7297b4aa1423f9d131c8a2ac8f8dd,51,12,39,Africa,25,464.59
1ba93d778bbc4611961351fb9e1669e5,124,102,22,Africa,20,1014.43
1ba947e24ad94b3da3443bde1a33b0a8,228,198,30,Europe,22,1907.27
1ba9b6eeb2e141c2b8dea43264f4a8cf,321,301,20,Oceania,21,2556.62
1ba9ce393bb741cb9302ae3d5cb331df,144,112,32,Oceania,18,1226.52
1baa055e000348e684d85258a644a8e2,231,189,42,South America,23,1097.12
1baa1ce6f9284040b300f914ec6c6598,141,107,34,Oceania,18,1004.51
1baa57c85ec44544a7396fcaf122b406,337,307,30,North America,23,2172.81
1bac18d30fdb4c2f9b0c3a8b7eae05bf,276,245,31,Oceania,20,1897.77
1bad1d7f39154a40b625353682cd9671,312,266,46,South America,23,1926.79
1baf4b32b93c4e6c8ac649002d10daba,243,214,29,Asia,16,1708.9
1bafd44c292c411dae8fa6f8e5f5f96f,230,192,38,Asia,21,1367.71
1bb1e7dcef9c45488618a5b636a533b9,365,323,42,Africa,20,1855.68
1bb4c88ce76947c39e9718a4c3c5d879,272,234,38,Africa,25,2322.54
1bb501860ae74213bb566f294b649fb4,153,99,54,North America,16,789.92
1bb5071f2e85485b9a3f6c661ed91d75,365,347,18,North America,22,1987.07
1bb7e5d035ff40d7a74cca0c4714e650,327,289,38,Asia,19,2278.3
1bbabc214cdd4671846807f3db289bb5,273,226,47,Oceania,19,1528.48
1bbb60553fa743609bb43dc7b8205c34,117,65,52,Africa,21,244.4
1bbcb3338eaa4c0a9a08d7dff64eef56,365,331,34,Oceania,23,3226.85
1bbd5832a7c748c4aacd1b14d1843b24,230,191,39,Europe,22,876.26
1bbdab2e333545eb994e7749f342db85,222,190,32,South America,15,1553.61
1bbe4357e1ad4667893a7cdeb57aabf0,285,251,34,Europe,21,2011.71
1bbe65fc5b08417f969f0d2d9fc0a271,259,210,49,Europe,22,1532.45
1bbeba9095f74515a7e4865344a2daff,127,88,39,Oceania,19,792.31
1bc01a2a42b646728f4ea8d3877f9b00,177,157,20,South America,19,1727.97
1bc6101ab3ee4890a0a0d8836cb677b7,332,307,25,Africa,14,3141.86
1bc6209ebe084490b8618e762418b162,327,287,40,Africa,20,2383.72
1bc857fff9954991b883340dad085b0a,217,194,23,Asia,21,1518.85
1bca485451f24e8e886e83f319910736,67,39,28,Africa,14,577.07
1bcea3df235b4445ad22fde9ab056385,66,12,54,Asia,20,539.18
1bd01b269bbd448f9d7921936ebf4e2a,341,291,50,North America,18,1915.32
1bd333dd6cd34d949dc64e93b3552cd6,91,57,34,Europe,21,596.23
1bd6ebc8e3d646d19e299460da009df3,285,231,54,Asia,18,1628.31
1bd7fc1c010b4aee8b9218b0abcdc14c,198,159,39,Europe,15,1411.91
1bd8cf4020e4401f97b7f0beb280c2b7,349,316,33,Oceania,17,2268.83
1bd8dd0bc6fb45e2a6f2c90668733928,162,131,31,Europe,20,958.17
1bdb5163124746d19b3643621449c48a,168,113,55,Oceania,20,614.68
1bddba2b24bb47d7b24124d4823f3308,141,120,21,Oceania,21,805.97
1bde4ef823eb44e2a0d219753358c4f7,206,157,49,Europe,23,803.92
1bdf91872c964aeead629ee020922243,240,183,57,Europe,14,1367.24
1be0079f371743fd9e47e563f078c64c,255,205,50,Africa,16,1204.07
1be0565b9fed4447a1109e4034bd50e8,212,172,40,North America,18,1370.8
1be05e88bbbf42d79b04c4816d036f13,327,273,54,South America,18,1059.94
1be48d92af6e4895a3c0b5f8b0e08c50,213,172,41,South America,21,1208.2
1be826765365487094feeea0a341c01b,165,139,26,North America,22,1410.23
1be8576664454a8e8efa7fe2922766fd,249,201,48,South America,17,1123.27
1bec913275944be08938b8c8ee09a636,84,35,49,North America,22,566.23
1bef2a9208aa4e3eafaf7d86893773b3,355,306,49,Oceania,24,1763.82
1bef50c925a949ee8d551a5fce7c293e,284,258,26,Europe,21,2319.3
1beff5274f8f4ecd8b419fb3ba5e4d40,324,283,41,Asia,14,2328.93
1beffcbb046a45dd9caa9c0161b7385a,283,239,44,North America,19,1336.59
1bf017c880d24520b960b354474f7e31,363,337,26,Europe,22,2005.55
1bf091d9bb854543a2c44a14c581c4ef,347,328,19,Asia,21,2328.4
1bf12585ace74405960e655c8abdbb58,188,169,19,Europe,20,1954.42
1bf233f862a642e6845b42cf0bbc4d7d,317,278,39,Oceania,22,969.51
1bf26839c887461ab62e7c57f79e3745,251,207,44,South America,19,1485.18
1bf27fb9fc324f63891a6ddc03623e71,146,120,26,North America,19,649.67
1bf326d77c784783a30e8a630f56c6c4,353,321,32,North America,17,2150.3
1bf4863615754f7f91223115b845d550,96,58,38,Asia,21,487.91
1bf8049028fd47caafef923c21ec12f1,270,212,58,Asia,21,1047.83
1bfb870854ca489f9656329295c70dd5,187,145,42,Europe,18,1463
1bfc57cf806a41be9e9c7dfb7c6c56a4,92,54,38,Africa,23,1109.51
1bff0339dc09433194fcf60fd8482b12,62,7,55,Asia,16,377.88
1bfff04e2f564cddbb315e55f8055e2c,51,10,41,Europe,18,480.05
1c004c96a5c842f5a3b5e7a19a51d53f,317,274,43,Oceania,17,1632.03
1c01cb395abc485da3e8947885ab2fbd,111,54,57,Oceania,18,346.79
1c04a4249ec640c7ab0ca78687301f0d,251,207,44,Asia,16,1980.69
1c0857f5d46f4aa6a40988046a77de7d,219,190,29,Africa,18,1817.07
1c0b5610658940249cac2b2f2cd81e30,69,41,28,North America,20,301.28
1c0c9e8d6832417181f1293b6e1c21ef,343,321,22,Europe,23,2468.06
1c0cf6336ed543afa763a31a30a2872f,364,328,36,South America,17,1995.96
1c0e6b6b15bf450da98a38daa755e9a0,57,25,32,Europe,18,292.8
1c0e98d1b00d4d44b2fab79f39630e4b,129,103,26,Oceania,22,1448.49
1c0ffba1dc9b48eb976a42cad93c5935,51,5,46,South America,22,281.88
1c1024c106a74b298a8d0d20972e6574,251,197,54,South America,20,1299.62
1c1093bc3c4e4f94b8c4891922cc1721,284,256,28,South America,23,1833.86
1c10abb20759427c8314f2cdc1032267,302,251,51,North America,21,1401.42
1c115bd0aaf844de9bcaa88ebfdd8fd2,207,188,19,Africa,14,1549.36
1c12a16a48c1448297bdbbefcaf223fb,48,12,36,North America,19,391.33
1c13abaeef614691bc697a058cb7aa18,242,218,24,North America,20,1966.74
1c142299b1e249b9be91d45b25793b27,365,365,0,Oceania,18,1806.36
1c1595e32a5146ecb73fd17094ef525b,238,190,48,North America,25,1726.4
1c1597ca5b9244fab3a80b5f2e994283,365,362,3,Europe,16,1517.5
1c1747f75c664119985323e6af1d9e67,180,149,31,Europe,17,1385.38
1c1ae076542241d3b8ad79264145c348,226,195,31,Africa,15,1476.99
1c1ba78c273348c7aca1bf6111db9eb9,133,107,26,Europe,23,755.5
1c1ffe7c75e245e98cdf286e50465b93,365,340,25,South America,22,2234.65
1c21a956f3e74cb1ac818415fe7a20ca,365,359,6,Europe,19,2157.7
1c2521ceb1f94f00868ca6e3d9b5ce9f,159,129,30,North America,25,1376.25
1c2a7b218a7e4eeea399a7fd3610e7cc,76,24,52,Oceania,20,721.12
1c2bdb63e4b24b19a0216aba8bd9020d,290,252,38,Africa,14,1383.69
1c2c674ed1644c0099c2b9b6ba7fc2aa,364,334,30,Africa,27,2306.65
1c2dfd208fb74df3959d0c358bd68cd1,362,318,44,Asia,20,2325.27
1c2e9a0438b0466a8773b1dfd465fa2d,364,346,18,Europe,17,2746.75
1c2ec07846ce4e939b14f3c5aacbb9f4,228,186,42,Oceania,24,1964.18
1c31ae09d5b34b08bddc91b1a0a8a3cf,336,294,42,North America,15,2025.72
1c330f1605b04c68bac58d15027d0966,253,231,22,South America,17,2562.4
1c3349f2c07341e199ff0431fb6ddd58,126,101,25,Europe,21,1073.15
1c342019bcf94f46ac949789db2abaec,180,148,32,North America,18,1603.39
1c3432bd916b4e19be2bb44fbcb28661,334,291,43,Asia,18,1517.13
1c357db72f194f6a808ebfb26ce75c7c,101,86,15,Africa,17,529.46
1c35e60a7895445bb12034aa51f5e197,196,163,33,Asia,24,1091.21
1c36697a93304da1bc7bb27c6d969f28,223,178,45,Europe,19,1628.19
1c371b2c079c43869286545d6157c4eb,205,161,44,North America,21,950.41
1c37444808ac4dbcb40b5875adc4f7ef,177,126,51,Oceania,20,803
1c37c9c1599142b9a97ebbe5c93c7e69,41,16,25,South America,21,486.25
1c38194176e44621950ed62d84aa9256,89,64,25,Africa,20,1226.1
1c39fca05ff949b8be64bee38569e99a,159,115,44,North America,22,960
1c3cd62878e24a88a33eb4ee0c496afa,264,219,45,Oceania,22,712.19
1c3eae86c6ed4d49be539c6f90fda97d,303,256,47,Oceania,21,1326.88
1c401deaef514e809a10dce55b825391,116,90,26,Oceania,17,633.41
1c406d5f9e624539ac77894f10e36fff,231,194,37,Asia,22,910.14
1c4131468c1f4932a0e40dac5d66cd0c,76,29,47,North America,17,802.17
1c42d918784544e2b246d9460308a511,283,237,46,Oceania,22,1433.56
1c442f814a9c4c038186e7febf708217,88,51,37,Asia,19,568.11
1c47ff746e334647a6bebd693eee84fc,302,271,31,Europe,20,2118.08
1c49ad2ad514485aa84e30350ba0e618,114,80,34,Oceania,18,1288.56
1c4bd8128bd54716abfeb76910b89ef0,292,259,33,Oceania,15,1930.25
1c4c762cae954a7a9831a81e87c8c07f,342,313,29,Africa,20,3021.64
1c504e039d4443a0a58ed8b79ca1589a,214,198,16,Oceania,22,1344.58
1c51e73883bc498b86f327f4053a739f,187,145,42,South America,23,693.32
1c528421321e4c88a84da700fe738c68,134,97,37,Europe,24,627.07
1c54aa1b65d14a59910eef0a971c5cb7,119,92,27,South America,17,1000.35
1c54ef7c73d64970b3451f4235c84fee,63,44,19,South America,19,383.75
1c572279db0c4e40b1a41999b1968c18,243,191,52,North America,20,1200.95
1c57ebde0e0c4cdb95469afff6080209,80,24,56,Asia,22,667.05
1c58204bb9fa4e539153f1e004eb6f2a,232,183,49,North America,16,1527.94
1c5859dbe6cb41238abcd725c1ee8442,282,234,48,Africa,21,1421.1
1c58ea4ad8404e7d9998996910bd1f82,220,178,42,Asia,21,1011.17
1c5945187d0b4296970cb098ba79f95e,58,14,44,North America,22,871.89
1c595e5087cc486f969a9decfc63bbcf,365,320,45,Oceania,26,2082.58
1c59db44ab2e4447addeba0adc781603,132,95,37,South America,17,745.18
1c5a8f7719334e78ba0cc0a35e1e1e3d,54,1,53,North America,20,393.47
1c5af97151d94aac8b36ce9010d2d7ef,260,226,34,Africa,19,2311.92
1c5b6c28e8104c8cb21a5314ca9e9914,137,88,49,South America,24,866.97
1c5bb8308e08403088e38fa456c793a9,349,308,41,Oceania,18,2346.8
1c5d734bf07243aab150bcfebce7ba79,328,298,30,Africa,21,2313.89
1c5e300536724dbfaadd66fa1b259e68,362,331,31,South America,15,1650.95
1c5e43d8088e41ab8f0a382c8aa764ba,221,176,45,Oceania,12,1204.29
1c5e7a8658ad47d6bfa8638fa697c287,79,40,39,Asia,22,312.38
1c5ec955232848599db19c8a88f8bd4a,121,73,48,North America,21,668.69
1c61cbd46b3c472fbb67a01879801eb6,363,353,10,North America,15,2219.89
1c645fb3d0924249a1496251b4a32a24,94,75,19,Oceania,21,604.03
1c6563d745ef4492b2bb64e437a6fcf7,63,38,25,Asia,20,522.25
1c676b6fb8be43fb92d207f7d36adfbe,81,25,56,Europe,24,236.1
1c69347679c547de96174c937c87eb43,345,305,40,Europe,18,2342.52
1c69fa41bcd24b9c8795478e42ef90aa,83,60,23,Europe,19,717.13
1c6fb557ce044a2a9af1f788505b6ad2,91,47,44,North America,21,318.06
1c701ccedec84e55b73c9a8d15d755a9,158,134,24,Africa,17,1269.22
1c7094b3394448be9f2bdf2610fedd2d,101,64,37,North America,21,492.41
1c71cb035bc54276a0c50d2cdea1c523,68,25,43,Africa,24,482.73
1c72031a38974b44aa69378704e5c330,131,110,21,North America,19,801.93
1c726cae072b4c1cbf0b5fc18935b163,238,210,28,North America,23,2109
1c72fcf4adca4b1994d03c34c7b3b379,364,328,36,South America,15,1994.06
1c739b7980274d8993a466d9edc9aca1,85,62,23,North America,18,675.78
1c757a0ff3814317bacbef38be77437b,224,174,50,Asia,17,1026.42
1c78d7f7777842e89aad4e75a0309ebb,364,322,42,South America,22,2177.9
1c79316b0e3045478d0940935e344ca8,341,298,43,North America,19,3342.49
1c799a77f6b44d3aba43c4d8bba484ff,348,316,32,Asia,16,2834.21
1c7afa2ad4b34bb69d6d97eafbe3477e,142,122,20,Europe,21,910.07
1c7b40ad45234126800e9f982e573807,77,30,47,South America,23,411.91
1c7d11a8951c4d1abfdd1b5e99d801d1,140,112,28,Asia,24,463.82
1c7dd5decc9b4f859df33f76ff38de2f,321,282,39,South America,20,1772.97
1c7f355c86304cdd8f746c08c3840eb6,296,253,43,Oceania,18,1711.61
1c7fbbc3863247c0aa7d5334eb23fe20,143,119,24,Asia,23,557.88
1c80406d5d0145eb9046e4622311f101,168,136,32,Asia,17,1910.49
1c80dff75b694a669969731306b0072f,300,247,53,Asia,24,1813.51
1c817be4aae34e8bbb024b245095973d,321,279,42,Africa,20,2150.25
1c8228d58f51490191d6719a7ee28edb,104,58,46,South America,16,629.19
1c82472dd29b4f9bb4e8ce08117e91e1,249,209,40,North America,23,1292.06
1c83db56e97e4cc39d71088a5daeb5d7,365,333,32,Europe,22,1763.89
1c84d0ec9205407b9387ace254a580cf,365,356,9,North America,14,2172.22
1c85a40797ad4125b056f5b9ccb85855,220,174,46,Oceania,22,1424.67
1c8e48b8c0554046b8b41d1c3a26974d,316,265,51,Europe,19,2063.64
1c91c76f0d54432590c4d35d4dd0618b,288,238,50,Europe,24,1482.63
1c93b62879404c78914b311d2b37e850,228,172,56,Africa,20,931.1
1c948c0e0de94fbbac5163e331d895a6,230,196,34,South America,25,1317.71
1c95a9bc9e1b4a3a8787d09342bcec7d,57,22,35,Europe,18,201.03
1c97e6dc126441829b2da88aea3107ee,282,242,40,North America,22,2100.77
1c97f96f3fb9404396bd950f4d19a787,60,22,38,North America,21,358.39
1c9b081f43b74250ae31bda5977a5148,231,204,27,Africa,17,931.89
1c9b395a704c4068b43aa53ea9270c8f,59,20,39,Asia,18,331.1
1c9c88e7d1694a6da8812095cb2bb8d7,250,214,36,South America,19,1859.83
1c9dc449df9746a1a888a81c44348492,246,205,41,Africa,28,1751.28
1ca07291b6e9422f8568fd7203d82da5,361,310,51,South America,20,1745.39
1ca1258b97a244a79f90a8a8e1cd4ce7,362,348,14,Africa,21,2040.17
1ca2da57989f495e974209359742a82d,164,113,51,Europe,17,887.95
1ca2f0cc92c94661b827982f05dbf426,255,206,49,Europe,25,1216.03
1ca2f310265241efb56e6b6a65267cd1,92,68,24,Oceania,23,929.27
1ca4d8953fbc4137addfb29a401a01a1,365,329,36,Oceania,23,2635.68
1ca56ffd0e4f49c49eb01610eb3c76c4,259,220,39,Oceania,22,1166.34
1ca5a2ae57a24d609fceb296748a69ee,180,153,27,North America,18,1423.49
1ca6ce296d7d4b4cbb0469922145d299,116,89,27,Oceania,21,841.06
1ca7d67e6d85418ead5b41f8ade70469,161,135,26,Asia,18,1258.77
1ca7dbbeff2f4703a392477f34fb01c7,257,209,48,Europe,11,1410.07
1ca7ffa582564785b7091b5cc4872015,137,101,36,Asia,24,582.26
1ca98ec63ca5447dbd91bcfb12f4c424,23,3,20,Europe,23,250.04
1ca9dbf2bbfe4ee6a680bcd6127abd8f,187,130,57,North America,22,1325.86
1caa805cf8d04f6e828a43549d43a351,296,273,23,Oceania,18,1811.81
1cb00847e0024c9ca706f057592e116d,312,293,19,Africa,21,1468.5
1cb2984e209c4e939307e9930ce69f21,278,238,40,Asia,17,1808.52
1cb42000d19c4bd78a47b59fa234f673,285,253,32,Asia,18,2665.33
1cb47dec3b61459bb82e3b4006500f56,121,64,57,Europe,18,989.16
1cb4fdb6fc774680b607850a476ce453,276,250,26,North America,19,2245.16
1cb540676a134ed9931a145586df9055,365,334,31,Oceania,19,1821.59
1cb61cc464f14d35933f039feb9dca70,239,206,33,Europe,20,1890.56
1cb72eb4ef2e496098c1ba2766bc3905,194,162,32,North America,18,1246.37
1cb83902318f49b3bf334a4e28077d74,362,316,46,Asia,19,1567.77
1cbc880b93b14d97aa66d79749e4271f,200,175,25,North America,19,1514.19
1cbed217426b4ea4bd8f872b04a127fe,252,202,50,Oceania,20,1894.82
1cbf9dc368024657aaa606c0725b8706,217,168,49,Oceania,17,1287.64
1cc075d69c644d8987a910d373ac2bc3,211,161,50,Oceania,17,1106.93
1cc4c6acd7b54e0987ba4d30ff014d81,315,256,59,Oceania,19,1191.23
1cc5c81651294b74a014ed72c4c39e3e,185,133,52,North America,22,862.85
1cc94b99509c4555a8bc6f72efbac9d5,236,209,27,Asia,16,1618.37
1ccbbea63b6b42d39620c6563be192a1,95,72,23,Africa,26,590.15
1ccca88dbf6a4a75b729b3ef0d04332e,293,270,23,Africa,20,2309.69
1cccc7d503ef463798c770b2027ed198,188,154,34,South America,23,1321.21
1ccdf0b3de9043eab2338ac9dbc0eb9e,116,71,45,Oceania,22,705.42
1cd02d0ae2b3462f936a0307a8cee6ec,71,36,35,South America,18,439.59
1cd116928a194c6a91d454dc02f3d374,363,347,16,Africa,18,3029.89
1cd593f96c2249abb951cbbc354b503e,51,16,35,North America,19,404.86
1cd68e457db149a8b8f064b25ff757b9,298,248,50,Asia,19,2019.08
1cd6b609628b40deadc93e67cb1d428c,297,283,14,Asia,20,2710.23
1cd75b355f184d9681b32670b1177038,33,10,23,Africa,24,397.61
1cd8a1b5099349ba8bc2d2a2cae9d1af,365,321,44,Oceania,23,1567.16
1cdae322cede48f096b040ea3fd1a6dc,162,117,45,Africa,17,739.02
1cdb451b3187408e87788b279aa2599f,96,52,44,Europe,20,674.46
1cdc48e1737d430889baf00dd246b8b0,200,150,50,North America,13,1514.83
1cdc8405657543b9a6b1308d9dbff619,308,277,31,Africa,23,2783.67
1cdd908cdcc64437b0a6797b0a8e9e2a,98,78,20,Oceania,19,816.44
1cde5152e9be446aa31c0c0d317d2dc8,160,120,40,North America,20,876.09
1cdf760ec26046329d6896eaac35fa34,175,150,25,Europe,18,1185.6
1ce24ab080544097ab3ba3bd88bd401a,137,106,31,Oceania,26,1518.54
1ce36bc1266f43bfb68a200365d74544,101,50,51,Africa,15,748.77
1ce5fd8d03c54712b9f3ebf8465e5208,262,232,30,Oceania,24,2020.89
1ce68098b6c24e06ae7c25ba38502829,312,252,60,Asia,25,1385
1ce75da104f04b5886bfefba40599aed,326,282,44,Asia,20,1972.57
1ce8ccd5a5564310a32aefd6378d5200,365,335,30,Europe,18,2240.32
1ce903ebf4634b8aaa0d5f5bf32ead78,365,334,31,Africa,22,1991.68
1cea46a36787438aadf35177c2b75da1,325,306,19,Africa,23,2368.11
1cebe20c82dc4eea8732eda3ad3fae7a,167,119,48,South America,20,844.67
1cecc9809c4a44d2a636ce24ab7230f9,276,229,47,Africa,22,1658.41
1cef26e437af4fefab578e34371fb4d7,61,38,23,Europe,22,365.49
1cf15ea11ba34b0ba4c04185edc497e0,92,64,28,Europe,17,668.21
1cf1bf62a0f94a4e923065c8488996b1,134,116,18,Oceania,19,798.87
1cf29722872f4bbf8ac880a9f3f28448,292,263,29,Oceania,23,1872.06
1cf2e0e96b6d47e49e238c5017ed44d3,135,115,20,Europe,17,837.98
1cf620c66c1f4365818b260ef964df57,337,315,22,Oceania,24,2238.67
1cf995b865df425c96479f88d328c05c,96,59,37,Oceania,24,419.06
1cf9d1fe3cd4472fb6417b7c27074ee5,365,363,2,North America,22,2382.06
1cfa429189db4d5c95ea746065177950,73,27,46,Oceania,20,412.44
1cfaff6c9f6d435aadba0f69452e6b6c,362,335,27,South America,19,2867.84
1cff6f61782f43228b1141def2638608,269,247,22,South America,21,1854.03
1d032d355838493ba8db8b7cbaa3aef8,183,136,47,Europe,20,1436.58
1d0330773074491986694c20cf175e53,310,272,38,South America,17,2250.65
1d0535f795654ee8ab0d548f1cf6ba03,217,198,19,Oceania,22,1998.26
1d063fb1d35c4c738340939c7cce0f0c,283,237,46,Africa,20,1370.29
1d0817e351ff4e7f91130f04d87ea156,292,248,44,North America,23,2345.13
1d0869c7e7f04dfaaf8cf86a7387e030,153,106,47,North America,18,662.48
1d096d4c53744436a5712754a2da7291,264,210,54,Africa,22,1142.8
1d0976be0a37444f8db47b7ac1fd4624,205,178,27,North America,24,1788.05
1d0a34a07b3b4d31aac878889eb0970a,338,319,19,Asia,22,2537.92
1d0c9d72591c4613838347f0e37dce41,162,122,40,Africa,17,846.74
1d0cd0086e8846bbace9420f09a094d4,310,272,38,North America,22,2064.03
1d0f41e3aab241a5b0cbab63019ae3a7,365,335,30,North America,18,2912.61
1d120759b2b14bae92ad9c97c8f2d041,327,290,37,South America,21,2008.63
1d14fa519045410381d8afd5b8b24d90,246,190,56,Oceania,19,1460.72
1d15032e28bb418db45c4d1f00c78c17,268,222,46,South America,23,1863.99
1d156ce050414e02b04049a407a2b439,365,338,27,Europe,15,1777.4
1d15af1ef2a542c785e93bd476d0e67a,34,6,28,Asia,25,473.73
1d15e6bc18704d8d804c7617727e4604,362,354,8,South America,24,1958.31
1d163ce32a9b4c2ea778207360408681,106,89,17,Africa,20,570.86
1d195846d3264b4e98f4648c1bc4edad,363,317,46,Europe,15,2411.56
1d1af01359b44b62baa6d92e01fef79a,231,195,36,Asia,27,1546.94
1d1cff236a6440aaaf512613a8b80e0a,201,143,58,Asia,17,1185.37
1d1e598c21f64c6cb62b1ee228650897,359,334,25,Africa,25,2891.57
1d210633d80f46a18da752b7cd4430a5,284,240,44,Europe,20,1863.43
1d21153a82e54b4286422117dc5b8c1f,315,287,28,Europe,24,2181.22
1d21448a7b9e455e95c6111a4d73af78,230,207,23,South America,20,1264.12
1d2159d5ba8f4976b2c1004081a59c40,253,207,46,North America,24,1191.37
1d21828d1f224f57815802cab61bed06,28,5,23,Oceania,19,293.32
1d268532aab04f9a9baab6dc870e4618,260,205,55,Oceania,18,1424.96
1d28501766f14d969e93289b8f57797a,184,154,30,South America,16,1735.55
1d2b76d166334edf866e8183ce9feb3f,359,331,28,Europe,20,2591.61
1d2fbdb998bb450c841ecd5fd6bb1937,268,236,32,Asia,24,2279.46
1d307850f679478c8333bc162671a458,42,4,38,South America,21,184.1
1d317f3305e949ffb8e119dae7724fa7,198,160,38,Africa,21,1095.04
1d33ab114710458cb9a468161f9a2a29,84,54,30,South America,14,726.82
1d3463b172714481bd2b68dfb47457f1,209,180,29,Oceania,18,1403.18
1d363659fee643448796f3de77b9fcc2,247,211,36,Europe,17,1508.82
1d3832e3deb74d418ac3d6687179d821,363,357,6,Europe,16,2100.11
1d39697bda1a4b88ac076b1e9eb33083,364,310,54,South America,14,1719.17
1d39a369f30142db89f0d76c0a487d52,139,98,41,Europe,20,1002.86
1d3bced731fb40c3b964f4f6f6133f6c,365,348,17,Africa,18,1968.8
1d3d5f0eae564d4798f935d34d69c289,229,172,57,Europe,16,736.06
1d3e0b4e41f64c8fb7637354e9ee899f,74,52,22,Oceania,23,836.47
1d438eccf0264cd0a629b60b4c59b6c2,300,275,25,Europe,21,1849.94
1d4543c22f6048ba809c1d93b490befd,105,51,54,Europe,19,471.35
1d459af83182407ca021522a5d6f9f0e,101,81,20,South America,19,802.38
1d46b41223e147cb821b3048ed7b0b3f,364,358,6,Asia,20,2585.79
1d46d1266cd748faa97ae9f4a9a24106,182,142,40,South America,22,1291.63
1d46d6b6383b4653bc50390122b30dec,47,23,24,Oceania,19,235.07
1d475fdce485470098ec89f47646f212,220,176,44,North America,22,1227.66
1d4819a23c3f4ec6897ba2c0625f3c11,157,105,52,North America,20,622.9
1d49123a46e64489ac7dd2aab3d777f6,305,274,31,Europe,17,2058.29
1d4b8fc74a044b72879217a40464a167,260,241,19,Oceania,18,2091.14
1d4f6484c8544b3ba35a26997acb2fdb,199,157,42,South America,24,941.21
1d4fc88f77e248868f03e12d20b51ae7,223,201,22,North America,20,1728.04
1d5245da04494f6cb99c7ae314af4343,237,202,35,Asia,23,1880.38
1d52cbc3e30040cfa8615502f8fe522b,162,121,41,Asia,24,914.9
1d539d08a0ef4366a523f9355c2f6ce3,156,119,37,Oceania,14,979.14
1d54d42c4ed540768587d3ffdddf2dcb,182,155,27,Oceania,19,1357.82
1d55f63be5ef4cf6b260f724a0389b10,73,32,41,Oceania,15,154.25
1d5668a99abe4b79974b4b25505c3b90,148,98,50,Europe,20,991.61
1d589867f3c5431aaad9aaf4b0fe5084,276,232,44,Europe,19,1571.86
1d593100d33a44fab6e5c57204415bd8,290,247,43,Europe,21,2315.1
1d5ad430fa574db1a45e6c4697e3e04c,92,72,20,Europe,22,588.62
1d5b7605ab494269b4f6687f290e6571,133,105,28,Asia,21,952.53
1d5e5ff8a0284deea5fd8f26ca634315,330,286,44,Europe,23,2028.51
1d5f4c4db2d94c84ac275b0b4a202c7c,365,354,11,Asia,21,2319.94
1d5f7c06f9c24f918d1864b45c2cf32e,60,5,55,North America,20,339.8
1d5fcfcf830c490aa609766de9ce3752,291,253,38,North America,25,1733.05
1d6003f8f4684cf38b1bf0b627c1ccbc,209,173,36,South America,27,1297.22
1d61347239834f2a9829f3239e45a364,190,171,19,Europe,24,1569.79
1d6432fbc5bb4a569ac46381cf76f952,215,169,46,Europe,22,1645.85
1d6745c0862b4238b8f0d5fe76960c63,354,313,41,Asia,19,2079.9
1d68581ee7ab49fdae1a02cdb77cd562,317,299,18,North America,20,2817.03
1d6921d1a1874979a315d6fb5b33da1a,170,122,48,Asia,19,1340.44
1d6957593b3649d3bd7193c0d6873c59,365,339,26,South America,20,2597.45
1d6de1c3207d42dca799c5701b73caf2,181,126,55,Asia,19,586.49
1d6fcfff6f744464ac54b692d181846c,82,61,21,Oceania,22,600.42
1d75cb3b80194b85a9b8979544404ff4,211,170,41,North America,23,2502.85
1d78de82913546da8e2233bf5ec7be2d,65,11,54,South America,24,295.7
1d79e21d8c5a4b75a5da02faaf035df5,155,110,45,South America,22,978.88
1d7c0dbd2b1149cba50838be63a942e4,255,211,44,South America,16,1195.71
1d7d524a786947e888381e6f28107739,186,141,45,Asia,15,1101.75
1d7da34cd31a460c85d043d7ac203c8b,259,216,43,North America,23,1887.02
1d7df32c39694115840aec6c43da759a,228,193,35,North America,21,1788.38
1d7f9b41f1fa4f16a66328eab35d092f,351,307,44,Africa,20,1743.23
1d8366058126430c8f1016f66d1707cf,64,10,54,Europe,17,314.23
1d8380ef0ea141e0ac942ef315352d10,133,86,47,South America,20,587.83
1d848986ec004fd9b047a58799316b9a,90,57,33,North America,25,607.18
1d84f6ec78f640ab923f7214027eace3,172,117,55,South America,18,1215.49
1d856920c4d94984816a3a4358049702,181,133,48,South America,15,1142.02
1d86c33d47094c63b48f0aa613311fc5,329,270,59,Oceania,17,1434.72
1d88846014d44cec8cc932766ead1a93,288,259,29,Asia,26,2616.65
1d88b34a75594e099df5989b1779d974,100,61,39,South America,23,514.14
1d89dd4ffa844ff48e0b7396277ffba0,33,1,32,Africa,26,154.89
1d8aa1115aa349a3af216e2c58bf8119,152,112,40,Asia,25,1007.2
1d8ea98f9e4a46c6b0f20501724a1368,357,334,23,Asia,23,2869.03
1d8fddfbd63246bbac829e5e03c92f73,365,328,37,Oceania,25,1905.25
1d9006e03bf54d8b97909aaceb04926e,285,246,39,Oceania,22,1947.1
1d9452b261fe4d3e914b268755aaa546,117,91,26,South America,22,715.42
1d987d3e2462465e93b0550bd9b53d5f,108,88,20,Asia,19,779.47
1d9dbbdb17d14de6aeaea074eabdaec6,160,111,49,Africa,20,1249.2
1da0a675bf144f27a22d9f5a0e6bfc00,241,198,43,Africa,20,1899.55
1da1e4d2082f4de4a1fded55f7abd404,170,120,50,South America,25,1276.61
1da29f39518d4ae7b1fe72751e3abba9,92,70,22,Asia,18,427.24
1da2eec27bbe4ca590106d38466b8dae,251,220,31,Africa,18,1516.14
1da3664e9bae4023894728bfe53c15b0,284,249,35,Asia,24,1934.96
1da3dd6883ff432b87ad345386e9aa59,232,191,41,Oceania,25,1253.09
1da535c29ade4846b1bd791cc7b79f94,365,327,38,Africa,18,1909.82
1da5c5566ae349a580b0fb9a2678fb95,314,285,29,Africa,23,2324.32
1da78e65a2b74c72bcf38e8c67cc2ecc,337,308,29,Asia,23,2988.03
1da7aa51362a453ba8346152c25fcd1a,92,48,44,Africa,16,439.63
1da9ec4b3514429494a7acd68e14b181,100,71,29,Africa,22,782.05
1dac380999de4af4a420939f3f203347,179,128,51,South America,13,932.66
1dac9164335247618e8592a4ca9cbe31,179,133,46,Europe,18,756.71
1dae47e1510540a89da1b076fd718bfd,60,27,33,Europe,19,527.25
1daedd8b821946f2baebe8efb7bb7d96,311,269,42,Oceania,21,1998.85
1dafc9e220b04a66bb119de88f009bec,115,80,35,Europe,21,811.84
1db0ea0ea3cb495bb2d4ae8c838c93de,161,136,25,South America,21,1184.94
1db1cc7ff5b24d939ea0baf2f7c46a9e,364,331,33,Asia,17,2047.99
1db3560be33247fb95c404a54d7096e5,211,157,54,Oceania,20,1166.03
1db37a5a91b648af90bc96542871ef77,62,15,47,Africa,27,502.07
1db40dbd5dbe40e687ad6eeb722d89a1,57,29,28,Asia,22,312.61
1db50ba273a545acbd4d821e76c02668,364,335,29,Asia,16,2344.8
1db6755b74ab4a54a531938b6e52cac2,330,283,47,Europe,20,1933.8
1dba33af9f2d49478530f779f9680638,159,119,40,Africa,21,717.69
1dbf4005308a4671943b0e08bee887f1,256,227,29,North America,23,1594.76
1dc1e6161ef44e1f8aff33f392045d6e,340,289,51,Europe,24,2414.14
1dc486d26c8443ed8fead0a529e673b1,364,308,56,Europe,20,2013.29
1dc56b16637e4e359eb4b8b1da40c3c4,62,21,41,North America,16,591.31
1dc9da35454046a898e62e118fd500ba,97,63,34,Europe,16,947.52
1dca89cabfcc49a08588fcbb296feced,119,86,33,South America,20,1439.52
1dcbf54799234df7bc72c5989e1b9502,338,313,25,South America,18,2191.27
1dcbfbb77b3b4e7693ab46be2cab2630,264,237,27,North America,17,2010.37
1dcd304a11c1492183de42ec38ac42cd,190,171,19,Africa,23,1382.92
1dcd3c71cfcf4398b61551637d194072,128,82,46,Oceania,21,502.54
1dcde0ad9ded46449b5221e052ed9941,137,110,27,South America,21,910.52
1dd029726a194fe79ea48efa11772a6b,172,135,37,Asia,19,1493.8
1dd243b0615342e985756252bf523a28,194,151,43,Asia,21,1781.39
1dd24d91c8e146bca60a2df7d0ee2e75,297,248,49,North America,21,1443.16
1dd4861bd97c436798cd0ca3253621c6,82,54,28,Oceania,17,760.58
1dd493fcfe2a4829800974a5f5d1c00e,82,36,46,North America,24,485.13
1dd5ee3153934104921757d969145925,321,283,38,Africa,15,2996.63
1dd7d76b1fba4c2eb980a7089c5ae6af,360,341,19,Africa,17,2540.47
1dd931b154954853a941e3538cf24456,236,213,23,North America,20,1667.42
1dd97c11201e491293f378fcf57b9555,350,318,32,South America,23,1830.23
1dd9f194ec8b4d5982ff690bead9ade7,365,323,42,South America,22,1172.08
1ddb42b659f946b6944f14ccb55ff03c,176,131,45,Africa,21,838.8
1ddcd5cdc06b46e6a3f405b2b5bdea2c,281,241,40,Africa,20,1490.88
1ddd020bd5a54c848fa2b872a30c83ea,320,270,50,Africa,19,1334.15
1ddd463fe0b44c9684a1fe6fd4b055b9,260,226,34,Oceania,22,1404.14
1ddde491cf3f4f929664927593804645,79,33,46,Oceania,16,575.11
1de00dd2d06b416486c14d6d800a0b39,177,152,25,Asia,21,1489.67
1de1f0ff219e4d69a86065a1b2d60a47,363,326,37,South America,17,1793.99
1de2e17b88d3465b94acf86ee4b6e8ef,142,113,29,North America,17,954.91
1de3228c3a7a4468be447c13a630d5cb,164,144,20,Oceania,20,922.72
1de517742ba544a9b27a099d808f15c2,248,198,50,Europe,17,1102.24
1de7ce1d690c4185a4a047d19653d0d5,183,153,30,Asia,22,1077.92
1de87c6ddf904809a6baefb0f7292937,143,122,21,Europe,20,623.69
1de8b02ffb974203b4935aac30a361ad,37,11,26,Africa,20,190.88
1de8f3eb7c0e426d811fa661ae0225d8,69,19,50,Africa,17,153.18
1de8fbf12c0d4e4183f794b47558134f,294,254,40,Europe,21,2196.06
1de9de421b614f848369b1d9d8425681,93,57,36,South America,21,279.3
1dea3a1aab8c49c4bf873534977aa1d9,122,70,52,South America,26,698.2
1deb3d127fc747d8b2590f22ed387c71,146,89,57,Africa,15,761.26
1deb4ad6fabb459fb009c46c27be3486,156,121,35,North America,19,1079.93
1deeb163542c46a3a8947bb4614269b1,155,109,46,Oceania,26,718.87
1def67ab80314c1f8dd0dad453456fa0,66,29,37,South America,24,306.1
1df09268b7254b7293abd60d71c8d943,189,160,29,Asia,23,1214.73
1df0d5d3dbe84f4e9503809ece72ed53,117,88,29,Africa,23,1037.22
1df159656be143a5a2a0c180850265c2,122,83,39,Asia,19,595.33
1df40a5215904c6ebdf8ad848da4e133,258,237,21,Africa,22,1955.77
1df41c4aad6a45cbb7e9bce23ca13fe7,217,170,47,Oceania,21,957.57
1df63a4f05cc4f71bffcbb58d518c236,362,323,39,Africa,25,2141.48
1df6a7d4787e44568c6199c421e4b07d,347,299,48,Africa,17,1377.71
1df7ab6679b343dd9b0900d656e6fc3b,228,211,17,North America,19,1634.02
1df8eb2c87b445b9b3fab59b8eb5be08,83,53,30,Africa,22,635.8
1df9104803ff43b296bf55e8c19381be,169,129,40,North America,20,933.08
1df917ba980345dcaea174416504abe2,358,334,24,North America,17,3053.33
1dfc2b0f7edb4c4595bc5bda5fe1670e,166,110,56,Europe,20,579.6
1dfe6ddbdac147bfa63fbb508bdf1a73,138,90,48,Europe,26,680.83
1dfe70b9c0084976ba219e646b50b911,329,280,49,Oceania,21,1450.07
1dff16b7a72f47d39334504be418db27,292,244,48,South America,20,1193.68
1dffd3e482f34ce6bb65382bd97b7203,219,197,22,Asia,22,1815.65
1e01e995354a434f88ff902ca0d53dbb,56,6,50,Oceania,17,413.77
1e0519af65b04cd0967d9b198bbf4205,262,238,24,Asia,23,1929.7
1e06b0cdb1c6425c9b4bfad36669bbe0,51,12,39,Oceania,20,307.3
1e0bb6efe22b4a8cbf66612aefac4cc6,206,155,51,Europe,22,1217.32
1e0c895b7da944ffa2423ed10c6f8de5,158,131,27,Asia,20,1749.49
1e0de7c2d75b41a793db00b17ec06375,40,18,22,North America,22,88.75
1e0ebebe98ae4745aa2bd22e472e7c83,263,228,35,Africa,17,2047.62
1e119d983334461cb9adf1c5d4acdc6b,157,113,44,North America,20,1151.11
1e12af79a3f74d68aae359c009dfa0f2,203,150,53,Europe,15,909.66
1e13500c867a4f6d8e9c2aeaa0da291c,318,273,45,Africa,22,1379.21
1e1382cec74449c7b80cb79831e90750,304,267,37,Africa,25,2599.49
1e1524acb985457bab8823573f6eebc3,99,55,44,Europe,21,628.63
1e15bd60986641d09b543c89cfabcc2f,152,110,42,North America,18,692.41
1e189cbfa132412e8aa6aa5b29545fed,268,237,31,Europe,20,1474.76
1e1a0c651cfb4319870e1c9d70988a2a,276,220,56,Europe,23,1421.79
1e1abe087fa243659005cd78e5fa835b,235,212,23,South America,15,1674.4
1e1b783451af4442b15e1dcd422859c0,349,317,32,Asia,22,2663.4
1e1fc2485db84d138709b297d1a82ba4,330,289,41,Oceania,18,1159.07
1e205dbb72734e188d7be3dbf956db83,241,218,23,Europe,16,1972.66
1e20c440d0114b719a84cecee4a30284,293,256,37,North America,22,1963.39
1e210ce841a447a4bd8ee47ceb3a78ba,122,88,34,Africa,19,1185.96
1e2111f94d6d437399e255288a259fbc,365,354,11,North America,16,1860.69
1e21935af5304f8cb985ec77c31e281a,364,330,34,Oceania,20,1723.63
1e222bf13aa04d7aa3102ee71cff2335,285,258,27,South America,19,2252.25
1e22c7cb186040b68405fa2e87366133,364,328,36,Africa,17,1917.3
1e249e24193846989743a710af49b403,254,233,21,North America,21,1704.26
1e24af47bca04f0f8c72b393beb546a6,231,183,48,Africa,19,1499.57
1e26d0c1a9974cc1af1affc5b27d490e,273,245,28,Asia,19,1681.75
1e28f6868bf94f1aad2f21f6a6387be2,365,365,0,Africa,19,1828.26
1e2a4193f6b44b5faa371affade1389d,365,353,12,Oceania,15,2024.36
1e2b5e272812490781c4614b36622889,230,201,29,Europe,17,2403.68
1e2e03f3f37a4284b688834f9f1a11a9,364,321,43,Oceania,24,1863.44
1e2e2ebee15e465d81c72fe9f1f3c8d6,290,252,38,Oceania,27,1738.16
1e2e55cc1a104feebc90d75fdca6f069,318,283,35,Oceania,14,2189.61
1e2f0e173c7f45bdbe3d2c2585f2da43,73,27,46,North America,15,576.22
1e2fa70abeb44d62b6027b6092efd8b5,326,276,50,North America,17,1531.63
1e30b141c0d64cdf8be721f4c3e1272f,308,280,28,North America,17,1924.4
1e30c79afead4f81b7858f5197b1591e,31,1,30,Africa,15,240.53
1e315ffc18e84765bb6d86facf5113a2,96,43,53,Oceania,20,725.43
1e31e203f6df4d4597725c0b60956382,221,179,42,Europe,22,1531.09
1e3750a9fad84dd290ecc5515118ed2c,363,352,11,Europe,25,1816.37
1e388c3297374d9d9ae7f3c000e3e02b,294,235,59,South America,19,1599.87
1e3a5eebe07d4ecd92b17dd9d9eb55bb,321,295,26,Europe,22,2718.26
1e3c6b3d144e4fde9d9678797793c945,145,103,42,South America,23,676.9
1e40e657afbc4132a915127fd0de7556,350,301,49,Africa,20,1830.45
1e423cc4af72471ab59cd26f204d7841,365,332,33,Europe,19,1684.77
1e42f0d3207a4acd8d319130614e91ea,233,181,52,Oceania,20,1264.18
1e430c6125ed401f90f5309fe72af5d9,347,293,54,Africa,17,2262.27
1e431afb3d9148ba82d38fb3c3ceb17e,129,92,37,North America,20,1391.12
1e44fe5b79644c9c8162da5178fc4408,52,9,43,Oceania,20,485.75
1e4527593d11488ebda6a9fcae99747a,365,335,30,Oceania,22,1464.51
1e458d5e1a684c14b381087c405bf266,365,348,17,Asia,19,2437.78
1e46f80446b74071bc60db81de182360,270,249,21,North America,20,1518.51
1e48ba78d64b450d906c2536b76ac544,213,183,30,Europe,24,1376.98
1e4a9a3760e54ac29aea37d0afde89c5,177,125,52,South America,13,1050.14
1e4c05a202964941a6ff9f61d235216b,175,149,26,Asia,17,1404.18
1e4dc1c7482b47469fe9e3dfcd3958c7,90,50,40,Asia,20,572.44
1e51ac4ea89f4cd0b131282bd6f13e25,334,277,57,Europe,17,1881.14
1e523fd88f054ea2b6e116c4fbc4474e,318,270,48,Asia,19,1465.01
1e53ae4ab05843cdb78b79b2048e1ced,319,280,39,Africa,22,2179.57
1e53d63e9da645e38d0fa1915cec58b4,196,151,45,Asia,22,1669.56
1e559829fc694d9987a47fe3bc64602c,312,288,24,South America,16,3095.49
1e5636e3f55d4dbaa3f7abf39b55580b,125,71,54,Africa,17,498.92
1e58b5413beb43e28e236014b1bd80f1,70,53,17,Asia,26,376.22
1e5b6417304b40579b070758531dbf57,115,94,21,South America,18,758.57
1e5ca38914c54bf5a681aa649a21224e,135,90,45,Africa,16,591.52
1e5e22aa887a422c8dab6336664713cc,364,334,30,South America,21,2677.59
1e5f30fcc40045cda1f295205b0f6469,159,106,53,North America,23,1025.15
1e5f76de870445fb8a344eaa67b8de3c,168,120,48,Oceania,16,916.54
1e5f88b768fc49a2b0d483a92d40c689,327,277,50,South America,17,1534.96
1e6145f41dc54eb68e729065f680666c,267,234,33,Asia,23,2487.44
1e6196d5eb994017bdcbe4fc7cb2433e,196,147,49,South America,18,1155.44
1e636d1a7bae418981401eb5f4ebde41,365,331,34,North America,23,3447.1
1e66d2e652fb4423a93eaa1901ff95b2,215,177,38,North America,23,1036.75
1e68bf890b69460891959299de0a9fb8,248,224,24,North America,22,1479.52
1e69d6642a0e42f49799cba02c7e50ac,352,307,45,Oceania,20,3106.83
1e6beef20d3c4b9a955ec58f9369d8f3,122,90,32,North America,17,748.61
1e6d39b9e42342de9d6b7eb487a49940,337,298,39,Europe,19,1669.25
1e6e5fd829c34b4482023afd22ff2a59,364,328,36,Africa,20,2816.57
1e7112f5196d46fbac2f5770e2e56697,85,63,22,North America,21,584.16
1e773637b3f5499daea5955993e2d920,195,175,20,Europe,24,1334.71
1e773a1f39444590a83a05e04a3d51b3,155,107,48,Oceania,20,961.24
1e78a29dbf674de8876065b193f92b16,217,185,32,Asia,23,1828.24
1e792aa5121b4ed09463c4a9ea8fc1be,322,269,53,Europe,21,1404.75
1e7a89118db04efdb23c55d260d4e673,197,155,42,Africa,16,597.41
1e7bfd087cb24a86a310b65e74a4438b,85,55,30,Europe,23,386.32
1e7c955ae1ac40928ec2bc035fbaea1c,287,256,31,Europe,13,1678.77
1e7d5ced70f349e2a005997e5848c65c,365,344,21,South America,21,2699.3
1e7eb8ff80864f729c9cfdccd407b7c3,232,196,36,Africa,18,1261.49
1e7ee61fdeb94c0db0d957ec7076028b,313,278,35,Europe,21,2693.36
1e7fa8d1a0bb43ddade81b44772f1aa3,191,157,34,Oceania,21,1356.01
1e808269bd25455696572e246fe204bb,281,226,55,Africa,27,885.76
1e80babb5e9742079cc159846e22ef08,138,97,41,Africa,20,648.74
1e82648e2aef43e689051bbce7c23112,55,8,47,Asia,23,163.96
1e82ab04dc064e8e80290cbc4d956ce9,121,93,28,Europe,23,880.41
1e8504bcb856467e8d77743203f92f2e,47,14,33,Europe,21,196.89
1e851610a66b4d0ea999a5251635c9e5,70,21,49,Asia,21,287.71
1e86698ed4574f3a810ceb342eaccdc8,235,204,31,Europe,19,891.88
1e878118dbb9418cb2685099d86a8182,285,253,32,Asia,23,2453.58
1e880850bae143c0b6f87ca695f804ec,164,145,19,Asia,19,1380.16
1e889d83b9c84b1c894c7d841e9e98b4,359,330,29,Africa,18,3335.57
1e89b3e02deb4e399a11121aa80fc74b,356,322,34,South America,15,2693.59
1e89d90dbf0849c7a8e4ef5970b3f21a,360,346,14,North America,20,2496.15
1e8bc4a7c87f4700925bc9cbed387a63,126,102,24,Europe,21,802.08
1e8c040ce7274e598c7bf4cd362c66c8,320,274,46,South America,17,2242.41
1e94d7cfc0604e83b27dd58ab5f7b7d2,214,173,41,Oceania,23,1027.66
1e952e142aa74139b4e720dfd57c8cc7,32,15,17,South America,22,414.33
1e954a89bb574dce92e4b05cc4e9cb19,365,312,53,Africa,16,2040.19
1e95f3e3a4334db4b6938e15f07a2c05,78,25,53,Africa,22,532.3
1e96f792d596429297d053bb6418050a,171,146,25,Africa,21,998.85
1e97f57e45eb4b7192b3153ab7a55f29,363,355,8,Asia,21,2204.88
1e982a497b79472b857e7c83d77eea7a,57,14,43,Asia,24,118.87
1e9a5a001ee64783a9739194eaacbddc,347,312,35,Europe,22,2691.79
1e9b6e9501944f2089f4fc101da831d2,330,275,55,Europe,21,1788.77
1e9b7ce0611d46d1a900fd6d1c148010,61,7,54,North America,22,306.83
1e9cee764945473a86eb992e0ca8f666,29,3,26,North America,21,318.98
1e9dac85f9164eec8542a81cd8891ea6,358,330,28,South America,16,2954.54
1e9df6703d9d4a7f964d93a960f93f7c,360,319,41,South America,20,1786.56
1e9f058c04a84aaa921f14f49e7a35fd,353,311,42,North America,16,2104.72
1e9f1025b176404c9d7e2ab993d4cd13,327,302,25,Europe,21,2437.85
1ea06e547886404cb56276b1b1a90277,267,216,51,South America,21,1179.69
1ea07d13c95748d9b4b887ad1a3cad92,76,52,24,South America,25,691.31
1ea185cc3bc74fdabf5b0e4961c3c67f,228,184,44,North America,22,1766.12
1ea2026a7f274c2389eabbc127e83757,54,7,47,Africa,23,220.79
1ea230fa119143c3a34c24b9524a2230,299,267,32,Africa,21,1601.79
1ea448ea7e8b4d95a8f3491c944dcd76,93,62,31,Africa,16,911.26
1ea476c839f4468f8bd813b2ca4790e8,232,201,31,Asia,19,1547.44
1ea6d838bdbe481e81a71be54e7af947,251,204,47,Africa,21,1550.45
1ea785b537084f1ab835e3d854a7872e,364,343,21,South America,21,2721.03
1ea790147ea045f39812a6c12991a385,365,327,38,Asia,24,2178.49
1eac07e05fc74acd8f202bc6aeabfc0a,170,123,47,North America,23,916.48
1ead0f518fbd4775a73b51d7a3c910df,286,260,26,Africa,17,2301.5
1eadca1fb8da4544b48e16187eeecb50,72,36,36,North America,19,533.41
1eadf9af1b1f4ad78472dd450e6b8d2d,237,210,27,North America,16,1776.39
1eb0d00eaede4d47b2f159b9f33df23b,127,84,43,Africa,19,517.26
1eb444d1eb7e45b786aa874f3b1cd0dc,363,328,35,Africa,23,1964.95
1eb49cfe3e644892baa775534e070ccc,209,169,40,South America,21,804.34
1eb63ce077634d6f8625bcb7d48ccdc0,219,188,31,Asia,18,1709.87
1eba2e1a1cc046e9a75f4d81fe5af06f,224,177,47,South America,21,1320.51
1ebb0997e698457e8559880d9d36dfda,158,99,59,Oceania,14,581.96
1ebda081219d4a7b869ab676c242c4e4,268,253,15,Oceania,20,3313.12
1ebddfa845a4400abf990841aaae7de2,216,169,47,South America,20,612.72
1ebeac83226546f6987b32b9b1e31b29,95,56,39,Africa,19,807.61
1ebfc3868fdf4d34ba8a53edff7c8009,338,285,53,Europe,19,1951.27
1ec03d90ca5742249c5abf25ea8116a9,164,129,35,South America,20,1126.66
1ec0935920a44ff4af1fb0a3610f3f77,271,239,32,North America,19,1939.58
1ec126a8995a40258dc7afdfe97e8707,73,39,34,North America,13,372.19
1ec1807988f74dc287f4547f4b002cfe,262,233,29,Asia,20,2287.36
1ec1e37b6f814db9a37307c4c22251d0,203,153,50,South America,23,995
1ec301b08a1245739e28dc98e3cb4f08,174,139,35,Africa,17,1367.57
1ec514b75dfe4cf29f574823cd0aaa3b,206,188,18,Oceania,20,1483.9
1ec5c06721c242c895a4f5c5f7364997,186,137,49,Africa,24,1224.31
1ec729eb705c4096879b728aa999572c,244,209,35,Asia,17,1480.74
1ec896d902e34bb68fa1942617dcd202,185,158,27,Oceania,18,1424.37
1eca14fb038d4f718ab8a07eaa441872,351,312,39,Africa,24,2512.1
1ecc1a0241164e47893ae507757f5fa8,153,133,20,Asia,17,1275.37
1ece28a4c17d45eb806b170f427ffb90,304,285,19,Oceania,23,1955
1eced44b8d5c45b895de729820258e25,73,49,24,North America,18,524.23
1ecf1f9457724db7b039d0e0a8b766ce,365,343,22,South America,23,2801.41
1ed235ce287545238bb3112e5f1af7c7,127,71,56,Africa,23,891.83
1ed273be861a49e1b9e11b671061e86d,130,107,23,Oceania,22,929.96
1ed276647e4a4ddfb1c3a47a52d71ea0,85,49,36,North America,19,432.29
1ed278a339724327a5e7f3b332f5a7d2,277,230,47,Asia,22,1219.11
1ed3b687070f4b718e9afb8fcc503fc9,365,354,11,South America,21,2460.54
1ed6933fc42249aeb795c7520207dae3,66,21,45,Asia,21,515.38
1ed97ced96d24935a3036d02bf8b4f93,336,282,54,Asia,22,1347.36
1eda03c537d44f80a3d1e4f537efe10d,153,122,31,Asia,18,1077.02
1edbff6e8a234b7fb7d572963daf2f70,283,242,41,South America,17,1401.75
1edd2aa58211486090344a6c20ff88b2,354,319,35,Oceania,18,2713.9
1ee474953b864738bd49301b8c9d86f5,143,96,47,North America,18,827.43
1ee5042d48e34f078f98dbb852dec87b,252,226,26,Oceania,23,1930.7
1ee5cab63bed461e9bb82230ec730505,306,259,47,Asia,20,1878.54
1ee60036388f4d55b677c873678609b8,242,223,19,South America,20,1883.39
1ee628985d4746d38afe1435f0aafbe6,288,239,49,Asia,19,1471.14
1ee8924e3c9648dda8198354b98e6b30,58,19,39,North America,20,567.06
1eea9c76935a4e659ddf8a93e331f8cc,41,21,20,South America,18,163.35
1eeaa66d63244fc0830f59c4a7191f0b,365,306,59,Asia,14,2058.79
1eeb62a4e1d34110b6ec5c730e39905b,249,193,56,Africa,25,1502.89
1eec0d42e52f4957acab926a8aed70ec,119,81,38,Asia,18,766.87
1eedf918ea3844feb569e5b5c061d4a4,156,120,36,Europe,21,1065.85
1eef46fe4c2b4cc5afee4522e5fea2bb,248,210,38,Europe,25,1042.21
1ef12b0cf20743a2bda1006c235cf795,278,225,53,South America,23,1682.94
1ef15e768bc74b15af35d39d362274d2,162,124,38,North America,19,890.51
1ef739984ab64b75af583f07512ae23f,334,300,34,Europe,19,2233.25
1ef7824b7554428ebd93a2c48debdb70,342,309,33,Africa,19,2827.53
1ef7edf02cbc4fa0a37ac4a1f06fb064,209,189,20,Oceania,18,1146.01
1ef805bd544c49c08982dc9561c21576,70,32,38,Africa,22,276.31
1efaebc59145426ebe5a522fad9284b2,160,113,47,Asia,19,1303.02
1efc79425a4b4bcf9b249f3ff6098cdd,181,141,40,Asia,17,1364.5
1efe6d0303ca4441bc2fb6f3ec49287f,365,344,21,Oceania,26,2366.2
1effd20b5a7544f8b41d58be359e7361,214,194,20,Europe,21,1342.53
1f01d4112d7246f594f4627de83709c3,351,304,47,Europe,17,2139.1
1f0267b6c6a348e18f0e28abb8db9e23,14,1,13,Europe,18,299.6
1f043aa6ab5d49dcb0ad78a10c4e151f,164,117,47,Asia,24,760.46
1f04d7f0bbe048afbb8146a90c85c7da,356,325,31,Africa,22,2698.31
1f07701b746d4ebf91f3ca94f71d1a62,98,44,54,Asia,24,752.76
1f0985281ad241f2ad3536011c6c403c,161,107,54,Europe,20,1132.44
1f0ad53644c34353aa8727845e9d43e9,113,73,40,Asia,20,612.41
1f0c5118472845c7b864cf8e68e56953,365,359,6,North America,20,2914.65
1f0c512a18554a3091db47592ade5a51,325,285,40,Oceania,23,1915.68
1f0cc431ad57453bbdf445df1748d33b,302,251,51,North America,24,1493.54
1f0f2c431e7240ba9be5b34436ac717c,352,324,28,South America,18,2948.23
1f10ca00fbdf4ba792ea2c96128567b6,238,186,52,Asia,18,1532.48
1f12fd20ecb647718422e2229751c228,363,355,8,South America,25,2843.01
1f14d394d2bf4737b723a5372f44b40e,326,282,44,Europe,21,2409.22
1f15225fa6304f7595e38a7c9a6ab114,349,292,57,Oceania,21,1619.6
1f182f035c994a6eaf1c1064a51b871b,184,149,35,South America,18,1158.2
1f183a0e689e40278be4d6d85a2c7c32,160,116,44,North America,23,910.02
1f188886434a4f28a2d612bc799ca999,351,307,44,North America,20,2061.74
1f19764aecd949f89c777aba6e835dd4,34,6,28,Europe,19,52.86
1f199d7eb27c4afea411cab9c5995e71,95,57,38,South America,16,889.54
1f1a06b9a7564d5faa0b24d0e25d463b,46,19,27,Europe,16,333
1f1ec4ebe30544f3ac13dd15d2e6c4cc,40,19,21,Africa,22,346.33
1f20ae8d9ba24374ac2a4b3f50fcb583,317,287,30,South America,21,2855.93
1f268157ddc14bb1ad048dff5524b564,220,166,54,Europe,22,869.91
1f2989def2e44bce9d5b0bf100b3f514,363,349,14,Europe,23,942.56
1f2bcc5ff54046ab9b91a967b250866f,186,155,31,Asia,19,1277.79
1f2bda30af2f4698b6290f9ddda4760f,64,9,55,North America,25,486.4
1f2c39fc5fbb4f2db60c5550ce035b70,343,309,34,Africa,20,3173.98
1f2ce969d84c470b84822ef9875491f0,55,7,48,South America,21,437.94
1f2d6073b5b94e17b16f5b2e4cd97269,217,164,53,Africa,21,933.69
1f2e0afff7354aa8832aee4e47d52bc3,184,165,19,South America,25,1173.26
1f2e15a086014013b6ba2777020747b8,194,152,42,South America,18,1063.48
1f2e33302cde4090918e5b779db80805,272,256,16,Africa,22,1951.99
1f315ca54d084a5da0277d76c29a523b,153,121,32,Africa,22,1350.22
1f31942ca5514d22b2aadeb8573e8057,128,114,14,Africa,14,1144.28
1f32dc4a0dc042269a6487c864829c3d,255,232,23,North America,14,1741.52
1f342ffcae3946e08715faf6dd99c4ff,238,204,34,Europe,19,1708.83
1f347fe2ab1f4eeb811b340bee3898c8,229,199,30,Oceania,20,1553.14
1f353533076743d1b4795ab8cce3c923,26,4,22,Oceania,18,225.42
1f365bd899a74b368a5f90a53e12b53e,246,195,51,South America,22,1460.04
1f3735a940bf416a9a12b173010fba9e,148,104,44,South America,22,490.15
1f374333be4d4c5ba16f0121c7406502,180,146,34,South America,19,930.68
1f3b6b0de0cf4124b645d3740099b8a7,218,170,48,Africa,16,1006.04
1f3d304f40a4400589d139538dbeabf1,95,57,38,Asia,17,308.8
1f3eea96a1f243058367a313bb91519a,206,175,31,Oceania,20,1347.5
1f3f87a70d4d4927b90ea7a352fd0dfd,86,31,55,Asia,16,479.65
1f4003179b2549089a9c23e903f1bca0,233,189,44,North America,13,1124.83
1f421617883b4c3d8b649fadc5776d99,79,38,41,Oceania,18,725.19
1f4378983c1b4185b5ef626770daed36,181,129,52,Africa,23,1513.6
1f449bf23c3b4f2682593c7595feeb48,66,12,54,Asia,20,228.37
1f45257d7b9d41d2af475bcea58da2c6,365,329,36,Africa,22,1267.49
1f457c37acf1471e97fabe16d3551192,304,261,43,Africa,21,2429.99
1f46316f756147fa9686d2c3d12dadf9,122,95,27,North America,25,833.42
1f48821e77e049a6897b84e9245b0054,322,299,23,Europe,25,3470.5
1f48dfbf0e1041918b3aaa46dfec00e5,364,354,10,Africa,18,3122.5
1f4a0b4b6b1d43c19ce506c86313cc52,275,231,44,North America,22,1383.2
1f4a480f5cdf4cf5bcf05d40884179c7,119,68,51,Africa,14,583.62
1f4a86a300794ea2b2d3d4ea973cb924,365,339,26,Europe,16,2888.42
1f4ea0d6f19e4a18992fa3582ca55b7d,315,279,36,Oceania,16,2678.73
1f4eefca811a4e9da2a98af39b4b2e91,204,169,35,Africa,16,1279.26
1f4fc6f166c74c1a8d439d36c61ab671,272,224,48,Oceania,16,1283.18
1f503266687f45fa9800939655ea6945,365,347,18,South America,23,1542.73
1f5041e7864f456e9381857e6df9d3a2,362,319,43,Oceania,21,1814.25
1f53dbf575d24722822362011771f2c7,365,325,40,South America,21,1026.97
1f5667eaf56b48318843d6924b327323,331,291,40,South America,17,1988.44
1f56a9c9b5aa4b84bf72d457a4276e55,356,319,37,Asia,23,2755.99
1f56e7e1d1f0439d96721b97e490a7dc,365,349,16,South America,22,2749.98
1f578770929f474b9a37842ea5c22362,95,47,48,Oceania,17,223.37
1f5a13e7c0b64b8c99ee41f1d5910d26,189,165,24,Europe,19,2153.04
1f5e96cf92a443689d91471b5a0e5265,255,211,44,Oceania,26,1022.02
1f5ec2fe81b54874986b0dc36e18d489,254,237,17,Oceania,25,2221.55
1f5f95b305bb4f5982d971dd340f7905,62,34,28,North America,20,478.69
1f609454a35242e6b85983d2492b18d6,319,285,34,South America,23,1896.34
1f63eef28d464a9280bbd0e61f77d40a,210,161,49,Europe,20,944.38
1f68c26be4c545c7b7eb396765676a30,309,293,16,South America,22,2220.52
1f6b28e9bd0c497397fa6efda42799b9,215,183,32,Europe,22,1758.95
1f6c7a507dbe4c3298a60fa19da203fb,94,44,50,Africa,18,478.94
1f6d082772d346bbadd17e5d8e71f91f,328,270,58,South America,21,1990.19
1f6e03e626da43188213730eb519c9e6,221,178,43,Asia,20,1445.76
1f6e3e3904d643daac5cfac3c8ecb455,365,348,17,South America,21,3269.65
1f6eba0e2d6f48b59110ffc2f957be2a,356,308,48,South America,18,1729.13
1f6fc85f246f4b268db746e351e9d936,297,256,41,Asia,23,2703.93
1f704be68f8743a784d940814a6cbddd,235,197,38,Africa,22,992.35
1f712e3c993f4706adc7e18cc081b981,105,64,41,Asia,23,561.2
1f7155b1656d4e85b454c4df4bbade5f,269,215,54,Europe,19,1283.05
1f7260b50d1043058bbc4e9d847e8fae,307,272,35,Europe,19,2019.59
1f746c87de4d48e0b40a9ed17cbf89d4,258,225,33,Africa,22,2034.62
1f75b02f550c47b38dece34e5af50dc2,264,226,38,South America,21,2089.02
1f77a9651d2947cd874117dc541c75db,222,182,40,Oceania,23,2040.76
1f798824a15c4cc4bc34637f116092d5,63,23,40,Oceania,23,176.6
1f7d5464e14f4d08ac975e329b7686f8,365,328,37,North America,19,1771.13
1f7e66fb4b0346d6af9a325fa0205556,251,210,41,North America,18,1700.78
1f7e9321e85145bf821773841891454a,271,216,55,Asia,18,1369.54
1f7f8b4a7b484020ae726484c6428679,66,44,22,Africa,15,457.38
1f80508c0115461db915bae0e2237a10,327,303,24,South America,21,2134.5
1f80f93306664bf98cf9dee1d53b1c2a,258,227,31,Oceania,22,1608.48
1f832cbb9f2f4142ac8e3ceb71ccf315,135,99,36,Europe,23,953.64
1f84e19469c5416e942116d359226dc5,80,41,39,Oceania,23,881.82
1f8623b818e64e839ab40db02a706221,191,146,45,Oceania,21,1234.68
1f8796584900464a8a050afa00d7a607,132,81,51,Africa,19,800.42
1f8b2f4e8ede45ba997d3b7f2b35f0c2,83,57,26,Europe,21,648.31
1f8e3947457143eaa3d627e7f4f43231,135,111,24,Europe,14,818.01
1f92ce795d2040bb89b8404c5cd2bfab,344,315,29,Oceania,20,2993.31
1f9321627855442ca9b3ae98fe7b6191,105,62,43,Europe,22,587.13
1f94f46890754f40a167895ae0628b25,325,297,28,Asia,22,2262.05
1f9719d5f6f34d43aad64404b0cfcd2c,174,134,40,Asia,21,979.45
1f99ed6e3aec4d03b2318484a266bfc7,257,226,31,South America,19,1501.98
1f9a62faa52b428fa649d77e01eec6c6,52,4,48,Africa,17,236.71
1f9ac26915b5478d9154f09a66678e3e,365,365,0,North America,22,2611.15
1f9c4e3802084f98a49fc971848319df,309,272,37,Europe,18,2069.33
1f9e30e48c7f465cbf3aba7048545ee6,53,19,34,South America,24,517.23
1f9fd41cf04d44eaa58f5e6731296d86,223,162,61,North America,24,815.15
1fa10f24049447609fcc40ea789d7198,36,10,26,Africa,23,198.98
1fa350e6dd584065a6eb7c5a98214550,364,340,24,Asia,17,2420.91
1fa38f63b8214366be8ecedde9d55791,163,132,31,Europe,26,896.86
1fa7ffd053fe428e9571b2fe41ad5ce0,260,225,35,Africa,21,2506.95
1faa151e142e446c92218770ea1ba09c,112,62,50,Oceania,19,953.81
1faa86cf310b49bfbf0f672aeeeda48c,86,68,18,North America,20,490.99
1fab4fca244443b396cde71ce3b38764,106,78,28,Africa,16,571.65
1fae849e79584a52bdc9c95f0797b1ec,70,17,53,Africa,21,406.48
1fafc012e4084147b93acee9ac51b420,185,161,24,North America,21,941.65
1fb0789313074ad9b1a59279324a2b2f,189,163,26,South America,19,1384.56
1fb2fc3427c64091807600f57ea9c8c6,101,57,44,North America,19,548.73
1fb4f0fbcf86424dac60db0d5dfc94af,246,202,44,South America,20,1235.09
1fb5374154644ba3a5b46301e6953c95,365,364,1,Asia,25,1956.99
1fb57c9b938c4c1eb2d2ac7054a8ad25,207,172,35,South America,21,1469.23
1fb8e8b2a2a040a28b820d17a88c9002,218,163,55,Asia,16,805.91
1fbf5411bb94494b9e871e44e49957d4,247,214,33,Asia,17,1255.04
1fc074c1d28840f9b1f473109a315290,147,94,53,Asia,22,766.51
1fc170751d2c4bef8297b42ef60c0b75,362,347,15,Oceania,19,1910.81
1fc1d7076cf04024b0dd1131378c40fd,294,263,31,South America,18,2066.15
1fc688d2ebd74d14bd647fde18fdd16c,82,47,35,Asia,20,614.18
1fc6ecde40d44f618505e1ebcb2e93df,352,311,41,North America,21,2927.85
1fc85a56e7464a7c89e590a446423859,174,134,40,Asia,23,874.45
1fc871b3353d494bb71accd4ce8a6ea4,43,15,28,Europe,19,293.09
1fc8a454ccbf47babd455820cc531a87,206,163,43,Oceania,17,1541.72
1fca6c02b7e74e14a681e5a5492a74eb,78,31,47,Europe,20,312.51
1fcaaa5a46144aa4be342aa1bdffa6ed,91,54,37,Asia,18,290.02
1fccafbdb49743de892d7f23ffea008a,293,243,50,Africa,20,1924.3
1fd08caeb1b8458a87becddb36cbcc4e,319,274,45,Oceania,20,1977
1fd15502ef224844a113f961e3e7ee4b,109,65,44,Europe,24,529.92
1fd4f68f97254833a7350b57ac1332bd,229,183,46,South America,16,1131.65
1fd5958b016f43a285769a2bedbb1c4a,85,34,51,Europe,15,312.93
1fd63e569a7e41bba57e6fc55b4aac1d,363,358,5,Asia,14,2233.77
1fd719c6578e4fc8a7e19f408081c4ce,90,60,30,South America,18,447.14
1fd7aa9494b7460f959d58db543c3a1d,97,45,52,North America,22,533.54
1fd9f6d486da42d9a9051a3b14fc8cb1,335,282,53,North America,20,1666.31
1fda429f2eae48fbb6e6d3c256e14d57,89,62,27,Africa,20,950.79
1fdac5e54f4b47a9a2f0811880c988d6,186,157,29,Europe,24,1618.3
1fdcbe06186d4b00a522720bd8b24cce,227,178,49,North America,23,1388.86
1fdce2ff65904269ade16482a1e49f2b,346,312,34,South America,21,2129.23
1fde4e4102574547b5912fbfeff284c5,364,327,37,South America,19,1580.64
1fdfcb3147f14064a6243b9628ad87de,205,155,50,South America,20,1272.43
1fe0db9f8e894639b227261bce50da6a,21,3,18,North America,19,97.6
1fe2618c13c24f23baccfcb8087dc3cb,307,277,30,South America,21,2398.88
1fe96cbdcc0d43808ce02bd18cbadb85,338,297,41,Africa,19,1599.13
1fecc4519703408390c1770c6e435f64,99,50,49,South America,15,591.2
1fed554019254619b49c3f31644524e3,341,319,22,South America,20,2275.22
1fedcc73825d440b9cbc632cbe4349d1,143,89,54,Africa,21,858.08
1fee30fa1c494b41b865af6ef990e90a,121,100,21,Africa,17,945.25
1fee698a60334ba2b17d59ee862d8885,223,176,47,North America,24,1170.66
1fef37ae8be64cd6a1f16fcd180aaa6e,325,295,30,South America,17,2319.08
1ff217f3e3cc44a3b16d73863101a8be,365,339,26,Europe,19,1460.65
1ff2569cb49a4993a2c02a58aef942f5,76,27,49,Africa,23,579.14
1ff75259d8e94cf19515303f4fa375f4,362,332,30,South America,14,2960.37
1ff77072df044bd8a41f01eb79066107,275,230,45,Asia,17,1818.28
1ff7a86e75db4b9798f71c4abf4c16b4,312,263,49,North America,14,1701.81
1ff7fb0b41b24b23a6b07ca6b1a9f41f,190,145,45,North America,23,1266.85
1ffad5ed32d445399e7d9be6e0aedfaa,105,82,23,South America,17,1110.71
1ffbf1cb3d1145d6af2f4864f02f7667,301,278,23,South America,18,1855.56
1ffef3ea26444bdeadcaad3e9186d6dc,117,81,36,Europe,18,893.8
2000003cee6e4e3abb4e24d3613211fa,134,94,40,North America,22,759.57
20005d0a441048b8bf5fbfd39e959399,282,260,22,South America,20,2836.92
20006ea23c1d43ea9918e34e41115bcb,35,15,20,Europe,17,248.74
2002bccae8464e298afb88b5fd8d05d5,55,6,49,Oceania,20,581.11
20031088f7ac4973b242bd0d8b494a91,349,325,24,South America,20,2933.45
2003e51345dc4d0fb6e3644af0a4f67a,365,360,5,North America,23,2527.68
20042108616f4d8fae85e1d0deb94ae0,365,360,5,Asia,26,1773.64
2005a60b2de04e448fbb2f92e295f633,274,241,33,North America,23,1746.67
200633dad88f421d8d2c652881cdb530,42,3,39,South America,23,204.44
20070e5e892849e39c864c79f5f3fc1a,72,24,48,Europe,21,440.72
20077aa9d60348dd84ce824a70643133,220,178,42,South America,18,1663.79
20095c39eacd4683b0863c413377b1a9,353,306,47,South America,23,1843.12
200b1305885047679ab8523351c14479,86,29,57,Africa,24,266.6
200ba01901e64c5ab687550e3693b6e9,176,156,20,Africa,22,1570.21
200baf8cd60d4527835c11351a07c85d,167,128,39,South America,20,1242.53
200ce4b145ef4f79bdebfc060969dac4,48,19,29,Africa,23,85.68
2010e66d39654ba1ab725b9b4bf886e6,240,217,23,Asia,17,1896.79
2014bdfafd0748f486cab0b3eaac9425,263,224,39,Oceania,19,1848.31
2014e6d9c5e747128214c9f943faa16b,232,185,47,Europe,22,1148.23
2014e700fd6649e19eb989f7fecd62e8,27,10,17,North America,20,414.88
201519c6fa7c4b03a206fabfdd6407dc,250,214,36,Europe,16,1686.03
2017e64ab50843eebbab976ee52045a9,222,181,41,North America,16,1507.25
20189c08f9a743ed8a9c5beb5d48db7b,335,315,20,Asia,19,2591.61
2018a6b8934c4ad0be88b26fe6dea6c7,238,208,30,Oceania,26,1564.72
2019e0d31dd649849065c1c644ebd575,247,203,44,Africa,19,1159.99
201a1fd0d2374109806ed265d49326c4,285,231,54,South America,21,1190.75
201aebf8a7b04e9aa16912a0e6659173,34,10,24,Africa,13,376.89
201b3150928b482eb1153de4970d3460,365,361,4,Asia,23,1431.68
201b5910935e4d6298ffce1cb62d2eac,111,63,48,Asia,20,471.52
201c103625aa47eca2d563331595c06d,68,16,52,Africa,24,361.75
201c123c30634a768655f2025f93fccf,154,116,38,North America,20,1226.64
201c39067f15452ba8693e03600a3738,52,32,20,North America,17,429.95
201c8017de2f4a28815e3693f898cd8d,364,319,45,Oceania,21,1694.82
201e2e69b4ca44ce8f44a66f05842784,363,343,20,North America,20,2191.24
201ee60a82e4495997f3058d797fdae2,233,208,25,South America,23,2068.98
20204c52a6164137af95fe88f07dc560,270,247,23,Europe,22,1849.16
2020fce0964f488a85c542ad4776fd39,358,306,52,Oceania,22,2410.11
20210e909f8848e1b6985fc969e60f02,365,338,27,Europe,19,2623.34
2024529d9c1949fdb7317b150992be91,181,146,35,Asia,20,1345.4
202584e3e41d45fb91117baed052196f,29,2,27,Oceania,20,270.46
202787f49452476eac055a0b426840ba,342,315,27,Africa,26,2634.92
2029276357874bbf8b3d088bab803d57,189,164,25,North America,21,1438.43
202c496f31284ff587e667862a998cb8,246,229,17,Europe,20,1813.41
202f5439ca854cee9c8182c4259789d1,183,161,22,North America,26,1483.29
202f851fe7d24201b0e78ffc144e697c,90,59,31,Europe,19,607.24
2030a9b4c5a64711a94a7d0a947c551a,155,134,21,Oceania,21,1695.15
2031523b5fc94e1bb3650d82f98a3c60,364,353,11,Oceania,19,3103.61
2032b6edae544b08b20547ee284169f8,217,190,27,Oceania,24,1580.14
20339f121c9340189f2b5d0e8266f2a1,173,147,26,Asia,22,1128.71
20344e3d329b430089be99057d69c748,109,76,33,South America,19,747.08
203594bdbe344f5d8e1d1bfb36d6b0ee,245,207,38,Europe,22,2511.39
2036bebdd54c4edebd41b33a6f44d7da,344,307,37,Asia,19,2838.52
20381d85dfbe400c98a3d833da224ddd,278,248,30,Europe,18,1907.45
20387959fcbc47989582a1953521d131,365,335,30,North America,22,2266.66
2038a47d323343fa9a56942b7d3b1aaa,278,227,51,Oceania,19,1534.37
203ba5c4210140169bd8dfbbb494f8f6,361,355,6,South America,23,2369.23
203cf54488c34da4992639db5683a1ce,311,285,26,Europe,22,1985.11
203d3782fd654e57a33adc5c97a9c622,184,136,48,Europe,21,1164.26
203e3561ca854571bccd829a39ba6acd,53,17,36,Asia,21,182.23
203f0c458f424bcb86dc4eb1ace26f4a,112,73,39,Europe,18,639.16
203fc60a2b664896be39bbc9b6d5bf0f,157,119,38,Africa,24,1663.8
204198ce249746138769370088702190,168,136,32,Oceania,21,1171.8
20427788142c425fba1760af14a5e2f2,264,236,28,Africa,18,1687.18
2043f946ee4647249502999fe296cac8,365,348,17,Africa,22,2760.29
20468877e3fa41d79be1d08b8e60d91a,186,139,47,Europe,16,874.45
2046b641e82a44afb6e351b5d035a870,228,200,28,Oceania,20,1450.42
2047a805475d4a2283ca8d4980ef4ad9,363,360,3,South America,19,2500.7
2049a625db034734a2698f1457b910bc,158,96,62,Oceania,22,798.54
204a726c3efd4fe58c4fb0072d3aa3c4,365,318,47,South America,14,2053.89
204a77bdd1ff4edd9fc37ec132efb2fe,100,62,38,North America,19,661.3
204adfd5722648b4a2ea8544467102dd,205,157,48,North America,19,617.44
204b466b68df40059e40f9141544471e,341,309,32,Europe,17,3449.91
204bfeda566845eca54759294fa4a547,247,200,47,North America,23,847.53
204d840f9c624697b296021905486308,131,80,51,South America,15,642.38
2050ae52661e4e92a540e4be0282ca25,365,330,35,South America,24,2421.99
2051438159bc43fb908f813b12468ab4,151,109,42,Asia,24,890.22
20514a3140984b298671239da20edf61,350,321,29,Africa,19,2387.37
205458ad324b46c8acbca21b7920cf6f,228,180,48,North America,16,795.06
20549de6ccf14301a4e6767479dee349,181,151,30,Europe,16,1319.4
2054b1ce486246a1b411a6872b82e528,365,349,16,Africa,20,3100.76
2055ce4af56c4fd88218e2fbe059cae5,55,18,37,Europe,24,402.29
205655bf4e32475589f8d733b3f50ca6,365,336,29,Asia,19,2327.95
20581553a7d544a4b91e2a79be0aca74,315,290,25,Europe,22,1852.16
2058a3d000bd420aa92f41432fc97ef8,166,112,54,North America,21,1185.5
205b9f412eea4ef3babd7c7541d28c15,137,106,31,North America,13,727.04
205de478460146fb8cb65bb7451ef5cf,239,201,38,South America,19,1818.24
2060badcf3c542a290bbdab06ce27685,342,315,27,Oceania,21,1913.9
2061fbd878d145c2999d41f456d851a6,337,301,36,South America,21,2102.23
2062893a2f084521a56bb42858e2af6a,363,351,12,Africa,18,2610.08
2063d5767f7c467c930b9b43de0724d5,90,42,48,Asia,21,1040.48
20640bca08ad45d59092a0617752aa36,171,138,33,Oceania,20,1302.9
206412ffd5b64935a8abe2cd849b82e2,264,222,42,Oceania,19,1775.88
2065fabedad74521bcf91873877a8b2a,294,265,29,North America,14,1954.49
20672a70cf954e9bb273e1242eac9790,195,153,42,South America,24,875.93
206be1b1c8c44205a1dc4824d7d890b9,258,210,48,Oceania,20,1260.42
206ddd2623ff4f708f3b6bd86c58426a,136,106,30,North America,26,1193.35
206e95f6e79741beaca02389a9b224c3,232,206,26,South America,22,1454.65
207070a2d9114731aa77b9db0d2336ac,255,231,24,Europe,20,2097.92
2071dbfe7c25447ab08b3c852799b02e,332,299,33,South America,18,1540.92
2072882d5ca64569aad6ebd38cad1a1f,282,249,33,Asia,18,1503.46
2076145635cd45a3a2296daa7f4ea6eb,61,30,31,North America,20,819.81
20764877799c42d0bd3d1cb287325cee,254,212,42,South America,18,1879.92
207661cec3984736957e9b13a2ba74c7,141,117,24,North America,20,874.19
2077b245d5cf4d04b0b882f0602e4b99,146,123,23,Asia,27,821.72
207993cac578446faa1e689af289ae78,279,223,56,Africa,22,851.71
207af9ee7bb74f29a7b92e30ad1228bf,126,72,54,North America,22,399.56
207b8e019173434f81cb19208e791f3f,365,363,2,Europe,19,2419.23
207d7299d6314c198b916d25f44284ec,110,97,13,Asia,21,632.31
2081ac68f41541a3ba2f726a3216d8a0,146,117,29,Asia,21,1248.31
2083030faac945c295985930d97abf58,274,245,29,Europe,19,2327.28
20856f8130164fb8a709a2e994f32673,265,241,24,Asia,18,1528.36
2086554f65884202b1e5afa3a6c1f93a,322,297,25,South America,22,2729.78
20885d15c1504d8f95fa53d17c671126,281,225,56,Europe,25,1838.73
20895ba6d62742709124c04bf4c6260d,104,79,25,Asia,22,866.13
20897c9522db476abd99e66b7f444fa4,224,204,20,North America,21,1701.28
208a95e55b5149eba68eea2b54bc0d0a,306,258,48,South America,20,1616.21
208d6fe89d5749fc843baf7253c0785c,205,163,42,North America,23,1137.14
208ee21b6a284ef1bae07160e58a7f02,301,261,40,Europe,18,2915.68
208f320621344b7fa9656af779f8ca0a,76,50,26,Europe,21,872.87
208f6734f561444d8eed68daa5656859,363,326,37,Africa,24,1893.55
209055c6967346029f190fe7a92b0374,209,163,46,Africa,21,1020.65
2094ad7b581d4b85b56100ae09df2fe2,321,275,46,Europe,18,1640.84
2094b2c44aeb4158bd9eff26fb83e7b7,233,189,44,Oceania,24,1383.04
2094f4dcefb344839234618b91aae1eb,271,236,35,Europe,24,1732.96
209574e39a5846ed9c53852a885b497b,183,144,39,Oceania,17,956.97
2096871ab64a44c8bc3e6d756bf51038,133,84,49,Asia,23,569.66
2096aa7ffd384e06813a5b550cba7600,365,344,21,North America,18,1649.33
209832687d9e4062af4806d9afd99839,255,208,47,Europe,22,1207.09
2099795f18724852af078e7db65ccb07,139,102,37,Europe,21,1000.04
20999c80f42d406a88fd17084cb75d6b,117,99,18,North America,22,822.43
209bd58c78d5446a8aa95f24e50b6ce4,127,102,25,North America,22,1147.69
20a0b6d508cc448caf64bd748f9d027b,223,183,40,South America,19,1396.06
20a0bafc0d3e40d99b1b0cd868250b54,331,280,51,Oceania,20,1526.51
20a5bfcf336549228595c958e3882867,350,329,21,Africa,18,2697.71
20a8466d6d5c470a81ee41d4f6ec5664,365,365,0,South America,18,2403.6
20a9eb41350a4ac5bbf5e5b614abcac9,351,326,25,Oceania,21,3333.54
20aa3f5c418d440498a3defbed9c4004,202,177,25,Oceania,16,1531.43
20aad29201a640a08e0795d8174fcd8e,96,44,52,Oceania,21,294.73
20ad047ca36442948b6a0bfca024c4db,128,95,33,North America,17,925.48
20aea75f8eac41df9de9db19a9c3e897,166,143,23,Europe,18,1434.22
20b04a6e332b4a6993cd1bfab3ef7d28,233,198,35,North America,18,1060.92
20b05c0bc8dd4fefbc4fd18304910851,365,356,9,North America,20,2818.4
20b13d69008e4ecaa6b194b66d022d3f,50,28,22,Oceania,14,309.28
20b2008eb6b948e79ece70fbe31b0956,365,325,40,South America,22,2632.55
20b2771da38a494093ce8a4cbbe8e623,244,210,34,North America,24,2137.82
20b4373361b545ea81cfeced498c7a4e,252,204,48,North America,24,1633.9
20b5cf3bbd144243b36e3f3724b0dd34,66,33,33,Europe,25,329.99
20b70207395c4eb88258b4a0b894454b,365,336,29,Oceania,19,2253.57
20b7975df8704190b230d0418df27244,211,189,22,Oceania,21,1550.72
20b79e1b94cc43a084b5a73330cbb171,62,37,25,North America,18,521.07
20bb18d8ed8c4e77be9055bd8bbceaa7,305,274,31,North America,19,2810.35
20bdcd4f527344cfb56dc9c2ed3227cd,161,113,48,Asia,17,925.18
20bfb5e6e4f741888aa5c1bb35a47f30,289,247,42,South America,25,1895.85
20c1db210aaa4ff6815fbc41092ca811,127,105,22,Europe,14,752.25
20c5787626c74bc09b952e5748b8073c,179,162,17,South America,22,1356.23
20c5c6c4443c4ffbaa089632007e5203,53,16,37,Asia,21,332.59
20c8d30f370c4d68bdcd2e28eb0a9348,321,291,30,Oceania,25,2180.38
20ca2164e7dd48f69ef713d3e9b523a7,340,307,33,North America,21,2307.84
20cc6c080044468cb79b4d59eb92b0de,365,312,53,Oceania,20,1708.76
20ce4411662c4c38a4d061da4149f028,146,126,20,Oceania,23,861.17
20d00491108843e8b3f5af453dd2e614,284,236,48,South America,23,1099.67
20d08b0e85c94c3ea77cd5f661e2118c,214,172,42,Asia,20,1412.35
20d0d8cf9ba44e6eaa70800740223f2c,286,249,37,Asia,18,1692.65
20d10d98f79440de986f0e0eba0f28f5,203,176,27,Asia,18,1584.61
20d1b8c7df1c41548c86b38bfb50fbe5,225,177,48,Asia,20,798.69
20d31dd5e9bf4573bb8fa76c96e6cd1b,337,309,28,Europe,22,3722.95
20d3986c75f042f9b2810f3d5330970f,122,96,26,Asia,20,810.04
20d4536260d8492bb7cdb9d749936b18,222,182,40,North America,25,1509.34
20d6a42bc5ce484e8f53587a9a708995,198,170,28,Africa,19,1313.32
20d7223cb48a4936b7fa21d727d34b19,277,236,41,South America,17,2011.34
20d944ef692d4f9eab5d624cec29967e,72,13,59,South America,21,364.65
20dbd9e2abec4f7ab9590567aa3d418f,362,307,55,South America,17,1858.22
20dc65922949466f9afd95b604c07e2a,288,227,61,Europe,16,1352.17
20dda2cc6cb84b3cba68acfebd2bafa7,138,85,53,Asia,19,494.91
20e53e84b837447ea1ff51998f2dceca,111,79,32,North America,18,711.2
20e617794e934a3cb43a79d4f6afb9e6,101,61,40,Africa,18,770.95
20e67d7fb8294479b242d90014a2994b,229,188,41,Oceania,18,1551.6
20e699e46266495bb564ad1d64bb2428,281,240,41,South America,20,2063.94
20e7c7d9a5bc480aa43cf5ae07688e71,204,162,42,South America,24,846.64
20e9a60e7803454cb804af52cd3c6463,271,241,30,North America,18,2209.19
20ea6b9593b3483c8b57811d4e9c890b,61,17,44,Europe,24,274.12
20ed58df086043a8a4b91c363c836da3,358,344,14,South America,17,2004.98
20ef6244032545f1b0f80631ac5b10a8,115,68,47,Africa,22,450.68
20ef6855999f441296096b1019d287a2,128,111,17,Europe,17,1017.42
20f3ea96cf724f28aa3356d8152ddd82,364,334,30,North America,18,1703.8
20f4d4646ebf4fc7833f1d331beb4f00,319,293,26,North America,20,2340.98
20f51389788c4bf2a6e29d8b03b12fe2,365,340,25,North America,22,2844.99
20f57c2675c14e7da349921f08604132,153,124,29,South America,24,1220.33
20f7dd9e1fd14eb9a4f68ce465aae100,125,94,31,North America,21,1044.22
20f7de47dcbe4669b2b57fb1fb1bef6e,364,348,16,Oceania,22,2461.64
20f7f67576b543e7986bf02e3908d693,97,51,46,South America,23,610.55
20fa111681af4dfdad998ee087635a95,280,256,24,Europe,19,1989.97
20fa9ee2273d4bfb92155f29a026fd37,190,170,20,Oceania,14,1100.86
20fbd603ffb94a5d988f16274137ce21,137,90,47,Africa,25,1073.9
20fbf77cfdb044a187d96ca89800cc16,117,78,39,North America,23,397.38
20fc63d526724596bf42e81691fa60e7,365,363,2,Africa,20,2262.12
20fdc9c683414d7589846f46927fc2a7,80,61,19,Africa,18,399.92
20fe1ae487224271b2a9aaae7dedecd5,248,216,32,North America,16,1911.74
2102436a83d847659779313c799bc871,189,137,52,North America,17,968.03
21040e225b554655bc922f197a4f40b2,363,358,5,Oceania,19,2043.22
2106577cf3c74cf8b58fd3d759e542fa,215,153,62,Oceania,16,950.54
21065efea0584d988fe7a9e0823c0c00,303,273,30,South America,22,2790.75
2107f9999285467e8ed8517f143e4a05,365,353,12,Europe,22,2892.98
210a0ec33b6d4e7e903fc10fa9ae2899,174,133,41,Asia,14,1205.2
210ae9abb3994af0a9ddf5d4d730c5f8,239,206,33,Asia,25,1556.24
210d1cd2a2ec4d6d85a3ad0b0c2971dc,113,67,46,Africa,20,552.44
210efc0e0bbc4f1e8bbc5ebfe8fe9844,361,340,21,Europe,23,2814.27
210fb77d7d7b4c3eb96abb242069e875,31,2,29,Oceania,22,343.32
210fc049c4394feb9e9ab46095e4d15c,242,212,30,North America,17,1374.75
2110c7cc944c4aba83d1481b63de6efa,215,189,26,Oceania,21,904.6
2110e56c94774567ac92e77bb33056f5,96,40,56,Europe,20,648.4
2111a4df3e214ba1814db8840966f076,316,272,44,Asia,16,2289.8
21131a2981dc4bcb9569c4135e25de5b,365,353,12,Asia,20,2271.69
2113842549094cf587d6c991a852f2cc,184,158,26,Oceania,19,1049.37
211420342df74fac99a6faed09da3741,135,85,50,North America,19,968.48
2115269b03724821bd1dc253594678c2,364,348,16,Africa,21,2186.77
2115a6584da94363abb5e0b6b3302d99,301,267,34,Oceania,22,2044.46
21165e46f3a041dabec10df75fa7eccc,81,57,24,South America,18,1059.1
2116619b3ca7426a8a96148c57462d72,276,231,45,Africa,19,2149.24
2116a7c9d5f345dc8f724574e083ab68,107,54,53,Oceania,21,691.91
2117eba3b6d94fe78dd4ccc3fb1a5888,365,332,33,Asia,22,2975.89
211d7452736c4f2f854ccc5b7138ae64,97,54,43,Africa,19,506.97
212017a6b3b24137877e367458fbb448,301,261,40,Europe,22,2124.08
2122b3beb383494eaef84a3f2ad5dfb6,176,153,23,Africa,18,1730.92
21232ba6f1aa4494aaf54ad4ef3fbd06,208,154,54,Europe,21,540.27
2123796639204031bb98a5afc29fd882,165,136,29,Asia,17,1123.74
21273ad7e4af4d38ae313aa2e1e47206,346,317,29,Europe,18,3529.8
212769c4efa44446aee8a807d56c798a,96,68,28,Oceania,17,549.17
2128c25a117741ea9c80c811a8554dcc,330,289,41,South America,24,2440.94
212a30c4595146d78bdf875595cfc91b,306,251,55,Europe,24,1485.26
212b8464821345e994be73b57a9dd363,201,147,54,South America,20,1032.88
212e83dadb6843e5b9258b50f4c03e1c,60,39,21,South America,19,424.74
21302b59bffc44e3968406a5869235f7,251,204,47,Asia,18,1278.79
21328191c5e742109f706cea86b09c29,153,116,37,Asia,24,943.43
2136cf3206524148a5b0c90f4cd3902a,109,74,35,Asia,19,739.52
21376b4177964f2a8a9ee0c2f8bbef4a,348,321,27,Oceania,16,2775.49
213e0e71d9b64986a2430c63f8e25e94,229,195,34,Oceania,22,1782
213e400286164e05b72e43984dd24ffe,269,219,50,North America,19,1760.93
213ef9d2d86b457a9a4fd7a2c7e5ba54,343,312,31,South America,22,2060.14
213f07cb56ce40dbbce9175c60fb702a,43,16,27,Asia,25,219.03
2141e246f3ed4e01b5ff4c088a657543,157,129,28,Europe,19,1549.98
2142e597b28b4af6b29ed7f09df39a91,91,53,38,Europe,20,598.38
2148b1c444fa498796f3b195fa03bf80,289,262,27,Africa,20,2686.5
214cd48c26bc4ac3aeb1b84e68972252,215,171,44,North America,19,1537.3
214ea4e8c0a74dc893ab32dc323f4aa3,181,148,33,Europe,19,1313.16
214f1ab0d876431a9fd7e2a04a012dec,304,252,52,North America,11,1952.74
2150032be9f64d22bde95e902e2c89dc,365,329,36,Oceania,26,2146.56
21511b4349764e98aede9e64162e2ac2,273,243,30,Asia,21,1664.18
215266c7ad9e4ca495ba9dbc129d5600,364,358,6,Asia,20,1530.5
21543c9d945141d79bd12853ad275c38,62,6,56,North America,18,223.98
2155a83f755e423ebbaf075416270935,245,210,35,South America,19,1668.66
21582af7db5e41e0b6efe70288bec6c2,189,145,44,South America,24,698.23
21588d0785304aec8b118fc4a4b19f45,364,333,31,Oceania,22,2003.86
215924a669c24583a89c719672176b3f,273,237,36,Oceania,23,1278.02
215a648c452f4d5c8a3172deee312d66,109,70,39,Oceania,22,701.34
215acbe2da604e8db129b83e3cc9b96e,365,365,0,Asia,14,2399
215c1738f03248968697bc9221941505,171,116,55,Africa,24,1049.53
215c6a272a724fd98082ad6adad3f56c,178,151,27,Europe,19,734.47
216123210a88474ca9dbd29fcf7bf7f8,102,61,41,Europe,24,292.02
216146bc5e164b8db597cf4b6909ffb3,309,267,42,Europe,20,2544.02
21620ffae49f45ff9f166284ee958096,117,68,49,Asia,20,633.66
21626c832da24b2782ab4ec3b244d815,111,57,54,North America,24,661.75
21628c062a874909aa68c0de508adf1a,344,327,17,Africa,18,3439.11
216441bf3224416aa24174227e11019a,78,34,44,South America,23,529.12
216727fd5afd47e0a852fab72bd71905,232,183,49,North America,19,928.43
21678d12094a4e488f113d7ce8d3c58f,365,351,14,Asia,19,1627.93
216a53373abb40f68b2e24e6cd7a075a,201,156,45,Europe,20,1331.99
216a6b282fe94f72bcaa62403f2b1a11,340,304,36,Oceania,21,1875.91
216a8f6837144e77956aa11963a39ca2,76,46,30,North America,21,547.28
216c4a658c32431e83c05d558257ea70,71,51,20,Europe,22,695.62
216d033abb2743f28d0240bf9d006771,118,76,42,Oceania,18,490.92
216ef0d326bc43e1be8f55d3f9fc2f0f,261,214,47,Africa,23,1334.1
216efc014e8b4a4c94f7f1ee2ea5c997,235,182,53,Asia,23,967.06
216f4a4974dc46a19b6bad428b8f05cd,32,5,27,North America,21,274.26
2170d3c77a334f5096f5fe0ac8528114,81,47,34,Africa,23,570.11
217250c9ad44445caa1389e914809dec,335,295,40,Oceania,22,1931.14
2173dd57e20e4a8592ca0fe7ac00423e,110,90,20,South America,17,1095.68
2174afa003e241acadd45b0ed13430b0,227,177,50,South America,22,766.56
217865f9633f445f8fef0f7719d3f2b9,89,65,24,South America,18,517.46
217be8245e6d4587a023ddb8fb7a2e3a,152,106,46,Europe,18,507.75
217c2375b45d46a4b1b2757b6ada3534,220,188,32,Asia,21,1363.01
217ee72400c348d2a61c449a278319c1,93,41,52,North America,18,769.4
21816e1ee77c4682ba80dd65ba350427,214,194,20,Africa,19,1100.07
2182b3107e56431dbf0ee03f93cb4484,280,265,15,Oceania,23,2460.83
21836104a0f54f148a806da560ab6ccb,189,138,51,Africa,20,980.52
2184442067f447eab4e4e702994a4349,28,2,26,Africa,20,442.91
2184e04c8a6040a28757d01ecaa9dd77,319,277,42,North America,22,1812.6
2188bc88195e45f18f6d72530b914acf,275,239,36,North America,19,1587.04
218bed345a19477c8b651c46b8fe1c63,365,362,3,Asia,16,3195.76
218cb46061134785853b8662049bdeb3,365,361,4,South America,21,2607.98
218d7a2be90f469caa72ae13ca772aa3,308,271,37,Africa,17,1903.62
219051e30fe2417ca5ea451c0c128a09,317,281,36,South America,23,1951.55
21911f10554647f49e0e8a11416fba46,65,12,53,Oceania,20,368.09
2193dc86c7fc4cbb87c82e864526b851,80,40,40,South America,18,544.9
2198c49bffe84ccf8133919c334979e2,364,342,22,Europe,25,1829.08
2198e3fff4b540a5969e47feed695cc5,134,97,37,Oceania,22,1034.24
21990de7d8bb42fba36c032545af7e79,184,169,15,South America,19,1276.54
219a8e8a9f134db797bdc53513bc5792,91,74,17,Africa,23,984.66
219da57dd6ee4705b7d92e9de266e312,280,249,31,Asia,24,2482.7
219f54b3956e41a1b8404b96c9b70be8,191,146,45,South America,21,1272.86
219ff093a0964e5381b3ddbcc7197ca3,196,145,51,North America,19,1174
21a05e95c6f14adf800063a3a80147c1,55,3,52,North America,17,322.7
21a08b9bd2a547eb898df81c4464a6a1,90,61,29,South America,19,1095.83
21a0988bfe7642f3af6f13e906640e21,55,27,28,Oceania,19,524.45
21a0dd64be0e4393a4cf705549bb1012,171,130,41,Africa,20,1206.88
21a3ca9a86c048b1bd0de195f919e81b,116,68,48,South America,16,592.41
21a3f2a7a1184fa29f6e18e1adf18efc,364,347,17,Africa,18,2748.67
21a5843dd9cd4fc083403a06bf7b4803,309,285,24,Africa,17,2225.75
21a712fcb2954da78ade3461406f8c1f,281,243,38,South America,22,1819.62
21a7a552006b426f8422c182a8afd69f,99,64,35,Asia,21,389.12
21a9ad7d1da24a1395050c34af9f3410,48,4,44,Europe,23,429.43
21a9da36cb6141d9ac70311618ffa6da,316,274,42,North America,20,2228.85
21aaab4266a54cfebcda965db646fb87,115,79,36,South America,23,949.47
21ac4e2193c640129e0f728c823da0b2,363,363,0,Oceania,21,2546.14
21ad0508066d4d25ab61b723077633d2,268,219,49,Africa,19,1387.91
21ad5bb61eca44a9a627fd61a3de9c1f,187,161,26,South America,24,1554.1
21b0c7fe7a374f69a5822b3dacdb2cd6,365,313,52,Africa,21,1902.86
21b15e7aa02e41da87c52c43801c1182,361,332,29,Europe,19,3409.99
21b16844b8004d1c8648552ce45a508d,163,132,31,Asia,21,1066.12
21b33df7b1114778900cdfc82291b1b2,157,129,28,South America,13,1066.79
21bb5b0c1b954cb8a7c2c0cb1733c2fa,175,120,55,North America,18,781.68
21bd52d7d0ad4566988ee438b0bb8148,364,330,34,Asia,15,1937.02
21bd6ba178754b51964e325c7fca64b5,65,42,23,Africa,18,857.29
21bdd5a283374eabae736cb7f8e49398,295,257,38,Europe,22,2018.83
21c14a0a62e84f099f5ef333f2a2047d,285,250,35,Europe,21,1642.56
21c906d2238c4517bcdb5a42937856d7,299,260,39,Asia,24,1706.09
21cb21e846d84c4cbbd07a092c7f38c7,144,96,48,Asia,20,1009.98
21cc595cdb2a4bd78c31290746d32020,259,219,40,South America,19,1461.64
21ccc85a72b04011bafa3b370a58512c,177,129,48,Africa,22,1248.9
21d16e38a9e041d28cb45d13be5cc7f9,234,189,45,Europe,19,1039.14
21d9fe21667a49699d2831c715d44a4f,340,304,36,Oceania,19,1991.78
21db1a075a514c99ae6c85ffd5fc2a63,209,170,39,Europe,23,1711.49
21dcd791c848475da798860af0e9f3e2,257,232,25,Africa,19,2226.2
21de6919ba114ba1a081b85f49a0436c,163,128,35,Europe,20,875.02
21ded407061045209ea112151798e8bf,126,82,44,Africa,27,486.48
21df8c63000648c883e6d2ffe2f57363,365,335,30,Asia,18,2094.94
21e120f4eca54685ae7853a227438c24,227,192,35,North America,22,1377.43
21e2c778224843a08f955a2ce45a06db,52,2,50,South America,21,292.61
21e4f878bb114e738b8cada3955927cd,363,337,26,Oceania,22,3016.41
21e50bb5a258486a8adb34b70e0fe1b7,78,31,47,Oceania,16,594.89
21e7148cac0e412c9926b9479d5a121d,52,15,37,Oceania,22,457.16
21e726e497474a42b77e9235577074a7,117,96,21,Asia,19,864.31
21ec159cfdb249948dbbe7618fb3faba,271,252,19,Asia,24,2136.05
21f0eed1b8db47759d4e67834575e563,365,331,34,Europe,19,2247.03
21f1acaac9e443cbb2cce8ea47a1c45a,292,255,37,Africa,23,1840.4
21f3c33b0d4c4e039def1979d8202807,262,218,44,Asia,22,1400.94
21f4b9d305444d068e147ca6e716ff92,155,126,29,Oceania,24,1249.99
21f4f21b007e4eb9b52d28dbf4564631,189,166,23,Asia,19,1204.22
21f7e342615c46559aa1d389df6ae608,176,136,40,Africa,19,1142.75
21fac6d49a5449eca2e046c6a2faab2d,193,161,32,Oceania,23,1531.3
21fcf8ef978b4420a8f2acb51cd4abe6,141,110,31,Asia,22,1055.82
21fdfb13e88f4070b4b9145d7b50b0c6,192,155,37,North America,23,1459.69
21fe0a9654cb4b27ac954cc3c50431bb,211,176,35,South America,18,1701.95
21ff5eecdf074c54b99a2133a5558420,36,11,25,Asia,28,543.52
2205b07978c94017bff043f943ff7d24,172,138,34,North America,15,1080.1
2205cfead2d84f37954d756fb6dd98fd,99,80,19,Europe,21,1079
2205fcd2238a40439f4a94cd21a4a910,217,184,33,Oceania,24,1058.44
22091e559acf4bd2be89ba5d1dae7039,39,1,38,South America,20,180.4
220a5465f6b1404f966f4e24b0225b11,78,47,31,Oceania,25,437.58
220a9b02c4c94319bfd72167a7e500bb,272,235,37,Europe,21,2439.37
220ad75f03344be6845ab6582a81c260,239,207,32,Oceania,18,2027.87
220c8c02192243bd899c5c82682b0991,364,338,26,Europe,30,1560.04
220db42c3a3140788a853f47b05d021d,266,224,42,Oceania,21,2284.43
221400bcb6be4fc68be611fe14e82f4a,234,178,56,Oceania,19,1231.16
2214a8e871e04acb8abe1cc54e17e8e5,255,209,46,Europe,22,1365.78
2218262117134a75ba100ae0ab316b22,67,12,55,North America,21,355.12
22198c97e3c44723b1730d7c3f236879,362,343,19,Asia,16,1634.06
221c7d046d9241c4898a141fb2f5d92a,231,196,35,Asia,14,1261.08
221ca04418c94fd0808d4eb7bf5d38bf,177,131,46,Europe,11,1167.78
221f5386afde4298802647cb04402403,101,59,42,Oceania,18,647.45
222354fe39e14b6f807b81241bef2696,234,199,35,Oceania,28,1438.31
2224b1751ac148b29953718473c04405,70,44,26,Asia,22,356.75
2224eb220cb740c085cc996d075dd638,181,153,28,North America,21,1315.58
222554f12f84495f8b6f442fdf6128ca,365,332,33,South America,19,1866.32
22272aa919c142b2bee84c64cdcba28f,182,159,23,Africa,25,1449.42
22280844a9d1454eba8446611b65addb,264,217,47,Africa,17,1194.94
222c448882364b82b611fa7aa97d9bfc,365,339,26,Europe,19,2110.02
222d9e2e08294d90b03a784e541e2afd,365,315,50,North America,23,2209.56
222fac77a7b541309a4d542c9ecc321a,260,202,58,South America,20,1232.62
2230ca84799c4967bfa7b676195b105f,310,265,45,Europe,19,2337.92
2230dcbbab9d4d00a390521a2d748ca9,78,50,28,Asia,20,876.3
2237845d2f694d8fa5ddbe4a032cc996,278,228,50,Europe,27,1337.24
223c4cd689154ad6a7c2ab637ef1d775,137,118,19,South America,21,1700.31
223dccb666574198a18431599bd4f38d,91,36,55,South America,20,308.37
223e445d57ba4d23b1ff1bda0a367fd3,178,140,38,Asia,20,828.7
223e457a227c4394bf714346b9178da3,173,115,58,North America,22,1078.34
223ea7bdbca64b2e851306c183ea661e,264,234,30,Oceania,18,1274.08
224010f263f64e5ea154575ccf9a18e0,141,99,42,Oceania,18,647.13
22433ec538824b6cb9700469f2cde67c,216,187,29,Europe,17,1213.63
2243d50df8ad4fdbbfb5332e5bca0d38,114,86,28,Oceania,23,1039.21
2243e9afebe2428aaa93a0c0b3c72610,83,40,43,Asia,19,459.34
22448f7029a24c048d11feb5da00ca34,259,206,53,Asia,19,1536.89
2245d63dde624b208fbf818f51405815,342,290,52,South America,22,1646.47
2245dbf34351495f88bca3bc1ff410ad,141,99,42,North America,20,846.67
224857da2f0f4eee85f5004b6c022238,137,107,30,South America,17,850.94
22494eb9ea6947209aeb286872cbfb48,333,312,21,Africa,23,3022.37
2249e849107545b1a7a9b257e25713ab,181,133,48,North America,17,912.2
224a05ddbf94418ebd84c2594c4b50f0,171,133,38,Oceania,19,812.26
224c64e7a22b47f28fae8c84b5b30700,365,352,13,Oceania,19,2127.43
224f9d1be47745e3af67544e5339acdc,97,56,41,South America,19,687.55
2250dcb0ca364ec4920359eef42b76d2,292,247,45,Asia,17,1850.78
2250e45260564a90afee56d25b9fcc6b,326,277,49,North America,24,2088.76
2251a16177af46309691bf4ec263bab9,85,55,30,Asia,24,680.02
225213673085406a8c71cae14e06e2b3,196,139,57,Europe,17,969.48
2253081c130b4a8d830f0a1f002f7fbd,305,258,47,Asia,21,1185.02
225408a0f3cc421d85693bdbdc52d975,104,70,34,Oceania,15,936.04
22554a55739847e7bca3051475e3f19e,130,102,28,North America,19,1152.58
22555ce28e914b58bf59a329e80e42b5,233,188,45,Africa,17,1462.1
2258e83f890a456f8b6dc4c86943ffe6,360,349,11,Oceania,20,3486.19
2259ad5a8a9a46b5bc47d94aedfaf961,179,146,33,Europe,21,1322.06
225d111f9b3b4bf1a2334b21c78260cd,265,240,25,Europe,23,1963.1
2262785be85042dc87c20c770ae29911,363,330,33,Africa,20,1290.14
2263673f6345475c874654e85e28adbc,252,234,18,Oceania,24,1225.83
2267b6a44a524bce85f718467ff71085,365,312,53,Asia,19,1718.3
2268ef9193114103aebdfcb013dce511,164,139,25,Europe,20,774.23
226aefa8dc2b4d3fab7540dc1d294880,192,150,42,South America,21,1733.69
226daeb3d76f46008a04dc60c2c35d62,146,114,32,South America,22,1140.03
226e2f5aa61042ee9709926ee1b05ef7,365,360,5,North America,16,2865.21
2271bb44c75047889292cf6eabe9d6bc,197,160,37,South America,17,1250.39
22741b3c92924d87bf087c2ff80e03a2,313,267,46,North America,15,1738.91
2278ec1da00b4920be5c65b5eebcf32b,97,60,37,North America,19,396.16
22793723bc134d86b69585bb580dcbc5,280,250,30,North America,22,2334.21
2279d28c1cd348e0b68e631adfc568ff,144,106,38,Asia,17,406.77
2279f40d8afa44fd933e350660dca618,200,164,36,North America,25,1449.84
227c8a9e1c584a2e88bb26fada22a430,132,101,31,Asia,19,933.06
227f0457b68f4576a5fe18facae7fd69,39,10,29,South America,21,203.03
22822ffcccf147459fc91de435f30aae,203,178,25,Europe,25,1353.79
2282a1fcee3545808a899eaf2aa2593e,129,84,45,South America,21,601.66
2282cf53061a4b5c98d16efe3755c896,232,197,35,Oceania,21,2247.6
22836b45ed354cd49c77d49934136351,364,330,34,Europe,21,2702.07
2283b12818a045d59ff081b770949a65,263,241,22,South America,19,1785.2
22843b2a117444a69e057314c11743a2,167,110,57,Oceania,17,741.64
228456f3598944c3902b116db3e341a1,200,182,18,Africa,17,2010.51
2285f45d5fcb45f4bc998dabfc097319,161,121,40,South America,25,726.89
22874e8a9ec44276a385917629a5bcfb,145,94,51,Asia,24,757.58
2287af3823b641fd9e385797687f036d,331,285,46,Asia,21,1799.76
228a0babca954ddda0a7d56ce5d60225,49,7,42,North America,24,283.77
228e997951084133bb7422718241c70b,172,122,50,South America,22,707.65
229088ace035487ba5a03f034ba0b101,83,35,48,North America,19,274.16
2295d6db28c4441581422e3d60b9c9d4,123,82,41,North America,22,1068.51
2297bb1a4cc441a0a4a6fbd5754619e2,208,160,48,North America,24,935.23
22987537fb964c5897fce7e133e9ba98,207,154,53,Africa,16,1016.7
229a0ee4154b44f2aa61614811871566,85,60,25,South America,14,565.25
229b6c1f212949efb5876855c81cd848,54,3,51,Europe,17,188.68
229e217fe1aa4c8aa0596fff31e67b98,304,283,21,North America,21,2043.24
229eeb9455bc4d548a06ca3422d176b9,79,36,43,Asia,23,336.85
229f79a68e5947f7847f27fcd497ecfd,292,248,44,Asia,19,1817.95
22a119e6b0994a379a572493d3d1d0e1,303,282,21,Asia,20,1651.45
22a1a52c08f445c5abc69c3aef3b5601,48,10,38,North America,17,348.65
22a1aa1cc1b9412091bfe78229e32f8f,307,273,34,Oceania,19,1970.3
22a47b1568ba48959119fe9d7ccad22a,325,275,50,Oceania,19,1926.78
22a54d8c751e4d90b192915c4df7b6d0,365,327,38,South America,18,2042.87
22a97bab716e4624b1240bb6812413b2,196,169,27,North America,20,1354.51
22aa3e15bc42435aa9617d6d26086b49,72,28,44,Africa,20,289.3
22aa87dbbb1949b9a57bb988bef19813,212,160,52,Asia,20,963.68
22ab2de5182e4423837d30f96c96772b,331,290,41,South America,16,2248.71
22acd680227247aba1ab958af12a18d4,305,259,46,Asia,23,1383.5
22ae621edad4481e95fef54e40d5d27f,72,42,30,South America,12,465.47
22b20f5c9f2a45d5b06565f3779ad5fc,74,34,40,Asia,20,501.03
22b7973d25754b3b903894d59507b859,147,96,51,Africa,21,828.16
22b81c6501334292925dfba30955e0a5,365,354,11,Oceania,26,1965.95
22b81fb97e434741abbcf9863cadb451,59,20,39,Europe,20,432.08
22b853ce747f4fe6afe442d9e3f8292c,170,116,54,Asia,18,345
22b8cffd4ca246cca15ecf5c7f3e3675,347,312,35,Asia,21,2565.67
22b9da622ab6442987207eb400a5c8b2,365,350,15,Oceania,22,3285.46
22be658de7724892974ceee490efb310,143,93,50,North America,24,759.97
22c2348393934238a6e5540b787d9a8b,324,292,32,South America,16,2571.33
22c3ac1c36c74feab8d0f305c32404c8,316,291,25,Africa,21,2382.93
22c3bee6909e41abbd6fc9959750193f,70,33,37,Europe,20,614.58
22c5db431c5f41c5b30ba7540faa416a,272,225,47,North America,21,1642.46
22c71d714f7e4c199a24bd47ce7ec4b9,274,219,55,South America,20,1166.29
22c82ef830504a868b1df38a62147a12,275,243,32,Africa,19,2187.44
22c83a1040d540a1b6fd0ababc97572b,94,62,32,North America,17,316.76
22cb2ec393024ad18dafa04a5752743c,365,317,48,Asia,25,1464.83
22cc5f9c997b4ecb903a8211d1d3317d,307,287,20,Africa,20,2364.77
22d0e553131348398878d3e98eeb1b9e,168,121,47,Oceania,19,464.95
22d17e3f6f0c45a08b408c514bbb7257,155,133,22,South America,20,1170.51
22d18ac0a49247a7b481b7e960c0ab23,121,74,47,North America,22,542.18
22d57d1018cc4500a156fa17e007b5ef,363,348,15,Oceania,25,1615.45
22d5c502f89b4243aa57c365b0d18d40,192,153,39,Oceania,19,1531.73
22d5de27bfff425481f38378a2c8b28c,128,96,32,Europe,20,624.09
22d794cd5809422987e4e1de00c6a32d,274,236,38,Oceania,20,1473.14
22d7f005b10549a4ae849751c5e896f4,103,74,29,Oceania,14,553.39
22d86033227247b88e14cc5cf35711d9,361,304,57,South America,24,2655.07
22d8a043ea3544408b8ab91919bf9542,159,112,47,South America,19,846.56
22db62706175448f9160f67e093aa131,365,339,26,North America,26,2053.57
22dcc47782c443b3a624ffadabf7a75b,358,333,25,Europe,20,2785.02
22dce13789c04d5cb24e8f85540ec8f8,319,274,45,Oceania,19,1630.78
22dd2b8386e04a339267cacb0f40b487,314,260,54,Asia,23,2104.53
22e0ad18769c40ceb98e6ee4411e8541,284,260,24,Europe,19,2081.12
22e1fc3c4b1844a6a61dec6ac563d794,324,270,54,Asia,17,2056.05
22e2b906c679462d98df91e299772487,97,73,24,South America,18,611.6
22e2fa2c874745279802408534d423bd,164,139,25,South America,22,1209.62
22e33471d49e41b5863eeaf362cb1dcb,27,3,24,South America,20,451.74
22e43d9c0ec147bb843befa61bf177b3,320,280,40,Europe,17,1844.09
22e6ec37e83a47ab9911f3e8b068f554,46,4,42,Asia,22,264.89
22e86e4ccf6741cbaa9fa5e68c79a5e0,270,248,22,Oceania,23,1993.61
22e900d8835c42ed90656b70ea4a8470,316,286,30,North America,21,2141.73
22ea2d6034f54fc0b30cc62c9613c808,365,328,37,Europe,25,1858.44
22eb986c7e5f4a838c326fc07ffde14c,288,253,35,Africa,18,1741.98
22ecdeb840a94fcfb4f089f0f23022ca,303,274,29,North America,22,1935.25
22ed546209cd424e983301de0d1f913e,365,331,34,Asia,20,2139.82
22f030d9ac644d23ae76fdfbe629dac3,284,235,49,Asia,19,1199.95
22f4add422f047878195c12e90befa5d,289,247,42,North America,17,1822.33
22f50a1dcc42493aa6fa917e3b5831b0,364,359,5,Oceania,24,2217.86
22f5f6a7f6f44e3583050ae76f9a2371,87,56,31,Oceania,15,708.7
22f7ed36f3824b47b59ebf68e9041ca5,363,319,44,Europe,13,2453.49
22f8157beb4b4cbfbd9b73d2b8c21061,71,24,47,Asia,24,285.19
22f97701ae5f4aca95f54f48631056e0,363,338,25,Asia,28,2650.27
22fa1b24492d482eb06db307ccb84ccf,271,217,54,Asia,19,1436.52
22fa5f59fab74b6781a1f95eecca9641,262,211,51,Oceania,17,1787.17
22faa1ed0e8d4a16890069bd2eae09b4,365,331,34,South America,19,2608.27
22fd9e3e80b34211a86528dc2b4240dd,275,245,30,Europe,24,1968.57
22fee62ede6a4275b0db89855742fdf5,51,2,49,Africa,21,218.21
22ffbcdfa40940848c88dc400314d922,114,58,56,Oceania,24,593.49
230098ef4a314eb5b60b7dc306bbd13a,164,138,26,Africa,20,1427.72
23010d91de8d4e6da55114720d079109,138,111,27,North America,28,783.72
2301aaf582e64fde8edd238204cb19e5,245,205,40,Asia,20,1360.35
230286768aff41b3bf55056fe154d7b0,336,301,35,Europe,20,1769.32
2302db03650a40459df596d20e769fd9,249,219,30,Oceania,25,1791.16
2302fac224074d9696d35c131f8dc83b,110,83,27,South America,23,492.93
23061a4c0ab8459d9040125730a01417,236,183,53,Africa,15,886.26
2307942e66d347c09005ba6cec90dc9f,281,251,30,Africa,15,2059.96
2308f85bc8c94c27b80d589be927eda7,107,73,34,North America,18,698.15
230da959f86a42c7a19cda603e0817b4,179,156,23,Africa,17,1209.51
23169229b2a9490c99422e5681d09082,274,229,45,Asia,21,1464.12
2316e6b40e484794950af6b671286a1c,301,251,50,South America,20,1270.18
2317481d1d294c878a6c9160b509492e,126,92,34,Europe,18,684.82
231815d0fbf54981bcc2d5604c11d1d1,58,4,54,North America,19,235.44
231853241068459db45e0c8ba1e220e9,37,9,28,South America,24,347.29
2319632e238c4021873fccfde7c87ff5,364,363,1,Europe,23,2676.97
23199e1db4c3469890dc420373ff17d5,260,231,29,Asia,20,2189.81
231a611582e545098c20fb3a5bdaa55a,365,331,34,South America,14,1957.35
231d819f0b29402c95eb851db3c18186,318,278,40,Oceania,22,1747.41
231e7a0718af42448b4991d2411598ac,82,44,38,North America,23,793.95
2320c902534b457aa08cb9c3f9bf20e7,201,153,48,North America,19,1103.45
2321c9493fce4e99ba2c7c24714bd3fb,268,253,15,South America,18,2485.05
2322d3d9c0f24b7ea2d94d3389f2f5f6,342,300,42,Asia,19,1788.77
2322e77486b8499198bee011b132477b,365,322,43,Africa,23,2463.74
23231d38b2044e2490d59d22f0ae3006,72,26,46,South America,21,383.02
23237dd6ba3a48fd9ca57e639e338ab4,234,212,22,South America,23,1499.27
2325f25e11184b2c8ab7e4b4605a5b92,133,81,52,South America,18,203.63
23271f9a8f004d06bc6ad9c37e80830f,188,169,19,Oceania,22,896.73
2327588d74304eee9795d96279c9a49a,227,165,62,Asia,24,790.79
232891330867423fa273441411003333,158,139,19,Oceania,18,1200.09
232aafcc28514395a1d5eb90434f9f6b,342,296,46,Asia,15,1971.03
232ae5e5a38946718ffe8c0fa83ae767,364,350,14,North America,12,1564.86
232c7dd951654d8aacfb3742893e1115,263,210,53,Europe,19,1200.65
232ee9154e93442dbff990be30ade332,218,197,21,Oceania,20,1771.64
23316657f70b4ce388aa12364a24557d,262,222,40,Oceania,25,1259.74
2331f6e71b6c4eec9fc3b137182b9b86,159,131,28,Europe,19,1141.48
23324f919c50471fa8654cbe0c64fd89,305,268,37,Oceania,20,1867.27
2333ba1ae9c54c87bea93b2988731342,326,294,32,Oceania,20,2284.96
233b56fda1f442b0b460d0d1a30d679e,144,97,47,Africa,20,1215.15
233e6f7009864154b80cadbb49a85755,246,205,41,Africa,19,1771.02
234566915cbf42c98bbd7d7460437d1c,87,58,29,Asia,19,523.18
2345e566595c430fbb62276cd549bb31,362,321,41,Africa,20,1979.89
23462412a90046979f8950d8ca05f128,115,67,48,Europe,21,817.95
234635b27c794e9f890b96eb73614b12,67,25,42,Africa,19,492.91
2346c4ddbc0f49d29b2d216690aab5e2,231,201,30,Oceania,14,1655.13
2347dbd399844bb8a0e0559dbae1e0b9,243,215,28,South America,23,1741.98
234a1743b5e742908b6af3c8cbdddf3e,38,12,26,Africa,22,386.11
234c3e09e222415db455f92804a3815c,322,294,28,Asia,21,1655.01
234c71529e0145c4b727c20bbaa25a12,326,286,40,Europe,23,2008.35
2350dec4523a4094ad48a08483e6218a,117,80,37,North America,18,667.49
23513669e69046a298213039b40ba81d,56,13,43,Oceania,18,423.77
2352d41947014ac88b1624f2c67d354d,165,125,40,Africa,19,1376.97
23563ba293ed43d8b88721bb644590ad,184,145,39,South America,15,1060.82
2356cd07249a46bf8baf4e98184a1f82,341,298,43,Oceania,16,2666.85
23577307bd4c4d57ba284d172051c13a,156,120,36,South America,22,1177.12
2357ac2d1c9e4dc89c942958b2d44b67,331,299,32,Africa,19,1932.51
2358a89455274d829ab2012c37845d55,311,286,25,Oceania,20,2560.96
2358be1beee84d6b8917b8d7621d689c,113,64,49,Europe,21,833.75
2359876dd63f4a658f4925f218a57eb7,344,307,37,South America,21,2493.47
2359fb7267f54d049a378dd00015f37d,55,12,43,Africa,20,275.08
235a5e1f946e4ec6bb736173882d5381,73,27,46,Africa,23,331.71
235c83fed2374000b7dbe5dbc2803b27,244,198,46,Europe,17,754.14
235de7282d67462d92e8afcf57a991c6,229,199,30,Europe,18,1232.57
235eb7a91ed347b8b8aa9b774b92295e,129,100,29,North America,20,1106.2
235fb44b4ef2442daea8bf61153c036f,118,71,47,Asia,18,652.7
236321912a9b4a118496d75b454af90b,154,99,55,Europe,22,1157.55
2365e931807a4212b8d12bbd4fb66831,33,12,21,Oceania,24,326.22
2366ee0c46664c4498da25c28f2c93be,357,337,20,Asia,16,2687.49
236a66c36eb94ce8a27e7c0ceab7c808,365,326,39,Africa,22,2144.94
236cb924f962446f894f99559ab32e43,142,94,48,Asia,23,555.51
23727df17e0d4614aadf8f8e6e19c696,230,208,22,North America,19,1356.7
23761f3d00b74ab8b892c88daee6d45c,270,231,39,North America,22,1648.26
23776947f4384a08a21b4f5463cb892e,144,104,40,Europe,17,1042.11
23776ef54c0c4a7493dc689afb246c11,119,96,23,Africa,18,1147.79
2377de1fe1c04c64a6d1bcb7f881c75a,288,268,20,Europe,25,2712.85
2378439d78a7458f9db4cd0fa45b0b6d,237,204,33,Asia,16,1936.74
2378a690f4f6420bb9c2951726c9f4dd,241,192,49,Africa,25,1172.21
23792e809d3b44918a9026b1539d2377,343,302,41,Europe,19,1884.57
237a65ecad50496abd2bc20c7507bab6,343,313,30,Africa,20,2145.37
2380082af1e8455894110a7392164144,264,229,35,Europe,21,2048.28
23817fb5ebd24cbab6bf1c91e4270e68,214,163,51,Africa,18,1086.55
23825f9349274cceb782b5835b986e7b,329,287,42,Asia,20,1848.11
238294b2e6ae457d89a0feb884252880,365,355,10,North America,17,1716.99
2385b78907024e798952ea917ab7d5ee,79,25,54,Africa,20,271.91
2385e9c20fda4beb93ea18457525c0d5,93,50,43,North America,20,1102.59
238670589ee04aa3aa711a2fca279ecc,22,1,21,Oceania,18,211.09
2386d0a2c0d448e0a5d2bfc1080c03cd,298,244,54,Europe,17,1367.66
2387373860a3463ab3813e53012a406c,208,175,33,Europe,17,1603.66
238875f027884db7acf1dea163490c62,225,174,51,Africa,17,1342.29
238ed3eff0ca4d43a8846f4c99e8fe5f,301,273,28,Africa,20,2077.71
238f4f36008a45b6a165832b349799c8,176,147,29,South America,21,1569.66
239208bffefa454ea047ea89a747270d,357,313,44,Africa,17,1911.32
2393255e4c9f4550a8d05d9a6579f000,243,210,33,Asia,24,1905.95
23938a32b04a42b5be7a5707aa9a0adc,235,208,27,South America,19,1882.83
23961455f10241769b66a096cff4267c,37,17,20,Africa,18,209
2396656da843458fb534cc23a4b725e5,172,115,57,North America,19,745.25
2396e19db03e41dea9eb334cfc5c8209,88,49,39,South America,20,739.85
239a0321ba19428abac207184a263765,337,288,49,Oceania,20,1497.2
239a702a7d484b9d8dc4653b30047d76,264,225,39,Asia,15,1700.39
239ac2b43adb4c71a99236d612cc5d24,107,55,52,Africa,25,441.42
239d241576494bddb8926a786bee9ab6,310,283,27,Asia,21,2239.55
239edeaada464b488b05826038aadba1,224,183,41,Oceania,19,1496.95
23a0dc202a204f5395757b150c4f9312,199,162,37,Africa,17,1346.33
23a49cfaca7a40f3a25bfd5d47b39ca6,359,319,40,Asia,20,2493.12
23a4e4b52e494255a6a365e6be7ebee9,95,72,23,Oceania,23,604.68
23a6bbe747a04b8b84b04e005e726160,98,55,43,Asia,18,597.26
23a788f6797f476ea5c180f052eba912,123,99,24,Africa,11,1331.61
23a7f6656ee848c4ae733d27cb0d5f6b,336,307,29,North America,16,2088.96
23a9bdafe8904740a88c6941ad6fc7a5,274,242,32,South America,22,1789.71
23aba60e33114055af355ce5165241c8,97,57,40,Asia,17,469.89
23ad2ac999ae426f8a8d37a894854a9b,163,115,48,Africa,24,808.76
23ae07b1be10412cb97b62cce1806728,241,220,21,Asia,17,1773.3
23afda34cc6143cdb5bdac14ff763fa9,255,227,28,Africa,20,2110.04
23b1a26f8f1845e680279c87fd35738e,150,108,42,Oceania,17,987.22
23b25b6d359542abb9bab99372a17d99,82,46,36,Oceania,22,591.55
23b44c49c22b44469ae38f328e081931,341,298,43,Asia,14,2032.5
23b7c6e6accf426e95c03ba3011cc99c,231,206,25,Europe,22,1762.87
23bdaf0dc0654d43856b1eacab1e02bd,230,183,47,Oceania,19,1495.25
23be2a445bd8459181eb2d4cf23a9900,365,334,31,South America,15,1466.19
23be3437125b4a5bae586d0e99f14844,346,288,58,South America,17,2035.17
23bf0b9c9b024680bedabc8eecedde87,132,88,44,Europe,22,1100.69
23c1b00f16b34c6e889bada715052933,112,76,36,North America,25,1043.6
23c48634b4514dda8acb99f184a0705c,326,286,40,South America,21,1338.17
23c68dde0e2f454c9f540e4a733ae4bc,246,207,39,North America,19,1254.69
23c7c38990c34b008edbebef8644701d,347,291,56,Asia,17,1265.98
23c81ff040e04c3a80d73107fcb24bac,63,23,40,Africa,24,205.82
23c922ae7e514129a02899f0f9d52f79,364,363,1,North America,22,2331.14
23cc38b3871f4a1fb46f75099cf1e636,69,32,37,Europe,19,169.73
23d19581d8ae44c7a03709922a801aad,222,185,37,South America,16,1522.81
23d1bb805506494d9f61140fbab477ba,167,138,29,North America,20,981.01
23d25a0439784df58b330fa65ccdb986,106,48,58,Europe,16,528.62
23d4f0614e524656a7a7f2921cbd33a4,286,256,30,Europe,22,1542.57
23d682b7fbea4b8da1acce7d54faaac9,326,276,50,Oceania,23,1990.04
23d8a86889f54f0796d7bcd472010ac2,37,3,34,Oceania,19,447.25
23db3caf17f142a88c12b87b85affc16,183,142,41,Europe,17,880.16
23dcf88f18ae4b93b5bfbaa7393440fa,90,57,33,Africa,19,518.39
23de40ef608f43728aacd816260863cf,290,235,55,South America,15,1727.5
23e034338af8435ea2e22716cfd10c6b,264,209,55,North America,20,1124.93
23e0a02f4e984985a85e8e736523141e,294,256,38,North America,16,1395.64
23e0c3e0a5804907a41aaf939c455095,365,331,34,Oceania,21,2727.5
23e0fde6c22d468cab371d487d0b83fa,80,36,44,Africa,17,222.38
23e244c53b0e43d7bee395c28991ecd3,147,88,59,Asia,23,772.66
23e46e6a8daf4fe8a263adbaea3745b5,348,292,56,South America,24,1996.06
23e492a91b534f5296b1168bc72e6770,308,275,33,North America,24,1766.4
23e5ae24b68f41539ca15796f4746d30,152,126,26,South America,16,1460.49
23e8ad3a426a4dc290fd94beb9792bd7,282,234,48,Asia,20,1630.52
23eb0b25fb214d34a4f8b259e19c124c,60,11,49,South America,20,132.31
23ebb228406f4869838692810d7206e3,124,77,47,Africa,11,612.79
23ebf7da91c54d90b9d20968453e35af,68,41,27,North America,18,272.21
23edf9447224409ebc710550aaed726f,212,157,55,Oceania,18,974.68
23f0ded8f8b740c2a20fe2c2051d12f1,157,118,39,Oceania,25,1042.69
23f1cee2cf2f4a35b95382472c4a50cc,165,110,55,Africa,18,546.6
23f24e616cc94f21a0924c66f47d95fe,185,162,23,North America,19,1066.51
23f250e3d1034aa2b1483ed3a08a6011,199,161,38,South America,15,1302.72
23f31eaa887b4850876dcfe9b816697d,88,37,51,Asia,21,229.69
23f6581893dd431cb7d8c583145ff788,196,165,31,South America,18,1153.28
23f6d902684e4e46a4f2486a4941a6db,255,222,33,Africa,16,2144.18
23f6dcd51da242938d9e527ea64a3d92,55,20,35,Europe,24,231.8
23f822b36f2a4b19a1f6f9f90af36fd1,60,28,32,Asia,20,615.97
23f8ebdc273540aeb2111957640aa3de,215,174,41,Africa,18,1697.75
23f9ae45fe4d4316beb1eaa72d34a5b0,245,221,24,Asia,21,1964.69
23fa305ffc6a4289a390dcf3f4551bf0,69,19,50,North America,18,381.5
23faad45a54740c28d085e0b52b6a79b,181,158,23,Europe,22,1173.63
23faca09064141e5ba32e62fac1efc79,94,55,39,Africa,21,973.28
23fc93ece9554fd295cb3d2b43afbd9e,224,186,38,Africa,19,1512
23fd109bedef447a97d954ccf3917bb7,352,324,28,Africa,33,1992.85
23ff8ee8f090401ba0846c19af86f3d3,126,92,34,Europe,18,733.67
23ffe62797544d7b8ef8e6af15e97321,299,253,46,Africa,19,1161.96
2401475c5b2441bcb94b4b6e0bdfadb5,148,106,42,Europe,19,977.11
2403a849eae34bdf9c885459ca34b5df,231,191,40,South America,18,1499.16
240663add6f64f3dac037c9d38745bd3,284,252,32,Oceania,19,1805.5
240c6ce9b4bc4cbfb91e00ff2e839865,339,324,15,Oceania,24,2721.55
240e642c3e154a7a9630d4cb82dbaf3d,335,302,33,Asia,20,2736.76
2410684704234137a0ac84484adc4129,113,92,21,North America,17,264.4
24123eea7cb94826ab54270f6f851514,223,174,49,North America,24,1603.41
2412998db9c747cdbab033819afdab8e,353,320,33,Europe,19,2775.54
2414da5bb5d54e699ac8c1d5dee38c2d,363,318,45,Africa,22,1938.03
2416d90b3bd547108d0ded946a4d4472,86,42,44,South America,20,785.29
2418d1afdc124729b31522354dbebff3,365,320,45,Oceania,20,1701.96
241d10270b5749aab4546627c22a93da,88,67,21,South America,18,543.15
241db42c5fc74e6daf008c000b870d49,185,151,34,South America,19,1785.16
241ed26a1aee4301b0819f4ff6575fad,359,333,26,Oceania,11,2599.59
241f940b8efe4e84ab695f8517bb6b70,173,128,45,Europe,22,804.85
241fba9abe1046df882c6c35b85e3c98,100,55,45,Oceania,25,639.75
2422470e42ab4aa69ef2c86b190a4bac,270,230,40,Oceania,21,2259.23
24245cd157e34db8bf0075a8e8205f27,185,133,52,Asia,25,1238.18
242477736d9e427bb8e4de9b3506e2c4,283,252,31,Asia,22,1847.46
24262616decc4555b46aceb948bd7502,160,123,37,South America,16,884.64
2427db74abc64540b36b8bc3ec081962,234,196,38,North America,19,1265.11
2427e87dc08d47b2a0cb7c074da7fac9,213,167,46,Asia,20,1289.45
242811b5237342d8b640c058f95df7f6,287,247,40,North America,20,1026.01
2428e88a1c0543358b234a08c01b95f4,60,39,21,Oceania,22,647.95
242aa2bd818043bcb4da0b93f225ea76,280,256,24,Oceania,26,2188.87
242ade7a1b1d48faa1a6039125dc6b73,262,225,37,Oceania,19,1991.73
242b77cc3139446fb26e74a08c0e6650,219,167,52,Oceania,17,755.98
242bf3c09d244be793808ed643dd720c,246,212,34,North America,19,1156.18
242da8b535224d5c80a53ae481df3220,362,342,20,Europe,26,2909.2
242dffd0840d437aae63870844c7dbc9,251,234,17,Oceania,20,1349.84
242eee315c3248febd0c4fc277298c76,205,170,35,South America,18,1868.08
242f28f5ff6445e3acbc94418a18eb12,327,293,34,Africa,23,2674.4
2432aabda89942df99dd148a3517cb77,364,321,43,Europe,21,1696.32
2434baf06d8c47b5a420f6ba954be0a5,266,224,42,South America,21,1943.18
2435b2a579ce48ec8d7fc08b3d2678f4,185,163,22,South America,22,1403.9
243617cf3af44af486ee21685bf6608b,260,217,43,Europe,25,1799.4
24372d0f041d48f0aa6104344efc66b5,61,16,45,Oceania,18,202.02
243a4068e01e4c72b2bc166c2ca21f5c,51,7,44,Asia,20,261.66
243aa194028a4b29a811a76258e126fb,106,74,32,North America,14,970.69
243ab6559e0049f6a71a098ec1b9abcd,345,307,38,Asia,23,2333.5
243b9f2d23444f3dabbc193cba1337df,307,272,35,Asia,18,1451.24
243c15f9d3bf46488470132c0ccca97f,208,175,33,North America,21,1792.51
24417f55ab944f359e7fa7a58de3a004,155,121,34,South America,21,918.59
2444d2466e2a460cab150c06c065781b,93,67,26,Oceania,20,561.44
244c0e95ce46420887466a62a8842028,222,189,33,Africa,15,1388.45
244eed8f40fa476c90532b76dd105329,330,282,48,South America,14,2707.82
2450f2861b9a42e9adbe8c72dc51d52c,364,351,13,Europe,22,1803.34
2451206068514fc68206020797257a00,320,273,47,Oceania,15,2202.77
24512fa2a0cf4091836dabad22ecfb22,315,261,54,Asia,24,1416.02
24533d3e2b724bda9e9350b7e07b8e05,352,331,21,Europe,19,2672.04
245542adca554fc08adff62755d34f25,257,223,34,Oceania,21,2052.48
24567be9bfb241969800a654e931026e,245,223,22,Asia,25,1383.87
24593efb86a44b55ab9e720405e440b2,157,131,26,North America,23,991.29
2459e8afae71499da8bac023f79a27ca,156,117,39,Asia,21,996.87
245b05f49b8748679d3c031f5d443b32,249,219,30,Oceania,18,2077.9
245ce44b22da4700ae7c3d026558845d,363,344,19,Europe,23,2804.7
245d68b78f2c4895bc69992f0225ce06,62,18,44,Oceania,18,505.17
245ed26d777f4cf3ba62a11945ce1e51,200,156,44,Africa,19,681.37
245ee365db0a4b908d1237f77a9c5bd7,130,92,38,Africa,24,767.51
245f3af0e99642f69b6c1211ca537625,267,235,32,Europe,17,1625.68
245f7f57cd9842d9aa7505f10fce7582,238,196,42,Africa,17,1675.77
245fd9ffcaab4835b4dfc1c97ba6b0da,239,201,38,Africa,24,1667.22
2461449eabc946ab86af83edc717c386,154,103,51,Africa,16,965.05
2461caab5f344b4585c64d1db3d3c371,113,61,52,North America,18,809.62
246447989263472aa4488d735f78583a,125,70,55,North America,20,860.32
2464eb1bb717417aafc0b84815968076,114,83,31,Europe,21,836.73
2466280d058e44f9bcbf6422978d7352,209,172,37,Africa,22,1708.36
2468aedf3619429b8d0969f9cb28bbcd,259,215,44,North America,22,1588.63
24696a3dd9fd40c8a1e798c5c9b3f34b,167,108,59,Oceania,20,750.68
2469ec97812840838492c45c6db8f561,255,221,34,Asia,20,1832.33
246a0e988797473daa938862978f0da0,361,328,33,North America,19,2416.5
246c2650dd4945f3a92686caaf685420,363,342,21,Oceania,21,3219.34
246dcb9c842f41eeb21efa96b6c8e733,238,211,27,Asia,16,1365.2
2477f1640dae476a9419d5e50da4663f,271,234,37,North America,22,1542.43
24791a15708e4e529f14a833f5bac310,165,120,45,South America,13,1264.92
247a47079e674080aeb3256d4d5814f4,66,30,36,North America,21,703.85
247a7a625de24a5da498d314865f51c6,204,159,45,Oceania,18,1047.6
247dbb7e3c9645cbad2bda602be13a84,295,259,36,Oceania,17,1680.39
247e478d45a242be8aed27ec35e8223a,348,293,55,Europe,17,1400.17
2481bd7ee99440e4808ad7b4cb6f5013,160,143,17,Oceania,20,1605.77
2483ef2c319a42b6806d8c2bc1a4dc38,246,192,54,Africa,17,921.54
24845ca77d4346809c4f666358294929,313,277,36,Oceania,22,1780.82
24866c339bcd492f80f736339de8273d,365,343,22,Asia,18,1960.07
24868a45e6234b6e91cb57dd78afef7e,364,360,4,South America,15,1352.08
248b0add13224291b35938993e8785d5,99,44,55,South America,25,317.5
248bbf0ed9bd471b9399a1643c0fdd70,255,202,53,Oceania,21,1368.51
248d345a3ab1434399f4bc173b1ddc26,25,3,22,North America,20,175.98
248d5ec20735474f8fbb7e21e6568842,170,114,56,North America,25,962.63
248de6a433c0469a97e4df31325170dd,195,166,29,South America,19,1094.38
248e78e3730649169ab23e8b89403928,271,223,48,Asia,20,1564.26
2490a773c15a417396cda6ce5bf7d5a8,177,158,19,Europe,20,1079.73
2499d5aa7f1446eb8b99de0ce682d6fe,365,364,1,Oceania,16,2010.27
249c368d14d843fe9c26c37ffb71bef8,120,84,36,Asia,24,756.01
24a2a2f044a54c1e97a9c086c5063494,217,183,34,Europe,15,1177.23
24a38bfb88994f4ab7aac9c60916d2ad,40,16,24,South America,20,277.48
24a724f2443b4bdea4f2ff5a5ce7c24d,315,282,33,North America,14,2410.3
24ab1eedf49b4e8cadab7bab3d455331,89,59,30,North America,15,859.32
24ae80bf39ca4d57a131ef923bd7a76b,365,352,13,North America,19,1859.83
24b20dca63af4e95bc64492cb3def533,365,326,39,Europe,18,1960.41
24b28354b45c40b4b0c1dc16e12efed5,271,240,31,North America,23,2033.44
24b3631517f44b70b3a4eec9eff82eee,186,147,39,Africa,23,1066.16
24b46a4e32bd4cd5981ca2d83cb029aa,58,18,40,South America,16,270.6
24b68f785f5448df9be9170bd912f2a1,365,365,0,Europe,17,3434.12
24b69c2e08cd42c2ab0dd228a7c41877,102,70,32,South America,16,578.36
24b8837964174058a175b4a95e898026,364,319,45,Africa,19,1581.82
24b8af2a0f9749d1b6edf11733f7ec4e,55,31,24,Africa,21,306.16
24ba4d599434446baccd3d22932cf14d,349,315,34,Asia,24,2309.66
24ba594919ec4b5f842b30840dd106ae,167,146,21,Europe,18,1286.88
24bb78e0a4d941359d9789ee2c83f98c,108,73,35,Oceania,17,1287.24
24bbc252807346e58dadcd648af2117f,270,220,50,Oceania,18,905.81
24bcb34b04d44a6587c2cbb7cb41c3da,61,13,48,Africa,18,766.52
24bde1c5666c45a1a37746c505fd2c96,305,295,10,Europe,20,2419.47
24be3cdbbb92405496e51d34e6a0ba81,365,344,21,Europe,18,3209.79
24c25e040da94f328796f81961ae0b5b,30,7,23,Africa,18,361.31
24c2994b38f04b1fafb2392fa91d127d,356,330,26,Europe,17,2518.7
24c2dc53e9084ed9b0858ec71d8a476c,279,256,23,Africa,20,2522.42
24c33a36145047078cb4b8ccf6a3ed06,365,340,25,Africa,13,2437.89
24c502bf70d24d7db50094453d1946f5,169,141,28,Asia,23,774.8
24c574c7dd9848219ddcc8262ee885dc,225,188,37,North America,16,1330.06
24c91926baba422f8674ca77fea69724,348,317,31,Oceania,18,2277.39
24c92fef8284450ebe519a6df72b8e55,365,326,39,Asia,18,2308.67
24c98b52f68b47fb96078878c6b483bb,95,70,25,Oceania,18,1185.44
24cbf63d002b4e6f849ee64144121e2b,175,157,18,Oceania,26,1590.04
24cd70c53c12473c9f1aaa4f8202f83c,145,112,33,Asia,20,1072.62
24cd7bb8f6de47059a0657edb55a3f2e,272,241,31,Oceania,23,2173.27
24ce268a8da948e083372ba4d7964d97,220,182,38,Africa,27,1956.89
24cf6d6f5ce84628854d5ac0ee241c17,354,305,49,Africa,24,1772.02
24cfd0b2b4fd4967b81ae79e25ab1c1f,300,269,31,Asia,20,2042.3
24d0b0d61a7e4632a71837eab1dcff97,364,321,43,North America,19,2159.42
24d240eab0ab4d73aec489742243715b,281,256,25,Asia,20,2246.25
24d2912409b74242a21d3d9b04065e10,362,345,17,North America,21,2630.2
24d41d9278894f278ac5e0a67c4672e1,159,135,24,North America,23,837.16
24d598119f2e4643ae6e8d2ef9aad587,364,329,35,Europe,18,3231.3
24d7517c263e400280f7099710efa543,61,25,36,South America,20,650.75
24d82dba2e9343af9e2bf8d9b5357cca,310,288,22,Africa,17,2673.6
24d9a6e1040f4af99d67d3b1c374b991,159,135,24,North America,17,1275.8
24d9bf13864048c68c0f787144c9d6c7,42,2,40,Asia,26,97.91
24dbbd8801134938b260b300314e95f3,338,304,34,South America,19,2589.62
24dcc1c01aaa4f76819429648dd65295,364,323,41,Europe,15,2310.94
24dd99de518f44228a149ce2ede1364a,259,223,36,Asia,17,1553.04
24e1751689754773b6fad85074524d08,42,2,40,Oceania,18,501.05
24e1be951f6647cb939df1d7dfa3afc9,289,233,56,Asia,17,1299.44
24e1cc990b2a4bb598219d456e62fac0,77,55,22,North America,20,623.4
24e1db1265474798b71b103601cc380b,290,237,53,Europe,20,1327.65
24e26b67562c48db97e55edce750607f,97,60,37,Africa,21,449.59
24e5a5dedadc4a67a5646fd6b322f14f,273,232,41,Oceania,24,1645.98
24e619ff13134ca7ba58e7a64134f4d4,56,27,29,Oceania,25,780.6
24e7f73863134aaba79ce20c6215de1d,237,206,31,Europe,20,2380.39
24e80bbee67e4caeb2b193edc11f3653,152,119,33,South America,23,955.99
24e90615af704b94aebd1976637ba74a,249,201,48,Africa,26,1063.41
24ea8b26b4424218ada68da189f17eaf,201,173,28,North America,27,1475.02
24ec11a029fa40308745dcee1bda7922,81,41,40,Europe,26,734.03
24eef786282b41bf83671471eda3ce22,198,166,32,North America,18,923.39
24f4031f469c43f2bc6a227980699c0a,225,189,36,Africa,18,1189.17
24f95a8a249f4be1998136e45d828960,215,180,35,North America,19,1742.34
24faaffc0d9c4aa8affc0eadeb18ba82,195,147,48,Oceania,21,628.46
24fb84668aae400aa7ccb32c4cf46150,263,223,40,Asia,19,2327.21
24fbbcf63c324a1dafa73103db7e0ec7,318,270,48,Europe,12,1641.11
24fc0bbc365943bfa7c151e596976efd,276,248,28,Oceania,17,2654.57
2501fc3e894941c79dcdd543b6819b03,63,30,33,North America,23,440.97
250387687fe74f18b94b15470e2639de,204,162,42,North America,24,1132.83
25041b3d9db040d8b22e522e3884d63e,93,60,33,South America,24,537.03
25047241b1cb4f1996d82081b8e99bb3,171,141,30,Africa,18,651.37
25069eb75a7646d89f8d7df2d4790e44,101,51,50,Oceania,20,641.06
2507085044aa47a6a9aefe8cb0c121e0,341,299,42,Europe,22,2577.73
25076aa1874f4d93adf2c13adb1ce930,86,37,49,Asia,24,305.29
2507c248c79545d4aa6815ab9513b500,230,202,28,Africa,17,1815.85
25093b3a45fe4daa9b0d68285908d47a,114,84,30,Africa,14,943.59
2509b073efb54b81a3617bb926a4bbb1,170,112,58,Asia,15,803.91
250b432c724242708823930c3e51e786,168,128,40,North America,27,1025.79
250b451809834063ba02327c88a537c8,306,267,39,South America,15,2068.49
250e90d6558144eb888e7d74d4b267ac,365,319,46,South America,24,2647.62
251197806a424dab8fb973ea704e098c,359,314,45,Oceania,15,1547.49
25122e7be87e41ada626dc4345c56fc0,153,102,51,North America,21,1382.24
251369c6ec6c4523ab0419bdf0042654,324,284,40,South America,14,1535.38
2513c7d19b77403da1a5c1c95a7a17ed,130,91,39,South America,20,903.49
25155bf37af74110a604f09066f4eab4,289,247,42,Europe,18,1248.11
251610e24e9a48149c737b0a0fb03861,364,319,45,South America,19,1645.37
25166dd636dc4a09a44b67b909ce7b7e,168,159,9,North America,18,524.07
2517ce50922244a7b6604839e5ce9d65,146,100,46,Europe,17,956.76
25188b1fca3c4cd3a3e67732012ab3c6,356,308,48,Europe,18,1807.23
251a27245cc54456971bedeaf70ba796,351,325,26,North America,23,3396.5
251b08a1f4544756908b0ab3d9116171,57,19,38,Asia,16,175.96
251c5a32c8774d039bc21541e1209021,45,3,42,Europe,24,302.36
251fef00e74343f1983fc878bba5799f,206,173,33,North America,21,1389.91
2520dd16bcfe4620a26e95152caef787,280,238,42,Europe,23,2043.9
25213a238fa34820977ea1b8f591514e,89,34,55,Europe,20,523.93
2523639c2482440887db0d0c279a1d47,240,192,48,Africa,25,1292.88
25237e7504dc4f00a741d413c7f7195d,83,57,26,Oceania,25,492.4
2523e323ccf141559434bb7030e571f0,280,261,19,North America,23,1594.65
2529c55246b74e6ca44129c6292ac37b,210,167,43,Europe,20,1115.46
252acb869ee345c99729eeae1638a5b3,340,306,34,Asia,23,2977.5
252d572ec2a24f3db6cda7ec84e4da23,227,189,38,Europe,17,1396.83
252f0bf364e84ddd8ed30eb9f6bece06,364,342,22,Europe,19,1696.86
252f56daca78459fa5486155ae74e838,277,244,33,Oceania,21,1343.87
2530d7ef263744d0b664656a900bfa38,156,113,43,Europe,15,1303.19
2530f764f5b940cb9a6b6e4c7d2199e4,154,123,31,Asia,22,1024.77
2531666dad1146978e429d1720f6ad59,127,86,41,Africa,23,1004.15
253197281aa34001869674908333c23b,241,218,23,Europe,20,1767.41
2532ac0c4f4447b09075154d6c767618,67,16,51,Asia,21,364.13
2534191c5ce94784898262b27dc2dcd8,132,106,26,Europe,19,1130.18
2537ba9242b341edbb126fcb88568678,365,343,22,North America,21,1941.95
253c6a90f627489fb18296f5b48f9998,229,189,40,Oceania,20,1567.16
253da09c903d4ae9b65b7efb95992a94,235,187,48,Europe,21,1219.63
25428abca65d4e9eaac5ab3b4bccf621,190,163,27,South America,15,1982.65
25428f76c420429cbffa93eb1a071936,147,96,51,Asia,19,966.54
2543d3c1e85545cf856a4634c7f3c3b6,54,18,36,Oceania,20,268
25453db1951f435c82f58b8a429acdf5,80,41,39,Oceania,17,680.71
2545f660c45b46639a831d310c391d37,229,175,54,Africa,23,818.95
2546607584b4457fb60ce5c7cb0b666a,298,259,39,Africa,19,1327.76
2546e677a379469d9c095e24ebf40992,286,261,25,Africa,17,2516.71
2547f7ac99764fb883f1d3d43e3519fe,248,203,45,Europe,17,999.05
254842d8470941f4a45fcdd665aa744b,359,310,49,North America,19,1890.79
2548482d4d2e4af489dae95ad880d1ad,264,208,56,Europe,21,1166.79
25499276e9c3490c9b959bec493e4e4d,262,242,20,South America,21,1631.23
254a30dfc66a4503adcf776aec3c76d5,361,360,1,Africa,18,2544.87
254d51ab49404237a9dae2e7abf25492,224,175,49,Asia,19,879.42
254f9437e2584307bf7f4077394b3b7b,323,278,45,North America,21,2222.54
255056c3e77d41c697178ce7dc631029,298,258,40,North America,18,2442.52
255138eaafa14e7bb1d5f25f0060e78d,365,364,1,Oceania,18,2724.68
25524c0bce214131bd9419e2cf87817b,364,338,26,North America,19,2255.08
255561ee25614c9683c21330826b42ed,363,356,7,North America,19,2903.37
2555ede035f84aef9bd2c0c5dd9724ed,120,92,28,Africa,14,680.22
2556b84ea0b24ee596845c1dd0404038,267,225,42,Asia,23,1837.94
2559fc3483734e918e79df91aae2f9ed,131,104,27,Africa,18,880.34
255a49a53e714ef88c8702ea0ccf1390,199,164,35,South America,18,1557.35
255b880a6ed84c40ad5cb530632b1da9,123,89,34,Africa,23,834.51
255d52a03d104818addff5f4fb758e4b,270,216,54,South America,25,1308.29
255dffa3e764421f9b8ced29e2c9db45,361,311,50,Oceania,21,1317.52
255efe59a7494b41866f3fca6618e4b7,214,180,34,Africa,24,1347.08
2563ca0dc4b14295a7836b4a152c0b03,349,309,40,South America,23,3071.88
2564b56b1b8a4adcbaa4e544c92d1a60,88,44,44,Oceania,18,376.46
25655ce2115346309674711f6310d452,126,110,16,South America,19,718.46
25667404a07640aaa8bff6a01e9b6cb8,252,230,22,South America,21,1935.64
256764a8fbd24b118225235fe4b13e1a,79,30,49,Asia,14,388.96
256b1f5ee0c14ec687f430ba0e65e9d1,282,235,47,Africa,20,1332.98
256c8de0ffc5430eb6905cafc150a8ca,114,82,32,South America,18,920.83
256d452a59a247408e6868012b13cf5f,169,114,55,Asia,20,1269.73
256dc3cada9c4779b2b58604be666598,199,171,28,Africa,23,1222
256e4b4e38384111b7bda4273675938f,365,337,28,Oceania,21,2440.36
25701402c1e644a0a9647bc5eaabfd2e,86,38,48,Europe,21,352.26
25708225e4064b7782eb08be48c559ef,168,143,25,Oceania,21,882.87
257217dc0d8043c2ab1a57f3ccf43f07,122,77,45,Asia,21,675.94
257377ab8edd4b059d1a84d0bd2c5cf7,286,245,41,Europe,24,1703.23
2574a55f5f944a1680458eb0b547b3be,98,51,47,Europe,16,1075.15
2574a91e21a94fd5addbb3d11630d8e4,300,278,22,North America,22,2069.35
257562f3a092433cba77b18250fb074d,103,76,27,South America,16,826.97
2576bee638b244ac9f7b272634a1cabf,357,330,27,North America,22,3125.62
25772ecd8d784e91bb36339dfa3f2f90,251,210,41,South America,19,1980.43
257772ed24c94c76bef72d0c38b1008e,285,260,25,South America,24,2231.11
25786a325cee4dac9340080b6a9f0dad,244,228,16,Asia,21,1791.77
257a1747294b4149a902dd904f6cfff5,307,270,37,North America,16,1903.16
257c6ecab70649b59bf1c78bc3c79a9e,260,241,19,Africa,21,2232.21
257e2f3a246448c684172bbecff89480,97,69,28,North America,18,1019.02
25817880640c4263a7841d88b0359fd2,107,81,26,Africa,16,955.12
2584b054acac4a7bb2899b8cb9c4082c,208,186,22,Africa,20,1071.91
2584bccb277040bca02f92ffe98ee632,55,6,49,South America,20,211.6
258527b0061044cfa60148c170928ce6,156,129,27,South America,23,1229.95
258683e5b34f4b5b8516ba1efc670307,281,247,34,Oceania,20,2168.52
2586f39a22274c619fc8c1031dab2c4f,109,79,30,Europe,16,849.08
2587634969744d419b135766287f04d7,60,12,48,South America,13,219.81
2587e6f0bc0742fc9b416e29658e1b24,90,42,48,South America,21,315.77
25899a7205564c2e827f03b13cb28db9,331,303,28,Asia,16,2838.48
25899af0cff14cc3aadf67920d684d35,216,189,27,Oceania,27,2054.03
258bb0907d8c453cb8a2c4ed0b0e99fd,340,311,29,South America,19,2297.92
258c780693a34326ab1b1b69afcf8bdb,322,295,27,Europe,18,2267.86
258d59db231a42a6987b8fc3d3d4073d,335,304,31,Asia,21,3074.56
258f29fe90c3498bb0152138d6c00727,186,141,45,Africa,21,1232.36
25903a6e25604638a07e297e5e68171c,365,346,19,Oceania,16,1798.63
2591af98a040429e837f306a26e48882,269,235,34,Oceania,20,1505.29
2591d62f727341f9b95fa8c6bd1e8776,156,116,40,South America,24,1177.93
259388cca34a4c85adb9c2e56e68518f,124,104,20,South America,15,981.72
2595009643f14a1782bf8fd9506a2a7b,176,129,47,Oceania,16,673.21
259943e0213e4b2da28d84ae82e0d344,247,216,31,Europe,20,1592.37
259b1ead0eb7420c84adcb4b6d8aef5c,258,231,27,Asia,21,2139.23
259bba228ab84780b749f465b0968027,162,124,38,North America,20,1045.99
259eba39efac42c5beef8ee51b1de315,219,197,22,South America,19,1300.45
259f3d88ae96409ebfa66625eb0d9f94,365,344,21,Africa,18,1926.16
25a20d35eecd446f8180ea6810007c67,84,33,51,Africa,21,268.11
25a33c22ba3040afa9d4f9d98e828de8,363,347,16,Asia,25,3000.54
25a39a1f85da422f8d18c74895419ca1,115,69,46,South America,20,700.31
25a4a4afc4104c159305f8e18467e317,335,308,27,South America,21,2350.66
25a8daa56a7944cf876f2fda9274d812,85,61,24,Oceania,19,656.51
25ad588c7a4146418e58d85f4f5ef445,152,113,39,North America,21,1198.58
25ae1b0b2acb4f4d8dfe653cff3af347,102,49,53,North America,26,616.78
25b0432cc9c94248bbaa975d801e0203,160,128,32,Europe,23,1008.29
25b231f344eb4d8e98fb9e597cdfc47e,365,355,10,Oceania,21,2193.57
25b2985573b54651bf654d2e71e1c224,103,70,33,North America,16,978.76
25b6c7232a644d3b8dc1cbfd2da85c86,169,121,48,Africa,20,835.61
25b71edf056a4874bcb2ae340549bbeb,365,345,20,Oceania,17,2617.85
25b95c95d72d4467960b4b87ec053400,363,334,29,Oceania,19,2528.58
25befba407d14286953c7bdab2047b88,54,30,24,South America,20,899.62
25bf47edf466450aa567fbda066405b0,315,281,34,Oceania,17,2296.06
25bfceeace784c31b3629bbad164d9d0,83,50,33,Asia,21,848.76
25c1115434d145a289119be127d71670,274,218,56,Europe,17,1548.65
25c3756f98cb4e70966c170463e75bd6,210,165,45,Oceania,14,1595.64
25c5495ba19e4956be7f75f6d52e38d3,365,345,20,Oceania,21,1630.52
25c5627b2e3748078c314c1070977a84,270,220,50,North America,19,887.87
25c62ca071074a44b6820e489df95fc4,223,189,34,Asia,24,1146.25
25c678ea73cd4a52a33a3b376e6a2eff,181,143,38,Europe,23,966.69
25c71bc246944f1582e1ced1133dbdbc,100,45,55,Africa,20,594.75
25c84ab5f4f6499f8536c01e621630bc,32,5,27,North America,18,225.83
25ca960fd7ab4f709438046695b58a37,338,310,28,Africa,13,2376.83
25cbbffd83cd42b5b5fb7c46eb2db2b3,365,365,0,Oceania,20,1752.18
25cda8d1a0fd4e4e8172c66280ff316d,259,238,21,Asia,25,2251.47
25ce472e75e54d52ab89c3726be7e292,136,92,44,Oceania,22,841.64
25ce9693fc174063901b2e4bd9e4db36,351,312,39,North America,21,2272.37
25cfef90fe0345989fb733dd6f1c4bea,109,58,51,Oceania,19,430.08
25d0bdc3de2d40fa9d6bfbffcd4c9972,365,324,41,Asia,17,1653.43
25d1002f39354dfcaeb269e3f4583608,92,38,54,Africa,25,374.9
25d58eebf4b549f180999d4449490a04,363,363,0,North America,17,2985.77
25d8c45f54ff4a748ec8b158df7f024a,64,20,44,Africa,17,177.52
25d9ad563a694e9abffd997c92e345f6,112,92,20,Europe,19,741.69
25da102acf5c499fa1332596e5693ba7,237,189,48,Europe,19,1162.77
25daa7c17f864152972dd42d33ca4e6f,309,261,48,Asia,15,1625.22
25dc178d9b414df79bcb4c05b712f091,259,239,20,South America,19,1607.16
25dea7989c2f4a509d2db8fb46331046,56,18,38,South America,26,642.75
25e0d9da85f240c19745c7c361a725de,195,171,24,Oceania,20,1313.63
25e1b440789b42ffacbba5a638f96eb9,101,56,45,South America,20,507.68
25e3035157ab4512ae086efe0879603e,302,283,19,North America,20,2819.28
25e466ee07d54b86840a307d8c951a7e,59,15,44,North America,19,242.32
25e7a2774dda4b68884fc916d63a8658,192,163,29,North America,23,1619.23
25e7e46552164de2b8c3fcf33e95bb42,57,26,31,Europe,15,336.46
25e874e4e22b48e48e0df7bfffe941bb,130,69,61,Asia,20,586.38
25e9bddcefa04cb2a06f2d852c711728,265,225,40,Europe,24,1326.72
25ec9e72d4ed466aa934c8df4eec161b,335,317,18,South America,17,2013.7
25ee22fb9e2d46e1a33625c2b5b3483e,204,167,37,Asia,25,1691.97
25ef112454e54018bff76a66dbcbcc1e,309,259,50,North America,15,2070.02
25ef4ceb79a14bb5884cc5659d964f4e,156,116,40,North America,21,775.33
25ef57b9152a430fb28a874ca107c1c6,255,208,47,Africa,21,1762.23
25f3679588624782a2f0752a66475524,142,105,37,Oceania,17,599.12
25f3fd2200fc46ce899bed1ecca8eb80,280,237,43,Asia,22,2050.4
25f537208ee64d84adce4233f7dd9166,59,9,50,Europe,24,256.72
25f55f7bbb544bb8a1f7546285baf719,28,6,22,North America,18,9.34
25f59d771e8c4dbb8afd615b545ff261,275,245,30,Oceania,16,2157.34
25f68ddcb8a5459d8cd46c8a83ae4732,234,180,54,Oceania,22,897.52
25f6eb5bdde14f26bdf2b24d899d876b,96,50,46,Africa,19,661.54
25f714be62c248f78847ecd44485feff,82,49,33,Europe,19,563.66
25f8aa7fb69d4b8d9b0cfe43a0b95841,49,14,35,South America,19,244.9
25f8b27166594048b5725f8d11f1c28c,365,359,6,Oceania,18,2222.05
25fc8fd93def4978815c3ee793b2701f,161,110,51,Africa,17,801.36
25fd81b431ee48f5b1f33b75dda4f9ce,333,288,45,Europe,18,1663.22
25fdacf4d13b4f24954681e65f2005be,91,39,52,Asia,22,255.52
26014792fa34445681bab5691e347a86,101,80,21,North America,22,215.81
260609da23c84d6cabf2d574db47a7ee,141,91,50,Europe,20,969.15
260773a644324b16a4c68b3bf5aac266,114,69,45,Asia,19,909.33
2607a8226e6c4e5fb0949c2a53eb11b0,219,185,34,Asia,16,2120.24
2608564f442546e4a3ffa20f95833039,78,53,25,South America,15,540.9
2608ce34439947fcba6957db94c51825,306,259,47,Europe,21,1789.22
260b86b1d1da46a4a15bbcc5f6ebfa5d,208,171,37,Asia,18,1119.49
260d49c939ff4a5bb37c56a88f98f495,47,9,38,South America,17,289.52
260e1ed0477c4f36a63f8c342a49d65a,269,241,28,Oceania,23,2008.93
260ef076d7314686afd8a4f0a607c0bc,163,134,29,South America,18,1435.15
260f3caf78d74de3a947bec5eb2bbfd2,108,80,28,Oceania,23,587.15
26113b55e7734e0cb410ac4b8c4421f2,236,185,51,North America,16,1120.72
26117f44e55c4e719c51d81dc79aab54,133,103,30,South America,22,833.68
2611b1d7f52d40eda372c41e8773462a,294,265,29,Europe,25,2185.02
26142e0fa2b84891b16e91ca3ef0002c,181,141,40,Africa,21,1094.33
2617792484b44748a91db9b4be675198,141,109,32,Europe,23,1090.8
2617b13ab703419aa4001655cbcb2176,281,245,36,Africa,23,1549.58
2619227673b6453bbb4272a506369fa7,365,315,50,South America,16,1683.37
261a48b9acd34ca0bb36211307d14fac,126,98,28,Europe,23,978.64
261a9093e63046658f3307fbae4dcec1,178,147,31,Asia,23,1312.49
261ac13af38147019565d9cee2c822c8,253,226,27,Asia,19,2119.82
261cfe83c3b9455badec4a3d28cc5e60,178,133,45,Oceania,18,1329.88
261ed9f65f164498a11f664280b803f0,128,74,54,South America,18,610.12
26215525a90449e2ab48803cd16208da,321,282,39,Europe,18,2556.72
2624d1bc33ad4e29bf71dcccf5577aab,48,19,29,South America,22,248.67
2626416e26994db7af15d99f976d619c,189,151,38,South America,22,967.18
26291d3b031c4d14a55393aed06bcf9b,124,82,42,South America,23,672.9
262994b5f0494317b7102ffa0f79eba7,323,298,25,Europe,19,2485.79
262c52b294e44a9f8029f1761578e081,178,135,43,Oceania,25,1194.26
262d011337dc4abebe30b34c65117ec2,255,206,49,Asia,24,1131.22
262d0afa51964070aebb4ecbd4b4e514,151,114,37,Oceania,21,1085.67
2631d7f9c61b46d9984d2d0132a28f8f,229,209,20,Oceania,22,1531.27
2631f254153c4e198353f933153ca4c4,365,338,27,Europe,21,2014.19
2631fcd03ec84884be709bed86004b03,362,325,37,Asia,18,2562.78
263548280c074e22b65007042a638ae6,225,182,43,South America,24,775.13
2639e784d67244eb8c62278d978039a4,53,15,38,Asia,24,301.23
263caafca3574f91a58e436601f20775,106,58,48,Africa,19,804.17
263f9e15aa5f42d0bcdd1f836d4e2b96,225,184,41,South America,22,916.03
264015ddf81b4041bebd724b5c6d6826,361,322,39,Africa,21,2906.67
26413dcef7fc48fb8b3eb706ca171ea1,240,218,22,Africa,21,1545.25
2643951d8ad04ed489272d0ea7a92bb0,103,78,25,Europe,21,1507.6
26447f9c63404694865f776566e2ad3e,219,177,42,Asia,20,1447.43
264932189f844d55b4467512a070d58d,291,258,33,Europe,21,1882.31
264cbf8a04fa441aa43877fe5b12061f,197,171,26,Oceania,21,1580.88
264cf15b03b1472587b024352ec3934a,67,39,28,Oceania,22,803.11
264d3d1784a841598277bb3777e3cec2,260,219,41,Asia,20,1755.27
264eb0cf693543669a236b5944d8a871,350,302,48,Asia,22,2024.47
265031de7054443699480e4dd3c13997,234,214,20,Oceania,22,951.13
2650e1f74ca54235a2ba85b0d8a76c01,284,268,16,Africa,23,2110.94
26511fe71b6946359c59abbea8ea31cd,209,149,60,North America,20,1198.09
2655daac1b154d26b5bbc78463b04e28,307,261,46,North America,25,1487.26
2655e9cb5b5447ecac46b02677651523,47,15,32,Europe,24,444.34
265640aa3fe54669999cc876161fb084,222,180,42,Africa,20,1687.16
26582c6a5601471f9e014c7682c41bca,66,43,23,Europe,22,759.54
265f1ef349a5462b8ea0f44aac03e5ef,191,145,46,Africa,19,758.24
2661d58f0a5b4327a98816967cdb827d,279,234,45,South America,18,1553.46
266247a283d74aeba9fda851df58edec,197,160,37,Europe,32,1888.23
2662a31f79b845b0b5d8fe278850d5ca,364,342,22,South America,21,2177.19
2663a0dd4a40421cb46a592930da2fe5,352,310,42,Oceania,23,1591.55
2665405ba6d143a4a835cfc8ab95705d,364,329,35,Asia,21,1892.47
26669172dc6b498194121ce77b51f7a5,54,39,15,Asia,17,557.91
266cbf4951944ca6981729e53969d5d2,108,68,40,Asia,25,426.84
266e1329ed904675a7003b6b68fcd93c,250,222,28,Asia,26,2302.63
266f006c80434fc1b27718c2dd94a497,250,200,50,Oceania,17,1543.11
266f815714df4e21ad2ef2531453f44d,78,43,35,Europe,16,358.42
266ff0caf91d47a88cb2cde8369cb245,225,187,38,Oceania,24,1563.41
2670119323dc490bb03f799dc0721b72,139,101,38,Asia,16,645.22
2671ca392016460291d20e53821f4fda,161,126,35,Europe,21,1010.26
267555d1f3484b42a3ddac80f6276a25,287,257,30,Europe,20,1457.28
267717072d9f495c948fda934883946e,247,225,22,Asia,23,2308.93
26795130f17440929f7da81a55eb14ec,235,198,37,Asia,18,1855.71
267bbc3fd676462da4e2ac73f47ed26d,218,182,36,Europe,18,1503.04
267e14592df74a91b049e25d7e988f51,361,337,24,Europe,15,2614.52
267e2962c4144358b7f2c5bcf82cf974,219,182,37,North America,18,1014.28
267ea5a715cb42b5b532bf9a34ccdddb,99,48,51,Europe,16,642.57
267fa83f61ca4563bb98dc4693bc3242,263,213,50,Africa,20,1479.46
26810e43a8f24c95932a3f464dec4351,87,56,31,Oceania,18,589.66
26816e8f85bd43e2a6816556ff453ebe,268,225,43,Asia,16,2049.09
2682e36cede54542b4de9630d7bd2119,296,267,29,Africa,27,2394.75
26842266661b4b359ad5ca20bb8425e9,299,278,21,Europe,19,2206.02
26852dc094f84782a7eb158aff99f77a,347,305,42,South America,27,2373.96
268681b0ffc44b73a888a6673e992390,139,116,23,North America,17,1162.54
2686b50620eb48fb943047f79a6a544e,283,256,27,Oceania,20,2861.01
26886516d5da426da792072d930a3cd8,66,20,46,South America,20,208.64
2689875ee12041f38d94ee1e9b37055f,96,71,25,North America,20,1008.84
2689a8698c0640349a79e532aaf5f265,253,222,31,North America,20,1496.11
268b494c52bb4e23be964fd20c006516,330,300,30,Asia,20,2370.18
268b7225e42e4d68bab7c5bd98394391,194,168,26,Oceania,18,1343.55
268d2d38c8744861a2b92c772489ef6f,299,272,27,Africa,15,2302.05
268e6c3f5bc842d8b48dc99c147e848e,335,289,46,Africa,20,1823.52
269164f64e21454c89a1db66126bf8a8,43,14,29,Africa,18,83.63
26919185926c43f5af76621080598c50,219,176,43,Europe,21,950
2694afa3f5e54cb6a21803a4a4a728cc,157,129,28,Oceania,19,1496.71
2694f25acbb1435085c6467e40b53b65,174,129,45,North America,13,929.75
26950f7239034a8ca95b4e94484d0236,120,106,14,North America,22,1083.08
26976bd26a404d57a5b0e7045802c61b,365,341,24,Africa,24,1843.01
269a4d9862d245d182e6c632f6a48c53,142,113,29,Asia,20,873.01
269a929c9fe342f793e2abae420e7a10,155,116,39,Oceania,17,923.94
269c4970efd54872b46105bbbb5090a6,31,4,27,Europe,21,270.88
269fd97760bc408eacdf03bf77f232d1,185,155,30,Africa,23,1299.91
26a4128dc65f4821ad6720bd783991d3,364,355,9,Africa,15,2085.88
26a4313022ae4320a626f8ff876b5681,322,288,34,Africa,19,2052.75
26a49206f5c54d78b00931c236e85b31,189,141,48,South America,24,847.19
26a718b3d43b4fe2b3e5351eefed9b8a,114,67,47,Asia,17,661.93
26aabc9a8dc94613b8e628549d78d9e3,365,338,27,Oceania,25,1559.33
26ac65ace2534daabd78f8e95c658b40,93,69,24,Africa,20,563.29
26ac6fd5ceb74923a5b531ba03216f9f,202,143,59,Oceania,20,1049.53
26acbe450dff4fc3ad63a662a8f697ac,259,209,50,North America,19,1210.14
26ad604ae16c4ae599b3187c1f998b52,176,147,29,Europe,21,1431.56
26ad80dc98984a68b0ce48d2d4a3d85e,274,246,28,Europe,20,2282.11
26ae6bc0b7d847e4aa06b7dfef1adf27,169,138,31,Oceania,18,1220.19
26af2f490299408cbc175bc7a6c37da1,245,222,23,South America,21,2079.39
26b12072424649bbaae674b065c1fb81,245,191,54,North America,17,1171.51
26b297ae88904cb396ed27f0e79870ab,342,308,34,Asia,21,2431.32
26b4012aad724562b6c0cc3e71ce2484,280,261,19,North America,21,1876.22
26b81afdd61d43f2b5b1802745f5b893,95,45,50,Africa,17,500.87
26b877334b6343519afef375d3d8bcfb,294,254,40,South America,17,2514.13
26b890c24cca4d93a5bb4312893c9157,90,55,35,Africa,20,712.64
26b9ba2820164c8bb0763c1dc77274d8,146,122,24,Oceania,22,1003.1
26ba76f5a85b44bc90161d2ad47efde4,174,152,22,Oceania,19,1129.33
26bb2ece74bd477f88395e11ce3936fe,144,113,31,Africa,22,1046.51
26bb70cf062b4bab8fc851079e168f6f,101,73,28,South America,21,615.12
26bde453670d4a3b89e92d660d09a791,133,80,53,Asia,23,875.17
26be54b8aa92424e81eb0bcc05a4c6b4,64,44,20,Oceania,24,340.66
26bef0c37b8f4ccc93ab1631cee642c2,283,257,26,Oceania,20,2526.19
26c5503af7e44170906a94cecd72ad73,327,291,36,North America,20,2759.23
26c9318c65594c4e97861d4c8c692544,203,163,40,Europe,19,1707.8
26c9826ffc2441a8852d378f1ab8f61e,273,228,45,North America,19,1115.06
26c98f60d51c4709ade1ebbb474fa259,344,321,23,South America,22,1632.06
26cafaa962894023b8e08137a0565c1f,145,94,51,Asia,24,720.23
26cfe7fdafd64cbab885cde1b4148db8,364,327,37,Africa,20,1340.31
26d20c0acff34a4d8f948ed7372dd431,269,221,48,South America,16,1447.24
26d2c9649b1b45bf93ff70be50470c21,289,264,25,Asia,20,2339.03
26d44872413f4870bf73225fd5607310,365,358,7,North America,17,2719.35
26d47e172fb947989b7218be2ab68fea,112,66,46,Europe,21,307.31
26d546d64ca84368a266b10fba18e003,217,201,16,North America,21,1480.2
26d65521b4c8406cb5eb94fd08e16a25,364,359,5,Oceania,16,2170.3
26d6d6be3e0b4869916782b8bf02095d,87,38,49,South America,20,301.82
26d8fa0b8ac6456f9c8278750ca0efb5,50,14,36,Europe,22,309.48
26d91ac2924a4863b653e72cb982e8cb,189,164,25,Europe,13,1339.49
26d934b576e44d30b6a6b92e03766ec9,287,234,53,North America,22,2052.36
26de384ac99f49ee82927850f179ccf9,363,331,32,Europe,18,1846.63
26de7968f08e46a1a892042e417ca8a8,148,119,29,Oceania,18,762.41
26df0916331a45768fdaaf17cf3130a0,57,14,43,Europe,19,392.89
26e0695dd8ed489ba029eaf598b0a6ef,267,216,51,Europe,22,1731.96
26e14c337fff49889b480cdedc7ac8ac,358,328,30,North America,18,2575.55
26e1dc0144464d8d9e4bb083f2752cd9,64,20,44,Europe,22,327.06
26e4ba4384a646399d13c37927261ce3,57,10,47,Europe,17,279.82
26e5c1ee30d74dbb9ceea82b3e7c745a,288,262,26,South America,16,2795.95
26e5df9dacc94a24941c510912fd4f24,279,220,59,South America,17,1690.63
26e64910de56433da9168890cb1fa0d6,299,285,14,North America,19,2365.55
26e77bef4ca9439b917435c91f36062c,365,354,11,South America,24,3112.52
26e866b88263496aadb13fc135e89b6a,62,30,32,North America,20,450.65
26e9cd337896495e855247437eef29e3,285,255,30,Oceania,18,1556
26eb787abfd04a41bd37276746ed9c64,113,79,34,Africa,18,917.35
26ec3a05cde94307bbece08945604179,248,225,23,Africa,21,1501.3
26ecda95cbe04c27be684213c94009ba,307,278,29,Oceania,18,2079.29
26ef58265c974417b867a54966a3e5ad,319,275,44,Africa,21,1988.87
26ef680ff29945f4a7eb38054e919d4b,147,109,38,North America,20,1465.9
26efc54199eb4f77bb17b1b1a4825568,103,64,39,Africa,19,554.36
26f1ea852b544682970ebbc250394765,110,64,46,Asia,18,734.71
26f268f5db50414e9e4f6173965765f9,107,75,32,North America,16,684.5
26f6985336be491ab39e5db18d56a6fe,73,27,46,Europe,23,359.41
26f7273e9432420698b7c1d6d95bc389,89,49,40,Africa,23,621.78
26f8cbf9ae0c4498afef561e1837238f,243,197,46,North America,24,1249.16
26f9483c904a4218808e2ace3b764474,365,359,6,Oceania,15,1933.51
26fbda24212f492eacb09b3e6667adbb,275,227,48,Asia,25,1132.99
26fcc90ca0ed4be2983289cb490de260,365,329,36,Europe,23,1890.32
26fe1abe9ad142c594c1b5515cbe2be2,196,164,32,North America,25,1134.35
26fe370ccb4a4e84a8fa45808c28f9ce,260,235,25,Europe,22,1225.59
2704d032324b4678bfdbb8162a248d13,362,304,58,Europe,21,1614.25
2706fe882e0c47a7914d68e4b130013d,141,99,42,South America,25,798.95
2709aab36ea74ed59bac0f10cce8b07b,262,245,17,South America,21,1343.93
2709eb96ac6147d8aec778f26c0db007,291,238,53,Asia,20,2011.55
270ac18263cd45f992c3d0a082ab11bc,230,194,36,Europe,26,1449.33
270b029a6f3647da903d983d371c3a74,33,6,27,Oceania,17,399.54
270b425e53b1437ebcebb03bff4d8267,190,131,59,Africa,23,1174.11
270f886ca4994a6f8a367d6224ae802c,178,139,39,North America,23,1203.95
27130eae5a6b49ac8010ed037da17d9b,73,38,35,Asia,19,636.21
271394e807ef46b881092da04953a890,171,138,33,Asia,23,1187.81
27163147b041462498a64ec3ebc8adcd,362,332,30,South America,24,1844.07
271745e7d95148d0a7ec39e4d79e72d4,168,129,39,Asia,18,1094.19
27187b1fbd75407198997dd6407b404c,265,250,15,Africa,22,2215.44
2718ce8c9eca4b0b812eced4845c349c,53,17,36,Asia,22,570.32
271a1d2e0e364720894695ab543abf66,309,295,14,Asia,17,2495.28
271bac4b5f1c4889a83857ac86137430,255,232,23,North America,14,1718.75
271e6fe6e74a4359ba305963c867e899,40,16,24,South America,20,362.06
272039512a7c45f78b1fd9fe6f5cf12e,70,24,46,Oceania,19,341.57
272220f6316f443dacf18bead551dc17,328,307,21,North America,24,2417.99
27230db916964a53b0593caced77e4d7,364,351,13,Oceania,20,2170.43
272322866bfb46d0a118bd30dacd1f67,153,107,46,Asia,19,400.81
2723a8e945644520b644566f7dfe6104,323,290,33,Oceania,20,2422.47
27262704c4274843bbc2fd865dab0243,127,103,24,Europe,24,1036.61
2726abefb1d84e278e2bd30bee885e20,314,297,17,South America,17,2347.96
27293a8788284b55ac3da28036f1f9ca,78,44,34,Oceania,20,705.57
2729e0752c7a4030af5a2ee08409a40f,212,171,41,Europe,20,1652.48
272f48e880b5449684ee8bd05f01a830,290,243,47,North America,13,1419.23
273001b111624e2da2f662ee8e7e0357,137,91,46,North America,16,834.05
2730b700d8ca40eaa16001aeba21154f,353,317,36,South America,29,3183.73
2735d885d60c4555a84245aa7827792d,138,78,60,Africa,23,423.16
2738154ff0f9483a9ff61f144c2165e8,198,151,47,Europe,29,1009.28
273863996a914c878349e847be68a599,84,47,37,Asia,14,584.28
27388fa0c5f542359ce19440cdf8a805,144,111,33,Asia,21,1163.04
2739ab7a737549d1ae0bc9b43e13d3fb,122,74,48,Africa,20,419.12
273ab1fc6a974c8c99f65a26206cda21,126,103,23,Oceania,25,783.71
273b13c0ab7e4b89adfe13eb6e91b9f8,281,224,57,North America,17,1320.01
273c4a608fed46dea986fe78e007a627,338,289,49,Asia,23,1969.04
273c97faee2548d2b49d7140fea151ef,200,155,45,North America,19,1472.89
273cef2813d2412687210c5d95ef50cc,365,344,21,South America,12,2283.23
273e8d8185034569b306bead42b4f58d,279,233,46,Asia,21,1765.37
2740633903bd488ab19fa20032445710,365,350,15,North America,22,1693.57
274259ddc2534fcaa8ce529f8477566e,196,141,55,North America,17,733.61
2742c203c3d847fbb435a85c808c8ba3,126,74,52,Asia,18,654.89
2742f6cab1ed4410bb4884b6438cc740,364,337,27,South America,23,2210.16
27432a0ffeda4b889fc312990b19bcb0,327,291,36,Europe,22,2167.84
27439082629b44b4aa37cb55a2312ca0,364,336,28,Oceania,20,1194.42
2744428206ff45d5a9bfdcde36a57b6b,263,220,43,South America,21,1282.11
27496ee1436246ce9e3a7a5426222ce2,347,320,27,North America,18,2897.93
274d90fcdeee4abda32bc02640ecfe81,103,55,48,North America,20,421.79
274e7f04f8bd43fdb3854e1efc515f2c,315,294,21,Europe,24,2268.08
274ef6b58675400cba39d59104ec336c,153,106,47,North America,24,591.89
274fa6f1a1e648e7a47d2744f07357ea,235,186,49,Europe,19,907.2
2750dad3420e4154a6df30a13dd298cd,319,280,39,South America,18,1929.26
27525b7b5cb04af08f0bce71439e1d58,223,198,25,North America,19,2486.69
275921f865d84cbe95f714fb56fcea57,365,361,4,North America,19,2753.94
275a37d5f8324077add5845116215f01,165,133,32,Asia,19,1115.34
275bbd52a74448a98600a2e59fd7347f,89,45,44,Africa,23,385.2
275dc6ecc055458081d453ddd1c31984,89,50,39,Oceania,17,743.59
275edffa90be4490b3b467124cd8e414,193,165,28,Oceania,18,1235.85
2761f9eef9c1456c8f741f68323e1179,214,165,49,North America,18,1353.74
2762039169e84070bfc0e96daf203fda,150,136,14,Oceania,16,1089.28
2762fd1f1914487d8e352e453c7f2af0,192,142,50,South America,19,1048.67
2765d9da3d054e3ba950efc57a2a62ed,56,25,31,Europe,20,407.37
276870a9e1144f4a944477bf9cd9eda2,216,169,47,North America,22,1073.75
2768d09d9deb40cca9027d0ba7b65d92,270,218,52,Africa,18,1985.46
27693891b56c438ab97351a338bea3aa,84,60,24,South America,16,692.55
276b43fd824a431b805e7a74ea9336d1,278,231,47,Africa,23,1257.03
276ca2a72a114dc6aa348beaeef33815,237,206,31,South America,21,1919.5
276d0bee72304938a245ae7403205d77,171,139,32,Africa,21,947.36
276d30170109410ca33305d5559f7ae8,145,93,52,Oceania,19,633
276d703aa79d4e9887a151899549b51e,364,348,16,South America,16,1125.87
276e215c4f0b43f9b9e89232a6e30e20,266,232,34,Africa,23,2015.47
276efaf502f9441d8b6f71cf755a5b92,365,360,5,North America,20,2708.46
276f7a37305445f79cf747e70e399c92,186,155,31,South America,19,992.05
276fea8023ec46858fe4df47142e48b0,223,175,48,Europe,26,958.86
277082d9ff7b4337bcb6cc386d88d1dc,281,256,25,Oceania,18,1790.39
27717d830a9a481c96432b52771a7f94,270,223,47,North America,16,1276.37
277270e60b8c4c9c9c3e59c917a58c1a,146,109,37,Asia,20,850.89
2773e04e547e4469847748a5771807c0,286,248,38,South America,22,1890.33
277550790498481194c7220fda917b62,365,315,50,Africa,15,1823.11
27779d2fbfaf4c72aeb6d99e79ccc729,329,282,47,Oceania,22,2323.93
2779addb49a2439982d36961ea9f4f45,331,277,54,Oceania,24,2168.87
277a369a2d5f4796b1c394df97a61770,63,27,36,Africa,22,458.18
277b2ad2be324156b84f1316c3753595,364,320,44,Oceania,20,1669.49
277b9c31e1aa460f86478821bbe1bf8b,117,68,49,Europe,18,648.9
277ba7c45467496382df19a145675e9f,153,120,33,Asia,21,1386.48
277babfb074c46bf8fa1ae5fce61d324,360,324,36,South America,17,2745.5
277e74744e3f419fa318531d67d7a7ca,197,155,42,Europe,19,1703.62
278466a72ab2429ca31b0b312ffd74c0,63,21,42,Europe,17,348.34
2784d678ae1e4240b00686e7cc815dfd,231,205,26,Oceania,18,1405.33
2785ecf70a924d5c91f92294c141c83a,285,227,58,South America,18,1375.37
27862a92914b4bc3b83713f21a615b42,365,322,43,Africa,18,1657.62
2786dbf167624cfa9da80f7d71afb2f7,365,348,17,Africa,21,1783.31
2786e27d753a406d9cfafdbbc7d1bb53,153,104,49,Asia,13,1004.83
2787a7ab69d544e5a9edccfb1d2dd889,295,262,33,North America,18,2005.66
2789e3df54744ac9b3d9314f24a3b513,350,318,32,South America,20,2526.84
278bde10507246cfb558a5c2056f1c03,207,179,28,North America,18,1719.27
278d53ee04f54144b3a6dbce4c19a1c5,215,169,46,Africa,18,1548.5
278e909865e94e44812af04e49cfbb9b,193,140,53,Africa,18,1643.86
278f6f0fa4a24c73a48b73217672c24e,119,79,40,Oceania,18,514.15
278fcba43c514feeae9ee9a1ac0910c7,142,105,37,South America,18,1067.57
27905719a5a44ab8a6bed2fbdc6cb5ec,23,2,21,South America,19,98.28
2790def8ab494a99ab4a8108a677ea73,356,328,28,South America,20,2745.88
27912ae87ae34c92b6024099c8c7ad3a,263,216,47,Africa,21,1335.56
27924f49435242479ddd157154552cd1,144,95,49,South America,16,917.85
27935d2b72334abfac22364bb961a338,363,340,23,South America,24,1882.02
2793bd459b6b4d579155035b65addcc9,55,9,46,Asia,17,311.14
27949a2a698a45408fb556cf9e61c3d5,364,335,29,Oceania,27,2341.11
2795039bc76244ac921f096891af572f,113,85,28,Oceania,15,760.49
2795ac7450954dbeb64d320e1f2b4fa1,325,281,44,Asia,24,1170.35
279a4405e55040f1aaa3b059e924b4af,198,149,49,Oceania,21,1401.12
279d4cbd000443da9935aae055677360,109,76,33,Europe,20,641.68
279ec215b32e42eaa7a13d2eccbd95a1,253,218,35,North America,22,2134.07
279fec4d8b0e43f3b8a8e7143b368474,58,29,29,Oceania,19,478.81
27a1c6bf6ce548afae0d16538585ddf8,130,107,23,Oceania,16,1075.24
27a1d45c36fe42f4b7ae22a9735b4aa4,162,115,47,Europe,17,791.47
27a20b74d4004235a5e612a3aa43d28f,343,327,16,Europe,16,2218.63
27a27797f4af489c8105833c3bad440e,302,252,50,Asia,17,1347.83
27a2e26a49854b97af6fbc81b9139c7a,334,298,36,South America,19,1805.75
27a73d08c5ec429cbb0264d5b5c4e03a,361,310,51,Oceania,20,1321.07
27a74ff590d945a3b792cab54249182f,221,198,23,North America,19,1555.17
27a89c4b484d4e3dab57fc4769c803ed,215,187,28,Asia,20,1213.95
27a8ae28342046d396ea3646a193f857,365,333,32,Oceania,16,2258.87
27a9d17f17ed4bc09d8ec6ae48dbb5e6,154,95,59,Africa,17,662.44
27ace4b53faa445a91616596ad4e4b9b,179,139,40,Oceania,20,1067.84
27ad0e1dcf19441c95934c74abede3d5,160,118,42,Oceania,18,800.81
27ad8a2526ad4a2b997dcd7478bc362c,141,103,38,Oceania,19,622.79
27adbb86cac5456ca6a43f76377bc66c,186,153,33,Africa,23,1007.3
27af050a0ec84378a499a084f8b02e00,110,67,43,South America,26,811.3
27af1b9240d541faa37c1d6233aa5a49,208,182,26,Europe,25,1526.59
27afc12e2cc6465bb55b033bb7267a5b,217,174,43,Africa,16,854.24
27b2a1a4d8f34b359ee487cd1b2faff5,132,95,37,North America,13,804.54
27b3c4ff18814eb98d6adc885478d468,120,92,28,North America,26,594.98
27b46b759cda44e5beece47b7ff2818c,365,325,40,Asia,18,2085.73
27b79175f5d6442bacb5d0a1f4061d0a,290,253,37,Oceania,17,1564.11
27ba4f07c89b43178754fe855d4f2c8e,283,258,25,South America,22,2497.62
27babc8eb55a44749be25120cbcecc0a,246,208,38,Africa,16,1558.7
27bc5cdd913646519d18fa4e4c302019,176,148,28,Europe,22,1760.19
27bd7fe23fda4bb9bfdad75034acae44,313,291,22,Asia,19,2255.51
27be34bdfcd54d3198a94db21db3f932,335,299,36,South America,25,2393.88
27c0410a77914c16913f254c7e83e25f,223,180,43,Europe,19,1831.52
27c2c22e4ed6432a8bd2704064ecd1da,132,96,36,North America,19,851.86
27c39a828da949869b23471503319000,137,105,32,Asia,22,1075.31
27c43553affd4438923e6509398797bc,302,271,31,South America,19,2123.75
27c43deddb3c4dd1a06003d27ec3af7e,342,310,32,South America,21,2346.16
27c47fa2f5f94ce3ae1029687b514d1e,172,118,54,South America,20,647.13
27c6a57de1c747eabd65b080c4452db5,331,296,35,Asia,23,2409.36
27c76c07df4c4a5fa1105c612afc4e8a,365,340,25,Asia,20,1793.16
27ca2031fcd84ccbbbfb0459ec219e58,40,7,33,Asia,22,109.85
27ca9fadc40a44728b44095ec609c126,150,97,53,South America,20,1023.28
27cb220e778246f3acfe8b00bdeac064,332,276,56,South America,24,1627.03
27cc2922f2fc4f3cb172ff8a2dc69e2a,254,214,40,North America,22,1609.03
27cc496a9d8f417db913408a958ec0af,348,310,38,Africa,20,1941.43
27ce73771f2945e19b7d79aed982294b,68,28,40,North America,15,689.8
27d03c4e90b24657a7c52f6adad586ee,217,167,50,Europe,17,1006.94
27d1f12410c842d2b1e430707f91a511,220,182,38,Asia,18,1237.49
27d2aa10f82148eeb3532f1d80956d30,40,6,34,Asia,21,288.52
27d3433e8c1c49ed8ec34c26e15551ec,59,10,49,South America,16,171.97
27d4579e90df46cd86eb806f15bb89f5,52,6,46,Africa,21,94.08
27d842216b09445cba8d5b5f3d587d76,165,124,41,South America,19,1379.76
27d8f6a3701c4192b391caba02a3ffb1,75,34,41,Asia,20,951.55
27da4be933ba4efface40214893d6b92,256,207,49,Europe,18,1425.24
27da767d3c614e10bb63c27e070db02e,34,9,25,Asia,23,472.04
27dd2f1c50784b4b82d13b12bb3b2249,269,222,47,Asia,29,1348.21
27dd7d8ce00b4d6cb32576f393e29b28,220,200,20,Oceania,24,1877.43
27ddd7361c7d4fe3a59176e1f49a596f,95,68,27,Oceania,22,635.62
27dfaf76d5ba4c17be47aaec102c6484,96,50,46,Europe,16,460.48
27e187bcdcc048558f5eaff001ec04a5,123,76,47,Africa,20,698.3
27e1a928362e4987a94b2265fce96903,279,254,25,Oceania,19,1967.91
27e2e39b88f043f8bcc915bbbbcdba52,278,224,54,South America,22,1184.77
27e3de3ebcad4beebe17bf6debec6e76,120,59,61,Oceania,19,928.77
27e44999cde2484e9ee03ec94d65ddee,93,49,44,Africa,26,631.47
27e4a65d05f54ace993bd33606b66d88,178,141,37,North America,17,1306.7
27e4fd3613294aae90e1a7ca33bbe3cd,334,277,57,Asia,18,1636.05
27e6be5747eb45ec99ba7ad823523eab,153,129,24,North America,18,1083.01
27e8642510f6413f8e75ef4d77af7b1e,160,126,34,South America,14,999.09
27e8a17f5d234909ae6f16ac02b02249,308,254,54,South America,25,2017.68
27e8d08837dc4684add0814b993bdd6c,361,314,47,Asia,18,1585.47
27e92049cb6f487da577acd3778b828b,99,50,49,Europe,24,433.97
27e9992408444eb6afc6df56be9164c9,337,296,41,Oceania,22,2133.22
27ea589e8115484b8544012b4e2c5334,202,175,27,Oceania,23,1357.6
27eb548e9ca54df2a39b17006fe68a13,291,252,39,Asia,23,1815.21
27ef20ab7ea74155a7a4eb29666581f1,204,161,43,North America,20,1479.16
27f0919fc37d4b88a7347509f4bdea66,126,105,21,Oceania,21,603.22
27f1e4b485c9481e93eeb02117810b8e,78,53,25,North America,21,507.86
27f2fdf969d34356927e436e2ac69b46,293,242,51,Oceania,22,1928.77
27f4979e01b9470fb5cf91c609cc185a,187,157,30,Europe,23,856.33
27f81234232848658b94bee3aac9727e,86,45,41,Oceania,16,465.44
27f8498016024adcac8dbf0777354ab4,361,317,44,Africa,24,1300.66
27fab7753f81477db7b04e495e6f8da2,136,99,37,Africa,20,1142.45
27fc261466974f7ca9358c25d91b196c,362,349,13,Asia,22,3022.14
27fc4b6383fb42178b9922ab173ecaf2,169,140,29,South America,23,1311.55
27fe4a4913634239962f9b883142a1dd,245,197,48,Europe,20,1211.98
280013e002f645079a23ae2039822b38,145,120,25,Asia,20,1390.06
2800ca0777424d72ac8234ac1a8e5a52,84,36,48,Oceania,16,569.68
28040cc4035141f8ab0617ca50b1cd4f,254,238,16,North America,21,1799.23
280428d0d0de4655ab2ea68a373b6c97,77,45,32,Europe,23,443.52
28046dc1db924fd1aa2a21173445733a,119,81,38,South America,22,895.81
28048f331aef4ef99d1c0e6efcebffd5,311,271,40,Oceania,16,2026.09
2807c781c0894580a6802fb208868907,172,122,50,Europe,17,1414.78
280bc123e88e486fa0000218e03ad664,149,125,24,South America,19,1218.32
2811f2fc6a0f4e0ca5c2cf77efcfb9f2,315,290,25,Asia,18,2837.88
281233318b4343f2980b014994c4a8bc,216,186,30,Europe,19,1993.99
28133ad942e640aa82958c65f665d2b0,221,202,19,Asia,20,1841.47
2816ad7e473a4d16b6c26ee391a6915b,155,109,46,Europe,21,448.93
2817823d3d8e4daf856cb6d2250d8055,166,110,56,Oceania,20,912.65
2818f3d8f7d449099240b165f7856c67,298,267,31,Asia,16,2556.92
281dd44813aa427191b52af2e9aaf7db,365,337,28,Asia,18,2029.92
281ffd52f3a54a9a9381cee4704443ef,365,364,1,South America,18,3330.84
2820f3b969a746328c80e022956f8719,334,280,54,Europe,19,1769.56
2821046775464df0a1a3a883bdade493,218,172,46,Europe,15,925.51
28223928fad24931af61d1f4ebdbd352,95,40,55,South America,20,299.33
28228cbf0cf94805a8a4004050fe0365,207,159,48,South America,18,1177
2822e9765f9249a19c4e0095758c044d,139,92,47,Europe,26,1043.29
28235cc6d9444e509a19fe274d6873c0,270,248,22,Africa,20,1966.07
2823c75a5fc54e86948040d741f777e4,85,42,43,Africa,19,193.53
28276ea408234e1b8ac790bbf8c2944a,111,83,28,Africa,22,672.38
282dd1b201bd4c788a78a4c8761d283c,226,176,50,Oceania,25,1265.35
2830d4bb0c3945af8f61b735a3a6c488,220,185,35,South America,19,1365.43
28344313bac148bbbaf2d2626ba3a8ff,365,331,34,Asia,23,3368.11
2834a459df484dfdb95799a1a36fee90,137,98,39,Africa,24,1329.13
2835c5eacb354782ae75700a3fc48234,57,18,39,Oceania,23,439.06
2835f89f25c14b7b808d89c69d59db22,365,336,29,Asia,20,2505.17
283767ca8f6a4ca09b7991cf5e63cfc1,268,219,49,Africa,19,1379.12
2837bad79b5e49e4830a536d873af27e,109,57,52,North America,23,466.42
2839f79ff0c842d99627b5f582605bb9,54,16,38,Europe,19,499.86
283a15288eff444e82cd2c3f1e4363b1,80,32,48,North America,21,482.68
283ac7abe56043cf9a9eee4ceaa1beee,336,293,43,North America,12,2296.32
283ae39a5ed24da9ad02005dc848ae9a,182,158,24,Europe,22,1585.95
283b9ba02ed24b29a347fb2ef4f4c5ad,321,285,36,Europe,23,1894.78
283c20ef36194297a8425978eb6be643,286,255,31,Oceania,21,1782
283e5dc6a60747c39dc6e0acac540ed9,99,47,52,North America,23,577.5
28402098722e4b1f9e97c943875cec54,362,342,20,Africa,17,2796.24
28416c046bb1469f95d5913c3b35379e,236,187,49,Europe,17,1397.81
28435c1c6927489b83a82df81895622b,293,260,33,Africa,15,1957.61
284388f59fbe411c852c08c08fd5f3b4,58,38,20,Africa,21,432.91
28455322338144ba83454e76bf0b55be,289,247,42,Europe,18,2351.99
2847179d171147faa9cd072d970409ea,173,119,54,Africa,15,1198.78
2849a79bcc274faea2df2feccd2ba209,340,321,19,Africa,22,2667.17
2849bb760a06411f90664699a9176d4d,20,4,16,Asia,23,82.46
284d500a84a84eedad449c0a99acf564,365,354,11,South America,17,2477.02
284d6e1a7bd74d16962e1d044d998a50,153,98,55,Africa,23,1050.44
284f3063e1b5418880c76b86f3e50ed8,230,213,17,Africa,20,1229.86
285164a5883045478605e4eafb3018f2,365,353,12,North America,23,2600.16
28519bb0ed13482faf6f48320b884e64,130,101,29,South America,20,1472.22
2854062cbfbf4cd2a38d0f0b12c445da,241,214,27,North America,20,1707.19
28591ede940c4744b3705304535e970b,129,82,47,South America,19,337.96
285afd9f83db4d988e58f86e31c744c0,105,69,36,South America,24,520.03
285c9c6ea597477c882aeba721cccf63,83,55,28,Asia,21,434.22
285e47e4d8bd4c919c3fa6e67a621f6f,340,310,30,Asia,19,2214.85
285eb6f9e2fe45c8baf2da333ae1e2fc,146,123,23,South America,20,610.72
2860d417717640dca8b9b12d5ff3ca5c,167,132,35,South America,22,1091.47
2861fbb72b0649b1bf50d854e168439c,169,119,50,North America,17,750.03
286832022bee4b87adb71d70880fe6b7,333,283,50,South America,18,2830.41
286835c012ec46818ba5c5c4e3015b77,94,62,32,Africa,22,1021.55
286988b68752471ca169ea926ba0e78a,318,267,51,Africa,20,1403.1
286ad4945b0a49a68d70097b0993fcf3,81,58,23,North America,21,479.34
286bfd881b964f65b0e75d47f5e543bb,234,197,37,South America,22,1571.46
28708c878c3f4f68ab083a439ee0d9b8,77,19,58,Africa,19,250.17
2870ba517581436eb68724c6bef3698b,77,54,23,North America,19,743.96
2873368108f640ddab0140aad06aa7c9,358,335,23,Oceania,23,2390.19
2877b70b6ba04a40bd2004d1ed0cd131,69,34,35,South America,18,358.85
28785c49c87f47e1979b3f0d119f73dd,100,49,51,Oceania,18,406.4
28799814a1604e5e9d7a885966aed35b,303,262,41,Asia,17,1523.24
287c4eafa8354608954ff7dc39a73e7e,66,43,23,Oceania,22,568.46
287c61c4922541edbe62b9bf90d2eff2,183,154,29,North America,18,1362.18
287c82b73380473b872d7305fd80f695,282,226,56,Europe,24,860.54
287cd04d9a5e49d49da74adcb7af617f,199,147,52,South America,18,980.78
287f02cdf8c245a59ea42556b298f920,200,153,47,North America,21,833.54
28819484cdba4db88291014c7a8b8566,120,91,29,Africa,14,786.77
2882ba38e92d4799a19fb46419568af7,313,259,54,Europe,23,1456.8
28838f2e1d0e4c1db6b99eded1d0bbe7,77,55,22,Asia,24,726.08
2884d8a98de744e9a85b546f31600c6b,350,290,60,Asia,20,1748.85
2884f72c274b401697ceb29ea535cddf,273,247,26,South America,22,1912.83
288587e3c06448c7a0075e41e9e449e5,307,257,50,Europe,18,1638.37
2886258cf5884ebd8cc6af3ed2cad58f,333,301,32,Africa,22,1620.03
28897a3d37564115bb8a1ef1902d5d00,40,2,38,South America,14,273.39
2889d6300b864486a26d118dda766f48,259,228,31,North America,18,1258.61
2889f121b18541e7af336dd29d1472cf,364,357,7,Oceania,19,2260.34
288bfece79cd40f7bf56c6246891a55c,134,89,45,Asia,21,864.17
288c1fbfba874718af77c94b212ed17f,194,169,25,Africa,20,1724.69
288c3a7282d24a63a366bb280a8facc5,321,262,59,South America,24,1205.64
288c5ac6ceed441791d38c8d6b235b29,232,180,52,Europe,19,1023.63
288e36925fb049debb3f603e8c7a3b0e,357,315,42,Asia,17,2226.89
288f04caf6db49db8323ab6b40ba50e1,139,113,26,North America,17,828.52
289136aee4134dde812c7a07f19d9f10,144,118,26,South America,20,1388.58
2891c733eafe40e8875df30eccfe94bf,65,20,45,Europe,21,417.62
2893d6f473bd4736b565df79baec53b7,357,326,31,South America,21,2426.45
2894851b90664963b75a2ab82e7f80c0,113,65,48,Oceania,22,976.45
289b8d255bc94126a5c68458bed6fe6f,313,276,37,South America,19,2519.29
289d74bccacc44c3b2c34e4d408984e6,306,252,54,North America,22,836.07
289d8470f9f24beea9d54cc79b59cf22,152,102,50,North America,21,767.3
28a01673312f4a6cb8816663c0bcdd75,163,139,24,South America,11,1276.25
28a38920825945ae8be23307606e1008,329,269,60,South America,29,1916.81
28a53c5658c447c1b446a0eeb868edbb,279,220,59,South America,24,1671.11
28a8dc10c84a433fbdc142bd0cd6f5c5,291,268,23,Oceania,19,1645.5
28a96a66fb7b4393b146ae067a65267a,200,161,39,South America,15,1848.5
28aa328f26004b99b1189f3fe3cc4eb5,296,265,31,Europe,23,1777.98
28aba12298e84d4988e1a248ce5d2cd9,365,334,31,South America,22,1737.8
28acd53bdb684f5eba808a2aa1bc3744,351,319,32,South America,20,3109.53
28ad2ac9316e4acbade27db21995521d,96,36,60,Asia,17,569.22
28aebda03fab435e854c7896eb3f778d,263,220,43,Asia,24,1263.59
28af98ffaca14a778b7fb715aac99406,129,102,27,Asia,15,1161.37
28b0185582df4d7ea1ab389c6129452b,365,360,5,North America,21,1324.35
28b03867d8dd4fdd998cf2f14f75fc4d,318,270,48,Asia,23,1694.06
28b354ecbc7a45d1bfaca21ac25e66b5,121,83,38,South America,16,704.1
28b3c612b921441086237d7e3d9ddbb6,339,299,40,Asia,21,2581.12
28b4d072c73346429679ebc50735dedd,142,111,31,Europe,22,1020.29
28b50d07ad2d45a0b9efb953a3ccaed6,240,214,26,North America,26,1716.59
28b5cf1a7a8b43a9ae94f36e371ccb84,182,128,54,Asia,18,1401.41
28b5f52f36764ef0af7b163607169bb1,139,113,26,Europe,22,705.11
28b78ae76c004b94b4afeb2f0071948b,191,153,38,Africa,17,1256.67
28b80b63de0043b6a8c6ec0d29b05bc5,199,174,25,Asia,19,1331.24
28b838105804489eaf27f807a461ce4d,365,350,15,North America,25,1547.75
28be525a685a4879888d28b5126d62ae,365,328,37,Asia,21,2872.43
28bf32a276eb4abb8eb336ccda8682ef,276,225,51,North America,17,1687.92
28c26ee3e2784d3db299c8637054f61b,59,1,58,Europe,27,76.75
28c4831effa943e6827d4a937231fc97,68,31,37,Europe,16,603.74
28c56e22527546ee96dd0f55a789bea4,245,207,38,Asia,22,1351.57
28c57ef942f0436485d13d6b9cdf9a56,364,346,18,South America,18,2985.77
28c773ffdcd348c6a9db8dc0d6c17e04,130,84,46,North America,23,708.26
28c856a2a758450fb0a434d348c2224e,140,105,35,South America,23,774.92
28c8dce508da414386b74fbafdd97616,362,338,24,Oceania,22,2129.81
28c959e72ace4527aae2b146a27334ff,246,201,45,Asia,17,1172.05
28ca08b1a0bc4c6eab20e3e2dc5a8d46,79,51,28,North America,21,425.54
28cac061d7ae4e949c18938fac6c1c3d,206,163,43,Oceania,17,1759.32
28cf0ce565c2435fa2847fb86a44f3a4,180,138,42,Africa,21,1748.76
28cff1d0a9434aa5bf9352d611887c5f,219,164,55,Oceania,25,1515.12
28d0f9b45391488889d000fbae32c3b1,153,121,32,Europe,17,1386.83
28d146f1ed1841de9f13113eb1bcafda,305,247,58,Africa,22,922.97
28d2ad384dd642a6a1142601475e6b78,360,311,49,Europe,22,1884.66
28d38f022f0548e2855d8db5c4d2716d,172,123,49,Europe,15,704.88
28d58547387c4b149a1d72531e943b71,365,333,32,South America,23,1578.69
28d596f907fc40f19179bee78e54f2ba,169,123,46,Asia,17,726.1
28d5d93596af4134985cf402be1f1f0d,77,53,24,South America,22,661.74
28d63ea035844effa35244af338f38f1,365,344,21,Africa,18,2411.69
28d65c16900645f6b4ad5db31a8ec0b4,132,114,18,Africa,24,897.92
28d729da85c245d3a9807ec96921f307,189,153,36,Asia,19,1074.45
28d85e11ecd8479a9cd3e52054e4e413,365,363,2,Europe,18,2391.2
28da3597056d407c93f28cdfc251ac6c,104,59,45,Europe,25,632.98
28dd43d3d3464e089f1005c9b7248098,341,305,36,Asia,22,2432.75
28df0a4f9c514606b536e8a8463ba839,122,87,35,Africa,16,690.87
28e10b70169b49e1af3d531f759da121,200,153,47,Africa,22,1697.53
28e3ac5101954ad099ef7c75a46e275d,151,132,19,Oceania,16,891.77
28e3d654529549cc99ebc7bdee1cd999,30,7,23,North America,24,198.84
28e4debdfaa04e80b1ca1242418924f5,277,226,51,Asia,23,1768.76
28e5735d2e484337977aca69e938662c,203,178,25,Oceania,19,1425.01
28e5ff5cfdd34e9fb23ef540e4a3276e,268,248,20,North America,23,2219.41
28e617f8d37d4d0cb3a0e285615c02a3,55,25,30,Africa,18,159.45
28e6e615e0d74af5aad692cafae1485c,325,309,16,North America,19,2263.97
28e7378fc6214aaf94321232b2ffe813,350,322,28,Oceania,20,2714.1
28e744a688d2448f811e8615b96ba335,153,119,34,Africa,20,1510.39
28eaa21505c44a55a1e43bb2779ab2c8,319,295,24,Europe,17,2052.29
28ee7bf7b4364c36bc68504d22108013,208,181,27,Africa,16,1569.81
28eff8e8010c474096351c27269c44d3,139,110,29,Africa,19,1227.35
28f206ea6b734645b709fd9e01ac5a7b,144,117,27,Asia,19,929.64
28f25ec6fed34bc6bd94123ba0e503fa,231,186,45,Asia,24,1051.38
28f46544b2604d26800848e8ca85b9f1,96,38,58,North America,22,407.42
28f5807d04e3417ba80b8615880c6572,121,82,39,South America,23,772.29
28f6dc9286c349cbb79ab4d9a7b23e73,253,212,41,Oceania,19,1986.95
28f73157e6c241df8bf4770e19af7587,182,147,35,Asia,24,688.84
28f7f89adf254c53816412f93498c89f,199,148,51,Europe,16,951.29
28f84d0dcc5149a1a3d8200e5118ca02,155,129,26,North America,16,1776.83
28fb55d877714a8ea5fc1b26dae392ce,114,93,21,South America,28,1076.94
28fca89fb7a549368cc0526ab0d488bb,284,255,29,North America,23,1498.06
28fee18301f7428a8fc4289d76c3da63,156,125,31,Europe,20,1314.56
2900db78ea194b2d8a8c8988344b9388,365,365,0,Oceania,20,1995.76
29020eb116de45818d8d0a325fd6f1d6,272,244,28,Asia,20,2322.68
2904b1b442bf44bfa64e2347e630bb93,300,267,33,Europe,15,2094.34
2905394a11d949e1832f6ad070ecfd64,103,66,37,Africa,18,572.92
2905adbbcb1e4e8094d552b84ea65999,301,277,24,Africa,20,2264.7
2905fcd8f4b848d3b4dc348e3be888cf,365,338,27,North America,23,1650.95
2907e93f51134f3b9f1e2a968fd570e5,278,237,41,Europe,21,2151.02
2908b11981f74adcac2868c43b9e3824,265,233,32,Oceania,19,1871.25
290a3388e35148f5bea17fe47a82acde,59,23,36,Oceania,22,425.29
290af9ee84ca4e448f88269f5b3e127f,203,165,38,Oceania,17,1739.24
290cf921abfb4d82bec465acd311e33b,175,133,42,Africa,23,1198.18
290e5bafeb8946a4980d506e0c42e73d,233,180,53,Asia,19,1388.95
2910c51cff32409296e7664a676c394a,241,214,27,North America,23,1833.36
29122774565b43af9ddd31309af8726b,185,162,23,Oceania,18,1128.32
29158f7d0cc5438bb793731cef13ba0e,346,303,43,Europe,22,2244.06
2915f3aa1f374cb28078437fadb75d28,147,119,28,Africa,18,1129.29
2917353696ea401386046c50c18c5de0,264,234,30,South America,16,1292.58
2919e6cd031a465c98569a04a43970fd,365,351,14,North America,20,3385.41
291abc6bfbe543bc8118acabe8da05fb,180,147,33,South America,18,768.22
291bf49c51d3470495df6b513fa0d23f,315,266,49,South America,16,2255.53
291cef426bc7476cb2a81c50d5a31ecf,54,17,37,Asia,18,296.13
291dd6039bcb427d94e938d783d9e916,179,149,30,South America,22,864.34
291eda1dff5341388f484b5165f0e1a8,85,55,30,Oceania,22,477.6
291f61e1cf6d4239a8189b81f2adecb5,353,319,34,South America,24,2866.4
29206354608c4af7b7d5d930b514c5c0,120,84,36,North America,17,858.07
2920bfa00bc74b6b8ec539484a2d74d4,222,202,20,Oceania,18,2009.6
29232aa9acd94014a1efd0fa5cbb0d99,345,295,50,Oceania,21,2451.15
292380ce74f246cb9cd16efefe85d011,188,131,57,South America,17,1213.27
292a569e4e144d1da891f640f3db30c7,326,286,40,Asia,23,1934.3
292b3515c0b347fbb059e601977971b3,155,138,17,Africa,22,1405.91
292bbe3471da4d8f95da1a568f375fa0,347,298,49,South America,13,2327.5
292cd91458504fb8a05c6b6b5cf83aac,238,201,37,Europe,17,1555.5
292d62fb93164e609fba5ff4792cd17b,205,164,41,Oceania,25,1001.37
29318577975d4ca1a8626da0db911914,145,107,38,Oceania,18,1055.31
29324adea2d146f99d08d4bc998bda09,345,311,34,Asia,21,1743.38
293591c289f94878b51b0df4da7e2ff1,218,186,32,North America,22,1592.46
293700c93e5a4945b2e53ea83e4a2e9b,266,240,26,North America,25,2069.91
29385bed61d14b25b48ebdf3aec7f58a,89,69,20,Oceania,19,554.11
29393d0a3fa24f18afb3a1f5fb662ab8,201,175,26,South America,20,1329.2
293a1d48a53945c9af657a2e14810f2b,348,300,48,South America,19,1907.5
293aeedb832a4915a2cabf1251e219d5,135,87,48,Africa,22,585.49
293d4e26d64240d7b0e8b1f0d1b1c479,73,21,52,Oceania,13,57.37
293d61b061fc48a0b9052f1f7f034d16,98,62,36,North America,28,132.32
293db5517b9b492391af14d0ae010879,309,276,33,North America,20,1938.69
293dc5a1bf8846fc8f5394613aa6670d,365,350,15,North America,20,1857.91
29434bcb561f4125bd1cf30f8db8b45d,308,281,27,Oceania,22,2843.36
2943c40a725d4418bf2ca18e2f4b9cce,365,316,49,South America,22,1625.87
2943faf1afc74f758cbedd46f673fcc7,260,231,29,Africa,22,1420.87
294474ffafc44f9099d9c30d2fbd59e5,80,34,46,Asia,21,391.88
2945603040ab410a8057c9a115d418e6,365,321,44,Africa,27,1268.18
29459d9d4f2c4d2dbbb2e90faf37f16a,363,359,4,Europe,17,2861.53
2946cfab7c0f462593677fdf59fabda7,192,145,47,Asia,17,1355.17
29488d3dccf343b78c9e813e6c484132,170,118,52,Europe,20,1002.67
294949dbf589448484c34cb40727fd00,365,346,19,Oceania,20,1383.37
294cf0be7f74442bb526e92cd663a759,260,240,20,Europe,26,1620.89
294e72943d0848aca7fa6cbcfb19cd09,228,207,21,Europe,19,1441.69
29500c3b958347c096c0172561cc2e20,174,137,37,Europe,25,1360.53
29537ce8934a4f1fbe20a0d0b03691e5,33,3,30,North America,19,118.29
29550eef1d96453b96719cc01913f61c,249,218,31,South America,17,2141.01
295517c8acc947d3ab0a90fecfa374d4,119,76,43,Asia,20,710.82
29569899d12d4c07be7a617ec46aebf5,364,333,31,South America,17,2159.27
2956c8b2492f47ea81a8935fb3df3866,35,5,30,North America,22,314.11
2957ddcbce554bc88bb7aa6dc6ddcef1,199,156,43,Europe,23,1991.92
295b52d4f225428792ca20d24823985f,78,42,36,North America,17,508.5
295b5d697b8b4639a34710d07a01e619,216,168,48,Africa,20,901.91
295e60f6af8f4f46b81dd3711ed74500,153,123,30,North America,21,1132.74
295fdfb7e88f433a94262d26d388c5ea,171,124,47,South America,22,362.61
2961392bc72346c296d37a72607e391a,53,5,48,Africa,16,283.83
29630d66b4cb4db7949ebfc7429bfa6c,202,175,27,North America,22,1250.38
296651b8f6db4654b8e8ec1156c42f06,332,280,52,Oceania,20,1759.73
296869d22d7b48caacf38c6a6046daaf,325,291,34,North America,28,2676.82
2969e737807f429a9d4c8b36d49f4186,281,238,43,Africa,16,1110.9
296b9c24b16b4634bb34d7df644688f0,348,301,47,North America,22,1298.29
296c1b08103441edb1682a92b6619704,84,45,39,Europe,22,557.26
296c6fa38d804967acd3fdf23b978abd,178,119,59,Oceania,23,797.46
296cad2fa8e7432187eb73fa37db17ab,301,249,52,Africa,17,1347.86
29708371c61c429fab6dee8974b13f47,365,327,38,Europe,19,2126.48
29718b4efcc24d4da1a765b33f457299,90,62,28,South America,24,566.35
29771fd739304321986610dab29f99dc,126,86,40,North America,24,567.5
29772d92573d4bb693cb6b8d057011ce,307,285,22,North America,16,2214.47
29798d0dcddc4184965cb9e68fbd1a37,334,284,50,North America,20,1833.05
2979f08132234f29915689b977d93267,316,277,39,North America,19,2511.39
297b943baf79483ab9a6b1b8c1e09061,170,121,49,Asia,19,1190.99
297cc7a82239452fa3216fbbf51859a5,66,22,44,North America,18,487.5
297d06aeaa9d4b81863d9afa02c2f6b1,222,193,29,Oceania,20,1751.37
297ffccb54d541c7acdb0a3991551f91,130,84,46,Europe,15,641.35
29811c6d9c284e8db863d78eec5ad906,275,250,25,South America,22,2117.93
2982d4088854438e91c34e02fbd6fd5c,153,103,50,Europe,25,1398.83
2984525d097e4da7af36e866ba468263,109,66,43,Africa,22,814.13
29875da70ca64231b9e4f696c7e2187b,73,46,27,Africa,23,442.24
298870d035e24b64b610874e2b9b8f11,337,298,39,Asia,19,2155.84
29888f24af3b4ad09799684353d7d9b1,289,243,46,South America,19,1860.64
2989a484038143fb950cba8e6e7ac0bf,79,56,23,Asia,19,820.78
298e4f20b50b4046b840739d2ac2d448,324,276,48,South America,15,1536.71
299049444ecc4d2191c65e90c87c2ca0,287,265,22,Europe,19,2028.49
2993e6d70e97424bb613b28eac7a1b2f,329,282,47,Africa,16,1549.77
2994f81e1d22491abe33819321435f41,365,347,18,North America,17,2150.87
29963660cac4473bbd9fb1a6623d7d72,217,175,42,Europe,21,1383.45
2997fdac17ff442a86f73c1d83ad2f8e,364,346,18,North America,16,2662.92
299964d386dd4de39f844702824ece6e,323,287,36,South America,19,2630.62
299af988aff847798b2141c6a2258107,90,45,45,North America,16,711.18
299e1a5e5ba14e549ec9b7554931d909,227,190,37,Africa,16,1136.7
299f6f411d024c2c908e6599b0dbe6b4,234,183,51,South America,11,1186.37
29a3e45920dd4cffa0f84d7f050e250c,357,308,49,North America,14,1847.59
29a565757cb14538a36052b4a9a0c914,109,65,44,Oceania,18,685.55
29a7f1addda847898a60f93d67012d03,106,46,60,Oceania,17,506.22
29a80195a1964641b6885c4d9181504d,229,189,40,South America,17,1743.08
29a9bcee5fac4613a7df62685708037f,267,236,31,Europe,20,1776.9
29a9f9fe1e8a464299978b52b0af1be0,114,71,43,Europe,23,613.21
29aab4ad6caa47fd98f5995c2bc1d21f,353,319,34,Europe,22,2183.22
29ac7ae4b830452b90a3f5d4a6899128,107,70,37,Asia,18,668.44
29ad5f15405b443e82d9397bb2508a54,113,92,21,Europe,24,748.63
29ad9d5dfe264534a6558fa24ee3b8d3,163,138,25,South America,15,1169.42
29ae14f3d3344380b619b119cc6f9d92,261,204,57,Asia,22,945.73
29aedb2c0e174bd0a7b3f90a2289a0ca,169,114,55,North America,21,496.12
29b01e3bea254a10b33986f301bb868b,81,47,34,North America,20,720.73
29b19efaeab1426e80891a2e97318bea,364,332,32,Asia,24,2577.77
29b24f3106854b019cbd51d1990d5c24,286,257,29,Africa,24,1714.47
29b27b0a44ec4fa7b21db365bcd7b83d,360,309,51,Africa,21,1578.41
29b51aeade754172b02448c9e5ff8ffc,285,233,52,Oceania,21,1321.26
29b8133d4b7a4a508073f6bc83260eb5,345,298,47,Europe,20,1599.96
29b8790da59241eebbddb5e36b9c300c,320,297,23,Europe,23,2284.62
29b8ae5d16014ac586c84234608b9dc9,250,225,25,South America,19,1732.66
29ba3b8f7cd8445f9c24cfac3b1b5fea,95,73,22,South America,17,624.73
29ba928ba9374dbab360616c2f17a5dc,263,213,50,Africa,23,984.98
29bb72011ffe45e4b1008e7024ff6554,184,129,55,Africa,18,1255.52
29bc9adf08574d62887ba2bb9fbd0c7e,365,357,8,Oceania,18,2279.44
29bd3fa962924289a80150cc52fc9559,160,119,41,North America,17,1394.69
29bfeee1b41348c5babe38fa81332025,146,100,46,Europe,21,764.56
29c2952d693741ee82a3a746407a10b8,365,313,52,Africa,20,1651.85
29c2f858de87425fbbab03157ea82ba9,192,135,57,Oceania,24,1057.39
29c448e2e0aa4780953c1832ad52a7ca,255,227,28,South America,20,1843.68
29c5c49dd437440b9fdefc8f77b666b5,22,1,21,Europe,17,111.6
29c7739c1e4544709ef9dff9845d12ae,53,30,23,Asia,16,313.91
29c88bdec7f04fbba5f8bfadd6265ce5,254,204,50,Africa,21,1210.35
29c9531d53e2489dae966c8b8228898c,364,340,24,Asia,18,1767.03
29c95aafddbc4d52854750a33b0fe645,64,23,41,North America,21,358.71
29cd4bfd7410494ea2a693a2ebdc2890,291,236,55,Oceania,16,2024.65
29cdaf37873a4440a3daf374de7a6908,190,160,30,Oceania,17,1156.66
29cfb037f3a84448b7ae1fe2ba407ef1,185,160,25,Oceania,24,1820.24
29cfd350752f41ababe5dadd7b0bc532,238,194,44,Asia,19,940.02
29d04b1e535445229bb6ec027b49345e,167,115,52,South America,26,1109.83
29d4c45dbb334e298626efb77845315d,229,178,51,Asia,21,1289.27
29d5505ea1b24862a55b957ba1cfd6da,142,105,37,Africa,18,1071.8
29d5568ba05a427a8a2f5e17bcc17cd3,312,283,29,Asia,22,1964.04
29d66e99336845ef9c0ca720d8b30b7d,47,2,45,South America,22,135.15
29d988f3bfab4a8fbb4e050ffb82397d,277,242,35,Asia,20,1307.96
29db9eaf67dc451db9677911449978de,238,193,45,North America,17,1148.45
29dc84675d6a407a91ebd358ac9af350,310,258,52,South America,22,1366.18
29dd1f352c6e46a69d4e8a2d75393567,137,95,42,Oceania,19,1104.42
29e0c321aed54382a4182004213c06cd,365,331,34,South America,15,2074.37
29e2fb9ca60d430a8053e635acf5cecc,227,180,47,South America,20,998.77
29e30ffc7707442e94a469723b1fc4d9,280,235,45,Europe,20,1279.9
29e467bc86d744b6940bff7730d4d397,199,151,48,South America,17,1434.61
29e4ec058a494befb7017dc89caa17ae,140,106,34,North America,22,619.84
29e60fc9d61d48dda3c47957f47538f4,127,98,29,North America,18,755.13
29e6e11cc1414cda825fed09c37352f5,326,307,19,Africa,22,2443.97
29e6f2d2254842a392e95cb207ccef8e,208,178,30,Asia,18,1493.1
29ea330f7a7c4abe9dbce8746b216805,97,79,18,South America,18,522.45
29eb3c07fa464b97a7ef123276eda9b9,227,174,53,Asia,23,1382.44
29ecf3cd6ebf4a859fb6e5b2a9b8ed7b,276,252,24,Asia,20,2115.14
29ed949b67c24067a36967065b1c07a9,365,346,19,Africa,20,3493.75
29ee96632fa8423a8f86aba3940f6761,174,136,38,North America,18,1708.74
29f09497cf294402ad26e5831765751a,225,200,25,Africa,16,1623.98
29f200f04f9c42cfa3fbd5a1f9fb7cf6,320,277,43,Asia,18,2108.03
29f444fbf47347e9a54905883cbf0f01,294,241,53,Africa,22,1531.92
29f63b23e52548f2b2badfa3e1e5b8a8,163,131,32,Africa,25,1042.46
29f85479c168422eaaa6586cd3e2e83b,363,352,11,Europe,11,2651.17
29fba18426be4c02a784956b92579338,336,285,51,Asia,17,1313.88
29fbb43de22a42989932c4da28e84cd8,296,268,28,Europe,23,2204.22
29fbeac8871346d4983be691ab6af822,335,278,57,Oceania,23,2140.36
29fd0deaf719494fb6158b6e9d1b992e,313,270,43,South America,22,2558.62
29fdba5fa9e644a8ad86a162bffad70a,329,295,34,South America,23,2180.8
2a0038f4d62747b985521fa33bb12aae,236,206,30,North America,21,1651.42
2a01d31cfb314fa19975521b19ec3d94,363,335,28,Oceania,20,2153.78
2a04592400174cfa8ca259a73b2ceaee,225,171,54,Asia,25,903.16
2a05cf7812bc48919ac843160f797865,305,281,24,South America,21,2461.61
2a05dcf7547b457aac89d2184ff256f2,126,91,35,Europe,21,988.71
2a067e0de7a445f5bafffc67b6c7c3d1,155,125,30,Africa,23,976.5
2a0696d3c2d245febdddb4ddfa31658f,347,306,41,Europe,19,1679.35
2a06e5eb6c1c41428fd62bbbe57c34de,112,55,57,Oceania,26,897.04
2a0764ee639d474292c2c35818b1abb1,203,156,47,Europe,18,1165.07
2a07faa5d2b740c193ed55795807ccfb,205,165,40,Asia,23,1632.1
2a087161078f4870b06465351c4a86f4,363,338,25,Africa,19,2842.54
2a08aa88175a4df7b3026368ad3bba75,167,141,26,North America,21,1160.91
2a08fff0fac34a24b9c2b811a7e4f251,96,58,38,South America,22,1014.74
2a09044a475e4c62b25d7834ee8fe63f,234,182,52,Asia,20,1016.04
2a0a497e3bcb4c02a608766ab1852072,280,245,35,Africa,21,1573.76
2a0baccf25f44369960687239eb5b9e9,132,93,39,Oceania,22,960.56
2a0ca919c4ce4252bf62aab8cb90fb03,268,239,29,Europe,22,1895.03
2a0ebd864f0c4c6e8ae35501305e0071,351,302,49,Europe,20,1387.39
2a0f94090b65441d814bdc8cd35e8a5d,247,219,28,North America,17,1877.75
2a1106d6684d451c9196c7a92800595e,100,63,37,Europe,21,730.09
2a1136f12d0748329b8919af5563f451,47,23,24,Asia,26,305.48
2a11645e91fc4c6282f223e1bc466ba5,116,69,47,Africa,21,421.61
2a119da68dea4d21b538b1340b585c16,224,179,45,Asia,22,1375.94
2a121f3ac7044ec0adcd74ded1057ffc,177,149,28,North America,19,1826.28
2a13d750e75e48129a44a1caae8a2484,265,212,53,Oceania,22,1241.22
2a151741a6324fdf8c947d95b02704e4,365,363,2,North America,19,2263.93
2a15b7a0b7df48ca89f8171d5d862206,365,330,35,Europe,15,1783.74
2a18b1ff63c041b99b19890404b8e5d8,145,117,28,South America,17,607.72
2a1998b5aa3c4736b3b5a73129811e04,281,231,50,North America,21,1969.52
2a1afc994b4441a6b49a9460232fa9ed,275,238,37,Asia,17,1954.48
2a1d458d20b74fa7b7c2cb67a678eab3,247,198,49,Asia,21,1090.32
2a1e0fb5f20a441bb2922e9cce28f5a1,365,337,28,North America,17,1704.41
2a1ea9fd2dde427b852daa300c92896b,82,45,37,Africa,23,436.76
2a20e865a91c4966be4be9f92546ebaf,151,131,20,North America,21,1098.44
2a221fbfe0e74c30a030e18ea4220c89,268,244,24,South America,18,1791.98
2a25023c9ae14da3a14868f9cf5821c1,72,18,54,South America,21,357.91
2a25549e03344abeb127357a4d0ff357,152,118,34,Oceania,21,1001.32
2a25b538a24f43aea645fd72699b7f0a,307,268,39,Asia,21,2431.13
2a25c1cc48cc4b34a2974f13498596b4,93,61,32,North America,21,712.19
2a2690f427b848aa967c449efa902e1f,97,69,28,Asia,25,589.76
2a26cb17ccf447019f241a3998d7a32c,186,152,34,Africa,18,1620.97
2a2727aa0b22485c9034fe4b33192512,58,18,40,Oceania,17,636.35
2a27d6dddeba4fd9838b7eba4177c871,154,139,15,North America,17,1099.98
2a296f942cb247818252c1e39723d6f7,200,165,35,South America,24,1307.07
2a2bb8d9978849dc855c6f9129c43355,310,272,38,Africa,16,1914.56
2a2bd0e30a3743da87765b1f08bae857,365,336,29,Asia,21,2097.31
2a2bf16332a14b8ab6eecf2422291dc7,182,156,26,Asia,21,1928.51
2a2c901ecdf240d3bc74387a6143876e,352,312,40,Europe,24,2028.68
2a2cc3f21afd40689acc71cb9f546d69,310,281,29,Oceania,21,2046.51
2a2d448b99784930af62d005d71fbf5e,170,126,44,North America,20,1799.16
2a2d4754f7b446b4816bbd10bb25250f,360,343,17,Africa,26,1909.3
2a2f4ef6e4e846f581fad4e66b3b7a7c,79,32,47,Europe,16,450
2a32c54264194abb9e04ceea51a6ec68,190,150,40,Oceania,19,1523.28
2a3571e3d531489bac017233189dfe8c,120,79,41,Europe,18,347.37
2a3d3d09681a4e51a4b7fc161f9ec88e,258,239,19,Europe,18,1830.78
2a3d648124fd489099d8afa1a224b1ff,356,322,34,North America,24,2754.84
2a4350ca80494c26b09ec0def6f6d93b,181,134,47,South America,17,1394.36
2a4404c4e61d48a0b8b538b0748d0760,114,69,45,Europe,23,534.73
2a457080ce0e47a9b95ff6ebc81de521,55,18,37,South America,17,381.05
2a4719c1d53d4af8af7708bc9a7a8b03,215,183,32,South America,20,1762.68
2a4af42078cc4a5b8a052e67ebf884d5,222,197,25,Oceania,18,1939.26
2a4cf43de49642daacbe66525714caf4,302,277,25,South America,25,1860.9
2a4df47112f84d69a26f87862b8a4d86,234,183,51,Africa,21,1327.11
2a4fb292c01441218b671bad9985ee14,240,187,53,Asia,20,1178.53
2a50ac09f8b4497fad5a1393eec21aba,212,177,35,Oceania,23,1546.35
2a52edebe53e461e8ec74ffaecb4cc1d,75,18,57,South America,18,440.91
2a5454733b514c4bb1f67afd35b86d72,68,47,21,South America,19,700.6
2a54f15364a144a1b25d50cf3e8df3df,363,361,2,Oceania,26,3030.69
2a563203297e4e0cac5dca66c367d7cb,365,348,17,South America,16,2271.17
2a57013e44614f539678c4d2ec0fbc8a,356,312,44,North America,19,3244.5
2a573b09a72243aba5afc3ea471ae415,248,220,28,Africa,29,2042.02
2a58c205064649e6a0f153d53dbc1961,129,91,38,Africa,18,708.56
2a59aeea14654692bdee047382fd1b94,141,113,28,Africa,16,1115.11
2a5a60824a4e4824bb99aed38bdbbcbf,281,241,40,South America,25,1914.14
2a5b9793cf2e4b2a8f330108139e6e3c,169,133,36,North America,25,1272.3
2a5d7fb940ab44f587a3213c4fef1f56,233,201,32,Europe,22,1872.39
2a5ec776c7cc49b28ff782f1f87906c2,114,96,18,Europe,19,758.21
2a5ee034025743cd90baf08db00559ce,212,159,53,North America,19,1076
2a60da7169164b40a940602eb97ccdbe,227,175,52,South America,24,1217.67
2a61ca5cf0014347863bb4ab63af7f31,156,109,47,Africa,15,861.01
2a61dbd0e9ba4548bc8db60c1229386b,92,61,31,South America,20,874.23
2a62227664d148a8bde4b74fcb422793,172,147,25,North America,26,1669.28
2a6305663acb4ed09d50236ca980afd8,291,250,41,Asia,16,2243.2
2a637015e9b04be48e1b4c3ac4901dd4,256,202,54,Oceania,19,1512.39
2a64d5e2e5264989b939fc7559776bf0,96,53,43,Asia,24,297.12
2a680486f6174941a1eace8f97371684,73,23,50,North America,14,458.91
2a698a218f3e4f0c90513d058aa155d2,180,157,23,Asia,15,1333.53
2a6dc6e4f0204af299fc8fc5cd3ff2a7,340,303,37,South America,23,1553.12
2a71a66262314acabd2c60558c44aafd,289,266,23,Asia,16,2308.21
2a720bac4f1d42f1b220904352c9e1a3,364,356,8,South America,23,2598.86
2a73c7931bf74fdcb1740dc77d227474,196,150,46,North America,14,1150.98
2a746b75100348dbbcfd6a88f0a078d4,67,21,46,Asia,19,281.59
2a74a16e8eb14c21a11fd00e0885f790,105,86,19,Europe,19,660.22
2a78ea6728a5431dbe1bf27916667815,365,359,6,South America,21,1771.55
2a7aefc4db2c45a68709731504a997f3,73,34,39,Oceania,13,547.2
2a7b2e4838f54bc0b7b10e92dc44c8e6,344,292,52,North America,23,1559.18
2a7f437c548647938b5d853797555eff,262,204,58,Africa,22,1532.56
2a7fed0b02d1459db5314686652d9265,276,252,24,Africa,24,1954.48
2a8227bfa707496f895e22f74a70ca15,121,97,24,Asia,20,1030.09
2a82b4d1be1343d69e944744ce91831b,47,17,30,North America,19,371.87
2a82da72ef854cd5819a3680059ec36c,176,125,51,Asia,19,639.7
2a843a6da1504bbc866705b0125795f5,120,93,27,South America,16,1067.95
2a84ae23f6694dc58c011c80d597d36d,78,55,23,Africa,20,421.39
2a85264d64cc4513b07b9bf2c19ce3c5,29,6,23,Oceania,16,3.97
2a86667985804ff19cb1379dd22e21c2,180,137,43,Asia,14,1190.59
2a86f8ce90a647b49c9370e0f87fb686,365,356,9,Europe,22,2398.6
2a877ede16a64ed7a9f2b4acb0f63a36,190,146,44,South America,23,1391.45
2a8923f1cc8e442a9e18811b69455df7,173,121,52,Africa,22,1464.68
2a8c462139f54aad8087cef28eef5c48,50,1,49,North America,17,218.32
2a8ce2acdba0441c8e9e044422321145,47,3,44,Asia,15,153.35
2a8df9ed2f314411b5807e8b22de1156,77,51,26,Oceania,17,747.87
2a930e39ade140bc8d41e1cba18e1186,273,222,51,Africa,18,1073.5
2a9364bf90874d4c993bd72045a59696,349,317,32,Asia,23,2450.09
2a94704b357442499401e06b7e2c55e1,113,81,32,North America,24,987.02
2a961b236cad4a7fb47ac4c9f67120b0,276,233,43,Europe,15,1768.78
2a970bdcf48f4ab6803d23277b408d49,357,317,40,Asia,22,1740.9
2a9937b477214dff839245826d1c10a3,364,355,9,Asia,23,2379.89
2a9b6c4d59b4428fb0c4d181ad4f26a9,298,261,37,Africa,19,1954.87
2a9c837143ed4d4cbf9a0e92e663e5c1,140,118,22,Africa,15,959.56
2aa0e8ffa683431aa301fddc9e3119a8,235,210,25,Europe,23,1814.07
2aa2a16aa2494ccd9f60dd12db9cc776,224,181,43,Oceania,22,1396
2aa5c19a1a454b9c9b121076dbf1d380,122,71,51,South America,22,549.38
2aa8258fb44a440a884c57bbfe53ee72,79,54,25,Europe,17,536.47
2aa832aea8d743cab9de0cda7f0da3be,268,222,46,Oceania,19,1863.34
2aa87d7c6e9641b5afbf74d55d3ae1ae,133,82,51,Oceania,24,887.07
2aa8f7f1687743eab074c4c217ee5c38,303,259,44,South America,20,1737.1
2aa95415434a42b1b5bcae50c21f00a2,118,74,44,Europe,18,1071.6
2aa9ce97f96749b4a2611f54fa2358cb,238,207,31,South America,17,1249.82
2aaa87544b774164b6af88d92ffdcaa5,361,323,38,South America,22,2113.17
2aab01d3847642aea7b5a8f6f3ffae53,363,316,47,North America,20,1858.32
2aab9f7c56664c6c85fc4695d4b93e09,291,249,42,Africa,15,2288.89
2aacd3965832497ba0e10b4b6b12c2db,201,181,20,Asia,19,1089.99
2aad206fdbd34edf92dd9af8dd3e1186,365,358,7,South America,26,1788.52
2aadaa2a24914c72a1463c4297ece326,256,240,16,South America,23,1963.27
2aaf4baa9a994ae9952506f694ca1003,163,105,58,Asia,16,913.23
2aaf6a46a5524ed38b5b35fac20bba52,89,38,51,Asia,19,631.76
2ab081260236443aa1df188566183884,346,306,40,Africa,19,2220.38
2ab089a61ca04a44b50e57fe83197afa,320,302,18,South America,19,2034.29
2ab0ac51b16741218311be30d4304640,361,321,40,Oceania,19,1492.65
2ab1091f93bc4110ba3b3c3dc03d549f,292,259,33,North America,14,2081.65
2ab18b2a5f21410cb3536698c9460c20,124,78,46,South America,20,702.92
2ab1abb5ffd545d19a39b9535499e580,111,66,45,Oceania,17,627.87
2ab22493e4b64c618aea7c6887b822b2,194,155,39,North America,23,1431.61
2ab3cf554e184acc9c390a8e451984ee,42,17,25,Oceania,23,154.69
2ab4e757a3f54bb4a841c00aac25ee73,204,177,27,Oceania,21,1854.31
2ab7c60c93124377b43d194a99de0aed,230,179,51,Oceania,20,1070.76
2ab897cf124e49618d05998095b07996,258,210,48,Oceania,24,861.97
2ab9227595c14d158519c0678879ce9a,102,60,42,Europe,20,507.64
2abcadbd12f040f68a29b0fb1d51324d,184,146,38,Africa,17,957.82
2abcc581c7564bb9a5fa803ffad9ef59,247,217,30,South America,28,2075.18
2abcee0f69ea438f8559570fbea18049,125,87,38,Europe,20,846.17
2ac64efe819a474a85e0511d64ff8032,289,234,55,Oceania,19,1595.31
2acbc6a1e10240f18c5b1876ccb137a0,72,37,35,Oceania,23,344.62
2acca113ddcc464d9bf21ae4c751ed23,365,356,9,Oceania,23,2421.71
2acfd62fc9794b48b8b53244fa77d157,228,204,24,North America,27,2006.26
2ad0f97f0cee40aaaa9afd336b467a2d,215,178,37,Europe,25,1321.35
2ad2ab390bb14a3b894674292a61de30,317,293,24,Oceania,17,1705.04
2ad39f8022f54fbcac7b21f1bb337ed6,187,136,51,South America,15,1109.72
2ad4096a56574cf5a8b1efefe5abe174,129,83,46,South America,20,239.53
2ad4a2d991e242919b4af92d87be1256,110,68,42,Asia,28,592.26
2ad536041b4b41e78fbae19584d9f89f,342,305,37,Oceania,20,1659.06
2ad5bb371d844609a7861576e75b1885,226,203,23,South America,26,2054.21
2ad6ba7b71df4754825d90bced5e7787,247,198,49,Asia,20,1101.66
2ad8643b98c445b894b4005e514bdb49,324,267,57,South America,21,1362.25
2adcdf083de04e4596266626215eedd0,124,78,46,Asia,22,871.27
2ae036a39728416996300e461b8ccda7,225,170,55,Asia,15,918.93
2ae282e02df04c21a57501e3a1de2ec9,155,137,18,Europe,21,1138.37
2ae2c83c3d114dc9bd0f06066fb651e1,268,222,46,Africa,16,1493.92
2ae45355ae9243d3a15d5cc1272af0ed,301,271,30,South America,20,2140.99
2ae67f60745a4402bcc596b78afc702c,271,237,34,Europe,23,2028.52
2ae7a02790f34f3684a236ee0924032b,80,58,22,South America,22,490.6
2ae81c641c5f475c92e606b1ee94344b,293,265,28,Europe,19,2438.53
2ae88768823a4512a0b8e36553e39ef8,55,16,39,Oceania,21,232.76
2ae8c461e9334be79376373e3df99b6e,266,234,32,Europe,20,1580.55
2ae9b96217184a3a9f05fbb91c6fa623,350,323,27,Europe,16,2222.91
2aeddb97c95e459bae4518b50b3c3cf3,214,181,33,South America,23,2304.85
2aee6b6842d74b519b18ca70a7929dab,136,92,44,Africa,22,555.72
2aef2625072c4e2282a86805d720d6fe,291,258,33,Europe,19,2207.93
2aefd5ad043f43b4a4779ec7246032fc,171,128,43,Africa,21,1182.03
2af0c2d5fe294d2faf1b99077936ae25,165,142,23,South America,22,1375.12
2af17f7df44b4fb88da9899fc6ea2d03,189,155,34,Oceania,16,1538.39
2af3be59dadc4b28a01aa462a61d0e7d,365,357,8,Africa,21,2095.37
2af40f29d73f4106a7df59e24573794e,262,212,50,Asia,15,836.69
2af4c845c5f043a1821471626bb8164e,66,28,38,North America,17,502.26
2af620e808e34aa2931b4b3b5c41973b,248,196,52,Oceania,21,1796.41
2af663e000ee403db9f366f1e49f0514,212,186,26,Africa,25,1775.54
2af67de1da314b02a3de56299bf8e8c1,122,100,22,Oceania,13,1091.42
2afa20f77dc34235869a6e472bd03437,63,40,23,North America,20,456.67
2afaaff7eaee41398629d9ee7d26ad25,98,65,33,North America,19,676.52
2afc1b741d2448d48cf1e4054c24065f,199,169,30,Europe,24,1285.98
2afe212ee3f04448bd73777fbdc6df6d,227,201,26,North America,21,1012.09
2aff59bf084d4decbdc0b812a1f78892,54,1,53,Europe,23,602.13
2b01ff81df63492aa3400b7521337230,276,225,51,Oceania,22,1255.33
2b02669b327f4a76b8743496c3157f48,247,213,34,Europe,22,1776.17
2b03b37c56b048a7aa4d7ecb590d8759,312,287,25,Asia,20,2540.76
2b04af2179a245cbb25e8e318b6451f9,342,290,52,South America,23,1879.23
2b05b025ea8f424285893950de776fd9,155,132,23,Oceania,20,1182
2b08bf8e426f40f48a9d839257263a9f,76,28,48,South America,23,177.54
2b0becbc8dfb4bd482aafea9fd56edcf,362,339,23,Africa,21,1766.27
2b0c4d6bdf514e769ae959e3748132b9,226,171,55,North America,21,1665.97
2b0f3e9c7644479a88d82dca87001be0,365,312,53,Europe,21,1946.29
2b0fb05309304e6a9d17bd55bbc0ca51,307,256,51,Asia,18,1605.87
2b1013c6e91d467ebb48690d164c8ed8,85,52,33,South America,21,508.17
2b133655b1a143d58e252b9e1f2ecd72,286,258,28,South America,20,2050.11
2b13fa45407c4d65a603fa8abdafde23,59,29,30,Asia,21,448.46
2b1576e7a3824d90bb08b0a2c5cc9353,132,105,27,Europe,11,614.84
2b16a3548b004cb38080b8b737ec4c6a,222,169,53,North America,23,1500.39
2b170672868e4ea09dc5713267bda82a,124,73,51,South America,22,714.21
2b1891fdcf5743459ebfc4854015fb30,153,102,51,Asia,19,789.64
2b18a378cde944379e3cde7b5164e901,348,332,16,Oceania,16,2437.42
2b19150478d946fead29727346d6bf1c,194,156,38,Africa,18,1508.1
2b19bc008d2b471c9f81f46e729083ac,86,58,28,North America,16,379.22
2b1b7af3dab64bbcac4ec9b4523801d5,319,277,42,Africa,20,1737.35
2b1bd6ed07a041fc9f7c8226a34d0e74,212,185,27,Oceania,23,1657.14
2b1c2d5a21a14017b4a838f85ab13364,365,359,6,South America,20,2761.56
2b1d31e4721049d9bc149880ad8a4c1d,232,181,51,North America,19,959.04
2b1d375c05344445aebffcd2d1c1630d,76,54,22,Oceania,20,876.39
2b21d614e9b34fb49bf378d141b67490,101,55,46,Africa,25,413.11
2b23453a8d2247c1a9aa8bccaa7fbe26,40,10,30,Europe,20,443.06
2b27955bc7c04e198afb3c159ce9f26c,64,6,58,Europe,20,367.28
2b2b416af4134aaa873c64c5851b34d2,100,79,21,Oceania,17,969.04
2b2b7f0e4e9f4ab791350d2683f482c5,362,324,38,South America,19,1879.1
2b339dd32fd948ee9cb7ee06f1946d6a,185,163,22,South America,19,1511.01
2b340082a2c5486f93cb7530d9cddf97,232,206,26,Asia,23,1258.27
2b34def189ba492585918d765dd4faa1,251,211,40,North America,22,1766.6
2b35b6325d5049b38484834950a3d0a6,365,330,35,North America,16,1916.94
2b36b048bfbd40d9a7147cabc0c636db,140,88,52,Europe,20,733.96
2b3c5e8954704391a43b800e16511b28,317,277,40,North America,23,2280.66
2b3d4306087542328bbba348235738fb,51,7,44,Asia,17,315
2b3f2d27b7254205ae172ac260cec9c3,364,354,10,Europe,20,2076.52
2b41906ca80b44c2bb4ab5d6257c2efb,330,304,26,North America,19,2597.37
2b427659d58f4545a4bad7e2e6c4e7e4,290,240,50,Oceania,20,1772.36
2b431acbf7e844b09411a090005d48ba,134,108,26,Oceania,20,1056.59
2b43aa2554a043d891bf97831a6c99ba,273,220,53,South America,25,965.11
2b4693992a3149ba8c1ce86cc4d5a54a,365,363,2,Oceania,21,3384.43
2b48f0423441461a871df97c4915a0da,124,100,24,Africa,20,1176.91
2b493aca0f354b2fbab6363b087bf89c,281,260,21,Asia,16,2021.57
2b4f951fd4404890bd13847af3730f46,195,167,28,Africa,25,1712.73
2b512492f8f4463b9cbe60d0d4ebba10,244,200,44,Europe,18,1925.69
2b5200687a644fd69258c05d2e7eb1ef,173,134,39,South America,16,933.62
2b52453d6c504f029c960bc9792514ae,325,287,38,Europe,21,1671.46
2b556582755d41ba8bda627885086c04,147,97,50,North America,22,735.44
2b55734665b24533af0ebaddd15606c6,265,210,55,Oceania,23,1590.05
2b5b4dc9fb8b46b396574b1628f1c962,120,78,42,North America,21,775.95
2b5f3fd095d8437bb8a8977353d9540b,364,363,1,North America,14,2403.46
2b63fc98c7ea443f89ceed6322573aca,236,208,28,South America,18,1191.47
2b65415eb88c420aa1dc962acfde87a8,365,356,9,Asia,23,2258.81
2b67a3efa3d54cc79e4cf126b4532cd3,221,192,29,Europe,23,1321.53
2b67eeb4b82b4ac28d5a6e9579e1ffe3,312,257,55,Africa,20,1743.08
2b6999fe1503458aaa05de009580823e,308,292,16,Africa,25,2221.33
2b69e39ea49047cda21c661837e57a18,277,256,21,Oceania,20,1743.73
2b6d34514bf24f8186593a367c5253fe,268,235,33,South America,15,1890.15
2b6d49abd89745208498b61da255219f,359,340,19,Europe,26,2943.33
2b6e20c282bd44e78090d3351d1fcc2e,295,256,39,Europe,22,2000.51
2b6e3da7f1d24253a84e3c06fd23bbcf,254,233,21,Africa,19,2456.51
2b6f0d65e0c046608bff9bd5e75288cc,363,332,31,Asia,21,1816.86
2b7108155bf8443a9ebffa37224b1aea,168,121,47,South America,17,829.27
2b714c636a2b44e3bf6cc423bec71b71,344,303,41,Europe,19,2039.68
2b718003ccbc4680bb5c66107bbbe30c,25,8,17,South America,18,244.15
2b74831545c54b14929238d4a1ab8448,179,149,30,Europe,17,1215.8
2b7582f6f90841f7b309280428a33f86,300,269,31,Oceania,18,2072.27
2b7820a84e674b2f87f9aabb30ea8ec2,40,18,22,Oceania,23,292.75
2b7981578d2e4ab1b837c8a27b69b969,96,55,41,Oceania,22,959.56
2b79b26cd2474e09a2bfe3d5bfd3e439,100,67,33,North America,14,462.51
2b79b72d33f149eda5550b188a9a3a0c,290,234,56,Africa,18,1226.75
2b79cb6776804fc6bbc6e4e31157d06b,102,55,47,South America,24,385.11
2b7f3c8597f64a15befe3962b49ffd1a,365,322,43,South America,16,949.24
2b825f2994a045dd9143fb2241489e3a,281,253,28,Europe,21,2318.68
2b82ccc921fd4d34bf0db9765a14b42a,299,254,45,Oceania,17,1722.03
2b837b3c407e455d9349ac246152bda7,365,344,21,North America,18,2563.73
2b84ddd604f9474fa6eef71fd15deea7,210,178,32,North America,18,1475.4
2b84f4e1b40d420baa2c253d9a38f793,363,322,41,Africa,24,2269.1
2b85adc212ac462ba5d0d38caeabd2e6,222,179,43,Asia,18,951.6
2b87a0e4a80742549c244f1b7ba594a8,202,140,62,Europe,16,1460.8
2b88776491ea41faa6b796f84b8668f5,137,116,21,South America,22,986.77
2b8ab3c23e454bb497fd711be38f9abf,273,238,35,North America,26,1722.8
2b8b11abecf545a280b2abf01235c2c6,96,73,23,Africa,26,395.1
2b8c37070ca84cebbdec82aa9b953db2,334,277,57,Asia,26,2014.67
2b8d2976e9204fa681c9d543a96b9c31,325,290,35,South America,17,2197.78
2b8da945c017420b9625f4f647fb27c3,130,102,28,Asia,18,795.51
2b8e04d2db2a4e808f886adc3c1be851,175,149,26,North America,22,809.9
2b93c4a53fad4ce99b517bff5977404f,110,62,48,Africa,19,593.26
2b97b91a1dc246c0afcbc64938912911,97,35,62,Europe,18,417.36
2b97f56a27bf4369bf763599fe6a5c0d,347,314,33,North America,14,2098.56
2b983b5fe65f4b528afcffcfad9a9b65,60,19,41,South America,19,161.47
2b98aaae969e4f5797bd046035e0706b,77,56,21,North America,18,637.63
2b98ab7535fc43ce823c4205d310ea59,286,261,25,Asia,20,2028.31
2b9969c784014eb2942f3a8e8a675c78,197,170,27,South America,20,1421.84
2b99e532bc514983bdea34367495b31f,99,66,33,Europe,21,1113.8
2b9ba8582b11473a8141d58353dac2d8,346,311,35,Oceania,24,2722.46
2b9bb78dba90466a87f34ec70b261043,361,360,1,Europe,18,2950.79
2b9c86d5d1a746c89a9f56c61beb44ad,39,11,28,North America,21,422.51
2b9c8dbb5a2e4c59b9652dddc7f3de13,295,265,30,Africa,18,2396.53
2b9d090aae6142028c3f1ebde8f44ce0,104,83,21,Asia,19,952.4
2b9f4e5bb8a540d7b3a4ce262dd144d7,180,145,35,Oceania,26,1484.05
2ba3e25e7b02483f9cd06e9ac686275c,173,144,29,Europe,22,1374.23
2ba46c360e1b482691e28adc868e2a15,351,311,40,Europe,19,2562.47
2ba6a71f647041ddb864bcddcb362621,191,152,39,Asia,23,1048.2
2ba6fc937c794e9f946292455ed6d731,161,121,40,Europe,26,792.9
2ba81b70d93f427fb5c7d2468f67dd16,61,20,41,Africa,22,430.26
2baa3680553e4949a88374185ff100ee,270,231,39,South America,19,1034.25
2baf7ff0b0b542d4ba79fe638a263391,276,234,42,North America,19,1743.64
2bb103e498294ac5a27bfa2794dfff9f,106,70,36,Europe,24,504.15
2bb10c5fdf1b41afb7163e33b232b2c9,364,315,49,Africa,25,1433.6
2bb144288a5f4f8daef71e7f5ba2df78,365,359,6,Asia,16,3015.65
2bb4204e720e4ecd8785acd82a0d26bc,116,75,41,Oceania,16,828.79
2bb495ff748b49feaffc61fb2a0c2fc4,189,160,29,Africa,19,1354.47
2bb5fa07010d407abc0a6b9a8e039d79,48,26,22,Africa,24,509.41
2bba7dc2ff164aa58a59728e0d8585f4,331,286,45,Europe,18,1670.26
2bbc25d652e24cfb855a726e9d56c4cb,106,83,23,Oceania,19,1233.72
2bbc4cbea02a4a1586f23a9f54fb71c8,365,344,21,Africa,17,1664.87
2bbe1dc68cc64b779b3fa22edb4eab17,123,74,49,Africa,18,181.27
2bbe74b7620347c196f1269e2455fc1f,299,264,35,South America,18,1702.89
2bbee55ed1f64124acabbae7bb58ec7f,79,28,51,Asia,20,176.94
2bbf3271e2a24828b55d36ff1be5bf8b,165,136,29,Africa,21,1299.11
2bbfca3818a24bf09ce7a188f162b491,327,284,43,Oceania,20,2057.11
2bc0c27a0d254677a4c8c72078ee4284,112,68,44,Oceania,24,641.45
2bc16ea106894b0f80cdd8f9f3c50993,270,233,37,Europe,20,1869.47
2bc501e0c60240e2ae66af4750fdc4fd,180,129,51,South America,16,1208.32
2bc5e09cb6cc44aaa42bd250511cfa41,364,356,8,Asia,21,1638.01
2bc700ff71164f6f9d6caf8959d052c0,340,302,38,Africa,19,2257.34
2bc90f225e2149e295941f9adca35078,91,39,52,North America,17,327.26
2bc9f95dc92c44578e8d7f06b567b641,339,299,40,North America,16,2007.41
2bcbd6cf019d426db0af31d0533fe9aa,349,336,13,Oceania,14,2985.99
2bcc98d877d648558b83a93e9e2d1d66,334,292,42,North America,25,1948.88
2bcdcea873d7478e9da1e7ca8f6c43a4,284,263,21,Oceania,17,2146.65
2bce5a6864ea4e86bb06ffe62265be80,198,170,28,Europe,25,1812.75
2bd0f136a3ba406288eae280667ef613,265,218,47,Africa,23,1497.83
2bd12147271344d894212073274a8133,234,192,42,Oceania,21,1732.67
2bd1d70d27664758a26a9bd3105f65ea,141,116,25,North America,17,919.59
2bd4d480b18643f6a7a1925652e98345,142,87,55,Africa,20,830.04
2bd650a98edb4281989284eea28cd163,182,157,25,Europe,24,1308.78
2bd92b34e8d44f05a85667b739570e24,332,307,25,Africa,24,2701.72
2bd92b72a8bc46e49c00869fa0942167,90,61,29,Oceania,24,861.62
2bda5e5d417f44bebc065f523ae7d484,226,195,31,Oceania,17,1923.8
2bdb957097d1471cadbcc1180f7b3426,166,126,40,South America,20,1019.62
2bdc26e354004e82918d1057327e139b,106,59,47,South America,25,333.53
2bdc41dbd9464bda8b73410157093449,360,336,24,North America,27,2623.76
2bddcd85005a4f1b9b737bd68d2ff6c0,67,7,60,Europe,12,252.28
2be1c18068ef48f8908554cd4722ce44,119,88,31,North America,14,1105.26
2be218917d6044a8bb32d92ee4a7268d,285,232,53,Europe,19,1552.88
2be2ab70f9204f94b3e5c5af9d11af81,89,63,26,North America,18,940.77
2be41b4943364cbe831d855252ae23b2,345,313,32,Europe,18,3000.2
2be49fb06ce04bc5a922265f9d5a5d35,277,233,44,South America,18,2045.53
2be4da61420844f7a34d36955aa7eadb,128,78,50,North America,13,477.22
2be529d85b9c4a989268fbe6d4c4dad5,186,159,27,North America,20,1105.72
2be78d1ad0b9474da1c0708cd57a31d2,364,335,29,Oceania,21,2846.18
2be9e4c3d1ba4c1ebbaf98209daa59a4,306,265,41,North America,19,2284.21
2bef87797e154635a64302e32d6df431,283,240,43,Europe,18,1606.99
2befaf9469a04fdd91aafcaa4411ed8e,171,155,16,Asia,17,1935.85
2befddc6cfc641fba3f012dbb97c98f1,83,33,50,Oceania,30,308.06
2bf000379528481a8e22802fcda0c0ed,181,155,26,Europe,21,972.68
2bf169df88304444967da91c9ce2c45a,242,223,19,South America,15,1545.15
2bf4bab8adbe425f868bfe91aad6b695,130,95,35,Europe,21,865.96
2bf78929962442c5bcf8b10bb4d3717f,51,12,39,Oceania,20,357.63
2bf795aaa9c9416482204cdd121c5f0a,365,349,16,Asia,19,2290.3
2bf7b65a69584845a862c99e3663543e,270,221,49,Asia,18,1563.86
2bf968348bb34eb3a614f1b58e60c0ff,348,318,30,Oceania,22,2762.76
2bfcf498c260404082de8664387b5e56,138,87,51,Europe,17,545.26
2bfd0859d97c4ee4bbb27397da8abd05,201,184,17,Asia,22,1184.28
2bfd1d81939a4474a65222dd8eefcf3e,280,239,41,Asia,23,1588.21
2bfe0c10bf164e068ebcb838e9ca53f6,218,175,43,North America,24,1810.79
2bff2d5e53da4ef0b1942cd278ad1613,73,20,53,North America,19,443.27
2c0166211cf54d4cb85be90f667c2239,282,253,29,Africa,27,2597.4
2c02da66432344a6a401f2411b1274e2,263,225,38,Oceania,15,2055.87
2c02f543dd3d4d3e899f97b4582f5233,295,258,37,Europe,20,2804.67
2c031f2a015a468193359a4cac5d4819,361,356,5,Asia,21,2022.95
2c06362e453f40acb9cd283e0e40fdcd,344,324,20,South America,21,2783.72
2c0677f589a646a98856fe39bf6bb3c5,365,342,23,South America,22,2400.74
2c06fcfd364a489bbe59cb4b63fcc1c4,71,38,33,Asia,22,435.78
2c095d4ddfe84d8bb2080c2e5fb5cade,221,170,51,Oceania,17,1114.67
2c09ba08d4954ecab899170086c709b4,365,365,0,Africa,18,1662.09
2c0aee753a434ecc9d2f72accd8880ba,282,226,56,North America,19,1293.67
2c0d7aecb34e484e97d01205457fa8d0,365,361,4,Africa,16,2103.49
2c0ea243723d43878b898ce2ffaef366,131,92,39,North America,17,1094.5
2c14ac434f5847d2bb19e2212a47190c,206,156,50,Asia,23,1224.93
2c159e6500ee4fb1b2e8a03a9a569f05,233,212,21,Europe,20,1600.89
2c16e5d293ce4fcd9637a2d7487b844b,199,157,42,South America,20,868.03
2c17efe080e14d3d9de7a89b9cebb543,338,296,42,South America,16,2532.78
2c185a73ffb341c7a0b032614080d640,284,247,37,North America,19,1837.25
2c1f97442fc9489bb2284f02589aa42b,361,339,22,Africa,26,2113.45
2c205b3d43be489c8bdb48d3c4cadd9e,106,59,47,Africa,19,161.66
2c22298bdb754a50848805ad074c2146,255,230,25,Asia,16,1482.55
2c23510fa96a4855acd83a0862b7c55f,109,87,22,Oceania,19,817.66
2c2430f8200344fd875f085df6f2d926,168,126,42,Africa,18,848.81
2c269b2d11074e408bf7d51db38f9afb,303,280,23,North America,21,2971.01
2c270e7a8827442991cd97af0ecacd0e,365,340,25,South America,18,1717.74
2c28b1cd041c41edb9d58f54b5149691,365,323,42,Europe,15,1702.39
2c2c74a74b294510b6613b153814e8bc,301,265,36,South America,23,2446.72
2c2d3489b42e489ca57b6bd10bbef73b,104,55,49,South America,19,796.18
2c2f18ed5e4f4dfeb1b95cf0a53b99f3,330,284,46,Europe,21,1713.09
2c345759981f40e6a2ed377efa1cf858,295,243,52,Africa,22,1091.06
2c34a403a812461687b870bafdf9abef,122,106,16,North America,17,588.49
2c35f1375575468085995b2109b0f95e,240,206,34,Oceania,21,2474.66
2c36d9d6cd9c4af8a334a43d5e9ceb8a,365,363,2,Asia,21,1961.16
2c37250da07f4c7e84b4006c7ab7841b,128,77,51,Oceania,17,629.38
2c375d1478624fe49359139ca01e16be,167,117,50,Europe,20,625.8
2c38b6e0d5f94ca9ae3549fe4e089d96,365,330,35,Oceania,17,2566.8
2c3cb5cff0284fa1b57c055ddd59bd13,125,89,36,North America,22,958.28
2c3cbaa2a0014400b06f448e71b6996a,97,49,48,Africa,19,389.39
2c3cc1a2bc7a4bc7a4dd3a44f87079c6,198,162,36,North America,18,1486.56
2c4409c220a74c008204ee70926672c4,147,95,52,Europe,24,1186.47
2c495eded34c4c859d3df47d90170429,62,17,45,Oceania,18,90.58
2c4fa93f82004c00908f2bafd832226e,297,277,20,Africa,20,1873.69
2c50efe51efa4453938f6c4d7159b67a,363,357,6,Asia,22,2541.59
2c5245b53c0644f392a22ad8d6036d3a,141,95,46,South America,17,936.6
2c52fc1af09445a28cf477e097a749e2,79,24,55,Europe,23,712.82
2c53e12b553e4882b731099d3b0d584f,365,345,20,Europe,22,3290.88
2c5524134b04497dbe34900e07f044ef,56,33,23,Asia,22,676.63
2c5579eea4a748b2adca941874ffc4a7,78,37,41,Asia,20,516.96
2c55c60d456645b8a31a54e2e2473e73,123,84,39,Africa,17,629.45
2c570032a1234eab9359f8fdd9414a3f,329,294,35,South America,17,2163.34
2c571a32f0494ff6ba334d3d155e1c35,211,168,43,North America,24,1262.7
2c577eeaf09640a684062c8fe8a11902,222,188,34,North America,21,1570.86
2c5c1ced116f44f98cb4c2b25ba0cc36,190,155,35,South America,22,1340.62
2c5e26fb5d8d406a80c93786a478957b,234,194,40,Asia,29,1153.63
2c5f92e762f1434dadd5ee371ec77066,206,181,25,Oceania,21,1484.53
2c656a8f344d4669a22f42033c909d42,131,113,18,North America,19,1128.16
2c66d16926204dc7896bb905b815960b,362,330,32,Europe,19,2065.63
2c67013b50104e09a56a3fd47848354c,363,355,8,Oceania,20,2539.48
2c68b1a15aa5465da774423fa9636cea,298,240,58,Oceania,22,1632.78
2c68e93a4b9748a0bded43af591e65ec,95,71,24,South America,20,759.47
2c6919608fcc476cbb7a49171025ca94,80,31,49,Asia,18,234.22
2c6a0db8a10543eb952797180062e798,341,319,22,Asia,25,2029.23
2c6ae510e4e64053a9481e42136a6814,59,28,31,Europe,20,200.2
2c6b8e39878640b8affa70314a8e41e2,90,74,16,Europe,23,513.36
2c6c50f247af4c9b8263a76a2230cd1c,360,314,46,Africa,21,1879.86
2c6cb3374e2f4647b8f4857a5ec5e9e0,72,51,21,Asia,20,623.14
2c6e30d836d741248856514c001c948d,75,48,27,Africa,20,844.96
2c70700d346d4c91a44ad3ed81c199cb,188,149,39,Africa,17,1397.84
2c712cf6cb6c456996ea82be5ebaf81e,126,80,46,South America,18,420.86
2c7684c323b743e88dd7452c4df7721d,60,22,38,Europe,25,487.13
2c781ce71753436085b636d3700f7bb5,220,194,26,Africa,20,1822.57
2c790e6ede184bbd9ea7e7ba7f3c68ec,125,82,43,Europe,22,679.67
2c7928dbd438408684713447ee769924,338,282,56,Asia,18,2570.16
2c792fe51b0b4cc1b3149d8ce688fb91,277,225,52,Europe,22,1140.16
2c7a5b2e0edb415893de00dd84fcfd13,119,90,29,North America,17,1040.41
2c7c2d2f2dfe47e5954e596f13f54296,238,191,47,Africa,21,1253.24
2c7caf0f7d2b451d8e4319bdc42d9f7b,365,348,17,Asia,22,2538.55
2c7ccf1c306a45ddb686775bb2b6dc48,365,344,21,Africa,16,2595.22
2c7cdc561b694484b388ab8dff3e3fcd,178,125,53,South America,17,1243.92
2c7dcdeb870f4a7c82f7601de8f3c4da,45,4,41,Asia,24,213.37
2c803071d17f433e969f7729fbfeaa1a,55,34,21,Africa,21,216.52
2c80328bb04949e29e3425c850b936d3,169,129,40,South America,17,929.12
2c810bc0cb9c464b915f0ed71671c3bf,320,298,22,Oceania,20,2575.19
2c82d1954f1c429e91689d5e8d8229b0,239,222,17,South America,17,1733.31
2c8416e7b6224fa09e6025d342f28a12,118,94,24,South America,25,799.53
2c8721dd04fb4fd0a8b7e41fd3f0cf6f,323,271,52,Europe,21,1497.79
2c8801d62d5245fb8ddb7f58a196ff3e,365,355,10,Africa,21,2414.32
2c8b6aeedef7428d802df282179edfd1,26,5,21,Africa,12,312.9
2c8d0e6653654f81b4e70b783898c964,260,225,35,Africa,19,1993.93
2c8d38308b1049c38d8ee4ee55208e8f,193,143,50,Oceania,19,829.87
2c8e12235a2e44dca6ff305cdf3e5e07,243,218,25,South America,22,1688.7
2c8f691f222a4f5d898b8e7e57b2f680,356,316,40,Africa,15,2441.64
2c8f73a24bb04820aac1aacddabdc4e6,362,334,28,Asia,19,1905.64
2c90142a82dc4b1cace3314d8fc8a632,166,121,45,Oceania,17,1105.9
2c902e84ef9b4c109fcb12c866851a15,182,125,57,Asia,23,786.61
2c92a590e1c7495b8ff29fe17649b325,88,56,32,North America,18,472.18
2c96dc0359a845bd9e4043a58e3e6be5,187,146,41,Oceania,16,1421.88
2c9885261b6b4f1495f131885791e25b,249,218,31,Oceania,19,1796.31
2c98d225bffe47d59716074724ee7352,259,201,58,Europe,25,1857.32
2c9a1d1e3a4447b3afd15ff8da8009a6,274,238,36,North America,17,949.55
2c9b105a0fef42b89a51f717663566d2,363,360,3,Europe,28,1753.29
2c9b358b508e48afbc47d7b426e8c033,95,66,29,Africa,24,707.47
2c9cc2a285a34cf1af5143e317291703,277,255,22,Africa,24,2125.52
2c9dcedcc8b6445092ec3508e13c91e1,344,310,34,Asia,22,2152.33
2c9ffceb86e94d70aef9d6c222d35bd7,226,192,34,Asia,22,1514.05
2ca1c771d7274ec0b7c7a7bc09ba3b21,143,119,24,South America,19,1185.21
2ca5411c2089474a85af46ab27362cce,321,280,41,Oceania,27,1561.27
2ca6e74e3d1e469abbca21dfe5972562,107,83,24,Oceania,22,978.17
2caaee81608e471d9ee4ff806392f037,48,5,43,South America,23,274.71
2cadaf0bbc9144aeae0b0e9bc20e3ab2,240,195,45,Africa,23,1616.33
2cae42f8b17e4eadade59618867247b7,314,269,45,North America,20,2093.84
2cb43afd4eca4e00a9d8124344c3b32a,215,175,40,North America,15,1546.44
2cb5c8eee8444334aad817deb705c471,240,208,32,South America,20,1483.1
2cb8db77befe4ed181085b47d5907a26,300,271,29,Oceania,20,1764.04
2cb911376bc54402b32c9664a3db303d,231,185,46,South America,26,1419.03
2cbb97c2ea344b93be402e0f18864124,238,185,53,North America,25,656.4
2cbc5035f6d54d4dba7052907da52b12,277,248,29,Africa,19,1544.18
2cbe09321d7e445c965b6fd8fbbe0021,365,337,28,South America,18,2417.24
2cbe3f1b909e4588baac36bf787d258c,103,71,32,Europe,22,752.07
2cbe480c46324fb785c53069efb82906,206,178,28,South America,24,2094.83
2cbe9fda97a8469987b8a5e14f286b41,126,79,47,Asia,21,969.48
2cbfbcd53af8401b9e24bd50a670db76,82,60,22,Africa,20,452.85
2cc24af2ab4f4920a1e45a1609089b2e,131,102,29,North America,24,1303.74
2cc74a4e3cd84ca9a4b351e33ea09c9c,304,259,45,Europe,20,2338.03
2cc905e18aa2435a936576a7b8ad443a,313,292,21,Africa,17,2546.34
2cc968ad92304efe9b243db1c9e5b815,115,79,36,South America,22,599.91
2cc9cf7372cc4b1ebba79399e177a80d,104,73,31,Europe,16,858.99
2cca322ca34945f7936f59b1e929c8cb,85,56,29,Europe,21,398.65
2ccc3b0852f44c429c11a1c69823ecce,56,2,54,North America,18,144.93
2cce4e731028478b88778f9f46c9654a,362,343,19,Africa,15,2311.05
2ccf2b057eb540539d38fa031042de78,60,14,46,Asia,14,201.29
2ccff22aa5b549cfb9b7f8e6581e28d4,145,109,36,Africa,29,682.69
2cd28b474a1b44569a6b666038409789,103,53,50,Europe,20,142.01
2cd2ddbc019d48fcafe6b35c5593743c,167,131,36,Africa,14,958.64
2cd45cff91e042c8a509bc3534f3d080,72,34,38,Asia,23,546.21
2cd5229d8b8a4884bc20a631896e1223,54,9,45,Europe,25,208.81
2cd55676db2c4776b40ea3c09d994cbb,138,104,34,North America,20,1308.42
2cd55f898aab439089fb5a957c0e80b8,179,129,50,Oceania,23,934.25
2cd5e5dcb46b4c3294b9903658dc57ab,166,119,47,Africa,25,1138.21
2cd6e6c667284cfab7739e793f37d0d1,58,33,25,Africa,15,526.42
2cd707f48b1c4ec7b01268c83b326b66,329,292,37,South America,16,2468.93
2cd76211901c4ca8ae0b1f562fa24197,121,71,50,North America,17,518.48
2cd7c3fdf21047099656699f4ec91043,178,132,46,Europe,22,571.9
2cd7e8a982404bb1a2daa48e92efc6a6,135,100,35,Europe,17,1004.3
2cd8d1a64cc04c2cb5c3bc854303543b,114,93,21,Europe,19,870.66
2cd8e0e4f2a44293ab38540bb9b35de1,240,192,48,Europe,19,1168.36
2cd9a9e1ab7b4680be40bf3f9afd2105,119,64,55,Europe,19,548.82
2cda89e585b4471aa3f6a3d230a42f63,283,254,29,Europe,20,2005.05
2cdd9bd9eef544b78345e4f56f78c6a7,324,277,47,North America,21,1951.24
2ce04079117c4bba9c13927e3b2a0108,330,294,36,South America,17,2168.91
2ce0a3ccdd454a4393fba1acffb97f7c,287,257,30,Europe,19,2517.37
2ce3efd3ba884513b859472903d02226,363,326,37,Oceania,17,2528.38
2ce40c9b399943b38d772bd0cce68df8,298,255,43,Africa,14,2464.15
2ce54ac4f1024349a0aa168ffedcefcc,225,194,31,Africa,17,1913.83
2ce9fcc879644a4c90573e67189c1c3d,174,146,28,Africa,20,1436.92
2cea6df5ddae4449bdd846093a7beae2,349,304,45,Europe,23,1819.65
2cea7548e80a4952b41eec4e5dfe4c9f,365,363,2,Africa,17,1862.17
2cebef6a0b194bbda7c1237bf10581d5,253,220,33,North America,24,1456.64
2cf139ddd6934e3da3dbf708ae42a00b,321,281,40,North America,20,1848.29
2cf229d12b4241b28de21e2cd2fdbb4a,236,204,32,South America,20,1397.81
2cf6556f40b742f38fc98f1e424501ab,239,187,52,North America,17,1440.27
2cf71655037947acae03a46b72a4bacd,246,223,23,North America,21,1883.29
2cf74fbd7feb4c07a74d7a6865fe1870,353,330,23,Asia,16,2231.33
2cf851ec3aef4c8fb5a49aecd6c3059d,362,322,40,Africa,22,1978.17
2d00112adeb64653bfb9e2e26ef12919,365,329,36,South America,18,2123.53
2d02955bda684d1a9c9d53bcf4393dab,277,240,37,Oceania,22,1315.11
2d0481cdc69144809356665097324223,74,38,36,Oceania,21,301.31
2d06053ed52c420e83f3dce9db62fc49,312,283,29,Asia,19,2003.1
2d0675814e634bb59eb5f7a17775176f,325,276,49,Europe,17,2092.23
2d09b92a0a16442aabac58dc015a94b7,361,316,45,Asia,18,1791.74
2d0b85a2aa0b4452a8c4f31492cf2230,340,299,41,Asia,13,2358.85
2d0cf83ff5f445d797f4b085001846e3,200,151,49,South America,23,1524.5
2d0e3d1612cf46cbbfaed20f96a6595e,55,20,35,Oceania,27,271.08
2d0ff7591d7c483a99a7be42c47d6f1d,190,134,56,Oceania,15,693.88
2d1458b319054e4e9e8ac98856a2c1fd,290,258,32,Europe,18,2152.79
2d181ab9893843b8a7a2c59df1188c80,87,55,32,Africa,17,503.38
2d1905ed86da46c1b88c7f8dec0e58fb,254,230,24,Europe,14,2248.76
2d19402c4cad46d680cac4f705fa9e38,120,87,33,Oceania,18,630.2
2d19e3524602474f98473dad330be1f0,212,170,42,North America,19,764.53
2d1a24b17c1d4b48b3b9e6e3d83b4150,312,283,29,Asia,21,1980.29
2d1a2f9e0c5d43cca6bad65b25469212,319,279,40,Asia,19,1902.99
2d1aab58bb4a4ca89ed7731d192141ae,133,108,25,Africa,20,1406.37
2d1e1505bf16489da72fe89e142a45e6,124,80,44,South America,12,451.8
2d22b15e7c3047d487728ad595022a79,282,229,53,Oceania,20,1338.61
2d23cae28afa48fa8e22f61c0a884ed4,141,93,48,North America,20,347.32
2d24bba1c12a4aff8aee000839fc2ad1,364,310,54,Asia,16,1736.05
2d2781dccb424f4881374635839231a8,176,123,53,Asia,20,839.06
2d2b981bd7514a769fe4c4a158bae525,273,230,43,South America,26,1322.23
2d2e23946bf849fabf65693c28fda365,337,301,36,South America,20,2222.85
2d2e8b582bbe4325a2ab3dec1a5eb6d8,186,141,45,Europe,20,741.52
2d2f9438d396429eb1f7ae2a0f2d427a,365,331,34,Africa,17,2346.44
2d32418dea7f41c1a120c394f05d3b5e,343,315,28,Oceania,24,3295.87
2d32b0dda3214c8ab8692898adce61a5,210,167,43,Europe,25,1287.29
2d36e2a2a1e34957be72ad371a8b486c,155,118,37,Oceania,24,879.09
2d38b93acb214f9eafe0020b1c17930f,330,290,40,North America,24,1735.42
2d3a26c5a5ee4fffb34fa076623bc81c,364,363,1,Oceania,17,2434.82
2d3b4974d7ba4c9ea902fa52141f9c58,98,81,17,Europe,15,323.01
2d3d1e0a63984fa793ac59bbabc08cc1,143,98,45,Oceania,23,816.34
2d3eda4144a24172b8ae71e02df4ec35,363,355,8,Africa,22,1815.92
2d3fe1d4a1424cfebb2eed24865fc57f,54,12,42,Asia,19,126.36
2d429a0dc55849f1be8963ece15a8800,133,96,37,Asia,20,1065.5
2d4430c8b59142ffa660b6b1cf50b45d,160,133,27,Africa,18,1498.27
2d4869de34234bcead1103e31b205a81,283,253,30,Oceania,24,3106.19
2d49c982510a4f6c80d0b256b1a6f194,38,2,36,Asia,20,179.28
2d4a7baf64514aee97e36bbf26dce9f5,208,164,44,Asia,21,1112.37
2d4d8a192a9d44129349c2ed61a2e894,249,223,26,North America,21,2005.67
2d4fa05b96134557ae468518dad44c6e,101,82,19,South America,21,1005.34
2d4fe469cd94470498966b07ef65f974,74,36,38,Africa,17,787.64
2d50907304724f54a897810e2b75c209,345,294,51,Africa,25,2109.9
2d53c23e752d4893b23b4d782f915b56,276,250,26,Europe,15,2399.41
2d55209da61841ee8ea03f917470ff7f,118,69,49,Oceania,14,510.16
2d552f94c3b94536b760045f0cd3bb9f,89,74,15,North America,13,717.8
2d55f284991e474e979596381adac9d7,210,182,28,South America,20,1150.31
2d56e622e3734b7c9719d2d3ddc844d6,220,184,36,Asia,14,1266.69
2d57affb36b8433c9130d2d5084c7917,365,365,0,Oceania,23,2061.27
2d58d5d4655f4c4cae5a6337dc76f730,364,329,35,Europe,21,2138.53
2d5ae18827b6445499d3e6e8efc308d3,364,352,12,Africa,18,2095.68
2d5de390d4854a5aaf45a796fa838367,59,10,49,North America,26,236.09
2d5ed12397784c55b3bfadd61b0634a9,39,16,23,Africa,17,470.92
2d6361f2d5d74e76aeb042c42b295fec,320,296,24,Europe,18,1989.97
2d64a02e53d4452196b801be6882e090,146,123,23,Europe,16,1199.62
2d655ec45e9b4fa9bb0178cb19bd30fb,165,129,36,Oceania,23,819.56
2d67cb9103154ef197c8834d581a5e2d,327,284,43,South America,18,1244.71
2d6bb38057304050a08b13bb1c4ea2bf,176,126,50,Africa,20,902.69
2d6be2226f344455972a517c0eb63e96,258,215,43,Africa,15,937.36
2d6da2bcb4f64c6cb7df24e9f29206f5,348,300,48,North America,20,2304.98
2d6dff469f894cd4b15dad0a65fa2126,237,200,37,Asia,17,2125.41
2d6e7a4cb8924616925642b0f204cbee,362,352,10,Europe,16,2617.64
2d6ec979a0cb4b03a729a39998d40cff,150,107,43,Africa,25,777.84
2d6ece32999047949775fe8b4ce43a2b,365,356,9,Oceania,18,3075.1
2d6f3ffd322b495d93b9400c6789b67f,156,136,20,Europe,21,1101.45
2d714950d5144be782b3f82307ad18ac,206,175,31,Asia,22,1380
2d721d526f6e48b5a9571db26e9ead50,221,180,41,Asia,18,751.02
2d72f4a197ea4bcf8c48eedac013d292,250,227,23,Asia,16,1478.57
2d768f1b4c3845348821b6e38fe9b09e,72,36,36,South America,25,419.02
2d7762158eed4274b8597085b4cfcf76,299,249,50,Oceania,22,1623.05
2d77e546a16149c3a3efe0a595eb0c9c,93,65,28,Africa,23,572.98
2d79b18661c04ee684ec05d2740df9c6,64,43,21,Africa,22,249.92
2d7b41b9070c4816b140cbba7cbad762,192,154,38,Asia,17,1506.49
2d7c7e03c6f842b1a257da285ebd14e5,33,9,24,Africa,19,434.03
2d8093b1c4a247f3bfffb71d546de28c,365,359,6,Africa,20,1530.82
2d8422945624443fa7046a4fb79d0bb5,176,146,30,Oceania,18,922.01
2d857b51a6bb4905bd1518224f40161c,121,80,41,Europe,17,542.27
2d86a80d2a8c45cbaf55a4e45bbd1c5b,106,78,28,Africa,22,751.4
2d86fae5f7624c8bb67b1a9b2363e934,156,112,44,Africa,21,955.61
2d89a76c97684795a6a787a42594ff1f,294,245,49,Oceania,18,1456.45
2d8a04ce13ce4b3e916c7dbdaa1cdbe7,225,197,28,Oceania,19,1807.1
2d8b8174bd5a4ba9a31f0d5b0e8269ef,86,45,41,Asia,22,679.6
2d8c2d86e31246ce853b628ee21d6ded,274,246,28,Europe,18,2612.62
2d8c3db04d0744de9a376f25793579ad,280,231,49,South America,15,1919.72
2d8ccfcb8db14abb9b0f2ee7a7c2f67d,101,68,33,Europe,16,493.99
2d8ce82b2c32415f9ec2e104aaf2bd1b,258,229,29,Europe,18,1570.86
2d8d3be34cb1422f846fdfc761efafff,47,4,43,South America,22,504.24
2d916a6da2ab4bf09783480cacb7fb42,163,129,34,Asia,21,894.26
2d91b5abbc8240788c000a5dcb38fce4,263,228,35,South America,23,1443.04
2d91ec4a90c54e0785b2f2845c549726,125,92,33,Oceania,21,901.72
2d935607d3354c95ba612914fad91122,363,360,3,Europe,25,2983.93
2d94cb81102948a5839ad56d66276905,53,14,39,Europe,28,294.01
2d963f9d29ec41548b59646fd3bb0da1,225,176,49,North America,22,1092.99
2d998d82bda54536a7a7b715687fad73,119,69,50,Asia,19,747.08
2d9aa8c7b7b54d66bff340a9de1d3905,365,330,35,Oceania,14,2086
2d9ad07380204edd9f78ec5f9d75d46f,114,64,50,Oceania,19,431.66
2da186835a524a8fa6df41f550bf9c3d,344,294,50,Europe,18,1887.41
2da3bd1813914a1695d85faf1e9dc2e0,166,149,17,Asia,17,1079.83
2da4779a3e5b4ce98ea685669392e95d,120,95,25,North America,20,1128.18
2da491b3ff8847f4a7a4b8e03bb3f843,87,51,36,South America,20,628.11
2da4a668f83540c687dd1a7dd6b9f598,250,199,51,Europe,17,1036.76
2da5f7437b5941459868945b8f8bc7cc,168,117,51,Africa,20,1126.1
2da6eb73fb434e6da679c5712d9dab4e,273,235,38,Africa,18,2064.43
2da839f28b214455a9202d84be062abe,365,344,21,Europe,19,2049.17
2da8571d17c74d16a46877608ba9403b,105,55,50,Asia,21,687.98
2da961bb34da4f23a38775febfe8d5b1,364,321,43,Africa,20,1367.97
2daa46e7ee6f41ecbfc367142f57125a,365,359,6,Europe,20,1988.79
2daa6a8be724488f9fe13b8c274115ec,192,170,22,Asia,21,1488.87
2daac6c5c2554df2ba2b837d7d932ef3,364,344,20,Asia,25,3261.5
2dac75e080c04d57ab5cb001a895eb53,352,317,35,Europe,19,2273.52
2dadffb1f3d14d42969c5edb8e433b26,111,79,32,Asia,15,310.55
2dae14f7902f4b06951af2578257af7f,312,290,22,Africa,20,2603.35
2daf201a9a5b4e5d8c68f477a9220e7f,50,31,19,Africa,23,272.05
2db18733741e45a18eca5cc252a62b1f,164,117,47,Oceania,23,931.71
2db24adc129d4da8af7b26eb72195cc3,199,165,34,Europe,17,1747.16
2db87a0f779c4b2fa68ed88862f261fd,165,128,37,Oceania,20,1035.53
2dba67670df246ae9af75a447e2efc09,212,193,19,Asia,23,1262.86
2dbae44a93da40e8b84acea01219950a,364,336,28,South America,18,3485.81
2dbd20b23c1749cbb9e13e6dc9428e77,365,350,15,South America,20,1976.73
2dbe41bffe144cabb4816092f82a7b10,365,349,16,Oceania,22,2297
2dbef85a379a46b98961b7bf876ec586,295,272,23,Europe,19,2190.67
2dbf83fecb2f4677baed546adec0b446,189,135,54,Europe,21,1210.45
2dc19611eb11425e8be4b0319cdd296f,117,78,39,South America,17,865.84
2dc455ce76024b57adcb6db5ef29c702,318,268,50,North America,18,1815.21
2dc5cb9c218d4903810e4173d675493a,185,136,49,South America,22,722.25
2dc638c27acc4a2aa46466ce1a46a171,165,132,33,Oceania,18,1176.46
2dc8632b13674b0eb394069f03f45339,56,5,51,Africa,20,205.82
2dc875e69fc7411aa17635c026d46d5d,71,29,42,Asia,20,428.37
2dc9a44f7e194b6fbec796db1b21454c,36,9,27,North America,20,153.2
2dcc218aa5b141c49a4094d1433e439d,297,276,21,North America,24,2581.03
2dcd5826bd7245c8890f446602b00700,227,178,49,Africa,22,1275.57
2dcebd6fd6b74d4f8c47ddd57ed28220,329,306,23,South America,19,1806.76
2dcf0be1b19a4e878e4b16909996738e,113,84,29,Africa,22,951.32
2dcf45f85a734725a87120f54b073027,231,209,22,Europe,15,1754.86
2dcfa821c1ff4d0788e9045a2ea996ea,365,354,11,South America,25,2098.43
2dcfb5d78e814a9da6d0bbf13f27904e,362,335,27,Africa,20,1680.42
2dd013414b614cbb8fbd8d3e912977bd,365,358,7,North America,19,2678.58
2dd0aa31e44f488db312f96e107f8469,144,126,18,Africa,20,1198.26
2dd63ff33727472bbccc497f957baea7,145,111,34,South America,20,761.01
2dd6a81f7d6945a5b4013a07e3272f95,155,138,17,Europe,17,1223.6
2dd8174fadf2434f9d44366a80e11a17,78,49,29,Oceania,23,597.37
2ddbe2e12cff43ba95e9b17bb9102e5d,155,115,40,Africa,20,1341.4
2ddca7e7a07e43b69c328f8e5c4e1953,255,204,51,Europe,21,1007.5
2ddd09c398e4429c9754ab8e6b5c5474,154,115,39,Asia,22,1291.65
2ddefbe49fa44752abbba49ff920eeae,114,57,57,Oceania,21,863.02
2de09a0e869d4946ab47d9562320edc2,71,22,49,North America,19,310.83
2de21915a06c421eb6393c37265c0454,285,261,24,Asia,18,1545.01
2de4553e62ba4383b869db826dd501c2,103,75,28,South America,20,486.5
2de69604c4d84532a1aea11158e90d9d,290,254,36,North America,22,2533.62
2de85b140526459a8006c9fff52b7912,70,49,21,Africa,21,526.02
2de8a7ac397f438bb6f8a23db7bbb2ff,353,335,18,Africa,18,2570.42
2de9836d737843e79f8efa3c68a12414,343,328,15,Asia,21,2495.66
2deab93f87ad4989924cfc2cfc625afb,46,22,24,Asia,24,396.81
2deaf769cad641fd8c7974551b2edfe0,365,333,32,Africa,18,1927.16
2deb866f24d745f69b5591aeafee41f2,65,19,46,South America,19,141.32
2dec5906a5d0434cb7bcb9c16aaa88b9,241,192,49,Asia,24,911.72
2df007f5e030404aacf36b3e261777c7,122,95,27,Asia,17,1009.78
2df11fe5b22346208916386cbef77cca,99,59,40,North America,21,389.18
2df1ff6e959e49caa55cab24f39094f4,155,129,26,South America,22,1136.8
2df52983a3e3476bb35c1022dfce8075,308,259,49,Europe,25,1736.29
2df5993f947b4ce6a48ec1a0a3832869,365,356,9,Asia,19,1881.88
2df788d14dcf4ae8b5570a6bb925b3a1,262,246,16,North America,13,1899.69
2df83851b1bb45abb9b3d5faa862aed4,91,63,28,Asia,18,667.12
2df8df2162dd43a7bf08b2c53d9cd803,356,298,58,Oceania,21,1853.94
2df91b8ec431412785bc0b45bc6d053a,65,43,22,Oceania,17,775.09
2df9e49d8abf4dc2928210d54ad1dd2e,158,129,29,Africa,18,946.31
2dfa896cd65f4a7f8cf3a549bcfea533,63,26,37,Europe,17,712.98
2dfada6d3189445daaf68ce069cc6bf1,166,111,55,Africa,18,536.51
2dfb2b0a13cc4aacbf5b49935e4a70a3,71,15,56,North America,18,500.07
2dfdb8d94f674140861971207fdc6486,150,99,51,Oceania,23,622.14
2dfeea7381314644ba2851bfde19925f,361,355,6,South America,23,1793.6
2dff61ae78794579871d2f5ee0cff235,198,153,45,Oceania,20,964.96
2dffcb407e264cb3900b58178dae200a,38,9,29,South America,20,288.46
2e00ea9bfdd04656b7e077d3cd9e488d,141,106,35,Africa,17,1163.3
2e01f19e9e3b4fbdb4d063a640ade036,232,197,35,Asia,16,1566.86
2e029c1c595b43f8aca2a0b47eebecea,178,135,43,Oceania,21,1619.9
2e078f479eb746fa999c78261270bbe8,199,159,40,Europe,15,1645.08
2e07dbc7c69a458187bf40e04f96643c,181,148,33,Asia,18,1308.63
2e08fba2a541459ab7db3ae552e34002,361,326,35,Europe,22,1724.62
2e0b1050f6d7452b8ade0e5feab2769c,44,22,22,North America,25,120.86
2e0e0166bd1b4a0bb8da4e80eaf1e8a4,104,62,42,North America,23,889.31
2e0e4e573ff94bc899a3f5cd3dd83370,223,182,41,Africa,21,996.9
2e0ee0ec3dcb4dc58af4638229dc32f6,365,322,43,Africa,15,2522.07
2e0f670ab6e04f7e94c303fa28b21ccc,325,305,20,South America,21,2028.77
2e11140ccb024cbc965d9d3dc2cf498d,365,329,36,Asia,24,1238.8
2e11a214486c4a86b59808545881090e,281,254,27,Asia,21,2308.58
2e1243d711b0450383c6551ba4d0b63a,208,157,51,Europe,18,890.26
2e12d150dd224a149584c47dc9e3a7bf,247,201,46,North America,17,1264.78
2e1411537a2a4b0692cb8e3461236a3c,365,336,29,Asia,16,1626.17
2e1556764f0d413f95317caf1e926288,153,128,25,Africa,22,1707.29
2e16c527bf604413afc7dd0cf5ecd367,185,144,41,Oceania,18,967.51
2e18bb443d4b470ebe488ae20129581c,225,199,26,Africa,23,2225.12
2e1a77f385954a09b21c60bd9b5a7bf3,100,60,40,South America,18,728.51
2e1aa458806542658d4a84a11421f94f,284,249,35,South America,20,1853.88
2e1ab1c0fec24d97b2c208a7265e706b,251,220,31,Europe,18,1757.91
2e1b20a341fe4eb0a2673f9c1944eaee,52,10,42,Oceania,19,94.47
2e1c5ca6947140108d5e9f30b831bc79,362,341,21,North America,26,2488.53
2e1c6ba24bf54404bca43b9a48573fe0,176,132,44,Oceania,20,1156.39
2e1cf03d14364a428b3a3cefa48bc4ac,68,22,46,South America,19,395.52
2e1fbdb40d994cc5a622fcf2fd961884,255,225,30,Europe,24,1480.84
2e2062336adb4340a9c056d398c60501,102,49,53,South America,18,329.75
2e20ccc1271d4a6191b9c893568be977,177,134,43,Oceania,20,736.58
2e20e4942cc34e79b88cdf8cbbf3ae7f,261,235,26,South America,17,1983.52
2e215b5789534d37881655b859096b9d,190,134,56,Africa,22,946.51
2e21aeaf5d854b1e8733cbc15c17315f,242,212,30,South America,18,1917.71
2e22357e11a34f1d90b443b49ef1d9c3,301,263,38,Africa,19,2046.4
2e25ec045c98444ba599256ff21b14be,245,227,18,North America,16,2052.13
2e265c16e09b4c3d91b63445ac2a3e86,358,309,49,North America,21,2225.83
2e26738d97774db0b4964e4573b8bf6f,172,151,21,South America,21,1049.7
2e2c5364ede7400eb902bb7191f46afd,129,91,38,North America,16,501.45
2e2cc3b2d9904188b5708fcd45cbf8ca,223,185,38,Oceania,25,744.88
2e2ce36d38da4bcb802058d5628575e9,365,323,42,North America,19,1860.42
2e2d8ff138cf4fb4a8895af789c2f50f,364,339,25,Africa,19,2788.88
2e2db06f23274dd18a799ebca767982a,364,353,11,Africa,18,3253.36
2e2f59e1a28043c68724f3745d61cead,112,74,38,South America,17,1073.56
2e335b33d27a4debb79a10f656acfa8f,96,69,27,Oceania,19,822.3
2e33fa678996423ea3ca3c6eb99e4efc,258,226,32,Europe,20,1655.12
2e351bdec9d146c99fecc594efcc92dc,257,203,54,North America,23,1070.98
2e353b7a20394a609ff3f07a09374c99,220,162,58,Europe,23,1187.39
2e398324157e490c9b993abe6f14417d,364,360,4,Africa,18,1954.1
2e39902979174f5bb5736d38c4a9fa88,365,359,6,South America,25,2095.23
2e3a57dc6c5546f2a3a08f8bdce0fa05,114,92,22,North America,26,1507.61
2e3ae566d591432d8268f60aa95977d0,292,236,56,Europe,21,1799.15
2e3b84bec2e84de088b0103bf03c7585,50,15,35,Europe,20,441.17
2e3c5adfe99249639da842961ba7e531,341,311,30,Europe,20,3226.21
2e3df1545940404bb3bcc1240b947d02,90,48,42,South America,19,499.1
2e410522a6f840318e029979358be2a2,67,30,37,Europe,17,506.44
2e434552b02a43798f79472a3d4cbb19,68,14,54,Africa,27,304.35
2e459829e31e476283c7239d8509ddec,260,226,34,Asia,24,1546.05
2e46fdc7a9cd41c1a9575377731c178a,196,172,24,South America,20,1492.68
2e485a7ce1e04318b1cad8c10f5051a2,27,2,25,North America,21,447.6
2e48ee7d66f64f49a4b70e8d59f9b5aa,96,68,28,South America,21,695.48
2e4a69c1180242e0832ba560f99d9c41,153,99,54,Africa,18,791.98
2e4a74bfd1254ec1b1bcb82dcf5951e8,365,361,4,North America,15,2841.79
2e4c5817da5249268b2c78381b71b8ea,265,216,49,South America,16,875.34
2e4d6068fe72471eab2872a4a7e75eb9,147,117,30,North America,26,1139.09
2e4f0f92f387407b8aff1ae9bd670be2,82,30,52,North America,20,285.68
2e510a1da8ac4e7db5b350a4c63f7db4,348,298,50,North America,19,1153.47
2e560707c4b34b64aaf480d66add0043,301,256,45,North America,25,2132.77
2e5a65b978494a92a8f08ab4412f78bd,95,37,58,Oceania,18,207.64
2e5bec56fa974755bfcae46c67fdfaa8,254,229,25,Oceania,22,1752.91
2e5c1a36254444008b328e99985199f8,136,100,36,North America,24,672.65
2e5cbd0ea4654acd9246704374dfa77f,205,189,16,North America,22,1347.4
2e5d4b649e874b6181a005054ec5f803,364,322,42,North America,20,1402.3
2e5da1c549f0464ca1b5c54b27f66ac4,240,218,22,South America,18,1445.46
2e60ab43e51b4403bce4050b822bb735,135,96,39,Asia,21,1137.19
2e63e7e3ae0c4b6281ac8618ff2d0a6b,314,280,34,North America,20,3143.2
2e649939eae145799cdc898268cfd077,82,25,57,Europe,28,393.79
2e65a22b0e874569913d5edec835a525,364,340,24,North America,18,2705.82
2e66717a7adc41168c0cc8605540e052,359,325,34,North America,16,2410.15
2e68046f8e56405a8b9ba6a18243992c,154,104,50,South America,22,862.49
2e6bc189f96744ad80b7c16d25d3e823,96,69,27,South America,20,945.82
2e6e783082a3467182ceb10f32b0dc78,355,325,30,North America,22,2785.92
2e6fb069f6f042519221699b4241c896,242,213,29,North America,22,1406.19
2e72d0d81b8848f2b332a3a455145855,359,302,57,South America,16,1153.76
2e7549ad3ad1492993596afcbc46f9c1,103,72,31,Asia,22,796.61
2e764e78c5514ac8a3dcd4536199bb3f,346,296,50,South America,14,1293.69
2e771b8f6d4e47e68d2ce25785c67423,259,234,25,Oceania,19,1748.78
2e787a1fc8c741bdb8f8c913921e9843,365,331,34,South America,19,2764.95
2e7ab9e0f4f7492b8ea879fcba09ceaa,364,361,3,Africa,20,2140.21
2e7c1757baac416497d487324788851e,359,330,29,Europe,21,2449.27
2e7c7019c54d4a0fb071417bfcd39d95,99,64,35,Africa,23,576.06
2e7cd90a6f1f4044a8ff03b574f68e14,327,297,30,Africa,19,2681.26
2e81440f826d449faf2c77b75ebd2b75,48,13,35,North America,20,440.04
2e8238d2742747c9b05b5f5462ed0031,306,259,47,North America,21,1633.27
2e82852284404c41baeb4e2e716a2d20,192,158,34,South America,18,1075.9
2e867d57f2ee4c3598454fc2865d81cb,59,6,53,Oceania,19,271.88
2e87e43328c744f997187b39eb042a54,211,172,39,Europe,21,1284.28
2e8b2eafd06746fc93ebe769b435bb65,154,126,28,South America,17,1400.23
2e8fdf47851143fba1fd0c5ad1412eac,336,295,41,Europe,22,1776.56
2e903ff36dde4c27ac6050e2f278e0c8,365,341,24,Oceania,27,2094.48
2e91553e79bd4986aabfaef676f3df7e,128,92,36,Africa,17,739.65
2e92333aedd244db9dcd69b7b81f6cd8,254,195,59,Oceania,24,1677.13
2e9298d6ce614bca8ca5b8ce20b08cad,172,137,35,Europe,22,726.44
2e93920dfe43440d9e25e88232e77f4b,182,153,29,Africa,16,1257.1
2e9502c8de264a00a1b31607e3ef3f70,299,241,58,South America,23,1612.99
2e951bee31574ed39475d3b26e5195ba,362,344,18,Asia,21,2606.72
2e95913bde6749928b8e70fd08c558ec,171,134,37,Europe,14,1209.88
2e95e408bda241de9dc36509e887b7b0,167,125,42,South America,21,1380.9
2e9a184ada5e4e2c9e7b7061a120f84e,138,91,47,South America,18,477.43
2e9be5bb4a2542e2a285f817a61837b0,120,76,44,Africa,20,514.17
2e9c504529784c7c8e287a63476f6598,185,131,54,Asia,14,1101.93
2e9d35b35925454aa1f17bc39dea6154,86,35,51,Europe,25,406.37
2e9ebc77f82a440191a6e4800d7d10f6,206,181,25,Europe,20,1460.87
2e9f36814a154b7bafb8184e5f6d5b48,204,177,27,Asia,18,1389.66
2e9ff4d6239444d4ba45ce74b8ead30b,289,255,34,Europe,18,1842.35
2ea02cf4252d4db295716743524e00bd,333,280,53,South America,24,1471.86
2ea3df27486e424d824965c12afa9bfe,365,362,3,Europe,21,1970.99
2ea45eb43211418c82c3621e935dc187,192,166,26,North America,21,1246.52
2ea63e2f1f22452ea5e25f67e81f1466,113,74,39,North America,21,414.48
2ea7e78a149d441c8aed0510b8da47f6,96,77,19,North America,20,825.38
2eaae425080b4afa8a064ac69bb2a9f7,81,56,25,North America,16,485.53
2eac54a35656485ba28938b34ca44310,115,83,32,South America,19,1482.56
2eaeb37a918244968a24ed625d7cccb0,162,126,36,Asia,18,1330.46
2eb50a8c89174fc4b7108c21ff2db60d,126,80,46,Africa,23,567.47
2eb773adc6bf4e6f95055463a5ba7442,221,170,51,Africa,24,1401.11
2ebae8f16dd04b0a97cd21f8ac5784a5,296,260,36,North America,17,1782.79
2ec28a61828146ac9118e01eaa414aa7,79,50,29,Asia,19,930.02
2ec3064d68b848ffa695b25cb1864f57,181,127,54,Asia,24,1188.06
2ec31ca86ff347d9a989ac0958187f18,323,282,41,South America,17,1831.25
2ec379ed65a04e09a656c6f8c593c5b7,176,119,57,Europe,22,1126.82
2eca2eefa8c24cf3adf061e1c064386b,244,185,59,Oceania,24,1315.46
2ecb51e575af47f8994831a1d5163dda,117,79,38,Africa,24,805.78
2ece27ffca0b46218bd2b7d0b1b7b06e,186,167,19,Asia,18,1029.45
2ecf57ddc4184e11a27d75836803e054,339,290,49,South America,24,1437.55
2ed0eb05e1cd4baf9a29975142856366,297,251,46,North America,19,1349.28
2ed5c2376d5646d4b0ef075babaa2ecc,323,278,45,Africa,18,2625.32
2ed6348915144c479ca66bbf0ff822a2,74,24,50,Africa,20,606.63
2ed708d8678140c9922c58356be2c748,150,128,22,South America,19,959.47
2ed7b048f9704154a452e5aadcb5a8e0,71,15,56,North America,23,289.95
2ed7dfeabccb43bab9668c4131dc3eea,365,353,12,Oceania,19,3083.72
2ed8c93a29af4520811157659429b5f6,357,333,24,Oceania,19,2739.89
2ed9525b4a9b418cb20d7195636b6a18,353,331,22,South America,24,2290.42
2edb5c7f6a424a3e91692d18ee5d8962,279,226,53,South America,24,1247.63
2edb6fdbfae04a0f9ca05955d0d79e29,138,108,30,North America,26,674.3
2edbd8ce9ea84b6481219c27a53ac87b,287,256,31,North America,21,2473.87
2ee0507475444c648d48edc03860d8e5,322,298,24,Oceania,23,2312.08
2ee1446c0fc945d799070d11940035c6,277,224,53,South America,18,1348.67
2ee450ebb3e747d993f91d815208c299,109,74,35,Europe,19,428.91
2ee497b15c6f403baf2a6ab5f11db730,240,207,33,Africa,24,2067.59
2ee4c76993d5471791a5aefd48bb0d93,76,19,57,Africa,19,457.18
2ee75ae255314806bf516e044fdffbf7,184,163,21,Africa,17,1814.91
2ee782aa9454472a8fce43c6b1215d22,174,113,61,North America,24,924.44
2eece618dbe9435397847a91c6479197,365,330,35,Europe,19,2294.02
2eed97a5d7be4e0a98419b3a9d1e0843,219,182,37,Africa,23,1566.13
2eede3ff30b34c06ac160ddc3cc794a5,305,266,39,North America,20,1888.63
2ef38a1e48ec4a37859a7a87fc4a1c89,340,303,37,Europe,16,1977.16
2ef43a62184b4dffafee16496a9bc352,258,221,37,Oceania,20,1713.94
2ef47431c52e4b55843d56d8ab91a2f8,286,232,54,North America,25,1460.47
2ef4d44e63c2400e9ddf33cd7b03d6c2,219,201,18,Asia,19,2369.96
2ef59bd2f4df4b5c8aa3a757b383fbe4,159,136,23,Africa,20,1252.47
2ef68cd1272b4d23b656a5ab7581335c,252,224,28,Europe,17,2182.26
2ef7d2f379264a25b64e21326d41b8d7,147,113,34,South America,20,1161.78
2ef8dda8ed1349cab2a7f66be5ca719f,211,167,44,Asia,14,928.69
2ef934777a8548939039ff70043049c5,298,273,25,Europe,27,1868.3
2efacf1e505c4f499aff58772ef2b4f5,189,151,38,Oceania,23,1121.77
2efcab125940495c998561fd77e08d1a,58,7,51,Africa,19,93.08
2efdfa5de0684712a14471a07f6487cf,142,92,50,Asia,20,806.97
2efe3d2dedd740f59cbf4cfa2cb3b2f5,351,319,32,Europe,21,3196.82
2efe60e9d9704f0c85140eb90ee2fc7b,121,73,48,Africa,17,430.08
2efea84625d643f498a4e86d6c921dc2,326,277,49,Oceania,21,1594.64
2f0053528d2545d089de611ce70b492c,246,217,29,Oceania,21,1067.53
2f00dabba051473eac19c13512631d01,126,65,61,North America,23,927.39
2f03d6962baa4dd1ad1105518042dae6,289,274,15,North America,17,2570.01
2f062970a58f4cd7add5017e73283eea,350,321,29,South America,20,2799.48
2f0894181ff044e799f8fe942aad0963,56,35,21,South America,20,189.91
2f0983033abd4b67b0069d45779b314d,151,102,49,Europe,26,853.36
2f09830e23934984b901ac8d33900c92,52,13,39,North America,17,412.44
2f0aa94d6fa04d5da35ba318b8b9a299,259,208,51,Europe,16,1248.46
2f0ae836739a421985af37f94e1a98e6,262,208,54,Europe,18,758.13
2f0ceaca0dd147f6ab80d328686c5242,329,297,32,Africa,18,2574.25
2f0df72c10344512bc0b0646356940c6,107,80,27,Africa,22,739.07
2f132176e55a495bb467091415c0fec1,196,159,37,Africa,17,1335.52
2f13beba008245d4abedad76f52a17c8,169,158,11,Africa,19,1217.5
2f1451298e654d61a87fc83a81cdf387,332,284,48,Europe,18,1737.77
2f198621761d4355b7a6ee4a65f07aa6,262,201,61,North America,15,1345.32
2f1a303703634dcaa098427cc7c97d68,62,5,57,Asia,25,743.13
2f1a4effa43649808b960c973966d8cc,86,43,43,Oceania,24,646.39
2f1b47cc2b334f37a2b123cfbcaacb36,32,12,20,North America,21,306.3
2f1eed1970854ddc921e40b1fa982081,360,343,17,North America,25,3478.5
2f1f22d4ed2c4e5ea6eea103377cbaef,292,261,31,Africa,20,1878.2
2f20a6c448df465f95ed53cb80865d30,185,147,38,Europe,22,1373.66
2f21d4a45d0441b4835e001d34edb4fe,340,316,24,Africa,20,3001.08
2f22575c15744b69bf0aa24dada7f713,324,291,33,Africa,19,1603.58
2f2331f7589c4e33960885fd49804296,180,143,37,Africa,20,1174.88
2f2648fc645c41f3a03c16b8e83aaa4f,154,108,46,Europe,26,1190.24
2f26b9d7c3e941dfba187f5555a12ee2,310,281,29,North America,20,2420.55
2f2aa21b657d40ae90f16456d142b4cb,205,167,38,Europe,20,940.66
2f2c842816e64bc5afd3a87338f7177a,301,280,21,Europe,24,2044.04
2f2dfc7840ec441cacfcc08671dee6a6,364,358,6,Asia,18,2165.73
2f3164b98a3f448a95d58632112b45ec,251,213,38,Asia,16,1489.31
2f333100f459410e9fd5e74aab7013c9,352,325,27,Asia,17,2928.54
2f33edee83cc4cfba7e82e0779d4dbd1,204,167,37,South America,17,1401.18
2f348090db824b3caa023d252a14add0,202,155,47,North America,17,658.19
2f369b9b019b456392e14ede760f973b,91,41,50,Oceania,17,621.1
2f3c331e17354676bd4355c96d075fad,286,239,47,Africa,19,1480.23
2f3cb8b3e32a4e21add1fa9852b2712d,277,247,30,Africa,26,2106.77
2f3d6bfa310840e79152f2f2c7a91a7e,315,283,32,Africa,19,2263.98
2f3dc2b60e1e4628b6b4f8dfc5870abc,264,230,34,South America,20,2200.65
2f401d1d873d4bb68bec3e8bb6de6be1,90,55,35,Oceania,20,649.06
2f433ec4744441e186612eb08d8214de,42,16,26,South America,21,115.12
2f4773f0a816479492cec0d327641367,199,161,38,North America,18,1143.4
2f477cc8aee44d59b15515ff2240ae9b,362,360,2,Asia,17,2200.51
2f47ad8468d24aef80e9b7d80aa07087,247,226,21,North America,21,2226.04
2f47d65969bf4a61b935f0e206ce0c64,50,25,25,Africa,19,452.47
2f4a1405ad014884ae628138c04c02ea,76,31,45,South America,21,829.34
2f4ba066a8c1404eba79c4d017f76a0b,103,48,55,Africa,19,360.04
2f4e0d9bb41c44cdb8283eaaeae79cdd,150,121,29,Oceania,19,951.42
2f4f33e57f4f47c7998e7f4f983c0ca7,303,273,30,Europe,21,2448.4
2f5173a6cc7c4bc4a6982eee130686f2,142,91,51,South America,22,444.3
2f5215577dee4eaf9c579c210927d224,69,37,32,Europe,18,658.68
2f52d1848c3843ed81239ba6e5a5a95c,94,73,21,Oceania,23,934.98
2f565d9525154251913c77e0f60e6f84,46,34,12,Oceania,24,333.83
2f568acf011a470783da935d816e470d,365,364,1,North America,23,1808.22
2f580cdec8b84c40b2dc943abbbb4aa9,81,48,33,South America,18,435.07
2f581ab7eb5a4ceb8babb5faaac9494f,364,326,38,Oceania,21,2363.09
2f58c2d216924e27ad6dfe3138085697,253,217,36,North America,16,2289.9
2f597a3a860d4a48b5bb9c68117d3b82,284,258,26,North America,17,1906.01
2f5d1b19bc6040488f4c7bae1d1e3f73,294,241,53,Africa,21,1160.94
2f5fa2f51ede44c1921888ae6b4496a9,253,220,33,Africa,23,2158.61
2f6022bf72c94f279a68a2133008c4e0,197,146,51,Asia,22,698.94
2f60b22393f54e73b0343ca18bcff00d,57,30,27,North America,18,477.86
2f60c82f32bb4943ae1d34727bff3836,233,218,15,Oceania,18,1782.58
2f610d6dd38e40eea4e430f9409a0935,72,41,31,Oceania,24,685.83
2f642b9a38834cd5af4a634b12021b23,85,41,44,South America,19,683.95
2f6479e499d94e6a99089f9699763506,211,196,15,South America,22,1618.28
2f66b856780d423bb3489e8f3ff76956,137,97,40,Africa,14,653.7
2f684b4191a7483eb60f2c5c08298841,211,171,40,South America,20,1831.58
2f6871495ad34a9fabebff5f5bcb7f1d,87,79,8,Europe,22,725.05
2f6a0dd27db842eb9c23af1fa2bc0b6c,64,43,21,Asia,22,784.17
2f6a74bee71c4cdd87b2f819d8db36c1,253,226,27,South America,16,1419.54
2f6acec4f92a42fa914ff0407bf36535,365,345,20,South America,18,2853.56
2f6ae3b58456432c9d4a1840aa4b8699,356,311,45,North America,22,1007.78
2f6b8a5e234249b7b3e1a09469452ae6,228,179,49,Oceania,23,1622.63
2f6ec68f195446ae9aa0be14c577d4aa,365,314,51,Africa,24,2119.96
2f6faecf7f1e492fb2fff4dcca208baa,317,271,46,North America,21,2293.33
2f6fdb17e4a040d3a65570143d62c2c4,186,158,28,North America,18,1514.92
2f7060d4d81546e58fa584c4e01d721e,234,207,27,North America,23,1677.4
2f70c3baac1b40af9b7626122320b528,353,309,44,Africa,21,1320.4
2f718e9e5efa4dcc8b97b1626fedfa97,185,162,23,North America,23,1521.3
2f71c61be6eb444d845ecfb3a5819fd6,184,161,23,South America,18,979.45
2f727e460474425ba05dbe8603018d73,139,112,27,Oceania,21,1489.41
2f7386ea4e3b44dc86cfd8cd624dad37,134,119,15,North America,22,746.46
2f7544826cad4af29a2d8e63f597fade,209,167,42,Africa,19,1143.61
2f79bbea61474f2789a125f9a70b2262,123,96,27,Asia,21,734.33
2f80c504c6f84a91a616f4d9d21c98fb,343,304,39,Asia,21,2587.05
2f8204da081847a9b725d68c16eda589,222,183,39,Asia,21,1391.53
2f82d588ff704e1a858c2cd49443442b,102,54,48,Oceania,15,560.39
2f84792a8bce48dab51627d07f8ced1b,116,81,35,North America,24,1067.17
2f8537f87fff4bd985be9d35e30e33cc,218,169,49,Europe,19,1244.85
2f87a4eedf314e009abca0a967d23b69,349,315,34,Europe,21,3129.03
2f8a4a9ff33f402a8f08cc0a17a1ee6a,354,321,33,Europe,22,2943.82
2f8cb483134f461db9d4a32bed930fcf,365,321,44,South America,22,2080.47
2f8cda167fa24d6dbb31eee3e4c294e4,63,36,27,North America,24,654.35
2f8cee32efd444d3b29ec3ef02c4e6bc,83,33,50,Asia,19,635.99
2f8db4e30e594720bf1efb6fe4655638,299,256,43,North America,16,1878.33
2f8df4dec8f943b58cc289af5aca56e9,243,209,34,North America,21,1554.82
2f8fb5c4df274c8babaceba0e8e0ae6e,126,96,30,North America,20,779.23
2f906240a43e4f40bbad40cec205a5d6,170,151,19,South America,21,921.03
2f9420f2f24d445ebc72073da6483fe9,299,275,24,Europe,24,2619.3
2f955210b18c4c45aa5f9a0a9eacc0cb,194,150,44,Europe,19,1174.84
2f99484281ec4ca88c1c11e97b6496ff,229,189,40,Africa,21,2085.16
2f9a7adeb9d146a5974ee4ec521e01f0,122,80,42,Oceania,18,481.24
2f9cf8757824458b8448e3abc3ff8872,26,5,21,North America,21,498.19
2f9eb252d3b844a7836551d4644dc043,259,225,34,Asia,19,1766.39
2fa156a4013043878753a8792097f374,150,99,51,South America,19,814.19
2fa73b39fd594713a326dc00e64b03e2,236,211,25,South America,20,1821.24
2fa7cc9f835b48b2a0955877531fbac6,93,72,21,Oceania,21,872.31
2fa7ef100ad94a208d581821cae0b2ad,181,138,43,Africa,23,983.04
2fa89a9d3a4b4eec8b86571a90154dff,274,246,28,Oceania,21,2497.93
2fab057a2d1343f2b15c0d9094704e0b,260,207,53,North America,23,999.67
2fad5f3b9652441c99e4ddfe5787a500,73,33,40,Europe,14,650.43
2faf5850709947c796f8818875687224,78,35,43,South America,23,388.77
2fb093178201447b88e836d04feac7ce,161,134,27,Europe,21,1176.09
2fb15a591ed146e280248fefb93b5a9f,128,96,32,Asia,20,1064.91
2fb38f0305554be096a05bbaca6c3c61,363,362,1,Oceania,19,2516.33
2fb3a2e062204a5383061ae3deaf0faa,270,219,51,Oceania,20,1271.1
2fb3b91f80a44ad8abc87cecd882e247,364,355,9,Africa,24,2586.07
2fb58a7c7d064c2e8d90a390ba751704,169,145,24,Asia,18,1102.69
2fb7018d961446a493bbd7ed2055c6c3,118,61,57,Asia,19,547.34
2fb9ebb582a24826a080b6d4b5494362,120,70,50,South America,19,708.45
2fbaeac35566426bb2faa08dd9f27bed,44,22,22,Asia,21,72.85
2fbc45b134e945f1a3188461b01bca73,317,268,49,Asia,24,1286.11
2fbe19badbe14e9f997493301b19c153,330,280,50,Asia,22,2174.98
2fc099fc0d7b4cfc955ed0d7587a3ef8,90,68,22,Europe,19,571.08
2fc370dd605c41e9b0fb39f1c9d7222d,148,106,42,Oceania,24,905.15
2fc479c73b7144e9bd123dd178b27f0e,187,152,35,Oceania,23,1315.41
2fc514879c2a4e9d863015ae00369212,83,31,52,Oceania,24,376.03
2fc5428d595d4f7ab7798c0ca902b17a,216,175,41,North America,19,1197.6
2fc714a4b838489680b5dd564768d960,74,22,52,Africa,20,409.76
2fc8afbfa475499895965468deda7cc1,106,75,31,Oceania,15,657.55
2fc98fa405604e36a65290b86dd6120c,270,243,27,Asia,24,2324.76
2fcc363bc586478fbf7c4ddc93facf52,292,241,51,Asia,27,1340.87
2fcd2d60bbf34bdf90506ab6ff2f34ca,183,151,32,Asia,20,1399.17
2fce4081886348478f55617bc99cef6c,160,111,49,South America,17,1155.26
2fcfea0d494f4bbdb4b311339530510f,178,151,27,North America,20,1642.72
2fd039398fef487d92979ea58cb591f3,114,82,32,North America,22,1067.79
2fd0aa5218e543a093146c18121bb4a7,191,143,48,Asia,16,593.09
2fd50e29d6e8484cbf92faf9169f4776,314,291,23,Europe,21,2815.16
2fd66f2ec6bc42f6bae89a813de6db4a,197,144,53,Africa,15,1520.02
2fd88bc2450d4a1abc55f91256602694,189,146,43,North America,16,1007.09
2fdd1f42459642a6bfd4cd8c30429320,113,88,25,Oceania,16,621.86
2fddec9e581e48408e34136d53b89cb6,340,316,24,South America,20,2233.01
2fe21d5623d140dbb81d186844153439,364,339,25,North America,16,1533.71
2fe2f4e2ee1a46f196511f1103d573e0,67,47,20,North America,18,668.68
2fe4030d9bcb455fb299ba7a95e31e09,89,54,35,Europe,24,545.89
2fe540169f0046448ee78f3489660406,28,2,26,Africa,21,476.17
2fe580a6a0244f289ac84d3092d19698,114,64,50,North America,20,432.3
2fe594efd1de43f286ce1b239ab8f51d,89,41,48,Oceania,20,589.91
2fe6a5415d974aa18ee0e1f30275f14b,212,185,27,North America,17,1569.62
2fe7306058a74c9b80b4ba71adec469a,95,48,47,Asia,18,1119.89
2fe80c50c2344c6b98528f3f62441d4d,115,80,35,Asia,16,683.75
2fe88b5f869d40fcbd2d70c34eb29925,333,307,26,South America,19,2965.94
2fe9208167604df1a15ccf7b743a7723,157,116,41,Asia,19,1135.14
2fea35a014294df88c24dc22a8fc933d,163,136,27,Europe,17,1123.24
2fedb286431b4895889a91c2bd242413,236,190,46,South America,19,1573.25
2fee334fc9154c59a2bcc246d0f11e01,273,221,52,South America,22,1679.95
2fee56a30ed34ba9a62be349682d7421,206,160,46,Europe,23,1077.77
2feecddf93634382a1fc7c630d365d68,220,191,29,North America,19,1366.72
2ff1489f1052438393e0f41b6adc8803,197,146,51,Europe,19,1401.83
2ff312073fdd45b98d8b0e47d0720acb,298,266,32,Asia,23,2127.78
2ff39a267d8047a1bf14e79123c20362,245,194,51,Oceania,24,1292.04
2ff4f277320b487483dfb011a5ac553f,363,347,16,Asia,21,1520.69
2ff59ce70f414c51915a1a55989dd8c2,365,351,14,Africa,22,2295.11
2ffa265975f547c7855eb66ad680c079,296,263,33,North America,26,1894.59
2ffa96a67a524ffa9534bc195c8053c4,364,353,11,South America,24,2569.83
2ffae7c203da486ab3c3830d085a32f7,330,283,47,South America,24,1810.48
2ffaf45be3a04e2d89a29416dcef148c,76,54,22,Oceania,18,907.27
2ffbfa8b1eeb43d284c56e3934d7ab04,159,107,52,South America,21,812.04
2ffd09ba22324ec492b3005863be6714,207,176,31,North America,20,1368.55
2ffd664b886b4d9a9ff8d5aa96fac25d,269,240,29,South America,17,2058.1
2ffdaba0964c4be19867c28f8a6bd825,225,185,40,Asia,22,1811.03
2fff506233f64d1ea6edb79ab4fe5f10,355,313,42,South America,19,1881.95
300586b067bf48279cb5525f784d1df7,236,195,41,Africa,19,1496.96
300bd7ac91964d74909738c29a4a2685,114,90,24,North America,22,602.63
300cf35851c24ac0b75f79b3abd24c04,318,279,39,Africa,21,1628.56
300dc2b3124d43f2aa33e92d417da7e6,162,145,17,Asia,21,1194.62
300f47e854804ed09d6bd6152e050ca3,228,180,48,South America,18,1695.63
30103ef326c64ff094b61a8f63394dc2,83,44,39,Europe,24,832.83
30109190e9e3474ebc1d38aecf5ccb5b,328,309,19,Oceania,22,2161.24
301131326f71446f9d343c480b91b89b,297,275,22,North America,20,2634.55
3011554d86324f78b32d7d93aeb0ee4d,110,75,35,Asia,25,592.93
3011653c3fc84a2e82c9b66b4a3ced60,295,243,52,South America,25,1349.4
3012ef383d0441c2812b387589afd46b,72,43,29,Europe,22,668.87
301356af29874459917707b29ed7e13f,364,348,16,Africa,17,2713.89
301607d9f4334891bbd2d6244843c438,309,263,46,Europe,17,1527.01
3016390a35594c8cb2b788ade1a1c38b,290,270,20,Africa,18,2422.67
3017fdfd8b414d8393bff43ae96efe2c,291,238,53,Africa,14,2083.5
301a714303d042488b2474e4b6fb702b,231,186,45,North America,23,2195.02
301d94b6f4b547cba09396d068946dbc,271,237,34,Oceania,22,1964.28
301dfde2dc4a48babea09d89cba031bb,365,347,18,Europe,16,2998.51
301fc2b4b4dc4e70a55dd06e367283de,334,317,17,Europe,23,2665.91
30205863411b44de9e86e6dd0beab323,326,292,34,Asia,23,2299.51
3023436550ae47929511f46288a0a78b,117,76,41,South America,19,575.91
302380e3b8144a0b9c48546dee5c3883,106,86,20,South America,16,825.1
3028c2b36e784afd9c39eb8c3581f2c7,243,224,19,Africa,19,2000.01
302a99cf5c1c411693c1ac7b77a5a814,290,258,32,Asia,18,1797.96
302c353b29814c3ea759ecb170384398,358,321,37,North America,20,2567.55
302dd81c412b4c88b6468ef4942962d9,171,151,20,North America,16,1091.01
302f4ca4adc34d3f9fb8c940a167b908,294,261,33,Asia,22,2238.05
30322ac0562d4b1980850fcbd278babd,357,322,35,Asia,16,2212.22
30339e2e732b4382b1880b5df54e00de,194,139,55,North America,21,610.74
3033b39b2cd94c799ec8da4266b0c606,164,117,47,South America,16,1448.67
3033f790574d4d148b0ded265039931f,365,346,19,Oceania,25,1732.55
3036030be33140b9aebd3278e8ef0603,150,94,56,Africa,22,789.73
30367c98fd4d4d8ca4f21a94bcfe4fee,224,186,38,Asia,21,1673.19
30368793b50445d4a320764408960823,362,340,22,Oceania,26,2371.06
3036b4324f334738a387f106e100a924,323,280,43,Asia,22,2315.11
3037010880fa4ce6a92944fa45e53d8b,126,100,26,South America,22,726.81
303783890dbe45bf8596bbf54de5451c,188,133,55,Oceania,16,698.19
3037b8bfabdd43d3b96efff0cf6d0c55,54,26,28,Europe,21,271.52
30399023c8674697a69dd2704f89788e,180,133,47,Asia,16,778.45
303a782c9c7041ecb7e275a43e6cd74b,223,183,40,Oceania,19,1574.82
303caa6d45ff4423885356c1f85c206a,99,56,43,South America,17,594.57
303eb3ad2cd04c7888835ae4dbdca1cc,255,200,55,Africa,20,1236.28
304032a366a64e9b94ee60d6c2a76825,308,291,17,Africa,17,3695.06
30403d71506e4bcab91730e49e03b1d0,361,356,5,Europe,19,1611.31
3040c184724f4523988204afba23745d,363,335,28,North America,22,2423.29
3041949878dc4c25b10911cbee90a386,108,57,51,Africa,20,336.66
30420091297d4344aa655fa6d0fdba6e,361,360,1,South America,23,2886.77
30422103459448f7a8b169de6d15efc8,300,246,54,North America,18,1335.51
3042e796fafd41d9b514bf7e856c425f,240,196,44,Oceania,23,828.68
3044ef81ac9e4bee9ecd606ed8174fdc,365,332,33,Europe,22,2759.23
3046f3a6329547f7bd4940f69af439d6,238,194,44,Oceania,16,1022.39
3047a7148b024f8fb6eaf3fae005fb62,203,174,29,South America,18,1484.45
304cc26135804706a943dfe7de8d5d7d,212,174,38,North America,18,1258.72
304d3d651e1b437496f27bb6a03ac03f,364,362,2,Oceania,17,3165.67
304fdff5d3c74634ad6ffae50e4caf49,279,246,33,Europe,25,1462.56
30540f0372544339a105f2ab6828e7b2,365,337,28,Africa,16,1643.8
30543f35836a44fcbe366f8ae824d107,171,144,27,Asia,23,1239.51
3055e58d5c464528a81c62931c9a615b,114,76,38,Africa,15,620.13
305cc4a7c1d14f989a24012c287b83d5,23,1,22,Asia,17,381.1
305ddf0bb31f47bf9a27ed6fd94be5f4,217,173,44,Europe,17,1396.01
305e17e69f5a4212ab6a2a10f54c5650,295,236,59,Oceania,20,2129.64
305e6222553e496397544eec65666dda,60,15,45,South America,23,289.2
305f88e79cb446a4b23e7b0b170630c3,228,199,29,Asia,20,1951.45
306235e5a48c4fb9bb54ea4fbf3f8bcb,50,4,46,South America,18,139.51
306343425aff4e989102a387627ac47d,64,41,23,South America,18,464.25
3067645b651b4db3845412f27a5d2721,56,18,38,North America,17,574.97
3068d578919047cda920fec21018a874,365,354,11,Africa,23,1937.13
3068f3a880d249b097149d03a9fe0aca,295,247,48,Asia,19,1063.6
306a6873eda04bf3bd30a3680eb15ec7,162,106,56,Africa,17,717.41
306a7fee384e4a0898ea8977562cc566,344,317,27,North America,17,2581.39
306a9af7fc3240f08fc779b3f9678ab1,60,17,43,South America,22,566.02
306cfcecd69a45e3ae8f7541379e2432,51,7,44,South America,17,531.56
306e456d231e4ddb821e975513ecd39e,365,352,13,Europe,20,2441
306e8e3e74a3400fa5f432b416669795,144,106,38,South America,14,1426.84
3070092b5c844df2b683294a669c7c8d,182,146,36,North America,19,1263.84
307155a930b6437d91e2c3d30f157a6a,55,20,35,Asia,17,322.54
30725a1455794b7a9dae52c2d0371233,363,348,15,North America,16,1809.5
3073b2cbc5844950b0ffa9e8eed6b002,311,261,50,Asia,20,1284.54
3073d39e7d3d4336a86f87a2bd425411,87,69,18,North America,19,418.76
3074f7cf9ac74ba4a73b7a770103366d,309,265,44,Asia,21,2232.98
30780c6718544758a8e1534e41fbf7fd,101,79,22,Oceania,20,1044.63
3079235bde384cdfa3aa264a5ceaa148,357,312,45,Oceania,25,1632.21
3079882a419d4afca3fef7c0efe55299,190,166,24,Oceania,22,1519.56
307aedbee40d4a4d8d9be38f57f0e51f,365,356,9,Asia,21,2609
307d57a2fc1145bf806b6ec20803b841,88,48,40,Africa,22,413.42
30804c6c01974e5ea6a5178481a1c4bb,266,239,27,Oceania,27,2026.77
3083f7921abe4a7da2513826b04ffeb4,177,142,35,South America,26,1236.19
3084899c082a4ed489110da5a0b40156,167,122,45,Africa,27,1119.18
3084c63a1429494aa82d46a049fb0a41,306,257,49,Africa,20,1620.42
3084d980b95242338c76b7424248837b,286,265,21,North America,21,1882.97
3087c8cc8e584ade90f1f0a5ed2794fb,76,38,38,Asia,18,662.35
30897300790e42039770778be8e5b882,334,307,27,South America,21,2971.59
308ab642afbc46e889e665f5cf382662,268,217,51,Europe,16,1955.15
308bf29077f449f1890eda045bf10d67,281,225,56,Asia,24,1810.43
308c27427f4c417eb00b55dd87b609ff,146,124,22,Europe,22,854.88
308c755de05b4718a0bd6c4e1bdba3d3,360,311,49,Africa,17,1505.19
308c998bd8c44c719f4b6433332f002a,333,291,42,Asia,19,2172.71
30907413188b44cd98ad241bb09ef8fd,365,316,49,Africa,20,2067.48
30909b37c9074d1fa8fd6e03e26d7dda,330,306,24,North America,25,2537.32
3091b6ff7a0e47e6b98ce65534702c68,363,327,36,Oceania,22,2298.33
30920c7c3687405f93c56dd568f81bf8,332,289,43,Asia,16,1294.92
3093c28f0bf547f883421bc7650ef3d7,292,261,31,Europe,27,1681.7
3093d2054e12403aa05e9fd301b9f8b7,364,356,8,North America,21,3205.8
309480fa0b054302b45b34cea78d80ae,347,312,35,Oceania,21,2187.04
30966b4c728c458a8b45ea72123c31d2,284,251,33,Asia,18,1795.45
30990aac833a4aa699645b900389679b,356,317,39,Europe,23,2293.37
309a5af33d7440b28707a1d136dce994,239,185,54,Europe,21,1188.32
309b12007f814931a7f0883b4544a5d5,62,17,45,South America,15,490.78
309b88466cd3434d96cbaef1772ba9ad,338,297,41,Oceania,23,3049.81
309c461955a74a2286dad07d8add0ca5,344,319,25,Asia,23,2794.45
309dc270db674f87a7049751b80bede8,68,42,26,North America,19,470.89
309dd6d500ae45b8a1abef41b7503910,269,222,47,North America,16,1349.74
30a1f261478e45d19a4fa7343369e492,207,165,42,South America,16,1300.87
30a3111ab6824134a897939eb6623b7f,92,48,44,North America,20,539.42
30a4d0c377474b05ab315b309313bcdd,321,281,40,Europe,25,1496.76
30a63072276e4f6da574e309f9efc7a8,298,263,35,North America,18,2168.02
30a8076fad4d4e33baf315177f4596cb,133,100,33,Oceania,22,804.45
30a916135ef041e3bb4e6fff5da4e355,251,214,37,Oceania,21,1671.02
30aa17004cc24a69aeb3ff272714df9d,72,40,32,North America,17,476.66
30aa60adf1444b4bae2b5ae82d0b4515,184,164,20,North America,22,955
30aba6a9ea5d4a148f34f020c7582459,72,35,37,Oceania,21,410.28
30ad6ef6b84040ae872b83b1cb02c75e,319,289,30,Africa,25,2337.12
30ae6eea743c4e1bbcbe7d103ef6e4fe,365,330,35,South America,20,2004.63
30b06a423c654144ab70775de9276dea,236,198,38,Europe,20,1253.71
30b22c65b87443bda711887fe39870d5,362,360,2,North America,20,3952.12
30b4d7c99cce47c09cfbdea029ca1d67,276,233,43,North America,18,1184.29
30b633735e654e0390e747a9147d4936,365,355,10,Africa,25,1573.24
30b7b751e39e4433b43ffc326fd100e0,184,135,49,South America,21,1765.41
30b7db4a65d84889a9a8767797f383bf,89,55,34,South America,19,549.17
30ba6a5d1e5648a59d26c2e14eaef032,146,106,40,Oceania,24,622.54
30baf60c5fd74186b1be664b32036d47,268,212,56,Europe,18,1119.07
30bd84a44fb749c9bfe32e36f6faa21d,364,315,49,Oceania,18,1366.14
30bfd0137042447bbdd938d1111b8feb,99,67,32,Asia,19,549.63
30bfeb03fbd6498c891d5fe4dc504f63,63,29,34,Africa,19,255.35
30c38b511952439fa0c566967cd87330,215,168,47,Europe,26,919.79
30c504b1dca14feda8181e765224432b,240,218,22,North America,20,1718.95
30c56f1b00a348e99a5d0dc0e80ad2ef,299,257,42,Africa,21,1629.24
30c5f18ebb3c4604bdb0288b22830ccb,37,4,33,Oceania,17,557.57
30c6cf29f0254cafaa22b73969d6bb53,224,170,54,Africa,23,907.85
30c74ecd3ea64f76910cb37704cb6954,160,128,32,Africa,17,935.81
30ca0d2c1e5e440db700d86ddb0e4856,50,13,37,Europe,18,307.55
30cc599e0e5742978abfd50ce2b7ea0c,270,232,38,Asia,22,1448.34
30cd20c792c3476fa58bfa2b6a0c0031,138,106,32,Europe,20,1395.91
30ce59abcce4489badf082576315d390,265,225,40,North America,21,2076.85
30cf7b3fc34c4b90a128c380cd0b615c,141,107,34,South America,18,1535.6
30d2137b03884f9498b980076a852f8a,253,211,42,Asia,20,2316.16
30d341bf64e24f58bb2d251333106d51,364,354,10,Asia,15,2269.55
30d353aa2d294e8e92e930ad0e357763,77,35,42,Oceania,25,474.19
30d45773a93d419199ef5e96712ac4b5,247,219,28,North America,18,2088.1
30d6ae4fffda4ea0b98c38a038e818c3,297,253,44,North America,17,2230.23
30d6b501714c40519ae0509021020350,50,17,33,Oceania,21,653.74
30d6e96b6d1143dcb9494be324678e60,365,320,45,Asia,20,2039.24
30d7a141ced344ec9aeb10a8629efc3e,111,63,48,Oceania,20,296.6
30d7ccf86899428a9898287bc9461e1c,38,16,22,Europe,17,503.48
30d7fd9b2e1d4f78b46ef432e348d373,365,338,27,Europe,22,3001.52
30dc7c5bb41c48758684332a43ad3c24,197,143,54,Asia,18,837.16
30df0e899b824c489f7788aeb07bbd98,347,321,26,Asia,24,2533.93
30e017d24e7b4fd492cebca39a80591b,71,46,25,Africa,21,457.37
30e0c4e1961a4d27b0250f5c27b4a41b,179,146,33,Oceania,16,1024.85
30e1ca05d50c498dba5ca2c700af8114,39,3,36,South America,22,358.45
30e7513afe4f4c7fabd74ddc269ac0c6,365,339,26,North America,21,1721.06
30e9de6e3051487a98195a8486d5ca3a,270,257,13,South America,20,1674.78
30e9ed5469204b1fa7e7d838b804e986,31,3,28,Africa,24,349.2
30e9f88ea7704299b56fd48d8d091c63,348,316,32,Europe,16,2369.46
30eb8cf3af4e468eaf24567a0d0281b1,71,25,46,Africa,20,283.4
30ee26041c0140959d4bf40e300bc8b3,215,190,25,South America,18,2004.72
30f0a39f932c485299e821741c60358d,96,64,32,Oceania,26,1095.78
30f1652964f74ee6be3d51c9d6dbaf83,137,85,52,South America,15,960.95
30f16932a66f4b9e9a769d010789cea9,363,361,2,South America,22,2508.26
30f38079bf2e42089fec9c496242d7f2,281,257,24,North America,18,1774.47
30f4ca1f2b704a88ac5f532c4c31333f,242,223,19,South America,21,1917.45
30f52f4e460044a5a1004b8d19eb31ef,123,95,28,Europe,21,1005.46
30f5a249ca0f46aaa2ae93baacc04f34,238,211,27,North America,22,2422.78
30f5c9d1c1e7477b93f4580fa2265186,193,152,41,Europe,20,1200.07
30f5eb698c604eb593a599258698f3c8,219,161,58,North America,22,1000.01
30fa21f54b0745a6ae02a821ac5d47a7,57,26,31,North America,23,505.43
30fbeec557704851bf9e091c28212834,73,28,45,Europe,23,208.07
30fc8dbd012b447995862d1794b315ef,110,68,42,Africa,21,503.89
30fe90adb45349b69c3120502339e6e8,337,298,39,Africa,19,2745.74
3101ff648e0947eca9d1833573969217,342,292,50,Asia,17,1836.38
310285db70944de29e13d92892f459fa,93,59,34,North America,22,998.36
31058c20b98b4740a0b3ba4b7699ddba,258,217,41,Oceania,22,1088.44
3106c9fc3bad494c9ebe7f6340f8eed7,119,80,39,Asia,19,874.97
310acf165b2d414180e86f94eb483b2e,237,209,28,Oceania,20,1899.34
310d0b01f1324fe484b4686a39d93d20,296,266,30,North America,17,2073.32
310f2481ff944059895934f8f0577db5,139,95,44,Asia,18,842.08
311021f5eef94be99766555699d54af3,258,227,31,Asia,23,1174.03
3111b6ea784944ee8168577c1c041dbc,117,101,16,Europe,20,1111.19
31130ee132d04af8a4181b74e4287281,194,144,50,Asia,20,932.3
3113959c8cd14215905ca6944620e044,364,363,1,South America,18,1586.32
311516d4ec5f45a08be7b0c367025ade,38,2,36,South America,22,519.97
311665a9c4284ee68a3fc1800118c6f5,75,34,41,North America,24,190.35
31173d4ea2e94773af2e708ab2bb6af5,337,299,38,South America,21,2430.29
31186ddf4358430c8a9bfdc2a1614da3,168,134,34,South America,19,1190.83
311a84d388ab41af88e909741530a158,119,71,48,Europe,17,600.33
311d64427a0145bf926e703514a59343,355,304,51,Asia,16,2342.17
311f8728edd145c9ab16f92b31e73557,196,177,19,South America,20,1296.89
312155edccd64be6b5ee7699f75a7a4d,230,194,36,South America,19,1770.55
312213edf8a940d4b4a8c67a2c295204,211,160,51,Asia,17,903.19
31222b1244544caf9ea4353f9b268fc5,105,65,40,Asia,26,359.31
31237db755464045babf2e43eec12561,138,87,51,Oceania,21,745.56
31291925abc64a6992cbf1bc6b920455,51,4,47,North America,18,33.58
31297a72cc0d4adcb4a4ed4184f9bd49,364,325,39,Asia,20,3237.28
312a93385dd640e1a3dabcef775bc8c6,154,115,39,Asia,15,1109.4
312ba7661b6a4374bd50aa54bd84f4ff,288,249,39,Europe,21,1381.58
312c94d867fc4c6694d263b68cc77300,340,303,37,Africa,28,2294.59
312d6d4a990341c68c201357e99be856,43,18,25,Oceania,18,101.17
3130f31efcd247d9885affe8191cb6bd,66,27,39,Asia,15,794.32
3131c8fdc203499781a2936f0d56ad9e,169,148,21,Africa,22,1104.12
31337355fe024a818806ab03f360acd7,106,65,41,South America,23,536.57
3133864a2ccd4c3c82fb8bd4f8d63e72,215,185,30,South America,17,1687.65
3134960c060046ffbe5506a547edeae6,72,23,49,Europe,18,184.08
31368bfc84f549acad3a56e945c07c08,121,71,50,Asia,18,725.44
3136ee2e1ee34a288fd94439e3c1ea36,220,200,20,Oceania,18,1202.79
313b7ed713a04e5d9f8ee24e104a9b05,202,172,30,Asia,18,1485.79
314051a7b3fb4f679fb18ec34d6ac2be,59,19,40,Africa,18,685.96
3140970ec0f4407d98f4449c3b4df205,322,289,33,South America,22,1696.3
31419a34ccb6455d9ba90918244c154a,235,192,43,Asia,22,1590.61
3144f3da83684bf4b1b46d23193c4225,300,251,49,Oceania,22,1816.3
314713ec26564c7380600021bc0bd1a7,233,216,17,Europe,22,1484.02
3148daf8d1904472ba5ce38492266875,358,312,46,Asia,21,1571.34
3148de7d95c946fbbd8b7ed672fd29ad,65,36,29,Europe,21,449.97
314e22ebb72742fe926088a8fb4ec18f,243,200,43,Asia,21,1922.71
315009ddd41644108330ad178eedce83,301,246,55,Africa,22,1551.18
31509105e6e4449fbec92ffebad1c7b4,365,331,34,South America,22,2670.79
315184a6415649ed80b0c10be4641c3a,144,88,56,North America,19,457.54
3153d9289fa343fc85320eb51dd38f9d,195,167,28,North America,21,1435.78
31544bd4dfb140edb2931df3c804fef4,364,359,5,Africa,20,2887.81
31550d8917154605a8ade4a323894c76,289,248,41,Oceania,18,876.18
3156966fc76a407bb91c8fa77607b7a3,363,326,37,Europe,22,2435.12
315c807bf28340629aa87555790fa2fe,82,23,59,Africa,18,517.67
315e5032ece84733b34bbfb65b3d67f4,214,175,39,Europe,24,1386.57
31619a8ae3c247389920e95c4a753534,254,229,25,Oceania,23,2217.71
31644843cf8e4f9a87ba7fa7da07a8dc,305,253,52,South America,20,1466.14
31655febe96d470cb5c4de9871958678,320,280,40,Oceania,21,1941.56
31661f5e9a3246a9a884912b73035085,268,232,36,North America,18,2479.69
31682817a8b54081b44df15fe37a4351,148,101,47,North America,21,595.89
316853a02f414a67b4ffacd358c5d5bc,58,28,30,Europe,15,213.27
316861fb1bf74c9a8b7596bb2a630ced,49,7,42,South America,26,214.95
316974f84dc14e6b946e2cc2a865f4bd,67,34,33,Oceania,23,745.1
316978caafce45f0b36dfdd311ab21c6,365,356,9,Asia,24,2475.85
316ab53097214775a5bb75876c895501,149,114,35,Africa,19,1116.46
316c25c9407f409eb559b86ee4e86495,108,66,42,Oceania,24,757.11
316f8e0d2c1a4e5790ae63126b4f0cf2,347,317,30,Oceania,15,2318.64
31763037e1c9427285af2adc810d0a7e,132,88,44,Oceania,24,616.04
3177be2ad0f94b6294897c9f395e4b0b,341,309,32,Africa,17,2591.31
3178727c17b54311825f0cc3b51a80fe,261,215,46,Africa,21,1412.54
3178ef90cb5d42a985e2c5822a0a5afd,171,147,24,South America,25,1351.9
317a854e03d244f78640cde09c2be6c6,101,57,44,South America,17,334.65
317a97754d5446f9bb612cfb429e1cba,86,34,52,North America,19,180.29
317ab7cda52846d4a7cbd3dc1b82b11c,308,257,51,Africa,19,1345.88
317abadc210142928d3cbe670ba46651,259,217,42,North America,25,1358.71
317b869433cb47dab80b78ae7772c04d,193,155,38,South America,21,1343.24
317bd59ba9bc4ba49602d925d08c4a80,201,164,37,Asia,23,1284.4
317f906747f742dd8a6edad679101fd3,218,166,52,North America,21,1338.1
3180a8b1ef3f47b887cd7387ff0a748e,201,170,31,South America,19,1258.48
31818746eb4e465db6306e4f154d8ead,67,44,23,South America,24,608.05
31828880f9a0496fa5ef6fd7e1e6d245,98,65,33,Africa,22,964.75
3182cc144da04cb7ab3ebc5a7f93470c,96,60,36,Africa,22,763.03
3183b428f7834787a70fc8fc80dbe066,152,135,17,South America,17,942.61
3186a64f99654f5bbc8ec04d49368e10,36,7,29,Asia,25,186.65
3186de367a5645c1b7fd615a2e847482,271,217,54,Europe,21,646.04
318728231f064e32a8f496a2f20aaa01,54,17,37,Oceania,20,474.3
31876af138be4b95a1d5d8f58609f65e,323,284,39,Asia,19,1721.79
3189a7a153214985a2acaac228a34189,333,290,43,Africa,19,2180.97
318af1a7024b47d9a8bf39e80efed26c,67,44,23,Africa,19,296.79
318b241e75894066ae3cfe13c909f87c,75,55,20,North America,21,850.75
318b3822eddd4e1792dbf372c8dd57df,210,189,21,Asia,15,1772.49
318b6ce850284ff2a51be809969a4582,224,177,47,Asia,20,1080.84
318cd48366a048fd80d53036fc0b3893,75,51,24,Asia,22,593.16
318cffb295774f7c8a6a60d9fa36a4dd,151,103,48,Asia,15,1385.9
318d13bdb7a3406bac2cf30e5f5e5b19,218,188,30,Europe,18,988.9
318d1f3011764ba2990e35f39bef2a13,114,69,45,Africa,19,333.6
31926e8cf3584c6c9116cf15a1b83fb2,99,56,43,South America,21,654.68
3192e6d417884fcdad845cfd5fdb2fdb,159,108,51,Africa,18,631.28
31986627fe894db3a77aac0f0a4574ad,136,100,36,Asia,19,738.7
319a29d912be4bf2b2f390d48c3a8c9a,216,184,32,North America,25,1174.46
319bb816d936495dadc6f842230a1df7,213,161,52,North America,25,1228.37
319d7170ef9b4408838c08b667f6b101,57,13,44,South America,20,425.87
319e1ef382e94b8dbedac94fe69e3be1,203,161,42,Europe,16,1230
319e9210531f412f8bf5e7a9c6d42ef3,184,143,41,Asia,23,903.88
319f0346b7cb4726a2cd3113c3b05849,116,75,41,North America,20,274.43
319f4cd00530427ab5d4e9c802e332cb,91,64,27,Asia,20,595.54
319fa7a440a24dc98d6f436fad889381,365,356,9,Asia,21,2837.6
319ff0f663bb43099d2e5d93c5572ad3,197,149,48,Asia,17,1089
31a08e4e113b424aa2c2f7c65c2f1f51,106,71,35,Oceania,23,760.76
31a0b07faf51448c97286cc508ed581d,177,117,60,Asia,22,980.5
31a39c955bef481eb37c4a7222a7d77a,141,84,57,Asia,21,304.49
31a4b3c554184aeb9b16da7c9e0186f5,222,188,34,North America,15,1709
31a4f0de362446419780b80f8bf8ed3a,305,256,49,Asia,18,1438.66
31a596b566404ceb9f729481681f75fd,365,336,29,Asia,15,2461.17
31a8bc5503f44ead8ffa7c9024777fd3,347,322,25,North America,21,2634.48
31a9a57c3f68405da8678dacf1af41d8,162,124,38,South America,15,1043.93
31aca6040d274031bf90712ce4aeb5d0,137,105,32,North America,21,1193.51
31ad05515cff46c3a46827b8f65672bf,355,309,46,Asia,21,2055.53
31ad4261cacd4da6a60cb124fc7d05f2,335,292,43,Africa,18,1719.06
31adc1903e6540f598258cce9cb598a3,333,293,40,Asia,16,1880.24
31ae7314d9284c5ea0d6dd9dc448f299,199,161,38,Oceania,21,1289.73
31af92fa9ae24a9d97a954cea5338fc8,82,48,34,Oceania,19,255.53
31b09330498942f59677ec8da2a5ad49,264,235,29,Europe,21,1685.91
31b3c4e909ba4d52928369dd1a4552d0,145,123,22,Asia,20,820.78
31b55b72e7ad433bb41b395a7eb93886,365,319,46,South America,22,1853.67
31bab4dba925416a91ba26f56e58ff2e,322,277,45,South America,24,957.92
31bc5009c8d04a19adca12782b32efa6,287,244,43,Africa,27,2316.2
31bc91fcb4ca47eda575572f6767838d,250,213,37,Asia,22,1111.1
31c0fa7dc9b24fdc83dc4acab6f85ed1,80,47,33,Europe,19,919.44
31c187e06ebb4fee81e87ce505308049,255,226,29,South America,23,1996.41
31c2cdcbc3e541e4ab08e5f26964b030,232,188,44,Asia,18,1465.13
31c2cdf1448a4bfc82294d60154ace0a,300,261,39,South America,19,1988.15
31c3fe0833794961b1f98c357465ca7b,334,284,50,Asia,24,1517.34
31c4ea686a2f4035b72951251a7ac7cf,83,46,37,Asia,19,759.73
31c5571660dc4ac5b27711f28042da19,87,49,38,Oceania,21,572.53
31c5855490aa4dfab5fa104657240ee2,365,324,41,North America,20,1520.18
31c6304558ea443d820cfa5a50cefc25,27,3,24,Europe,16,284.46
31c8919a5c324262bf0b0df2a160081d,320,289,31,Africa,17,1829.02
31c8d403ab9443f8b5ac2d4d53d09a8e,303,268,35,Oceania,23,2000.96
31cc45cec9104d3eb25475d540f517d9,185,151,34,South America,21,1269.54
31cc95b70fb64678867c8818b76dc89e,361,332,29,South America,22,3330.81
31d15ed5cd3f4b10a0b0f54e81b5562e,282,253,29,North America,12,1907.73
31d189346e954ff1b5e76106ca11e9c2,141,113,28,Africa,18,791.55
31d1e43a42f4418caaa33729d9c41bf5,204,158,46,North America,23,1244.64
31d42f321103439082c9154c5db78258,339,292,47,North America,20,1766.21
31d81c41b6e8464fa05ae12856e6334f,203,173,30,Oceania,14,1121.82
31d83a799c6c40f3b173e84377a27586,131,96,35,South America,20,1712.83
31da26f5d4f64bda86b0ec4098684139,92,65,27,Asia,20,1349.21
31dafa60efff4558ad0a7b76ec3fb574,260,209,51,Europe,20,1253.25
31db926bfc014795a822782355d7ae21,166,131,35,Asia,20,806.23
31dd893cf6d24076a1f1d68076564ef6,64,41,23,Africa,21,610.53
31de35d2c9234213bd6bf5865c1f7e69,39,20,19,Africa,22,96.3
31df393a40c641438e14eba811891215,211,187,24,Europe,22,1782.4
31e05dc8276f4d81af4dd74fbbdbc320,34,3,31,Europe,21,359.87
31e2a2a5bd884e1d8e40f9861a1d4e32,230,193,37,Asia,26,1353.17
31e31514358647aa8c2884a794097d75,253,221,32,Africa,18,1412.67
31e31691f15d4e93bab7ad7a8a636c7a,365,320,45,Africa,14,1726.93
31e4f66b13e74b6e92c64c0406e6270f,247,224,23,South America,20,2018.47
31e5b99225744696a33f579ed1445528,195,161,34,Asia,19,1035.23
31e60588467c495d8e5d6e47c09f71dc,305,285,20,Africa,20,2670.94
31e74f82217e4e558818b25aed20d339,134,92,42,Africa,16,1101.49
31e767a8c2e144fabb00fe12f3f51777,84,53,31,South America,21,476.94
31e89d83ff53444a93b4a996150b84cd,245,198,47,Africa,16,1923.01
31ea6cf82a584a328dc094d99d1ff928,310,293,17,Asia,24,2365.92
31ebc7f3d7da445184a8c9801a02b2e0,44,12,32,Africa,21,610.18
31ebfa5ea8fd4923936f57649b6d51da,169,136,33,North America,21,1123.24
31ec7e251fcc48a583b0617d55dd2f85,161,106,55,North America,21,1303.31
31ecb0361f5b4ec7bacaa19e6ea332e0,281,268,13,Oceania,21,1684.77
31ee13a9682543d3875ee825e31eff81,223,197,26,Europe,17,1448.37
31ee38aaca6042ab8bd28bd43df6e932,292,264,28,Africa,20,2600.23
31ee55321f384951b78283db08d4f993,146,117,29,Africa,18,712.68
31ef6afc7f52494c9ccdd152c6a99e65,230,186,44,South America,23,752.33
31f09f2ae62f465ca23ad386e73d8a06,355,304,51,North America,15,1699.51
31f1055d9e744385a79b42073b74d8bd,271,235,36,South America,19,2582.3
31f157b0f3a24d5883e44e3b8560249e,72,13,59,Europe,18,269.13
31f1b39deb454b22a60027abe268c20c,188,138,50,Europe,23,921.32
31f26fea1cea4e2390a30c095d9e029d,356,331,25,North America,20,3035.36
31f33e619ea840138f21dd3662f92ac2,44,19,25,Africa,22,137.88
31f38ac20c4c4ae2bff92e5024e74058,306,275,31,Oceania,20,2458.39
31f4231a1c7c48eb9a8d8c7a0862611e,270,243,27,Africa,17,2082.64
31f4bcc8cf79433faab0193477861adb,365,328,37,North America,19,2563.31
31f53ca91886441eb70cfa9f0e306edb,131,99,32,Africa,20,813.1
31f65585495f49e4b35c3b9e0f47d18c,288,273,15,North America,14,2769.19
31f7c87e2e854a9f82e736167b11b834,292,258,34,Asia,20,2427.24
31fa17918b9f4a0f8c80bf7db8974622,265,221,44,Oceania,24,1838.72
31fc46e5258c422cbf103ee1eb721f28,365,354,11,Oceania,18,2623.78
3201211e093b44a79ae9627c0513f7c4,314,282,32,Oceania,23,2689.8
32022c02a8394e27941c5bd292670793,284,262,22,Oceania,24,1999.02
32029a036efe41c1a90b41b3a8e99824,157,139,18,North America,19,1603.6
320879838e394ab8a9e09d658ff18402,276,224,52,Asia,16,1504.99
320af42c93364834a331b2be3223bbf4,130,81,49,Oceania,18,728.17
320baf297ac4428ca952100c95d29d6c,114,63,51,South America,25,811.66
320bfb5d8be74666807df685229a9fd1,305,260,45,Europe,22,1534.88
320c3513443146e0948585731042e507,25,2,23,South America,21,136.89
3210b6393aab4520b9246cde1d2fb9a1,209,155,54,Europe,19,1101.06
3213aebac9a446e989ea375a8d0b7557,86,55,31,Oceania,24,623.92
3214886fe93644b09f3ac6473f345a5a,150,112,38,North America,21,887.49
321759237b984c108ac8cb1c6087b5c6,98,54,44,South America,20,611.93
321781da2938417eaf06579ba66ca96c,235,208,27,Europe,22,2207.7
321db742aba444479f2d4a4e8de0805e,135,89,46,North America,23,621.88
321eac5ee8aa418891dcf39297be486d,360,348,12,South America,20,2874.05
32202bec240d4c3e97f4c7c423088a4c,260,223,37,North America,20,2021.94
32212dd6811741f98da5da38236da560,317,301,16,Asia,22,2463.69
3221b26c4e4e4bd2a79c71882906a617,98,70,28,Oceania,20,1065.79
32231ff68a894a2c88033fe8140624cb,228,188,40,South America,20,2192.42
32246123b6b84e96ba32fd4558027319,205,176,29,Europe,22,1511.05
322a56e62a184238909b927330becdd7,268,242,26,Asia,20,2333.45
322b1f6a94f04af08c2430e85cae49ac,362,359,3,Oceania,27,3072.05
322b8d6516a34176a636f72d331765af,106,79,27,North America,19,677.89
322cef544f6646d9998bc17cd3ef667f,365,347,18,Oceania,21,2219.34
322d41e2c9d04d88bdf6ac62cdb60b5b,311,299,12,Africa,18,1983.37
322ee459c91a4a8ea68c45b5e28fce23,79,40,39,Africa,18,753.39
322f3852c08a47c792a142bb0daecd80,205,181,24,Oceania,21,1467.14
32308bffd8694060a348a602bda912b1,77,23,54,South America,25,185.97
32328d4bdc1d4decb52484418a1bed52,113,101,12,Oceania,17,911.55
3232b8d6225a432c98f669d7f9554d53,278,249,29,Oceania,23,1683.86
32332aea3412476e94c21e53fa825c56,88,47,41,South America,19,511.2
3238af9f99ac462f84ca4681882fe9c3,217,167,50,Africa,17,1109.73
323c24cb387b43198ea729d43e668e80,213,176,37,Europe,22,983.32
323dc173b8dd4df5a8dd27093d99d3fe,85,63,22,Europe,21,881.23
3241bbe2bbd548e8bc60e930d0bd7ac8,356,322,34,North America,26,1962.73
3243dc6c096d4eb58bc196b78592ee3c,245,225,20,South America,22,1516.87
32445f92c01d476b9b0e3be2e97b9f4c,255,240,15,Europe,17,1697.61
3246048bbe4c4c9daa7ad134776be8aa,303,256,47,North America,19,1581.44
3247983937034399bfe06fb84dbcb716,57,7,50,Africa,22,464.37
324874d47e0c41d6b3452e43b5484f05,140,99,41,Africa,19,1151.92
3248bcb02f644b3d89385abedefbec46,274,245,29,North America,17,1484.77
324923017a9d438ba47cca04eafab192,158,133,25,North America,26,1122.4
324c748b47c24101abc12eb725054648,150,111,39,Africa,22,940.55
324db7ba4a7c44f29fd2e5c50bfa0c07,83,55,28,South America,24,514.84
324de97ddca647f5989aa2c6324ae739,108,66,42,Africa,16,547.37
324e203e88674c3e98a7d0dd09f664df,198,156,42,Oceania,22,1307.11
324fa00db92f48ae9f6cb00c44ec9888,146,109,37,North America,23,1457.27
32507cd71a6442da87c6e2e2914cdd6f,55,30,25,Oceania,21,517.38
3250c95815f54df59f7ac459e8c22022,286,246,40,Oceania,24,1740.98
3250f3a817664ae99ed492839ccd09d7,331,292,39,Oceania,21,2400.03
32544eafd3634fcc9887507bf3eb263e,172,135,37,Oceania,19,1177.26
325509f9e7914139b127945baea3dfc5,196,146,50,Oceania,21,1092.07
3256724052fe46b9a199337d3b63d6af,184,139,45,Europe,22,1195.65
3256ac7031b54c5aa62a606667b6d2dd,167,151,16,Europe,17,1381.03
3256c544b21840cdabbbab46639685a2,332,279,53,North America,22,1173.77
32573917205642fabab83ae5db8a5533,115,99,16,Oceania,20,528.87
32587a2ea6054e88984fadfeb1f832cd,128,78,50,North America,23,655.63
325df287958448e78f0c2643aaf973ee,220,194,26,Africa,25,2269.89
325e0aabe85f42a68d3024b79625e035,199,155,44,South America,14,821.19
325f88b412eb4b4e944da79aef8d7570,343,316,27,Asia,22,2716.55
325fc5c8a47146d1bf24e1eb23d4bab4,364,332,32,Asia,23,1641.35
32610827600648f8aad31466e2fd4ac3,146,92,54,Asia,22,1051.7
326293a72aec4a9699b60873872b2554,363,315,48,Europe,16,1451.68
32635df11a7c4c42a05e57d32ef4f78f,126,81,45,Asia,18,431.97
3263f610059c4d988ed46c7cb02b2a15,213,173,40,Oceania,20,1364.58
326424b011ca43f19bd815bf7eea2603,131,88,43,North America,17,864.9
326428e25d2743bfbfd95f691ad74012,77,51,26,Oceania,17,565.04
32652593a6a74bcc8178113aac565a76,214,178,36,Africa,13,1473.7
326554c7eb7646498840ac4d6b04cb18,269,241,28,Oceania,18,1470.36
326651ec781e48b7b69cfe904765cd2c,124,97,27,South America,23,831.65
3266664e1f734c02881555a1de4cdaf5,205,157,48,Asia,21,841.7
326730d64c174aa1bd593bfd1b2dd671,168,131,37,Europe,20,1028.55
326790637f2a4cde8014739bd057c1a6,269,236,33,North America,21,1879.29
3267b9e8b463448dbe730dc8de05730e,300,261,39,South America,23,1825.21
3268ab406aaa457fbd076bd2299b14a7,191,158,33,Asia,21,1564.18
326a2753cc454ca3bef4da56580724a0,201,147,54,Europe,24,1248.58
326a6f43fad045cc8409cbd497c3bc6c,318,276,42,Europe,25,2032.79
32728262b565474a8ed9214c8b7fc902,169,131,38,Oceania,22,681.23
3273451d39e649d1aaa8e09c69e2ac91,328,283,45,Africa,22,1862.36
32737c5789e14b78a2fa60f5dadc6036,193,170,23,Africa,18,1713.65
3273e61a1eef4b9092364799ecdb7932,242,199,43,Oceania,25,1786.24
32745c1b34004d7a948ae7372f9dd955,340,300,40,Asia,21,2474.78
327601df489642929b9fad625fddac18,275,230,45,Africa,15,1764.9
327a242f42094e9f8bc72133f3772772,103,85,18,Oceania,21,567.66
327bf1222db24ba9832616f23ef75c57,196,151,45,North America,24,699.62
327d2d9add23432796a39827b9dd79ac,194,145,49,Oceania,23,653.8
327f846587a74bc6a543e87bcbf010f1,150,105,45,Europe,22,822.19
3284e65a2b334062bb156baa8c8bec1a,206,168,38,North America,19,1542.05
3285b3e853384d619ea25b22d98097aa,188,154,34,Asia,22,1340.42
32873ba1e949417bbdbd6b93e92efbd6,54,14,40,Africa,15,314.97
328c1d8492e6408da91f2ee4936f50ba,88,31,57,Africa,18,440.25
328fcd925cd14532a80518c1b94f996d,75,57,18,North America,17,561.46
3292a9b28d714e59b7860b2ab721cb68,323,287,36,North America,18,1929.46
3292b9d32854438090101d93042c6076,44,7,37,Africa,15,447.22
3294de026a814511a206c83f98a24054,313,263,50,Europe,22,1614.04
3295223113e440cdb2867d2da265d016,230,204,26,North America,20,1502.27
3295afa2952b4431824f27bae1283c64,300,289,11,North America,17,1707.54
3296bbbfbb7b48a9abd17ed7d6c0de3e,295,261,34,Oceania,18,2056.71
32975e436410485b86312244e1b12961,217,179,38,Africa,20,1724.7
3298bd077cb744a88f550ad47b9e9e8b,177,153,24,South America,18,1855.59
329c5e4673734882b751653cac82a609,177,149,28,Africa,20,1002.59
329e329df48643958f110f79054b3290,84,58,26,Oceania,18,1066.49
329ecb2b92be4019a852c35290e7f2a3,217,173,44,Asia,21,1440.11
32a05ea92d1a4c28bba5a374205923c0,148,97,51,Africa,17,1190.3
32a22442a0e847b68dcf5699798761ac,90,41,49,South America,25,628.91
32a2292adfef440a857d93491db85512,258,220,38,Oceania,25,2058.2
32a256106bfb413884c4abb576715cd9,256,217,39,Asia,19,1502.32
32a2efe04fc340f6a26afc3f867d7759,297,237,60,Europe,19,1368.57
32a33868e2674566a9d01e887e158534,249,194,55,Oceania,22,1383.14
32a3ca8ae09340f2a47dc5e707911b9e,123,98,25,North America,23,1211.83
32a47f9c3b6248e39540257676464c68,104,60,44,South America,16,444.16
32a5706360c0485e83b400f035d46a1c,149,112,37,Africa,22,795.49
32a87ddacc684554997fa2681bb198e7,219,165,54,Africa,21,1584.56
32aa46d2e88e46eb9ef52f45e3ce852b,263,213,50,Europe,19,894.42
32aa722db3c646bdafbd3e40381a832b,352,311,41,South America,21,2525.83
32ad1136ff2b41d8b38a12e998c6961c,312,259,53,Africa,23,1647.68
32ae164915574b6fbb3ca141e63fd060,267,230,37,Africa,21,1759.14
32ae59e1aaaf4f80b7fbbd02082c2161,291,268,23,Oceania,24,2442.3
32b0b008568e4cb1803597dd551dd32b,205,162,43,South America,16,731.01
32b23f82cc80426893580784c2d2839f,58,29,29,North America,19,413.07
32bb0b7564b343179e7cbed6362c67b6,180,123,57,Asia,24,678.86
32bcad39f7504be38bd38f1ff8888496,200,173,27,Oceania,21,1362.74
32bd538550984a06978e3ae7863faba0,364,352,12,South America,19,1819.29
32bef676675e4838838c7689c1194deb,150,115,35,Oceania,20,1219.07
32c045a739ee47b88ac2735a7694ae20,269,236,33,Oceania,17,1579.56
32c23be5d6754f24bfb9023bf99c28ee,357,331,26,Asia,20,2991.76
32c5ee835b4b46ef9ee2ac092ac225d9,350,305,45,Africa,16,1766.83
32c6563b532f45f2a04c2253bec88042,109,88,21,Africa,18,1079.2
32c7b48d9d44415ebc559efbb932c302,137,83,54,South America,23,642.72
32c7e97aed014598ac9297be2ad991c3,122,90,32,North America,23,1328.87
32c81212548a446194814c7133ab1d55,215,179,36,Europe,17,1579.27
32c8406ececb4a33b23cb6b012b21692,365,339,26,Europe,18,2499.2
32c8e54e9bf5433fa23362191b26f8fe,275,246,29,North America,19,2361.02
32cc5f404ee449d1aeea3ff9a6b8ad14,309,276,33,Oceania,16,2137.13
32ce2fad9f724112904b7146e8b6ee4a,89,42,47,Africa,17,383.2
32ce60b0c80440918ff41941c7de0d44,346,295,51,South America,27,1635.28
32ced61de1c142a8b351991b3fbe93c0,104,78,26,Africa,17,1071.52
32d092463eca404c9c345a644e0993bb,355,306,49,North America,22,2275.32
32d396c198f74980967bc3e6d2093afe,319,265,54,Europe,21,1895.27
32d3db35153949ad972ca9d2fe0dfb2d,120,101,19,Asia,21,924.42
32d3dca6970e486b9cacb4d87dfe5d7a,42,18,24,Europe,22,318.24
32d48cbb2b1642adb893294f453ae03b,296,258,38,Africa,19,1734.6
32d8f40094054f7a91b30dae87c0fc09,262,233,29,North America,15,2259.59
32db1e960d824b89bd81feefbf28b743,365,345,20,Oceania,19,1805.51
32dd69435f6c49a5b8ec7762b5b89273,314,273,41,Asia,21,2093.99
32de606941ad494780c5118b5180a267,182,135,47,Africa,11,915.25
32de60d19dda48ff90921747c7cac8c5,27,1,26,North America,23,123.08
32de6408bb8c4ae1aa478faab767aacd,70,46,24,Africa,21,905.43
32e1a802cdb04be6a448baa472986221,202,161,41,North America,19,1518.92
32e2c43083a6460f84bfa62f25560954,140,114,26,North America,16,1149.81
32e697ce10894cfaa8418e4a7d15b4fd,119,94,25,Oceania,14,682.01
32e9f586942b48f59babc59cb22d50cf,205,161,44,Africa,22,1126.31
32eb4564acfc405f97c96e5199493c77,365,364,1,North America,20,2666.07
32ec5d0a7fb04d529fdcf7f281b5f0fc,264,221,43,Oceania,21,1725.82
32ed570e56a3467c8ca2cfffa55957b3,334,306,28,Asia,14,2333.36
32ee9243fa144ef896f35ec277db22c0,219,164,55,South America,19,1278.85
32f0bc95213c4ce4b92f8c34ed3e41d9,112,66,46,Oceania,20,467.09
32f15986d93f46fd958b01312e1f9f6f,109,79,30,Europe,21,600.95
32f1cbc3b7944f538708415ef4299814,97,72,25,Africa,24,562.55
32f304a563e54fdbb6bdff2fa4f32f5b,82,35,47,North America,26,397.42
32f322fcec424dd388ba51d92cfe9a38,115,94,21,Oceania,16,690.49
32f66d1cfa6e4153b9eea076c68ed48c,352,307,45,Asia,24,1686.79
32f685e47375430fac70b7b48a982bd2,316,293,23,Oceania,20,2396.38
32f74dd2c02749f88ea997dd282d7fee,365,358,7,Africa,23,2176.63
32f75747a4724147803668107d7740db,365,349,16,Africa,17,2633.6
32f7cef295ca46149785b7765f051bcb,78,31,47,Asia,26,469.3
32f82d70c5af4e90957104b2f6d9401c,315,277,38,Africa,25,1743.73
32f83d6bd433452490f73f65de37e69d,193,163,30,Europe,22,1133.09
32fb61279a55429e81d68c6b785164ac,220,175,45,Europe,22,1118.47
32fc5069d8e84540811b7b2e85331216,273,224,49,Asia,15,1307.37
32fc772642f84a44aad07b8a13abd11a,329,303,26,Africa,25,3104.94
3301794f2bf54c63aa1d1b15d7e0d865,117,92,25,Africa,22,933.07
33020c904e204e4c9a17fb63644b2f1c,80,57,23,Europe,16,380.84
3306dcd0015641dc8a41f7f5ff14d637,270,243,27,Oceania,20,2493.74
3307686e674b405d8dd12f3fd44f771a,98,73,25,Africa,17,623.2
330814a5ee33411f9be85be657eddf4f,327,301,26,South America,19,1829.06
330866f5e3d34aa8becfcaa7218615e8,164,128,36,Oceania,21,1041.76
33089113fb5245c688703a40db307c76,79,31,48,Europe,22,554.41
330cf1d298654191a2588c16995ec520,133,88,45,Asia,19,743.21
3310dd3651a94e219715e83777c26c80,155,112,43,Oceania,23,773.16
33120d0403d542d2b3b93e02c239fe3f,168,134,34,Africa,20,1185.15
3312ec2c4c784fb4b9dc4e2fa15480de,242,191,51,Asia,22,1135.37
33130585c2a447e9aa8f05cfa44bce4d,53,9,44,North America,20,206.07
3313f7a5cb514e33896d9b2e667db3c8,123,80,43,North America,16,838.09
33156291041d4c879f51f1ffc095f786,273,239,34,North America,22,2447.14
3316538d8e9d4e0391f4c6e4b6614f2d,196,152,44,Africa,22,835.08
3317bdc248a34c84bd59e363e46318f1,128,68,60,North America,20,530.74
33185c602634440593b7d46dac0af1a4,208,163,45,Europe,19,794.5
331d98c9141c464d82bb7cff75e71c6e,140,116,24,Asia,22,1124.44
331eb373e59c41f4ab7d9d27852c9139,166,132,34,South America,21,797.18
331f18528a81435d866b3e107b203f0c,33,1,32,Europe,20,394.47
331f7f2da7dd4f948fdd0ecde960abbb,113,91,22,Oceania,21,906.74
33229705c8f34f3299fab4ab3d67e129,54,34,20,Oceania,23,455.18
3323f40c452e4e4c8db330b58f6d5272,365,333,32,South America,18,2815.53
3323feefb2fc42648b8704642560c0e7,214,200,14,South America,17,1806.3
3325720852da4a73a6cd5dd006e293cc,110,84,26,Europe,18,937.62
3326771c190a47b1a1a59e36a212245d,137,86,51,South America,19,404.85
3326e220e55b4c98b4acfaca89d83ba3,137,104,33,Oceania,22,671.17
332832f8ec6846ff9cda3d86a83179bd,260,234,26,North America,16,2047.49
3328cc7047c64706ade8e72e0b27a8f6,220,180,40,Asia,18,1441.19
332950ca131643db82cbcf1d3a7ab3af,113,58,55,Africa,19,577.61
332ce5e51f844c99bca452d38bed2489,354,337,17,Oceania,18,2895.38
332db6cc0537488bbf2666ffe72d4695,29,7,22,South America,18,372
332f50296e8f4358b09ea6d6b3d5c11c,125,96,29,South America,22,1189.74
33307a8ce5dc43db9535ccf60cfe9d7e,320,268,52,Europe,15,1250.29
333287979fce4244af01ba37d9ef8a31,364,355,9,Europe,23,3001.01
333374c74c304fc68659238e0a36098a,358,339,19,South America,16,2518.72
3335eeb155d6421fac3c674ed9475842,212,166,46,Europe,22,1104.38
33367225229b438da74db6afc25f379a,258,207,51,Oceania,21,895.1
33392b5dcb134b3cb64c251497c9fe10,80,34,46,Asia,17,365.5
333ad12faa6a4f94933310a2d934cb3c,245,198,47,South America,20,1036.23
333e8546e1b2496e9566ea57a245c6ee,204,175,29,Africa,19,997.78
333f2ae2cf7f4edfa84af8e8ee5aeffd,197,144,53,Europe,19,1126.37
33408d0a1fbc4a27b8612acb683e0c44,365,303,62,Oceania,22,1905.08
33420d80094b492b97f61768efaf3796,60,36,24,Africa,20,601.08
334538119608415c8649eb3018889ef9,229,205,24,Europe,17,1934.52
33457f5a12874d10811ab33fe015e601,253,219,34,Oceania,22,1305.58
33467406d40044ce80d217db0c413f46,284,262,22,North America,23,1636.55
3346b4b8737343719b70dd3621279e4d,289,244,45,Oceania,20,1305.23
334c80398ba548cfb4a7d10877edb3b3,230,209,21,Europe,25,1709.98
334d705b7799425e96fe4ebb7f7ab88e,159,126,33,South America,21,1450.74
334db269973c4c1889fb679e4338d86c,220,164,56,Europe,19,1002.58
33538b60f7264e35b0a64a0718ba7a2f,365,334,31,North America,21,2552.35
3354ce69098d4542a56c7759e2794161,134,106,28,Asia,17,599.28
3355a068c8624ee79ed6f51a9c8587ba,130,81,49,Europe,22,813
3358f0cf89c64dacb5444ec4b8fab3dc,323,298,25,Oceania,20,2255.23
335a42c4cce149c48a6bf7ee362b8917,310,256,54,North America,21,1257.9
3360d548188c4d248a27a0d516550720,351,312,39,Africa,23,3083.43
3367c4946d994f9fa47dbece9cc45f1d,278,230,48,Oceania,25,972.76
33680426bcf9439fb2ececd313ae8dd7,275,231,44,Africa,23,987.67
33699e8b0f404df988bcccf75a46cf8b,46,21,25,Africa,23,239.31
336b8f6c3552490a9769746054c74c27,117,75,42,North America,15,415.18
336b9dec69814d8eb2e43953dd887d63,54,5,49,Asia,19,393.45
336c40c363e44a42b187202b5ef0636f,54,28,26,Africa,23,459.38
336cde6935874f0ebe4b0b643e45dea9,208,159,49,Oceania,22,1041.68
337705406da243cbbdea1fd4fd9ee6c5,365,343,22,Oceania,14,1903.9
33773c8a548f4a9b8cc723764cf94021,185,161,24,Europe,24,1625.4
3377b3a41aaa4603803d9de64436194b,253,215,38,Europe,30,1744.43
337904cbdf2949f3959f9f6d43562a0a,365,309,56,Europe,18,2230.14
33799400e3da46ff9ce363f7599c9f02,278,243,35,Oceania,22,1311.29
3379a7f398624398841682591d6eb731,365,336,29,Oceania,20,2528.59
337a2541a0df496fa0da908adec83ce3,331,289,42,Asia,17,2071.07
337b4fd38d7c42e39f758904ba05170f,365,340,25,South America,20,1938.17
337d1ac22fa34d95aac06971eab14451,165,120,45,Europe,19,946.96
337d579b12474a4180fc1b8e82926e4e,181,158,23,Europe,23,1387.62
337ebef0143943d6b9775eb9ec07d29d,112,64,48,North America,18,730.02
3384856e57804367a464efb0c8f2b90b,130,105,25,South America,19,1144.92
33848a045bbb4d2da6e88835acab60ce,361,336,25,South America,15,2432.48
3385417679384a1791b0c6dcdb444ffe,76,57,19,South America,23,301.77
3386546357fa415d98444c5452318896,346,314,32,Oceania,20,2207.7
338662fadd4840f4a233dc2d0dd27659,88,63,25,South America,22,950.26
3387c747aee7431aaa13b2efdaef1255,60,25,35,Asia,23,416.16
3387fd24c8c74ec9a388072e5aaa661e,124,86,38,South America,18,969.99
3388e61c42814d0fb3fdddc3f0fc53ba,127,82,45,Europe,20,603.33
3388e768cd014a9a9fcb3eed94702520,360,342,18,Asia,23,2246.18
338a0a156d6d4bb194cacfd2a0d4f0a1,163,113,50,Europe,23,815.22
338aab7ed02f43908f2681e0d57b544b,275,242,33,Asia,21,1903.84
338aff8c7ccc46c5a9c361df64055fb9,364,353,11,South America,22,2569.19
338b4ea179aa4b52baec116550ad4bc2,270,225,45,Oceania,20,1099.06
338d97e06b0c419894994f9db662a073,158,120,38,Oceania,23,1057.96
338e1a3e7d06438ba920ff7e001f1ef6,253,211,42,Europe,26,2150.92
338f925c2059429db85f17d4bc6aa98a,86,41,45,Oceania,19,637.69
33947c16a2654444ba6d583f16b164f0,153,125,28,Europe,21,1315.83
3395a0394cb6446881d4688448860af1,130,78,52,South America,16,862.12
339625a3841e49408b21521bcc173215,98,57,41,Africa,24,453.62
3396b8fbebf149a2b31ba949b64a0a0c,82,48,34,Oceania,23,604.8
3398e9bf1bbc41aabb5dfa9b2e840f68,209,154,55,North America,24,651.91
339c2972cc7f40e28ad179f9c87b215b,159,109,50,Africa,22,545.66
33a0b775be794fb6959be778feb2d7b7,315,264,51,South America,18,2374.41
33a12d2994a74f31bea6cb1a2067fad7,365,338,27,Africa,24,1861.64
33a3684c7cf641acbdde89c899093b1b,246,222,24,Asia,28,1358.47
33a36cd40cf54aa790da25e9c2d40080,213,183,30,Europe,17,1715.52
33a792c1057c4f8aaf2120018c690cf6,214,186,28,Africa,19,1106.25
33a7ff22d5e14e08a138d255394296e4,114,67,47,Africa,21,367.69
33a8299bcd76432e973d269cdcdb86b2,166,146,20,South America,22,1071.81
33a85e27e66d4bc580e7b9431286e0de,324,299,25,North America,20,2290.36
33ab1497015440c69501d4d3d3e12384,27,1,26,Africa,22,314.1
33abf5ec873e4658b27e96c7a2dd1f16,200,155,45,South America,20,1356.93
33addb3991b74e579a527819c7269247,101,73,28,South America,23,754.58
33b54d8a7dc743e89227275909150ebc,347,314,33,Europe,16,2190.36
33b88eddc0c04bb4bdf5238ee70842ec,295,264,31,North America,16,2223.9
33b910aee26847e7a391dff58628f7e0,113,63,50,Oceania,23,323.23
33bac6a6a860440cbe895e623b6a3ad3,49,12,37,North America,18,391.77
33bd0ed67890434bb9ff878f7b22c7e2,171,136,35,North America,19,1518.75
33bef773579c40d28ed677b1bdea98ac,282,245,37,Europe,17,2126.98
33befb6415b94f8f8d97f53c0ba71dbc,339,303,36,North America,24,1860.83
33c05dc027574f64a374c45fde3d7c58,122,79,43,Europe,19,735.28
33c2a6931d33454fbe467f653796dcb9,279,226,53,Oceania,21,1066.86
33c6348480b644a1b17606e350d83f9b,274,227,47,Africa,21,1600.84
33c679353d23404eae664600d94e0503,178,128,50,Europe,21,1399.19
33c71da4c7b9415da0a6a198871cd4bf,115,68,47,North America,20,372.04
33c9bc7c8b5d4585a4c4559721e78c10,25,5,20,North America,18,27.74
33c9c6b6d6fe493bb0886d6fb1386a8d,65,45,20,Europe,15,534.83
33caf232c18d4a26acd7649ab96cdc58,324,296,28,Europe,21,2657.49
33cd29fc3bec4643949e6bfd6abdf52b,188,147,41,Africa,22,1049.64
33cd72118bfa43b5854b2febb8e73ce2,206,182,24,Asia,18,1658.78
33cdc48380c047c486e3712fda8c3b24,365,362,3,North America,22,2322.8
33cdce0124934530be06ded27cf3264f,230,200,30,South America,21,1762.13
33ceaf11e0fc4e4d8dc6ecc71b6d9227,365,360,5,Oceania,18,3322.19
33cf682dbfd845acb9561c478efacdfb,265,212,53,Oceania,23,1355.38
33d2c3dcce934c149715d965071c1c09,93,46,47,Europe,21,368.16
33da349a9de843369f6f67dda8229ad6,120,63,57,South America,22,463.85
33db204da44b423d81d84d67b555e3f5,328,291,37,Africa,18,1972.91
33db28b9629448079777ff6bac4e523c,365,361,4,Oceania,23,3253.33
33db3e643c714fd79d5258ba0429edbb,167,132,35,Oceania,21,940.41
33dbd9cf5d6e4edeb77902631fa0129c,120,88,32,South America,22,809.99
33de40b3cb844afc80881564f95ac32a,249,213,36,North America,22,2088.56
33debeea13a141e480e0d748ed1dc737,108,59,49,North America,19,490.74
33e00539bfb14909b49fda5ac9edb1e8,279,248,31,Asia,21,1901.42
33e27c33420d407e9b73cd761134c5d6,252,202,50,Europe,16,1501.6
33e4687089ca4d9fa58538eea0e515f4,270,245,25,Africa,23,2271.89
33e984c70d5943c9aa062998a19f200f,239,202,37,Europe,24,1630.66
33eabf0919534e66a322340324d975fa,326,281,45,Europe,13,2218.05
33eae6a2ed124a208f8b6f471097021a,209,178,31,Europe,21,1328.47
33ed77bc3ee4473589d9bf0c81e65212,54,17,37,Oceania,13,601.5
33ee1b1f8ece49e5a07a7982e16487f3,219,191,28,Asia,17,1462.77
33f26138924d4d749e0459510afbcf29,155,125,30,Europe,22,1183.26
33f5dbdface84646a9e6ca746a955df8,365,335,30,Asia,18,2179.92
33f782d23aef4379a02a9fce1a382c77,233,198,35,North America,18,1964.23
33f7cc0fbb644b19be486b832a4ffac0,312,268,44,Oceania,22,1606.62
33f980bb18564014b646f4b2ab58805b,207,178,29,South America,18,1922.82
33fa311c3abe43439441763043655211,237,203,34,Europe,18,1276.12
33fa4d91d86d484ea6ce21d80b861a25,65,23,42,Asia,22,208.44
33fc385098a44d00a6a068e9f165b75d,362,312,50,Asia,25,1806.78
33fe8a7fff2542d6bb7b098878adaad3,44,29,15,Europe,19,271.09
33ffc515334c4cf88345f01f8d0f983d,289,259,30,South America,24,1860.72
3400aa09fed2497fb2354012c7645c19,112,78,34,Africa,26,1023.99
34015709b24241a2a26b969215efb605,277,243,34,Asia,16,2163.8
3402cee030144674ba55a35ee620cae1,357,331,26,North America,21,2614.61
34034983a8f740d1984c931b3661d63c,298,268,30,Africa,23,2039.72
34036320d8664a9c8c14dfacd8dadf00,323,283,40,South America,11,2482.17
3404e8f70bca4797a050257dc11d5d25,79,56,23,Oceania,21,704.92
34054ddbed114e5dbb40f8c06e1139bd,250,200,50,Asia,23,1443
3405818bcd3d4ceba1dc09394c764ba6,365,329,36,Europe,17,1703.25
3406cbb9220e40888f0999bc4c7c509f,69,45,24,Africa,19,427.77
34092c0e9d2d4dc8b6d33af25b7bd6df,244,187,57,Oceania,25,862.12
3409648343a9420b8be60985ab1cf815,78,33,45,Europe,22,567.67
340ada91ba9b4522b454c5ee281b7007,55,10,45,South America,23,161.08
34128831e1104f03aae15a9c123beb5d,219,184,35,Europe,22,1784.77
34177cb12b834fed9e6b0a65770ccff8,341,310,31,North America,18,2551.17
3418fc1b18f84a22a27047c5d934af7a,115,84,31,Oceania,16,1080.71
34199f9b7668440cb236d3b33899c447,157,110,47,North America,17,1141.38
3419d9f8599a47838af27e5a6628a5f2,345,319,26,South America,14,3443.69
341b7f8cef16415a9ea771b06559198b,173,121,52,Asia,18,803.33
341c558dd64640169cda244070696e2e,310,289,21,North America,25,2652.37
341d7d5562da452498c47b93e3eac863,152,124,28,Oceania,17,1320.05
341e1b8c3ec846818fc9fc90bacbee35,184,144,40,Africa,19,1087.71
341e2ea817c94a5fb4a1a4746666b848,90,62,28,North America,21,1203.22
341e555ac2454f98a700a66cc0a76125,141,112,29,Africa,23,650.47
3420eab6a57c42a89d715b6acfde06f5,363,349,14,Europe,25,1973.08
3421548c44494ac89a17a75ac4204880,363,344,19,Europe,28,2271.61
34220fb9f48047519543c39ede4a5710,199,155,44,Oceania,17,1098.1
3422160b15b0429c8323b5e89fd36803,269,210,59,Oceania,18,1534.18
342371a6c9f544d487f04b4a0a8e404b,132,102,30,Asia,18,905.31
3425edf8d0684b908530059605eabbad,137,89,48,North America,18,876.47
3426339f0d66419193181d93bb639d5e,210,174,36,Asia,16,1769.46
3426728dd948489489884171076101c9,103,82,21,Oceania,21,847.69
3426a395b1d64ca9978f41250e3b1851,279,240,39,Asia,20,942.41
3428b6dc4b73413c8fd74aeb41466694,119,95,24,North America,20,1099.02
342b62ce9cfb4e4d8c44ac5d3bbff2a3,108,70,38,Asia,21,971.8
342bb22cc0db4e799bcbfb0a3fb1bb64,329,300,29,Europe,14,1579.74
342cae6825084a46ab1ad37c1b175c8d,157,128,29,South America,19,1414.8
342d20d04b0e4898812d5b3756731c5f,87,40,47,Africa,19,305.19
342d498dab954467b50ae5fb516157cb,364,336,28,Europe,21,3164.67
342e08dbed9e4fda8d528c492faab40c,226,189,37,Oceania,22,1587.43
342eb721b58a45a7987a9a771d13b09c,188,163,25,North America,15,1450.18
343207a4ae5b49089706ced73d7fa5b3,263,200,63,North America,19,1237.63
3434c6dfbb8446f8bd7fb10032ee45d4,111,85,26,Africa,24,1026.96
343558e025864d6f9c18eeb1145e4cf8,208,154,54,Oceania,22,991.78
3435f827cc384149986015e08b63d5ca,365,347,18,Europe,18,1616.31
343820bfd9524677b56b98695919ae5f,100,54,46,North America,21,812.65
34388b87fe464612934680c092341e76,159,106,53,Africa,18,1076.19
3439a061261b416d919f417d27fad5e8,185,171,14,North America,20,1280.91
343be6a2d2c8407f8a4941d530eda705,46,15,31,North America,18,285.32
343beb82cde042a399a24ca2cf765887,328,290,38,Oceania,19,1973.59
343bec9f82ab489c87cac62322567187,117,78,39,South America,21,614.92
343f00d6b5a04e01bba1d3eabebdcb21,169,134,35,Europe,18,1101.4
3440f4f593144aebb9d08ecf10fc98ee,94,71,23,South America,21,523.78
3441d27267da41ddbd92ead908fd5a32,166,114,52,Europe,19,1517.44
3445c324ddd44f2aa19694c1cbf899f3,318,281,37,Oceania,23,1800.5
3446249ed40440babea2063eac6026c9,336,288,48,Europe,17,1356.09
344c0856a68a4638a90f1135846d1600,35,10,25,South America,23,530.24
344def030c1844e1be5951b122fb2b6b,224,171,53,Africa,18,1293.21
344ed07c87944c9ab98c67a2b2c84463,63,26,37,Asia,23,256.87
3453428ec608455d92fd041c4753b824,363,326,37,Asia,16,1240.96
345379d9f97441d79fd76bed15ca23ae,196,170,26,North America,20,1835.78
3457946f87144e2e87d6c930efb514dd,228,188,40,Africa,18,1491.8
345853cc51ad49c9a9aa82fa5e7db540,74,53,21,Africa,17,511.58
34586d0b18134eeda4ed1dab6f93fbef,155,129,26,North America,24,1389.14
345adc96d33240f7aa5199a8081bcd1b,97,73,24,Africa,22,453.57
345c59d24cfd4cd5b849a93f215202a2,331,280,51,Asia,19,1267.36
345df3f5115d40398980dbb3768d686b,303,267,36,North America,16,2512.48
345e6c7511d24897ae6bbabd51d9e4df,177,157,20,South America,21,1541.49
3462d20cee0c418788e3e8304a3370bb,73,19,54,North America,18,432.75
3463bc3ccfa644f691466137ddcde852,259,232,27,Europe,25,1877.29
34680b0d47c14efca5167dbde1abb262,242,214,28,North America,16,1699.25
34687451c8a843a088c1dbbaae4f8ed5,39,6,33,South America,20,277.39
3469059e19484a43864a13adea7f8a48,365,346,19,Africa,21,1878.8
346c0181bfe643149bfb5b280547f462,184,135,49,Africa,19,1218.51
346c0a0ffebd4c2da7ce2360043a54d4,365,360,5,Europe,20,1958.43
346c94c50f404ce89d224f09bebe4dd6,97,79,18,Africa,21,1139.67
346ee8bb828d42f5afeab7553b215f74,365,358,7,Asia,19,1504.31
34706fa5706b4af4b9e77e8ed086c0ef,271,244,27,Africa,23,1908.19
34720ef7407a4f6e8b7526fa1d064968,133,82,51,Africa,24,751.86
3472263e221c48cca20939885d583c51,116,81,35,North America,18,683.15
34744d634de3410b9354bd009ee9cb59,348,323,25,North America,23,2481.28
3478abcaa1e64977a22e8c1c4a8e3b6c,74,33,41,North America,19,396.41
347aeb5b30d44a9aba2214626b7aea61,66,33,33,Oceania,22,257.01
347c8b14f6fd47a791acb710bdfa17b8,332,289,43,Africa,16,2217.14
347d01018b91488591033b624b8fc101,197,161,36,South America,16,1349.07
347e7bf77daa40718a3b9d21ab98b047,33,9,24,Oceania,25,100.47
347ec688c02e47ba8ecf4e301a2cf51b,324,287,37,Asia,18,2327.95
348132567db343cd8a7903282d18fcb9,125,81,44,Europe,21,1092.62
34814254a67a4115a2466b84f48f825e,51,32,19,Europe,16,127.91
3481e5a76f7545148c3469af52ceaa70,365,346,19,North America,18,1914.09
3484cdc18ffc453cb6c93ec50229612e,165,145,20,Asia,21,925.22
34852884a2d24f13a6e045dfae5851b3,136,99,37,Europe,23,806.29
3485bc520b114693a5ebcccbd8e6464a,41,15,26,Oceania,15,260.26
348602a9d90645cf8d9f01574f4fa9e7,335,295,40,Asia,25,3013.19
34870b80d579477997c65e4e6b9163b1,82,31,51,North America,17,476.32
348717291bd44ec8ae2bdec31315f147,364,338,26,North America,19,2672.52
348af1fc25b44001accc729ea2ec91b6,117,75,42,North America,19,601.15
348b0f6708334c72aea3b30d4559d345,220,175,45,North America,23,791.22
348d6b46c722445cba5287df90b6e915,359,309,50,Africa,17,2037.48
349018a22ec848e08b7a8b145804d772,301,258,43,South America,23,1154.92
34908c66d3954b67964fe2635bec5961,161,135,26,Oceania,24,1146.1
3490cf33b6474ff7b9b42dc5af1fc710,173,145,28,Europe,17,1001.47
34910ddea39449649a4e79b8347210ed,192,161,31,North America,19,1334.74
3493094d258445b78a2a98012611905e,143,121,22,Africa,18,1070.58
34939210852f491194bf9d62dcbcc257,300,250,50,Oceania,19,2126.3
349398fa1acf4c61b40aff55d404c1c0,246,202,44,Europe,15,1784.4
3496003a84764efcbe329ef81c8995ae,30,12,18,North America,18,428.77
34981d386fce464085f3469dd4a4236c,149,120,29,Asia,22,933.24
3498bed8a7ea4eb0b779977f0efbeebb,324,272,52,Europe,21,1526.59
349969633e784a32931fcee0f382b51d,274,258,16,South America,23,2681.5
349b4a3b4b8b4fbd8e1eafaf4d5539e7,247,204,43,Oceania,23,2314.35
349c4e10dc8e4f50b3bcc4e2db2546f8,254,214,40,Asia,27,1249.08
349fb613923843b4b05a0ec11e8f710d,78,53,25,Oceania,20,662.27
34a06d82be7b4aa9844da6c923a0aa91,333,288,45,Africa,20,1461.86
34a41b2b99c641b285b788199b8828b3,324,305,19,South America,22,3070.95
34a66b12d8de4765a31d6ea1c4bee7f5,124,107,17,Africa,21,816.7
34a89f5f7f92483e90dfffef8766d8e3,132,89,43,Europe,22,674.49
34ae4050ac944abd81ba2f4aee52d3db,57,22,35,North America,16,278.57
34b02ffe9ffc4886830db5945723c3ee,236,194,42,Oceania,21,1237.47
34b23249b5d54254a5139ef55b84f350,210,155,55,Africa,20,1009.99
34b2eef7384c47aca184875bb35d688f,51,1,50,North America,17,204.49
34b4191c71e749ee9b1d144d9f196dbd,304,289,15,Oceania,20,2321.23
34b4a6c1888646a3ac6ae939076c2088,162,122,40,Oceania,19,893.99
34b5c02c0afb469a96759b07dd176bb1,289,241,48,Oceania,12,1431.64
34b732cc3bd14c97a6cfecd7e05aaa10,159,102,57,Africa,24,483.61
34ba5a8f7b68415b8cb736eb4b2095cf,196,170,26,Africa,13,1550.21
34ba5ccd4b884de6aa5032a02ec292df,288,250,38,North America,23,1958.37
34bc2b42522b4356870424fa1e057bbe,234,216,18,South America,24,2207.23
34bd11f2780d4f36ac20a4bef46247fe,24,3,21,Asia,20,257.45
34be0696c7f74c549621a4659e4c1a36,134,90,44,Europe,18,553.1
34c139f67f3a4052804a174f2b0aab24,62,17,45,North America,20,434.94
34c17f283dd64894b81898bc4c5a2ddc,54,12,42,Africa,19,204.56
34c2b3b7815342dfa588042bfbd0f9e3,362,323,39,Africa,17,2657.62
34c38bd835814c52924f15ae0f54b9d1,251,221,30,South America,19,2291.07
34c4f375d17045f6a93819f4661ceaca,290,255,35,South America,28,1603.14
34c6192b751947598c8e621b6f7427b1,317,292,25,South America,22,2662.11
34c73584e500425a8985614f556c675e,125,70,55,Oceania,16,640.25
34ca9fc60f3944b6b8e59e98d9734353,74,47,27,Oceania,17,625.94
34cab3742ac04cf0964116e8b0d7fc10,260,238,22,South America,17,1784.98
34cb689796164a34aa33301020597104,328,299,29,Europe,23,2154.35
34ce65a93d7240db9c3fadf496fc37b0,235,207,28,Asia,20,1944.6
34cfb02b9df74bd18d744971e12048a6,202,153,49,North America,23,987.89
34d1bf0561d94447983c2c6df93b4b08,145,90,55,South America,19,657.29
34d30fa9a1e341889d184a61c21f0940,228,181,47,Europe,20,1236.88
34d3eb8aebf741c0a1c6792a28779efd,341,308,33,South America,19,2587.88
34d729a7b70d45f18f0a5748284d6a70,364,333,31,South America,17,2300.96
34db0f1306194ee49334f3099ae055f6,211,169,42,Africa,21,939.85
34dc1a5620bb4abd9e081e05239c4c66,54,19,35,Africa,22,655.2
34dc4446a5064227bd3f6ea537972e59,224,179,45,Asia,18,1451.23
34dc73376a8f4b3d9fc986c86dfa668f,140,117,23,Asia,17,1099.11
34dca80f3b344f49a80f5837941c3aaa,365,344,21,South America,21,2049.78
34dca8cc4acf4f658c59e85ec6bd4274,151,121,30,Africa,22,1129.39
34e0b4c504d04455b71856c849209275,237,191,46,North America,21,1028.07
34e15bdb8e854a6dbbdc1dd19fb90357,192,147,45,Oceania,21,1077.26
34e4223805524073a70b1863da5428d0,349,300,49,North America,22,1596.22
34e6a99ff7f34db48205b4f3b2654d5a,39,19,20,North America,18,38.99
34e6d3cec1444ebd99acfc39f7e08dbd,212,155,57,South America,22,1354.29
34e916b7aa2e46bf9cf091d5c6dda2cf,363,332,31,Oceania,22,1900.39
34eadefb51f8494985c1f079ad7cdbd7,188,147,41,Europe,20,1935.55
34ecc13267ff458fa3f72e9ba9bf198c,184,135,49,South America,15,978.23
34ed5bcc909c4392afd97bbd86560a9c,98,49,49,South America,21,275.48
34eeb07d5e4b439a8e3ba8b2592e4122,256,225,31,South America,22,1914.07
34ef1935819644e697f4728be9410af3,363,345,18,Oceania,22,3221.46
34f101ca6d824e1f8c50b03010b71af9,36,8,28,Africa,22,412.47
34f61b86a8844767b7af806841e65bdd,266,234,32,Africa,19,1491.89
34f95a84467b43759932efef6071e6e2,194,159,35,Africa,20,935.18
34fd754ae07a4a33ba82e50c32bc0c30,135,103,32,Oceania,21,1045.76
34fe80dda7fc4a56a05de105bd5ee2b9,252,212,40,Oceania,22,1747.38
3500a732789c433eb2b27a1a37edca47,63,19,44,North America,23,388.11
35014f90def6431faba7eeeebf73c263,364,355,9,Africa,19,1895.67
3501adc6059f441e93743044e279bf96,363,334,29,Asia,25,3144.63
3507392f49314f9784aac0312011ef27,310,250,60,North America,18,1289.06
35075959149b4c85b15f3a6999aedb9f,93,56,37,South America,20,475.41
3508851b820740d88be2817691c4f2cf,186,145,41,South America,18,853.09
3509eb765944429485fb8ff3f5e3e9c4,156,125,31,Asia,21,1178.25
350c9a545ae245cd9123fe28765a5f26,233,196,37,Oceania,21,1524.92
350e559b04584b928cd0b6474b83aeeb,93,56,37,North America,18,511.32
35101b0b56854a2094310a1d0676b84f,117,71,46,Asia,20,366.03
35119eb34273493580d3a771f3a5c7ac,80,18,62,Asia,21,284.35
3511e5af7fd44dc78b395b7e24144412,363,348,15,Africa,16,2985.11
3513d9371ef140358980834c38a7e236,155,131,24,Africa,20,1172.07
35153d925545459bb3bd0732709afa60,365,344,21,Africa,25,2655.75
3515c4a8c46c445a8d9489764827ca46,255,219,36,North America,19,1833.27
3515e15a62cb4c87b63237fa4c9c1bb9,102,52,50,Oceania,20,469.87
351c0bf35b634c04aed031647b62bfbf,280,235,45,Africa,15,1639.11
351d0886fb7c44a4a1e9f39dcf375ff9,365,337,28,Oceania,18,2050.93
351e41762e0c4c47a671c6e65f7f79fb,173,144,29,Africa,23,1550.01
351eaca1d6c74ecaa23910ed21d99076,352,298,54,Africa,24,1692.75
3521bf8dbad744bf8888b71f4a1f0fa7,198,166,32,North America,20,1377.57
352277083ddc442c96732ff8abb7acbb,128,107,21,Europe,20,804.27
35236185d1554278945ef9b477669675,188,140,48,North America,22,526.96
3523b99c535945b8aa5ff76df6a6fc4f,236,193,43,Asia,17,1660.95
3523bc9607464cd9a7917c7a5f7e2e65,67,33,34,Asia,20,487.76
3524a72ec11c44ada3ec2fc8205ca13b,149,93,56,South America,18,661.7
3529e53bc89c46eb8f23a040fc9c645d,316,277,39,Oceania,19,1976.82
352eec802a2f4164b12730730eb7bbd1,269,224,45,South America,21,1481.56
352f131b2f464832b6591f048647a9e8,349,302,47,Africa,21,1804.6
353041b5e09941f3a77c4f0ff372e01a,272,236,36,Asia,22,1326.38
35304f7f0e5c4cf3a3bb72e50890a7ff,77,47,30,Africa,24,517.21
353211825e5140ec922175951d15e2a0,185,165,20,Africa,21,1217.45
353290ca842446358fa04d11e1322ef9,103,51,52,Asia,20,473.83
3532bd7e5b2747a7ac7ebe7efa8e668b,249,203,46,North America,19,1265.45
3535c0998a244cda9038b2ab212090c2,359,317,42,Europe,22,1839.6
3535d0fda4564263a17fb1e51d9a9acb,69,39,30,Asia,26,343.75
35379e91eaea475a9f7a54c40335af0d,265,237,28,Europe,24,1176.95
35380f71bd0844bf97958e180e3a230c,253,238,15,Africa,19,1462.56
3538af79a63548ea8cea442f5f4f32a1,364,343,21,Oceania,17,2613.28
353b067b2be341389ae255b7d38a8567,364,352,12,North America,21,2558.96
353c0e1296ba49f5b720143a34cc98f4,295,250,45,North America,19,2091.07
353c6bd56424497882b61ae2ea2bb0b2,365,337,28,Europe,23,1631.7
353c6e1e5676451d88c89abc420800c1,97,44,53,Asia,24,617.86
353f02e4ed85445e8ab25ca4cf7ffbff,98,46,52,Asia,18,665.66
35400eb0122647b4a7f4317814027491,252,227,25,South America,20,1741.65
3540834fd5e147969a526e483f015563,72,40,32,North America,23,612.27
3540a168a9c74c5293b04c56d332379e,338,317,21,North America,17,1971.13
35416983fdec427a91e3ec0898dc2f79,358,335,23,Asia,13,2752.3
35416c4fd7ac4d53976700ae947df9b6,364,333,31,Oceania,21,2456.36
354378d550d74216a887d374fe300fac,160,128,32,Asia,19,589.17
35456f1dc30b425f8b9e3b316385002c,81,49,32,Europe,18,640.25
354a6ec8937b4654b17f2ae2d4c02bba,363,348,15,Oceania,20,1374.62
354bbb1da0be4f95800dd7d7d4ebc6cc,270,234,36,Asia,17,2315.34
354d7af38d824066ac8e925e6e33812d,365,354,11,Oceania,25,2610.09
355179dd8fd041c88552b6ce49db4cb8,100,65,35,Africa,22,798.64
3551971210ac469c84efb8ce5a34aea3,84,36,48,Oceania,21,774.5
355312df677c4e8f80293d19e23137b4,283,227,56,North America,19,1296.92
355440f96d6b46449097a029124a942b,365,331,34,Oceania,14,2656.47
3554d7a2f2a14865a0793b5f75d8bd1b,79,53,26,Africa,17,577.58
35555fb18fda42d8ae92fa6f539ba81b,276,243,33,Oceania,20,1838.34
35561a40db764696aaef1ba7bf899a26,59,7,52,South America,17,540.03
355a2ca994ed4450b5f4659d70d7c125,332,282,50,Europe,20,1648.27
355cf11c89814f2ba2e43c8a36b990f4,77,56,21,North America,20,683.41
355e650d38444ede9d12dc263a421885,192,150,42,South America,16,786.98
355e7b3ae07d4ac9a89040f4f9740143,105,94,11,South America,14,1039.67
355fd0bc1a1f403ca7ae834a117c77a4,327,297,30,North America,24,2653.32
35607f868b5d45678f459de3e16bd6d2,165,138,27,Asia,17,959.94
3561327dc3b443f98d638673d0b681c1,29,2,27,South America,21,132.81
356142ecfbef431e83983a2892488ff7,182,136,46,South America,18,1407.86
356593269fa74f13bbfc99ce60991461,142,102,40,North America,27,1088.62
356720837df3469fb674e3cdf3f89386,95,55,40,Africa,27,799.62
3567ef1ee22143b999c318f5121c4d4b,365,352,13,North America,22,2416.15
35695017584244c88e12135a15e5fa68,316,295,21,Europe,16,1893.44
356b8cb4c6d64af3892bb22fa5ac6da8,129,107,22,Europe,20,742.57
356cb8dd3982426fa810501ccbc033d7,355,335,20,Asia,22,2769.68
356d628e8e7647e0a6120dad67a14348,103,54,49,North America,22,573.99
356da35473384777a43e665797bddf9d,86,33,53,North America,11,282.72
356f06728e10480c9177660d83562fb1,226,183,43,Europe,16,999.33
3570b00290ef4924b59152e50def4691,72,20,52,North America,25,391.34
357495257a9c4ee0a3a69f7a10e1c5a2,365,357,8,Europe,23,1725.67
3575ac5d2e9a4d0f8e1ca8d38f7c3d16,365,352,13,Africa,23,2295.33
357923508fe642c1b12053e85d4d31c5,68,30,38,Africa,22,314.89
3579bc551c7849888316eb3b1971adf7,134,97,37,Europe,22,893.97
357b04a211274d758c8be3fc88e48f2f,268,220,48,Asia,25,1434.56
357b3da7c0c947e5bb03d2d97e32b058,354,306,48,Europe,15,1848.34
357da94da3b84e489b728b21e7086d7e,123,94,29,Europe,23,922.38
358003592fe64f00b6c8c3e70fed39a9,308,264,44,Asia,18,1518.2
3580ac5ef6a945769f6e201968949c98,349,309,40,South America,18,2160.49
3580d34e6cb5426388d644c0d3a5d56e,179,129,50,Oceania,23,795.05
3582ab332320407b9f02e06d2ec969de,233,176,57,Oceania,23,1077.84
35843b7b97f146b99367a28319192e5c,107,80,27,Africa,24,457.45
3584466082ea4481b0c200c47aa076c2,222,183,39,North America,21,1779.73
3587578fbaa84001b341be3b18d29478,156,119,37,North America,17,809.86
358855e3acd94079b1d1e1881846558b,61,7,54,Oceania,20,42.16
358e0911425749d48efac8b634473953,342,293,49,Africa,21,2239.16
35936653ceaa47b683afb2c7f2bd4b5c,224,195,29,Africa,16,1616.98
35937b46ac3c49088839c39971690e44,148,107,41,North America,21,1224.71
359508cf570e4036a73dd56128d78bc3,263,226,37,Oceania,19,1706.24
3596255d4aa24e2589a0eee43adde97a,362,330,32,Europe,19,2611.06
359881913be04e75a46e5967188ee06e,259,235,24,Asia,22,2362.1
3598887dab0f46af905f6a0671ef531a,187,131,56,Oceania,22,936.65
359925e790cf4ba39ead7fbad6f8cd36,358,319,39,South America,24,1578.99
3599a4aa5f2b40b8ad7224254724ad04,120,82,38,Europe,19,932.18
359c1ee730364cfb8d870db43da66199,218,186,32,Oceania,19,1981.23
359c9e13621d41a3af7e42e25e3325ae,285,248,37,North America,23,1906.19
359e6fc76c124814baa20e9d756806e1,148,117,31,Africa,17,1006.02
359f0568b26748a3aa7ecd53e63aa056,208,156,52,Oceania,17,823.18
35a12014674040c4914805ec8af5408c,188,163,25,Africa,19,1417.61
35a191e9931a4a7992d50629cf5320ec,355,328,27,North America,23,3050.68
35a254627d454f539c8fdd1a73e649d7,136,112,24,Africa,20,1079.25
35a2aa6b78fb49fea48a1fd4050d70b2,335,288,47,Asia,13,1977.86
35a372722427474a84c03285adcaf955,291,274,17,Asia,19,2598.99
35a74f058b7841c19a54fd9664d90a52,100,55,45,Africa,20,519.65
35a865366eb1486f823b68d190c5c13c,365,361,4,North America,21,2471.82
35aa1bd76fad43b583f87857f1325de4,230,177,53,North America,19,1129.52
35abbc482e654de6bd39f8c702ddf095,365,347,18,North America,16,2334.56
35ac71c027274e4689a5dd21c260722d,313,253,60,South America,21,1665.22
35acff09ddcf4dedb5ed9742e1596256,219,176,43,North America,20,961.35
35ae1c04e6354cd98c159f61f08edcb3,178,138,40,North America,23,1466.42
35af507a47334ee58f34047833493d71,216,190,26,Europe,22,1566.64
35afbfab82b840edbbc803bef13ded2e,125,81,44,Oceania,24,768.45
35b0296467f04111ae203e88617f10fd,281,230,51,Europe,19,1422.51
35b02f5834f442de873a12f2291e1ecc,274,242,32,North America,15,2082.16
35b0c535fbc14077ba8614ffcd62f7ae,365,336,29,Europe,24,1969.18
35b18c9274e14a9aa9f591b58722969c,309,264,45,Asia,19,1805.84
35b24935f2c94f08aead7663a6f3f1fd,254,231,23,Africa,22,1736.14
35b296e1d66a42c48e1afc44989c863d,336,291,45,Europe,20,1580.96
35b2e4694efe43ff8d7fbffedabd61f9,298,288,10,Europe,16,2382.59
35b86c38f08f4b61ade8b71a2dd67e01,326,290,36,Oceania,22,2181.45
35b8c6699ea646dbb4d45bdb557951c0,363,360,3,North America,19,2481.1
35bba31b6acf4ef9a43d85c3cf53d3ec,278,260,18,Africa,22,2091.08
35be6c3e94ad416ca15d06a2a30a32e6,359,341,18,South America,17,1483.94
35c1bc58f3bd4aa2991d60ea97978f96,90,40,50,North America,19,260.96
35c1e2eb1b854da8be449372e592f66b,128,100,28,Africa,18,1112.91
35c1e8bd679d4abfa46e17a9b9805aec,156,107,49,Oceania,16,688.71
35c2276b16474cc0b7a9cd4586cd5e6f,258,220,38,South America,17,1472.12
35c23bf0d656434e9b970c2dd8f387ec,152,129,23,Asia,22,1379.5
35c73bcae0a34a9cba2d3d61364579e1,258,241,17,South America,23,2263.59
35c7476074fc4dc2beab9788bc13c799,93,40,53,South America,20,340.94
35c84a296368491c90adadd689e90582,124,82,42,North America,20,1188.74
35c85039dd8d4bad8be8b422fd7e4c70,294,264,30,Asia,22,1731.15
35c8ae3fdb504d1b8ca79f04b67e611d,365,338,27,North America,22,1512.34
35ca86744a77411fb2132a0b46806b64,226,200,26,North America,21,1447.79
35cb985255374f4181c221c388ce8ba3,60,37,23,North America,23,398.94
35d27cc1db654f4f8ac749c2217a953f,342,297,45,South America,22,2139.21
35d405f9aa804c61809a7f7387bea396,84,41,43,Africa,21,428.19
35d66a0702644b72918169a9a7b82fe0,364,337,27,Europe,20,2644.96
35dcd2da420c4b69860196e4284f0248,365,358,7,Africa,25,1780
35dd8c5e05aa4a309cc7e8eb89dee868,175,151,24,Asia,24,1592.52
35deeaac3e5545bd81dae46c7196f145,365,364,1,Oceania,21,2804.35
35defa1b913f4ce1a9b387985a09bef0,334,310,24,North America,25,2612.72
35dfed5473844532ae59807317e0704a,135,95,40,South America,21,848.53
35e21a9984754280ad67eae9c4a2a705,153,114,39,South America,26,940.83
35e2b5dba4ca43a4a7b1768122388e14,122,104,18,Europe,10,859.76
35e400499b694d0193c70ceedb785e06,134,117,17,North America,24,1136.64
35e41a242d2c48fbb1ee82c992192c6a,217,172,45,Europe,23,1901.72
35e6f9d747724c4da094af4e431e391e,331,293,38,Africa,19,2292.43
35e82c35668543609dedb8f3a5b6aa94,116,63,53,Europe,23,278.63
35e96fe1fda84073b88459b4a1184943,285,237,48,Europe,20,2131.85
35ec18a37a864f438d72f2dcfec1ce06,259,229,30,Oceania,22,2419.56
35ec52da0c4c4ae29c6e57aa53072a04,268,239,29,North America,16,1662.57
35eef9f39e77424bbf41d5898ef5c2c4,365,348,17,Africa,23,2579.4
35ef720ae3e84b169cde7a2c1e2fc54e,158,119,39,Europe,21,1360.65
35f11d2bbd494a7f89bac96267c58003,281,243,38,Africa,20,2027.15
35f2387888ec4811a962cf31da95d08f,94,59,35,South America,22,762.6
35f258875e8640658b321bc93e27631c,195,145,50,Oceania,19,856.69
35f311978e8349fcababfc04b4c48a75,298,256,42,Asia,19,1754.57
35f33c8eb85d4ee6a2cf90186d9fdfc8,209,161,48,Oceania,16,809.95
35f5cebd5405441989dda00e899d1186,115,70,45,North America,27,388.53
35f5e5c99e044f379b696273ed816b77,334,298,36,Oceania,25,2363.25
35f78c516ee24e80b46eaee72982ffe0,84,41,43,North America,19,454.54
35f9421b172647e191d0e82b52d4612e,352,316,36,Europe,17,2714.7
35f9bba8f85f4390940b9e5dca69b641,352,323,29,Oceania,18,2646.71
35f9d698b0cb40d2b959acc9c4f113ef,106,68,38,North America,18,1016.15
35f9fd5e5ac144689ffa997da4db2995,129,86,43,Europe,21,843.09
35fb0112ceff4ba3a2b03f7e5fd054c7,140,103,37,North America,23,1094.39
35fc80639d4449d39c39cbc6f41bfacb,365,336,29,Asia,23,2783.46
35fea557ff774d9ea921378277276453,89,37,52,Oceania,26,385.57
35feb3b3c7284c3ba9afa07eb3331e90,258,223,35,Africa,23,1843.18
3600858f452a44a0a273888e10e0d2a7,292,274,18,Oceania,19,2496.09
36013280ca5d47f39a3d0879e4eacc4b,91,48,43,North America,21,459.94
3606449936dd4a7ea78865769392776e,34,10,24,North America,17,301.63
360666da999d49a4829563b8da72fd25,85,63,22,Oceania,21,802.15
3606cd8666184283be726102f32b3d4d,315,284,31,Oceania,21,1830.53
36079d6c63dc47618e9a46f815ea571e,95,47,48,North America,13,248.64
36092546595746e8b70111b1747153e8,290,240,50,Asia,20,1537.26
3609ec4be7c34a73a9de667d3962788c,160,112,48,Europe,22,874.61
360a31411aaa4fbeaa08feee29d98d94,123,97,26,South America,17,1110.56
360a6b4e033f4eb6aa63b1a1da7b0219,123,88,35,Asia,19,845.55
360a8c9907e542198e4d45ab33476a6b,365,360,5,North America,19,1954.36
360b564484214734a81e76f0f0fc2368,177,143,34,North America,21,1655.54
360bfb1ef4e74ba7a8abbfd22e68dc44,142,103,39,Asia,22,537.38
360c52b08d5647d59e22b03c2cb0605f,271,239,32,South America,17,1770.96
360c6f7734ae4499b5efd294459c4302,102,65,37,Asia,18,761.04
360d76a6614b4d0db55fbc64685ea1d8,88,48,40,Africa,21,345.67
3611c60830f944a39040b5c303dd4030,83,44,39,Africa,19,742.62
361250994f77472098025a6b81c9cc7b,168,126,42,Europe,24,1215.35
36148dc24bb84a359b414522ba7f42aa,323,269,54,Oceania,21,951.12
3615b9860ddf4e33b42855d138b5a2aa,210,182,28,South America,21,1692.08
36168bc748464ccabf619a8ebe65831e,336,302,34,North America,20,2812.51
36169d226d9748cda9167823e029df4e,171,141,30,Europe,18,1040.12
36178c3a7d404351b72c60d2c0e360ff,231,210,21,South America,23,1640.31
3617f862a63e4ca6911fef5c2412ab8a,328,288,40,Europe,19,1948.45
361a9a3370594ed1ae131c5a9acb9e26,173,150,23,Asia,20,743.8
361aa788a2604e27a5cc34ca61d82b7a,250,221,29,Africa,20,1980.41
36216b6b2499485d99c60c88ebca16d8,171,114,57,Asia,21,1116.44
3623563ba9fd4f55842a3c893ebda43a,171,149,22,Asia,21,1030.74
36239f29d1df47718483d04d62eec385,365,365,0,Asia,17,1729.77
36253f102be048febb9b036214dfa2c2,200,153,47,South America,21,993.8
362545402fc043d3aa93106c7c8374be,44,27,17,Africa,23,473.3
3625552fa18f48a29bef8292f328821c,362,323,39,Africa,22,2152.91
3627dc3d50c84c08bd672026e3135e8e,241,196,45,Oceania,17,955.85
3628278abbcd4df9a4fcde1502b7e84b,364,330,34,Asia,25,2987.44
3629c2ca38884b389cce7cc10c5b63f7,119,71,48,North America,21,377.4
362b4d05e86b409b8fabe87e9c54452d,155,107,48,Europe,22,1069.11
362c21eacea64d0aa8d32e8177e47fad,335,299,36,South America,22,1947.95
362ec92227ca4cd8ab88b7c71c824f07,365,345,20,Oceania,21,2187.92
362ee7435a2d4b02ac85245666974322,365,335,30,Asia,22,2829.95
362f04b123cc4a80a3495597468db5ed,304,257,47,North America,23,1283.78
362f60fce796463faca7069820c0e707,166,123,43,Oceania,20,795.52
363255e38a524cd0a037904ca7bf5277,62,13,49,Oceania,18,419.99
36356407bec74d3cb0e325c0ac044cd7,119,101,18,Europe,15,1212.75
3635a3628144484eb12df96f20217e3b,297,273,24,Europe,17,2258.02
3638405d07d64dc9af6e604be0be216f,253,194,59,Europe,19,1039.72
363a24904c8f45f28eac6fa92b0d362c,155,130,25,South America,23,1562.34
363a3a7ea2484c55b4fc1be6dfe47416,268,238,30,Asia,16,1365.79
363a6c75a97a4ee0b82474bf8c29c1f5,360,317,43,South America,12,2261.31
363c69b460dc4a7e84374def5ec08f32,98,64,34,Asia,15,476.92
363dbe667fc84b40b2c45bff7ecd4cd6,315,256,59,Europe,24,1327.25
363dfc9ba1924c0a9960381d274faf1b,124,94,30,Asia,23,1025.04
363e123ad1b344628d3755ad27c393e6,155,125,30,Africa,18,1148.12
363e71d5fbeb4fbc85de37857d795e4d,249,222,27,Asia,20,1431.22
3641eca4330244379aaffd42a43855d0,117,89,28,Africa,21,707.07
36435975cebc41159497790a2f9ad79e,217,167,50,Asia,25,1270.34
3644a6ed432c42b5b794ab47e1256dde,274,250,24,Africa,20,2648.02
3645210c83f54966b6190b95cb270cc1,208,182,26,North America,21,1778.37
36465f30db5f401184f9339814f8d339,195,143,52,Africa,20,463.06
3649a6486ed249aeaf8cf202ea89c768,243,212,31,Africa,13,1811.93
364c008d318345f7a35959a8170c2ef5,64,44,20,Asia,22,348.1
364d3f185c854032a528a05f6040c015,84,53,31,Africa,17,720.21
364eab54b485422181c963a16dd37340,364,349,15,North America,25,2646.05
365116297733453b9282d390ea86e67f,69,46,23,Europe,16,1067.85
36514bf47b344bd6876d4f90536501d0,61,12,49,Asia,21,377.84
365275b233fb4ccfa59fee9953643634,343,303,40,Africa,20,1926.96
36532320226e45368faae0d61dbfc001,359,316,43,Oceania,18,2368.57
3655897c18214c159365a7ef530f709e,185,168,17,Africa,25,1590.16
365889cba4fe4739bbc5134c6b5780e0,72,32,40,Asia,20,500.57
3658e27e795d4472b36904e1011af732,155,105,50,South America,16,651.91
365957555d034a169892cc8f0921302c,314,271,43,South America,17,1259.52
365c75edce394103a91c6ad6a7bc6e22,322,286,36,North America,16,1752.11
365dc8f4ea554a8dad888d81f42f8019,361,302,59,North America,20,1818
366235bf9a6a4ca999f7337f10a1f069,261,217,44,North America,29,1175.72
36671f4eb0754bbab3483983b24d268e,61,31,30,North America,20,647.46
366bd670805a4eba9f451c023a2a286a,154,108,46,Oceania,23,834.95
366f7304f804406b8c405abc7e016694,53,2,51,Africa,20,141.71
367034efa2d3409aa39a04b78dcac62c,91,38,53,South America,21,606.16
367065dfcf7749058396e5bf2268802c,365,342,23,Asia,18,1728.22
3670c90047be4dbc9a511a3612285775,365,338,27,Europe,14,2818.33
3671af4be1c84f5fac9baeb55bc91800,334,283,51,South America,23,1237.41
3672bbf5d8bb438db1209f1c817ce7d1,125,92,33,Asia,18,1030.73
3673b245febb404db99e075bff363f93,146,121,25,Europe,21,1448.95
36751674b0d845278809641659a8ecb9,331,283,48,Oceania,19,2406.69
3678697343a448aeb197da14bc3000b8,146,110,36,Oceania,22,931.54
36789a5f2f8d4c86ae620ef0e314bd2e,101,56,45,Asia,15,261.28
367b2d700e054480963706af7f6f327d,316,276,40,Oceania,20,1966.69
367e1f8f9c0a432bae101cc265d56d0d,177,138,39,South America,21,1227.31
368206ab2fa54cefae76586652097e70,279,247,32,South America,20,1477.95
368436306ea4494f8f9cc0f80ea176ac,362,360,2,Africa,25,2710.01
3684c53054c741e0a74cdb5fa3cbf4c3,85,36,49,Asia,18,157.65
3684dccb475e482a8a8f2b6a4ac09f58,335,308,27,Europe,20,2961.64
3684ebdc03ef4d9d80079d75a5315fd2,313,267,46,South America,18,1539.4
3684fc4671d2437ea9cada50aeb88b4d,173,134,39,Oceania,23,1301.07
36853beccece474c92aa3cafa8b55151,82,67,15,Oceania,18,780.94
368662982dd64113b4469595d411bd8a,119,77,42,Europe,22,801
3686aa5fdca54041b46a37aa893d0148,212,172,40,Africa,23,969.37
3687e77f41b94c3c8239659c2e070384,208,175,33,South America,20,1336.65
368af23e53c14969a937de5676a6ce03,361,311,50,Europe,21,1910.69
368c2469316a443bb99cca891651ce78,83,38,45,Africa,20,203.31
368d6c45926f494da333b8d200473c52,73,38,35,South America,17,377.11
368d7fd163be4de7b71da5c64484b16e,224,173,51,Africa,19,1300.48
368dcad612934a7c97a34740f61b0ae9,333,289,44,Asia,20,1878.37
36914496acde4f64a7ce06dbc5a7d91d,99,55,44,South America,20,637.1
369392afe972435693fa47ae5456b760,83,59,24,North America,17,505.1
3693faf39e5c4629bf5ebd34964f5b61,364,319,45,South America,24,2640.53
3695a4a79fd742b18b1c8626ee90cd9f,177,146,31,Europe,17,1348.66
3695db2eb5b2408087508861de7099dd,318,271,47,North America,20,1810.14
369cef03cf4c47cb9f221729a6d2143b,312,283,29,Africa,24,2925.71
369e493dfb344918a1b59f5c25541992,314,289,25,Oceania,17,2317.5
369e7ca171e14e69b0b317d9b9cf935d,150,108,42,Oceania,26,503.36
36a0c0eee4cc4592a3bb803dd6d93403,312,276,36,North America,23,2612.62
36a1f12279024d7eb2a5d49a5b2d3af7,182,134,48,Oceania,20,681.34
36a30eae5bb7428b9ae8469ea31f424c,179,126,53,Oceania,21,1047.38
36a7351ab53447dca4a6e636349a95b0,335,288,47,North America,21,1691.87
36aadba4074a4d94aea883c5f6efc82f,244,225,19,South America,16,1689.5
36aaf0a4d7da4e1e8e5ad5b998dbbe91,138,93,45,Europe,14,764.46
36af46d1b2904f3594a56ae2eb8ee871,362,359,3,Oceania,21,2851.15
36afb01385b14a388fe1db5abce21d06,281,234,47,Europe,14,1768.79
36b12d94bc3a49cfa0be4772ff8a2a44,323,293,30,Africa,18,2847.84
36b17c6e7c2b4b7db039d00981be1e19,149,113,36,Africa,20,828.92
36b27a314cc14336b0ddcd8f5d41346f,206,158,48,Africa,25,858.62
36b68bfacf7e47aabdf0ca10378f93da,347,295,52,Asia,26,1705.32
36b7823e98ae4aae9ad70f45d98849b1,219,169,50,North America,22,1234.47
36b9d18baec84c8c8d999c9fb46b76fb,42,10,32,Europe,24,333.19
36bbe51c80aa471fa2493860dff7990b,41,8,33,South America,23,378.39
36bdc7aa165f4b7885bd0b3176ac27e7,299,256,43,North America,18,1251
36c1e24ea4374bccb7acc1f6d1d348ff,303,273,30,Europe,24,2129.76
36c2465899f948ed8f29c555b95aa846,160,108,52,Africa,18,681.81
36c2c94928514905b6180e0cc5d4fe47,223,199,24,South America,22,1958.32
36c36726dbc243d9bb1c89405a229048,96,74,22,North America,19,1102.15
36c6ddf0bc8e419a9c5829bbf681219f,243,200,43,Asia,20,1078.55
36c9384a51e348b9943d8b9e4fd0020b,314,261,53,Europe,16,1433.02
36cadb999a4640cdbee53e3a9cb6da11,78,33,45,Europe,19,314.22
36cb05285e624222a4bdcec0320b7374,196,145,51,Asia,20,944.02
36cb24404f3746828391af8a0aea45e7,219,191,28,Oceania,20,1462.01
36cb759896f141df80d1befbe91ea12b,332,292,40,North America,22,2674.81
36cc9cd017b1433eabb107450e22b949,91,68,23,South America,24,637.32
36ce3b80d6254c109005eb02c59d6d30,143,117,26,Europe,21,994.2
36d27afb134740ef8ac2c84d79fedb62,41,9,32,Oceania,17,230.33
36d3ab07d7a14284a1cba32729c5f880,364,354,10,Asia,22,2587.26
36d46b5b937b4e19ab40c2365dd4439a,149,95,54,Oceania,20,803.18
36d5a3e416d145528fc91e8c90ce2863,363,350,13,Europe,22,2149.86
36d7c495552142acbce6ec610ccdfa71,331,312,19,North America,22,2225.03
36d7f8585fbd4f63a01e8fea48020058,98,68,30,Asia,18,1041.09
36d839b3d24340859ab4b6d138c8be45,325,284,41,Asia,17,1553.93
36da461b2f3d460d98b5c7de822e8c9f,365,345,20,Europe,20,2909.25
36dc5a9d553a4435a4e10391afaa86a3,131,93,38,Oceania,15,1293.04
36de9347e66f48209ec57759f863e2b6,363,322,41,Europe,18,2165.89
36dfba735cf648b7a8e0e910128dd960,103,78,25,South America,19,857.6
36e0220895df48a8b4b1f1113885e41e,270,242,28,North America,19,1938.53
36e14f103bdd4f1cb7bf348ef043758d,66,35,31,North America,19,335.19
36e16c1263794daa991232fb671d65bb,155,132,23,Europe,20,1708.02
36e2fbc424d34d9aa566b00250b91823,346,290,56,Europe,23,1739.89
36e36b4735fe46c0af75ba46626eef9f,121,89,32,North America,19,1111.78
36e539f8cbaa40029f8a36713477b0b1,59,10,49,South America,24,43.47
36e7f823369a417fb05fd5019118aeb5,201,150,51,South America,23,1003.47
36e96487ead6457c9127773f2887c69d,209,163,46,Oceania,17,1338.92
36ea410b56c440ada6125fc0035428cd,175,126,49,South America,18,1219.05
36ea892aaec14dbc9a2cc5c4ec75bfe8,200,166,34,South America,21,1072.65
36edf9c03d554919a5e140a55c5bff57,335,279,56,Asia,19,2101.16
36ef3595a1fd4e428d052513007f1b68,146,107,39,South America,20,647.89
36f36051bc074ce1a331ce106b73e7e7,293,256,37,Oceania,21,2124.53
36f3c00e7f4042d6aad86f83b873e604,155,110,45,North America,17,782.02
36f44de32e2a434b9984df489e26cd83,142,119,23,Africa,19,746.02
36f68657af584c0f83d2c1a231c52f8b,111,64,47,Europe,23,342.64
36f8455920dd44629ba63f82e1a4ea3c,126,75,51,North America,23,677.24
36f8e40df48148938776bfdcfd9221a3,212,178,34,Africa,21,1955.13
36fcf20851044c329747dd9b9f15522e,294,244,50,South America,15,1487.51
370122172a7d48b9bb7bc24f484d9140,365,344,21,South America,21,1656.9
37018557fa9746b2958c302ad634b7fd,140,120,20,North America,17,1038.28
37018819489241bfad92ac5f51f8686a,184,136,48,South America,21,1025.38
3702b78ff7674efdab61d2a4836b1b8e,288,249,39,Asia,17,2355.99
370655ccfe664baeacd9a21abbc5daf0,271,251,20,Oceania,21,1877.27
3707abd7d8754eab9242fd85b56106cc,365,331,34,Europe,20,1533.57
370986ae81d541fe995debc9ac547ca4,45,5,40,Oceania,20,100.21
370bd1222b234e12a39c4d5350bd9a20,157,133,24,Europe,18,1513.14
370cee649d8e4932b24596ec5f1f4f37,315,270,45,Asia,20,1700.25
370d4d4111eb42d9bb4bdef2bdd66496,357,320,37,North America,18,1817.97
370ebf03881c4cd381854a04a2ac537d,190,139,51,Africa,19,903.27
3711ff99115f433e9bdce20b8e0264d6,153,110,43,North America,20,745.35
3713f89b3cce476f8bc6c297c404af83,211,159,52,South America,16,810.35
3714243efbf74d4bb65feeb2a07673e5,123,70,53,North America,21,785.72
3714fa7182d54053b584010bb06b6b9e,364,349,15,Europe,22,2174.57
3715906677cb496d8f7066688017d03d,296,261,35,Africa,21,1802.29
3717cc2f176e4f9098756144dae74bb0,208,167,41,Europe,29,1477.91
371943792f7143d5877041977226976f,211,173,38,Oceania,24,1626.73
371ac7fe8d3f46fa82c7d0c9e46aff81,147,101,46,South America,21,787.82
371d083aef99483ab9e9d4286cf7f7c4,306,249,57,Oceania,20,1340.51
371db0bfbf7b414e8a8cb0cfeab6098e,336,284,52,Africa,21,1426.91
3721358d53e644899fdc6aed03efaf9d,355,345,10,North America,18,2554.37
3722bb77aae94f6fad60288be98e5514,362,331,31,Africa,20,1600.73
37260967dcae49bea4c322bf700854ef,69,19,50,Africa,18,96.86
37265e28d0d44027b15572235f0c232b,289,240,49,Africa,21,1792.7
3726c2e9bd3542dda31fd283d7621baa,108,56,52,Oceania,19,584.29
37271e39feb247479a60b4586200c14a,365,335,30,Europe,18,1519.29
3727c0881c374b67ada2e8c5499786ff,103,51,52,Asia,14,393.31
3728bfd5b9924feb93bbc34f25ad3f55,211,181,30,North America,21,1415.78
372c869228c043bb98e1bfa5d449b413,46,13,33,Oceania,19,251.81
372e3e18589748ffac23595ebabcd867,66,15,51,Africa,25,316.79
372e5506d9a540d5957c3b47e71fb5bc,130,85,45,Asia,18,625.63
372ffe18e0cb42b8b88390a182ae822e,69,34,35,North America,17,543.37
3731b730bf1d49f2ad2567795a6a168b,94,61,33,Africa,21,487.12
3731c3dafa9c4af9a6abb1e6287254a4,164,131,33,South America,17,1120.96
373428000fea4c26b8459143b60bff35,363,325,38,North America,25,1633.05
3736ced97b1a43c3824704ab72c37e89,334,310,24,South America,21,2228.11
373815c1d6ae412ba6a6150c8949942a,365,354,11,Asia,18,2708.92
3738ce6588c846838d2f5d0c91e4e614,327,290,37,Asia,21,2023.56
3738fd561a134b97b66817316361d897,155,129,26,South America,24,1324.29
3739532d893c4bc0baf017933fe5bb4b,223,189,34,South America,21,981.81
373992673cda4443931eda241118f8df,340,296,44,Oceania,17,1756.52
373b375aacd640b1bbf19595b0ec9bd5,119,87,32,Asia,19,1490.17
373b3fac6e1a43feaf308a7aa9983dc3,321,276,45,North America,21,981.56
373d5f6e60a54c43aefda8a72ccd1a18,101,51,50,Asia,21,484.33
374075fb89784861ab76b4c86f63afed,217,180,37,Asia,17,1311.58
37409b3bf80240c0a5bef5b9ffea99a3,293,261,32,Europe,23,2201.67
37411ce3595749d6b646bc3176b6709f,211,170,41,Africa,22,1311.54
3741437cde3944fe84ff9d4c4a15b3cb,73,21,52,Asia,17,325.39
3743fa850a26463f9e311efbff029d68,108,54,54,North America,17,705.03
37452e18df36440d8d831e700e9d94d3,96,73,23,Oceania,17,365.22
37453a1a4786472abe9c822fdf39a68f,94,56,38,Africa,17,709.1
3746db03ac96429cab342abc67c5f2d5,132,75,57,Europe,16,854.16
3747ccaf3c5a4e0a878e19e9053761a1,151,115,36,Asia,17,1051.45
3749608959e84ea2a4a8774fe12d83cb,284,246,38,Africa,14,1466.78
374abae8918c46c6b0f7421fe8561bba,150,101,49,Oceania,13,513.45
374d437b69a6404baa11b0af628d1c5e,107,60,47,South America,24,623.07
375095750b184a00a88b4e76d70f6c2b,170,116,54,Oceania,19,740.56
375126d66f5147cba043dded77aefe50,45,26,19,North America,23,433.97
37519b4f18c141fdbb4a71bfa7888cf3,333,311,22,Asia,20,2516.51
37522dc7565746f78d7ae95072ffe5c5,153,110,43,Oceania,16,1153.67
3753d4a8113d4772b54c4f4b839488c4,58,6,52,North America,18,520.63
37557e3bc5c54a40adff9dc67eb763a2,147,128,19,North America,21,1539.65
375744e87d214d1a9832a7795733e20c,231,188,43,Asia,16,1927.76
3757d5aba88246cfae273809eeb07ffb,364,360,4,Europe,19,1721.21
375869481ab54e408f17ebd93dc0a00a,233,177,56,Oceania,24,1132.22
3759cfc86bc64777bc6c57eb1a2a5b4b,111,88,23,South America,20,642.34
375aa0e8af2c4634955e8a73f2b50ff9,303,288,15,Africa,19,2479.35
375ba0178e5c49d494a19a7ef367bb1f,112,70,42,South America,17,878.86
375c1229a5d74528997c4580bccf5380,196,148,48,North America,22,1298.02
375c1d0eb3504b408f1a16068adddc34,131,106,25,Europe,19,1149.99
375e175d5b734bc1b54c37b6ab9bd675,102,48,54,North America,21,727.99
3760df244d384a9d94d2bbefc6adc089,302,268,34,Africa,21,2531.25
376313312652480c85a1ee0691e95911,166,121,45,Asia,24,773.34
37656264a1134ff6984cfac0eadc6d18,93,71,22,Europe,22,568.6
37670dbf401d49ceaadf886f8de91df2,227,201,26,Asia,20,1467.32
3767d6ce5c9c46f79dc87cc734adbc14,261,219,42,Europe,25,1407.04
3769476911f8466ea917cc75a789ab1c,365,351,14,Africa,22,2355.37
376a808f00f244d58cef06340cb1d5a5,225,175,50,North America,15,1178.21
376d481e6572413bae64985b32b0eb9d,279,247,32,Oceania,17,2576.86
376dd1ffcced493196f39208e37eb2c5,250,214,36,North America,18,2249.21
376e1f77ee484a12a8be6a4559dfc5ef,232,206,26,South America,18,1573.71
376ef19161134dd290f32a5eccf769fe,35,4,31,Africa,21,136.17
37708a515b4c4f399d781e44bbb44f30,40,11,29,Africa,23,251.22
3770f52a68cc4cb0822af8428c77e49d,60,21,39,Africa,23,407.19
37726e4edf7c4ed6a93c6498674268f3,54,12,42,Europe,24,463.08
3774ea041c844b73a70841f5172f63a8,260,225,35,Europe,17,1412.39
37768f88fcae4c2488b5ba5a6c984b43,278,239,39,South America,21,1549.58
3776941b4d964ad5896b84f55a019db4,327,288,39,Europe,18,2463.57
3776e95200684514a315e74c82aefbb2,365,344,21,Africa,18,2415.26
377702609afd4a6d96843b341979b59c,224,168,56,Africa,21,1003.72
37787ff4b490477697b40320225c5e0b,330,293,37,Asia,19,2501.88
377b83215a44434cb08a82c2eab97cba,300,267,33,Oceania,19,1716.32
377bc295376d4377b0e94f48964001b9,325,298,27,Africa,20,2433.35
377bf5b85e0d4a7e899dfb525bc24a12,327,277,50,North America,26,1351.43
377ceed0c8db495fb915d7a47f4c9340,112,86,26,South America,16,899.63
377cf1bdba5849f58cafcace7b797b1c,286,256,30,North America,19,2466.94
377ee9934f9545feac28edaa5ad5ce26,187,162,25,Africa,21,1753.25
37813a9ca10c4e2ab65bc5602e8f7e56,206,182,24,Oceania,14,1683.75
37815fef63444700a52cc4825bf79c16,363,316,47,North America,15,1763
3782ab96e0bb4a8980e179f6eed28b88,260,231,29,South America,22,2214.42
3783927d914f46a9bf1f21a96a6998b3,106,60,46,North America,16,622.47
3787435c5bcf4f7d95cf83b4640e4c91,272,220,52,Asia,24,1578.33
37879407d7b04b78b5c29afaf4965abe,155,128,27,Asia,20,1328.05
378879cf62bd44e891feaa8e0b7c363b,154,129,25,Africa,21,1336.91
378b324c2e33441ba0e7aeff572fe787,119,86,33,Africa,20,519.65
378ca53d53d74df884a29f69af395252,201,157,44,South America,23,1210.93
378ccf1b490d4f70a9777a3949d63bc8,132,106,26,North America,20,963.5
378d0b83bfcd49deb7778df382517a27,197,154,43,South America,20,1575.76
378d4bbbc7cb4781ae4a043aca28e43d,210,180,30,South America,22,1783.04
378e9ac780c34ee5a00dc3ab6d674c72,176,122,54,South America,19,846.5
378ea031e70d42f1b6a13d81d83bbf66,190,143,47,Africa,22,1668.33
3792435a20f841a4923dbea0e2cab313,364,328,36,North America,18,3154.98
37929f32e1274d3aa1a9b7fcffa2ec8f,357,305,52,Europe,17,1415.11
3792aa157f15426abfdfc8cdd0fadfa5,365,338,27,South America,20,2164.8
3794fa51eb7543f98fe0022e9615ce9f,334,301,33,South America,20,2523.15
37968991383e40c7a194ed78a3fa4601,248,211,37,Oceania,15,1746.93
37975adf7c8b4779baaf3949feac8700,245,215,30,Oceania,18,1817.28
37979f7cb6604a458c9f032e3858f272,361,341,20,North America,17,2916.82
3798a86322f242cfa9e0f50bc2fb3201,41,18,23,Asia,25,592.97
379c38ca2e8d4075afba65556c1eb093,365,318,47,Oceania,16,1986.98
379fc56adc154d7d9e28017ab128df5d,92,55,37,North America,19,660.69
379fff6f0f8a4797bba3096cd4f2b4da,73,57,16,Africa,17,492.77
37a0e768326f458f90dedda5b47a4181,255,200,55,Africa,23,1364.95
37a0e9a48145459a947ca897d66f06cb,284,247,37,Europe,24,1852.96
37a1a4b4f395452fbee79a18d6f8040c,115,75,40,Oceania,20,721.33
37a24b13530e400986391612202f0e22,75,21,54,North America,22,476.67
37a29e581677423bb816b49d6df79358,277,261,16,North America,17,2252.76
37a31615ec67497094b37af29e2d0180,191,160,31,Africa,22,1690.8
37a541284d7249d5868c0d451be66381,169,122,47,North America,22,1156.58
37a737b1c9184b119aa1d641e76a10a5,131,102,29,Asia,17,538.12
37a93498f11f42b9bf4857f380a408b9,328,297,31,Europe,23,1767.51
37ab8c6e4ee043bbaacceb131e83e81a,164,132,32,South America,17,1386.06
37ace67bd62c461086aefb609e3997e4,114,86,28,Africa,14,1032
37adc016f868442ca61d626d7556e77a,282,243,39,North America,19,2276.04
37ae0a72d33c48739f613e1aa931a2b1,68,20,48,Oceania,23,246.99
37ae3cf08942490296c2d2a9eecd4f65,325,292,33,Oceania,20,2767.51
37aeb833f4ef409e944b795a11446a2e,220,183,37,Asia,25,1892.81
37af882a5be0400287c99cd85af7beff,97,55,42,South America,24,506.84
37af98737fd14aed953ee297e5a1b747,236,184,52,North America,20,1395.89
37b108b8bac6427e91037c175a75fc4b,163,140,23,Africa,26,1121.71
37b1627bfff64fc6b6109b1bcb79ba69,365,323,42,North America,26,2462.21
37b35d392044479b83b84aac4e025ab2,303,279,24,Asia,13,2823.01
37b8431841b5461e82a8b4a844e022e3,110,70,40,North America,15,892.86
37bce871827a462d871d79a3d2d5958d,127,73,54,Asia,21,809.86
37bd126e5f8d42d5abcb3fadb2c555cd,364,339,25,Africa,20,2812.33
37c0bbf0dd164fb08623923e8215da68,365,363,2,Oceania,22,3035.65
37c38f57f1154d8381cf3471b06665e5,96,66,30,South America,25,956.72
37c3dc2887d84009be7d9cfb0eef9a5c,100,56,44,South America,19,949.42
37c454b531684e2ab6f419af204a7a96,99,83,16,North America,22,1021.12
37c4ec4342fe431a9559f69a255be00a,134,90,44,South America,19,678.32
37c52fb93a67470a9888044ce3d0a0d5,56,31,25,Asia,19,548.24
37c80c13288d4709b436daed169ce78e,323,292,31,Asia,24,2302.21
37cae1d7fd994986a1ce028b11aecccc,204,158,46,Oceania,13,1118.39
37cb8fad7f3a4c3998965f1dd85763e4,328,285,43,Africa,22,1720.95
37d2ea53272c439abb989ce9e7252ad3,195,140,55,Africa,21,735.76
37d37c05ba7b47fb95584ec56f5a762a,258,209,49,South America,15,1332.88
37d48b62e27444f89a1805ad847bd88f,179,138,41,Oceania,21,1250.98
37d55efe8c3f4ca6aec9dfc374701c67,68,21,47,North America,24,653.19
37d6651b2fdf4c2ea376aea3f626110a,174,131,43,South America,17,1225.94
37d66e2938634a3baf0298efb4558c4f,135,84,51,South America,12,673.14
37d6868e8270461d91d58ce92efd901f,208,159,49,Africa,19,912.01
37d90c4a901c434db1f5944d5aece58b,364,347,17,Africa,23,1876.37
37da40d7cdf343ae9c24ebc4bd7be34e,99,48,51,Oceania,23,700.83
37dba2b1b9784887b8b8e57248dbae64,148,123,25,Europe,22,984.44
37dc220942b0477889b1a1c918828d61,139,103,36,Asia,18,1185.91
37de480ddbab402ea526c6861f7d8ab9,145,108,37,South America,22,993.87
37deb745e89142b790872bb30a194b38,336,277,59,Europe,22,1886.91
37df5fd59c7742e48afa719534382869,90,73,17,Europe,18,667.32
37e03f40a7444a25bd331a96c996a138,92,57,35,North America,25,835.62
37e0dd5ba9f342cc843c0133f1cb4dcb,183,157,26,Oceania,23,1596.33
37e23feff39b40e1ad835f2d86fbe9a6,252,204,48,Europe,22,1417.35
37e29fc89a26460b99eab09c3d03bec2,124,87,37,North America,17,624.24
37e58368ae344f508daf7499e4d25741,105,54,51,North America,19,530.44
37e705a6395c43018dd7dd8712541f23,130,82,48,Oceania,20,532.54
37e72267a39f4e9fa6f923962e2cb03d,318,278,40,Europe,17,2550.5
37e80bd264d548a9a3246ce0bfc958fd,365,344,21,North America,19,1533.22
37eb1dd5e25c44c69a646b7958e8fc84,276,250,26,North America,23,1988.57
37eba00bbbef496ebcc3b5caada80b40,270,230,40,Asia,17,1571.37
37edb4ca130b41fbae0a989840f01a91,134,104,30,Europe,19,1245.63
37ee2747f11e4a39aaeef97424b0eb11,65,54,11,North America,28,796.21
37ee6da4303e48479d538ab8903e87df,268,212,56,Asia,20,927.32
37f1170e20be4686a0be0be6e5622a57,216,182,34,North America,21,1635.72
37f1bf0423f74ce3b0222758bb3a1e1b,182,138,44,Asia,22,1201.91
37f1c8250987444cb7b3cc1129c425f3,276,263,13,Europe,22,2044.69
37f1f046a1034fc9b79442029e6dc884,246,225,21,Europe,15,2091.24
37f2806d8c084545bbe45a070df5a4da,284,233,51,North America,22,1474.92
37f503c5dc414a5c8257b5611976691d,365,337,28,South America,29,2852.43
37f587fa10b444d3a688fbf1912167e7,67,36,31,Oceania,15,353.38
37fbeb56f026412fb0af3f60c31156c8,187,171,16,Oceania,18,1439.6
37fcb1c8039d4a19a358f31902fd8caa,233,214,19,Africa,15,2101.28
3800ae687d164644bd54e22f40989cab,365,328,37,South America,18,1901.55
3803bb3b4230453ba3f6a4e9753d70e6,364,344,20,Africa,22,2300.13
3807288f01224a72886bb1e28c7fd99a,72,33,39,South America,23,688.65
38088b96b68a40a4a3fbc40a020adbce,198,166,32,North America,24,1452.45
3808f4fca2ff4f91ac5e3d0f9505d0f8,51,24,27,Asia,23,379.42
3809a9349e6b4a189f31ab8cb8d2e095,150,118,32,Asia,18,1174.77
380c3267f2f84b3889a0fb0b0ae81102,42,19,23,North America,19,609.19
380e4d70d277479ca18c3b5cf78e2c6c,241,203,38,Africa,15,1403.74
38117f675fd14a5ba1e322e04a495d78,50,29,21,Africa,20,317.3
381434f8cf9741f2bd8d867cdd9add83,256,221,35,North America,22,1660.97
38143ea4aa1d44f48246478972e97f5b,212,184,28,Europe,21,1511.84
381560e2c7fe478491f6bd770d3f1edd,213,180,33,Asia,20,1374.27
3817c5e5af1140e98966f4fe5c484ae9,364,357,7,Oceania,20,1784.2
3818028a41584e66a623f86964ce46dd,183,160,23,Africa,21,1375.63
3819a1aa72b4425b9b1cb198f1f819b9,307,272,35,Europe,21,2310.74
381b4046028c47838f0072f424e47be3,258,203,55,Africa,25,1386.14
381e38a25d9b4522a5071ee0b1a8f8f1,169,136,33,Europe,17,849.97
382294b6003b45c3b378230ba8a4b2cc,342,301,41,Europe,17,2452.06
3822b762852848ba8a7f6daa34a031f3,301,251,50,South America,16,1373.85
3824def904084ba7b29f29b5e56af726,298,273,25,South America,23,2824.5
38254d617a114a9384778f22c02f5946,66,42,24,Africa,22,787.04
38256ac60f2d4786bf41c3c93826b28c,320,282,38,North America,17,1778.1
3827f9b223ed4b5bbd549ea48122b50c,41,15,26,Europe,23,213.4
38280ecf15894962ad0c2f63059d5bea,71,27,44,Europe,20,148.83
3829cecd3984464ababb1f3c3da4848f,337,282,55,Oceania,23,1496.66
382a2f17a6114a74af94f4abd9c9f355,91,40,51,Europe,25,522.01
382bbaab70d543bc81de8a2f6649e550,361,359,2,Asia,16,1975.77
382bc76f5b8249a1885cf20ed3e89c5d,166,135,31,North America,17,1300.72
382e8352de3e4d958d140ae536006f5e,245,209,36,Oceania,17,1470.1
382edefd262c4cb38e105f1a0432773a,109,58,51,Asia,16,587.74
38313e09a5fc48e6a23371a021ed272b,325,298,27,Europe,21,2840.87
38327c6124f8415fbce78a5466bf1f2c,308,276,32,South America,16,2178.78
3832e4e71e8645af91cd418a788ed2a8,106,78,28,Oceania,22,629.06
3834230e3ecb4a8eaeb6ea0762c542a0,302,256,46,Asia,25,2752.88
3834cff05ac9439199b291d7946b84be,364,347,17,Asia,22,2491.02
383772a866ef426faaf9f8bfdff3f1a6,63,36,27,Africa,17,479.3
38392130f64142e7b77c55c35338d434,174,151,23,South America,19,901.53
3839baea73074efb81a3c7181f0ced89,112,71,41,Asia,17,494.24
383cb9efce2a41ebad65eeb8a1a3c7e5,56,34,22,North America,19,535.4
383cba72b76f4924be7f300982eb5bf2,61,29,32,South America,18,393.55
383d6d1547d54b9d817ded4e06f462da,313,269,44,Oceania,19,1634.73
383d7478b72f453d8b6170de1539cbf0,93,46,47,Asia,18,610.69
383ef6f5420f46f7b2f9b05d6d55483b,239,210,29,Europe,21,2298.12
38419a982ae64363ba5f1af81cbbb3c1,208,161,47,Asia,22,1362.3
3841c932d0db421fa959182efb97a067,363,327,36,Asia,15,1903.05
38423dd3615a481694eb3fb4b84b6321,335,297,38,Oceania,22,2477.51
384249a10ed2453187e7065f2aa130ee,47,4,43,South America,21,71
3843b7f2da63491094bc26324a5cf0c8,284,240,44,Europe,21,1581.29
3845faaa10d7483da26c101729c0e9b0,172,158,14,Asia,16,1163.87
384aa6d7df464387947df92db2ddabd7,52,11,41,Africa,23,211.11
384b31c9c3d249c4b48e565d4296b0d7,364,363,1,Europe,23,2446.48
384b75de75ec4a909f3e15b4f3a40ef5,191,155,36,Africa,23,619.72
384c9ce3c4234b2888b552c804a6ec62,51,22,29,Europe,20,121.65
384dba5b0e214d588d2c61367253f95e,364,357,7,North America,18,2280.45
384ed8607b6041489612495a5272ef16,166,135,31,South America,23,711.3
384f8bd87b8c461399e71b66af69fce8,319,278,41,Africa,24,1894.6
384f9616f7f54f3e94ac3d4394230661,83,63,20,North America,19,707.8
3850ef4e2e6e46028d6deec1fed61b59,208,151,57,Africa,18,1421.73
385146e2411044d5b39dfe730c17cc92,276,223,53,North America,18,1624.79
38518ba574e149c18e5cd0818803ccaf,261,225,36,Oceania,19,999.83
38526b82ccf8468db6ef90604194e5c3,148,99,49,North America,20,676.98
385325b9f3ea463ea3c78cac22955b68,351,315,36,South America,19,2095.15
3855b44d1bad4d708eec9cc8bb65d0fc,114,75,39,Africa,20,791.55
3855ed8ac9634108ac2a64a36bd5cff6,127,105,22,Africa,21,1326.48
385727a25abd416c85bdcc3ad0cbe6c7,68,40,28,Europe,15,679.32
38592a17e19e43e190650a2421ced6f1,209,177,32,South America,20,1315.27
3859f680e33642db9ea49bdf313eb8fb,233,208,25,South America,14,1961.84
385c5b7b240b44489a13c466ee1ccefa,45,29,16,Asia,21,366.26
385e9dee19c940bc99d92b901bd020d6,204,187,17,Africa,21,1655.49
3861ee07eaae4020a13ec4d588a46aa5,162,134,28,South America,24,1347.85
3863b02049cd45c0a4292259549a444f,332,298,34,South America,18,3004.05
3865368115494a81a3c6678731b30d05,259,224,35,South America,20,1798.89
38678a1c476543f29962618df3972552,146,113,33,Asia,21,759.06
3869fc6236b3475a90db03bc45aadb07,168,144,24,Africa,18,911
386ac1c8776346e08102d362c0254fec,315,305,10,North America,23,2847.05
386aeecc38a14265aef2fb243e33d1cc,181,142,39,Oceania,15,1644.94
386b4dd72be849b19b1b7231a828c3db,179,138,41,Africa,24,980.8
386c94923c14447da5f2a45460037888,315,268,47,South America,20,1369.93
386d4d9850bd4a5badcb95d4b086d9a3,267,219,48,South America,19,935.58
386decbf5834441895867eb457675529,341,303,38,Asia,23,2768.96
38706c6cf10745ebb3741bebf1ad8c93,41,10,31,North America,18,298.09
38736ec1b3fe458b92c925e916a22e42,338,322,16,Asia,22,2517.89
3874151f04394fb1a0c10143b673e712,132,78,54,Africa,16,953.86
387649310cf64102bd6fbff82ddb42b2,176,154,22,Oceania,23,1229.72
3877cf588a864877890fa70a55f37484,99,71,28,Africa,20,1040.15
3878fa2a5e8f44e1a6dfc5e67a33ad14,363,347,16,Asia,20,2102.93
38797d6098354ba5be03a234c96f71a3,154,96,58,Oceania,25,1054.34
38798fdaa4ae47e3b3e874eacf18b110,95,66,29,North America,17,977.98
387b8afbd1b846d281a3c85c4e98c43b,356,304,52,Africa,23,2964.76
387cdff9b60240108193fbd82e7f33b8,109,76,33,Asia,19,748.15
387d2f0ec18f41f899fc89ec0d7dfb24,213,165,48,Oceania,19,885.44
388234498439458698e7bc8b08951e9c,124,97,27,Oceania,16,1076.11
38832cd538644e1aa694bf559fd8bbd3,325,305,20,Asia,19,2385.09
388515f1ae67450a98fa50a797cf110c,118,68,50,Asia,24,928.48
3885a37657e04e6495ea92653a236ca3,117,59,58,Asia,18,850.27
3885b13de30744458e607e693b5df58e,215,173,42,North America,19,1687.6
3885d1edb3b64e6f8f9e928fbc0352e3,271,242,29,South America,18,1891.43
388a633cba5442b3a763124163485c3e,132,112,20,Oceania,21,603.42
388a993b77a34074a2ec1456e4dc0a7c,146,92,54,North America,21,415.88
389090bc473640b8b8c15804879bbbb8,43,21,22,South America,17,89.53
38912d7af50441b4874b89db8d32bffc,185,139,46,South America,23,1094.16
3891cea487ea49308252095b3aec75d9,167,130,37,Europe,15,1503.44
3892f4eeb5fa4fe4b0ee32b554eca6d7,46,3,43,Africa,24,386.22
38930473afa1465fae05f7b0e5e12cce,337,288,49,Africa,15,1198.69
3893c44ae4054132886f28a761cef6a1,126,102,24,South America,21,817.27
3894288f0f1d49a289fbe74db3ac3b3d,359,313,46,Europe,22,1903.14
389551c455d34d80b8b3e704b30ff21c,284,233,51,Africa,21,1222.99
3896abf970eb4345a5bd2084ee3b1ffb,259,206,53,North America,20,938.71
3897381b37774a85bc92a5d88bd89658,315,288,27,South America,21,2498.34
38984c518711497fa9e5f6dd903664bc,205,147,58,South America,22,954.07
38994607c1bf4e23abc1ddab43907ce7,192,151,41,South America,18,1287.14
389a924218a240f480fe616e45febc4c,330,295,35,Africa,19,2633.08
389a961eff784a1e8e05b8f619d3cbce,365,359,6,Africa,18,1747.81
389d2bed48644fe0ba7c4cd1ee9491bf,214,189,25,Africa,17,2221.29
389d2cc76b284902bde64a056eb8a87b,91,64,27,North America,19,682.04
389e3b99184344cf97184db83064f196,128,81,47,Asia,20,686.32
38a07ab730ea445896d5fc9ac18ca399,219,190,29,Europe,23,1470.07
38a147678e104502be8dad60a582ecb9,365,356,9,Africa,17,2663.9
38a14ff7e8d849f295f9380c26e16ee1,317,284,33,Oceania,21,2264.05
38a1c1388bc44aeaa5eafbd388120c5b,365,326,39,North America,22,1482.35
38a2aac96a8c4be7b078f87245a13972,124,96,28,Africa,20,972.02
38a30e0603c44571b26b33dc145a6bac,365,353,12,South America,18,2497.31
38a39a13296a49c793806459f5e98c04,59,39,20,Oceania,13,304.96
38a6082faf9f4bd9a320b87faff50c77,268,230,38,Asia,22,2109.37
38a6312136d94352b5128d1ded404139,251,220,31,Oceania,19,1787.72
38a72a00db184895b364a396a3eee959,289,252,37,South America,24,1385.47
38a886c0019745da81eace849ad705a5,291,259,32,Oceania,19,1534.28
38a91ed2e0144d0bb28b891c50a4edde,297,260,37,South America,18,1651.43
38a9d7477c764651b0c8a13da8159e32,276,220,56,South America,14,1421.28
38ab52b7a0d24a1cafaad21dec38b1dc,97,52,45,Africa,21,630.63
38ab7571b145442eb3fa9323ea881ce9,216,162,54,Asia,19,1194.76
38ac89dde655467c9fd4d1390d23a552,180,125,55,Africa,21,630.74
38ad6ef489544b23a3ed5f4c3d0839c0,364,358,6,North America,18,1441.92
38ae2b37cd764868919d8243d6a71e91,216,191,25,Asia,21,1419.54
38b040b3d9aa4c2296bc6edb3b625473,134,113,21,Africa,17,954.74
38b1eb60423340d59fa358d1c175395a,243,224,19,North America,18,2388.12
38b2e47a15eb40bfa58df9525a2f6ea4,162,124,38,South America,17,1240.66
38b4b7cb87c846b1996af9f1fb59ed20,254,205,49,North America,19,1216.53
38b5f29f076541cca0b6ccf4e77ad3af,157,110,47,Europe,15,604.32
38b76bbbb4b24c7592f18ae85abe975d,80,55,25,Africa,25,527.98
38b96297e3684e53a47a00ed6563e09e,120,95,25,North America,16,514.37
38ba92d27d9d4e54a69b344cd482c846,264,220,44,Europe,19,2196.12
38bb2e4bd7844d39a927b0b54f805709,331,280,51,North America,22,1702.71
38bb6567bed04c21b2feb04acbcce2d8,359,357,2,South America,19,3042.91
38bc1feb6fec4a3fbc7ee4ac03be36d4,257,220,37,Europe,23,1588.65
38bdd06195424e7ba0d0bdf0fa94681b,200,170,30,South America,21,1626.83
38bf7865cc8f414192dfb7a3f001b2ef,292,278,14,Asia,17,2414.69
38c00ddc1cf84996b1ef0859cb4acff1,118,70,48,Africa,18,653.83
38c09119bf294298981e7383c18403a2,101,64,37,North America,19,666.28
38c106fba22b460a8c2ef011e3782366,248,231,17,North America,14,1740.09
38c1d4a94d714b7cac4675bd0e6cebe9,364,340,24,Africa,20,1891.1
38c2924917134b9db86d6cde90dea51b,365,349,16,Asia,19,3631.33
38c39e1a2863433398312ba892c6c6ca,175,154,21,South America,17,1006.71
38c56ced0f1b414ca6c2efca8497a190,245,190,55,Asia,20,1551.41
38c5a0038893467a863590673c5c6b7e,33,19,14,Africa,16,203.68
38c621fff6d2441eab7183946349e61c,338,301,37,Europe,19,2030.26
38ca28944c074220b09c73467f1f0f00,330,274,56,Africa,18,1580.14
38cc67dcc6b84b5ea9eb61663527c675,82,56,26,South America,21,678.93
38ce07b3f72843d2be9b72338abb9ceb,213,185,28,Africa,18,1128.73
38cfea96f2244bbd96b5f7265909ebe4,237,188,49,Asia,23,1086.39
38d0dedbf82245998b2dd8abb76b11fe,60,32,28,Africa,24,863
38d55332e1ff4499896cacfc5488efa7,286,233,53,South America,18,2114.26
38d60aaa270143f482f31d1ca970396e,209,157,52,Africa,20,1080.14
38d73bc80e5445c8991d138c15aded54,211,194,17,North America,18,1664.45
38d757fb6aba44d0af73526203901813,207,172,35,Africa,18,1384.12
38d8b49ada5548fb9c77d78431d9af14,93,63,30,South America,18,409.07
38d93a073ae742a5badd8623301cf3cd,120,88,32,Europe,22,1227.46
38db970651f74637a3ac81d862d5eeb8,112,87,25,Europe,19,810.38
38dbcb390ab846d7b21d0f8c8f688eb5,82,47,35,Oceania,21,463.29
38dc2ea794194118a4a6f2c3ef7d110f,168,151,17,Europe,23,1140.48
38dce00e8e954b31b649e55d0f275228,323,283,40,South America,20,1527.77
38dd9dc6a2b64b2596b4e93501253ca8,227,191,36,Africa,19,1307.09
38e3793a0c354b95a9a10ddb43fa849c,319,282,37,North America,23,1410.85
38e4ddafcd9440d2acf4e8b5ffdb9f09,365,357,8,South America,21,2626.13
38e5bc673b4e42139b43b73f4de45884,219,198,21,North America,25,1981.82
38e9180e40ab4337894b0915872d40e8,353,306,47,Asia,23,2011.83
38eb7c1a1445409c8335fee6f6309f88,279,247,32,North America,20,1986.8
38ed5fe443424ecea29cb8a2b6534298,364,329,35,Oceania,21,2845.16
38ed8e5d1c5d48518de6b0fd649f0b09,172,146,26,Oceania,18,1202.59
38ef1136a4004acca6f7caf0633cbd08,276,235,41,South America,20,1176.65
38ef1fcaf4574e3ba880ac06737891d8,306,279,27,Africa,18,2147.32
38f079ad86504d7f813dc17e728d4f60,52,20,32,Africa,15,491.86
38f3f462a61b440ba7b685277c1c3835,56,13,43,Oceania,14,527.75
38f5a6d3cad149ff9f1ddf6aa21aff74,320,272,48,South America,18,1885.78
38f85d0efd6343f69fa5c4b793ad5fb4,96,56,40,Oceania,22,408.28
38f9a05c49314079949e28488954a748,361,305,56,South America,18,1862.23
38fac6dcb82542068b97ae67a7942b51,255,227,28,Africa,19,1334.02
38fb64813cbf4bd3a068f89ac4d5b10b,259,230,29,North America,20,2079.64
38fbbbd433aa43cf8772b645ff02e3bb,141,87,54,Europe,21,982.56
38fd6878c61446d18f89b0e370189311,262,220,42,North America,17,1598.03
38ff1af27037421490b1660037eb0a3b,269,232,37,Asia,24,1833.43
39044bb44d914552b07f4ab429f98b19,355,328,27,North America,22,3299.72
39066fd74d364d699db5fdbafe73ef91,176,122,54,Africa,21,889.78
390a9c1720114bffb50aa48f72a2eb96,365,339,26,Asia,24,1629.19
390b92ef545640ccbfa9a7d6f2a1f48a,208,170,38,Africa,13,1243.05
390ef683685d45d5be62dbed0c285de3,158,120,38,Europe,19,786.34
390f9e0d918b4ed19aa57c34b93e9501,244,191,53,North America,20,1412.18
39100c356e8d496fb8eebbc7d63db002,296,250,46,Asia,17,2172.72
39114e356d4b4f45b6be1dacc84de61e,100,58,42,South America,20,934.87
3914a8b39ef342e9871cd82921e70e26,190,144,46,Europe,20,1222.26
39160f3421d24a1d9b27580c0ac6fc7a,350,309,41,Europe,14,2491.31
391642a3ab3e40dcb92e54151956efd2,157,123,34,Europe,14,1190.45
39184564bb4643b0a4317210646c680b,96,65,31,Asia,19,952.48
39187e9eceb44c66a0e2b14b29c3cfe0,332,282,50,Europe,22,2178.78
391a6a7fc51f4675a3f555b8cfe35098,98,75,23,Asia,20,1050.72
391b578c434646afbef6a81bda5b2c0d,280,225,55,Oceania,19,880.04
391bea808cb048998fdcbdddb0502249,204,153,51,North America,23,1119.65
391f8fe03d6b4884874d9869a599fadc,124,96,28,Oceania,22,834.81
391fae3da80247b4b4e3e1bf2e580024,110,62,48,South America,27,495.13
3920f712644a48e08a5eea43989dfc55,313,288,25,Oceania,18,1782.46
39211ad42ea843ceaa1bb0c0d3ba9137,222,175,47,South America,18,1311.93
39216629f37a4acd932d1d4fb76ba42c,162,117,45,South America,14,730.11
39224e7f65a34e7ebcd497c5205a590e,164,143,21,Asia,24,961.52
39231ed5a6df42a481409a3e59acef69,174,140,34,Oceania,22,1569.36
392620e0fe7e4e89b089e02ccadeb095,108,69,39,South America,19,570.4
39278070929544768be306a7716a6497,126,100,26,South America,18,1205.86
39289652f1e942feba0d4bffd68cafb5,105,61,44,Asia,19,1138.07
3929628900ba484494c55ea4613f888c,326,290,36,North America,18,1879.29
392a317bc8524658ab65e402da79a184,76,55,21,Africa,18,541.29
392b7f223ea4466dabc864319c6ba0f3,365,321,44,South America,20,2348.92
392c2f58a93f4324a0b22df0b9ff3fc0,212,176,36,North America,19,1012.67
392f0c03be514a6ebdc36fc584f39638,365,355,10,Asia,19,2310.98
393047dadc3346b5b8950208931e661d,364,331,33,Asia,18,1750.68
3930aab7f6a148d8bdbd2920c1c98beb,89,56,33,Oceania,18,382.54
3933fae7336c4d779d514f8212633951,329,278,51,North America,17,1788.4
3934adac22c2424fb951441a770c75d0,126,76,50,Africa,22,777.28
393696c6c8d64f9e91b1d6c5bc696e1c,232,201,31,North America,24,2274.25
3936fb4fb5434f3abf441d0d1e789168,39,16,23,Oceania,22,482.65
3938859b587e4ffc9d16e18176fa7ff2,365,327,38,Africa,15,2468.02
3938edc6e2f94dac982c27c53210c5ac,365,344,21,Asia,19,3338.61
39397efac5d541758c79c1b1276c7d21,59,17,42,South America,21,362.3
3939d4fd5f94468a9a91c2618ae297c5,225,181,44,Asia,17,1252.97
393ab09c44444b12a6fc122f7bbd9e71,171,121,50,North America,19,624.24
393be9eedb854fd1b845ad467566b04f,183,161,22,Oceania,25,1404.94
393ceffd9de54ec9acceeb2f2a70df7e,363,326,37,Africa,20,1407.48
393ecd6183b5462e969738aa53e498fd,160,112,48,North America,21,740.92
393fa8cff0674c35bdca10d8a91f9472,364,348,16,Africa,21,2438.55
3940b9efcac441ce8c77f25a811305d3,212,190,22,Europe,17,1466.71
3942ef767a934f9ca2942daeeb6c066d,290,247,43,Oceania,25,1345.17
394726cf84ee452aa1c5a173df417bdc,350,322,28,Oceania,18,2254.76
394b9cfb7420414f8dc65c5eb85a9f02,140,98,42,South America,17,1130.65
394c8192cab84ae59514a3c5fd17b968,158,127,31,North America,21,920.34
394dadef553747e1a405f359ada32de5,114,64,50,Africa,26,301.61
394dbea335fd4f4c8258aa1da1df6bd8,336,307,29,Europe,15,1966.41
394dd53ba51e4685be857b775f84bef6,205,172,33,North America,21,1327.27
394e101785a145fd843c26f8e6ed8028,208,172,36,Oceania,17,1245.79
394fbf6765b84bdd8181ba45e94cea8c,336,309,27,Asia,18,2168.3
394fc43ed5b340f78e60e1bda5e96c37,364,328,36,South America,18,3007.45
3950a753660e47928935519e646821f8,194,143,51,South America,16,778.72
3952efa5f78b42db88ab948f9cb7507f,166,139,27,Europe,20,1026.2
3953ede8e5f443ef81fdb3e6fc91669a,53,24,29,Africa,22,561.07
3953f7a659e343019e4e94c2eb0f8bdd,364,353,11,Africa,19,3470.54
3954c158debb46df94b802f09c3ad576,72,19,53,Oceania,14,214.22
395b54784d834af996ca9c6d50503bc1,120,70,50,Oceania,21,479.34
395cad41eadc49058c228390383ef99d,210,173,37,Asia,13,1481.22
395f3db250104f69bf335fff1ef4eee2,123,76,47,South America,20,651.76
396223987f624070858dc5c6f2847527,190,168,22,Europe,18,1592.39
3963bc97f8534c30b262bed6f8576e2d,240,223,17,Africa,25,1533.18
3964168e0c4f4c08991e7fa58670aa1b,279,246,33,North America,21,2051.55
3965a6f9409e4d78a3092997d3bd59a2,259,232,27,Europe,15,1829.58
3968eabf7f6b4538954dcefc9d9fa1af,333,295,38,North America,20,2046.4
3968ef57a2c44bf2a46850166196c90d,139,90,49,Africa,22,803.71
396e13ca985b4df8962189eab1c62c22,364,363,1,Europe,15,2457.69
396faa12d1e44bcaa7bbd7a696d02afe,50,16,34,Oceania,25,531.84
3971eeaec6dc4fd1b3069b09d32a0f7f,136,92,44,Oceania,13,408.57
3972f613e088491ea862db3701e05d3c,104,61,43,Europe,20,804.55
397315b8f12c437988fb05bb9415fff2,251,212,39,Europe,21,1779.41
3974222fea434a82918133d8daeef992,214,178,36,North America,21,1974.43
397455095f8f4240b3a837e19f4445e5,248,237,11,North America,24,2287.33
3974f51c8afe4ff8bbbb226cdfa654aa,67,27,40,Asia,21,378.15
397575bc784049f5b2a0da7344c8fd84,116,87,29,Europe,22,690.96
3976b963ccbc482f989c1dbe2dffbaf8,122,70,52,Africa,19,537.36
3977f7f61400492394b99a63654b94eb,96,34,62,Asia,17,117.62
39787eb993eb42a0a351b7c3c2f4e2da,188,165,23,Africa,17,1646.21
3978f6ad8b5244c5b2037a1d56f11a51,358,325,33,North America,16,2674.03
39799cdbd665416db1df625aeb16b77b,250,226,24,Europe,22,2109.59
397a1f0029044b9e98c86bf9e970382b,363,343,20,North America,25,1743.69
397b2d3d37b247fabf132da4932534a7,200,160,40,Oceania,19,1450.4
397c87ca6bdf433698cd37d915325ef5,49,2,47,Africa,23,149.47
397d9f04035b49b19f02cefc766e7895,365,357,8,South America,20,2538.01
397e4397d37245189cceb6a780d45caf,265,244,21,North America,20,2973.33
3983b4c2c9884f10b185919535bb803f,31,6,25,South America,22,325.53
3986b145c4794d2098b923981bc0487a,235,205,30,Africa,28,2398.46
3988129db83f46f38925dadf47cb32b3,299,256,43,North America,25,1974.16
39895a2bc7b746a59216b4b6d29ccbc5,231,192,39,South America,15,1676.66
398a033c957541b2aaf24544ffe923f3,279,253,26,South America,24,1975.14
398cd0f45f1a4416aea2d2dd4c8452d7,85,37,48,Oceania,22,368.7
3992202426d1468c890fbe5b2d56b62f,161,108,53,South America,19,884.33
3992e4cebc9243dea140cdac873dfb0a,111,65,46,Oceania,14,471.44
39947caa50744f84a87587989a277356,204,186,18,South America,21,1030.74
3997d96b98bb4fefbace5ead24866825,354,311,43,North America,19,1892.13
399aba4ea64b4df680aec9c07267327a,360,319,41,Oceania,21,2566.1
399d17f9dc9241ca9d62069931a5cfb3,330,287,43,Asia,19,1431.86
399db0c8ed4f433cbfd132003066a420,174,122,52,Europe,22,1144.81
399de01630eb4bcb8e3ed8eca57d6466,239,221,18,Europe,23,2063.86
39a221301fca4fd3822d28a84a415e8d,114,82,32,South America,24,655.71
39a225fccf454fc48ff4916fc04d6b6d,122,84,38,Europe,16,1171.21
39aa84c437d047a193c0716d5bbe7c6e,174,120,54,Africa,20,1262.78
39aaf0f638a8492b8ea634b8cc0c4734,364,355,9,Africa,23,2404.79
39ae445348624e1b8e88afa6fdc5035a,223,186,37,Africa,17,2264.55
39b08a15b4e04e179945f5d73e0efb89,302,279,23,North America,23,2746.11
39b0b7a99194499389aa13fdd825067b,104,51,53,North America,22,438.19
39b3acafcd584c43a10556ac60e441cf,266,246,20,Oceania,17,1904.97
39b4b80a901340479b402e4d3fe6362c,133,95,38,Africa,24,833.45
39b67e4fa927436ba587b7868034094f,100,75,25,Africa,16,500.28
39b8c10b21184462822dd16412246ee0,234,194,40,South America,20,1519.06
39bb036997de4bb2a4515bf4c00e251b,229,180,49,North America,19,769.38
39bbea9da6f04d06aa30381d398a34da,118,79,39,Europe,22,628.59
39bcd43af18b45a08ce4bbfd205b941e,76,34,42,Asia,19,627.37
39bd4214528c49be8e4fe52dd3be1453,202,164,38,Oceania,24,1186.69
39bdb0a2f591468f8aed94f0887585f1,222,175,47,Oceania,20,1007.81
39bebed493d44f95b449d8a8645f97f4,128,72,56,North America,18,787.59
39bec86d2f284d3da5252792ca4ce4b0,347,298,49,Africa,22,1570.37
39c1cf2ff9da4e9c8faf9097ca3ade8b,326,301,25,South America,22,2237.04
39c234d505404393bcd835e626be0c96,60,16,44,Africa,20,520.31
39c267a762e0438caba8bb06513b1ed2,360,344,16,South America,21,3068.99
39c37c6d0ae442369c2b0aa7ebf22e47,339,306,33,Europe,21,2047.04
39c6fcf872fc4ecb9afa7f4888914494,358,341,17,Asia,23,2926.56
39c76c3356fd417b96ada5033fc948e2,149,107,42,Africa,18,976.74
39c8b615502f4b4aad3b29260b7fff42,248,195,53,Oceania,24,1089.25
39ca41e1dfeb4246ad75aa23366992d6,320,288,32,North America,14,2998.51
39ca85ce5f7747c8b177344d93663cac,253,211,42,Europe,22,1320.87
39cd122f4485494ebde416bc641ba685,346,322,24,Asia,22,2156.73
39cd34a730dd48bfbbbaa3d4a75d74d1,106,58,48,Africa,18,437.2
39cdbf9f5cf94987a1d1eb7a07ac6cb6,248,197,51,Africa,21,1068.82
39cf42e7294444dfbe70588f83fd7f09,166,146,20,Oceania,20,1512.57
39cfc1b6cb114cd09e9d7e45f51d3938,299,272,27,Asia,16,1902.24
39d04a7264234461b12f61b518c0f0ff,363,322,41,North America,22,1866.12
39d3c1d0dd5d410aa67666fe60cee6d9,169,129,40,North America,19,1131.7
39d4818feeb7446e9cb26f16de6e678f,124,94,30,Europe,19,822.18
39d6d30d9a92479dbc651d7eb50a0852,305,247,58,North America,18,1639.88
39d6f60a24464ea6bacf04d082c12b11,365,350,15,South America,20,1606.17
39d96b00facc41c2bd0f05aa92fa2c39,182,128,54,Africa,20,869.74
39dd3974a74e4ff4a0b39215332388a3,193,146,47,Europe,20,914.87
39dd6b6314564158a11665b20c4ab850,285,236,49,Oceania,20,1780.46
39e01e9a3ec84e218f8ccb90bf3e466b,110,55,55,Africa,25,910.1
39e251958ad844d0a55a8cde073bf13e,138,87,51,Europe,21,552.4
39e2e24052ca4480b94ecaf1c2077dfe,139,107,32,Oceania,25,1076.24
39e34e77b8cb4aeba56b8ad5d1c0620c,63,20,43,Africa,22,492.93
39e47eefa4654dae80837d96be891640,102,64,38,North America,24,694.3
39e4cf436c2449df8633756928c479f3,223,198,25,Asia,21,1187.43
39e604ca66f44b84afde0b85d343d746,334,304,30,Oceania,22,2617.71
39e66c69e9b44e57bd5a226424551602,158,136,22,North America,17,1236.17
39e7ed475cdc4872a6b3f0645350bd25,363,347,16,Europe,20,2183.63
39e8a20c79e6462b9d87eab3941ee611,172,145,27,Europe,26,601.25
39f026415bf94e49bda94eebeccdf0d9,227,188,39,Asia,25,1313.06
39f0661b03f645ac8837052932ee99d2,148,131,17,Oceania,22,1517.88
39f4604a46114c0a800525a2eed1c636,195,163,32,Europe,23,1498.87
3a050d35b51c46e68a45efe41d00028b,275,219,56,Oceania,21,1439.9
3a05314ef5014c55be6ae5be8918f685,117,80,37,Oceania,14,599.76
3a07d23ea53c43b8bafb1f8582f2a0bf,209,191,18,Europe,23,1802.6
3a0888b61c484d4d9ec3c00a457a8edb,287,253,34,Asia,20,1573.83
3a088d57dbd74d8ca60cc43176f96a20,238,197,41,Africa,18,1572.61
3a0be8cd9d6f498c8faf0740e41960c9,183,131,52,Africa,24,1025.66
3a0c3e6b14074ac983e3c1acbd6841a8,327,298,29,Europe,17,2710.77
3a0d3373191e41d2b7d3d58e5a9a29d7,162,124,38,Africa,23,753.92
3a0e61db67fc4424b7720b5314664ebe,85,69,16,North America,20,676.7
3a0eb8c787b243e898487454eb0079ad,116,88,28,South America,21,842.02
3a11a7cab9c34fddbccfcce99cc6aaf6,362,347,15,Europe,22,2187.11
3a12fb460a604e0aa01dcad10c002466,364,332,32,Africa,19,1955.14
3a12fe229f33467d84517db9fcf9ab47,155,102,53,Africa,22,566.71
3a13d0a0181845aba275ae4143d4383f,207,175,32,Africa,18,1860.25
3a15acb6f86044dba22e360b3a28a5b1,284,240,44,Europe,18,1061.22
3a15ec32060b438da153d951433390cc,351,300,51,South America,15,1513.9
3a19c51b00104f2f8dfa5a58df01c829,256,230,26,Europe,23,1606.86
3a1a079f63744bbeb2c6fe40d94511e5,317,276,41,Oceania,17,2174.22
3a1cece96695495d8615ddbdcb5a6195,247,221,26,Africa,16,1316.98
3a1f1d6d52ee43db88cb98f08564a5dc,306,284,22,Europe,23,2363.12
3a1fa1f92faa4dfc84273de3ce1eaa56,102,53,49,Africa,18,214.15
3a2009929d544c3a96eadc5fd729a7ce,269,250,19,North America,13,2036.9
3a205d59705e4006b46bfe4c57867a70,158,136,22,Oceania,14,1253.43
3a2362f0ebe342bc8a214e12bf71f422,272,243,29,Europe,15,1776.06
3a26e50ec80040668293c6b56f05ef93,118,100,18,Africa,16,855.76
3a279720b8f7404fa2ba8bb7639a691e,51,15,36,North America,18,351.6
3a2a70c508264a50a70cbb67aa713175,325,277,48,North America,24,1027.61
3a2a9b249fdb4201989b496d9b64e4bc,124,80,44,Europe,23,668.89
3a2b7d4d2c08442c82cf71739eee65d9,301,270,31,North America,14,1852.88
3a2ca73cd4374708bddd34b533ffdcaa,133,110,23,Asia,18,869.3
3a2ce28769d54cb09d111b33548bf8eb,102,60,42,Asia,16,204.97
3a2ec034f407478aac5d6b19e9f05578,360,348,12,Oceania,19,1419.93
3a33d26453574045a003316766f90f6b,205,167,38,Asia,22,1534.1
3a3591b4389f4d7f992ba3dacd8845aa,363,357,6,North America,12,2577.45
3a39d88a256b4eae9b290f98c04ec6f1,274,253,21,North America,21,2206.29
3a4163e14beb420f9427129deaefd862,330,311,19,Africa,17,2418.3
3a4cc7e1d1154a8fbded28905cb15b51,276,231,45,Asia,18,1265.62
3a4d6a3c101f462b86cab9893c18a053,129,73,56,Asia,21,438.12
3a4de8b1354a47c19821f4a0f8b9ac66,144,86,58,South America,22,767.38
3a4e929622ef40a6a8158de9fdd9d813,110,82,28,South America,18,646.84
3a4fec3e17894326a2f269279ff9cb1e,328,308,20,Africa,24,2181.32
3a52c594475847fe8bb6de276ec5ab63,303,277,26,North America,19,2088.12
3a52df2786334b2a8b122b4e424e2239,365,350,15,Oceania,24,2527.41
3a53b36f852e4e2abecbd15687b1eea1,347,314,33,Asia,18,2536.55
3a566729deb14b59ae3e477855a2986f,198,155,43,Africa,18,1446.92
3a5c6f1b7adb45d6ad6f40aaa8944df5,299,266,33,Asia,22,2050.26
3a5d5e3cab674b17a3df1091b8724676,142,107,35,Oceania,18,574.86
3a5d6c3b961e44deb21634ab88cd4d5c,172,131,41,Europe,17,929.56
3a5daf3e35424b8a9bf420624a9c46c6,271,227,44,Oceania,15,2214.91
3a5ddf7292a94646a821535618499a2c,79,32,47,North America,17,420.8
3a5ef388f6f6486493477b8e43619b3a,271,207,64,Africa,13,1742.13
3a5f048321fd4e06bd0ad4e15ee43dbe,230,177,53,Oceania,25,1574.62
3a6214a3b82c4adbbf6670a6dd37fadf,116,84,32,Oceania,21,547.46
3a621c7f112b4083a3f9a513ffea94b3,360,332,28,Oceania,18,1662.69
3a62428fa9b34c8e9f385fe4688f357e,303,251,52,Oceania,22,1258.7
3a668438d6644b00924699c2ad904150,97,49,48,North America,20,311.67
3a67730e156642e79c76eed0046d0dc0,82,56,26,North America,20,700.63
3a68802ae9544f5aa73b7438d727f8c5,55,33,22,Asia,20,710.76
3a6946f5184c46f9bbf5a97137e65faa,295,264,31,Europe,18,1903.92
3a6cdcf959bb44868487e6db5d65de02,137,91,46,Oceania,19,866.64
3a6cf36b9ad04514b6192b011e4585a5,165,121,44,South America,13,940.31
3a6f5fe7f7dc45c8b40390ea97b1a444,115,74,41,North America,29,805.28
3a6f6e95f4e940b582f045632d081819,146,99,47,Africa,22,561.48
3a708e81285643aeb5cb1e65016f1bc0,240,208,32,Asia,16,1797.11
3a71e09911e24340b22535b46d9807bf,98,88,10,Asia,20,809.96
3a74a9115ebf4e84976e047b52dd9bf4,129,89,40,Asia,18,801.24
3a76af3aaddd400784b694512d5e434f,173,153,20,Oceania,18,1922.33
3a7747b1cc134649b7a943233a9a9986,138,98,40,South America,17,1407.25
3a7a60f1f04f41c2bfd65ad121290552,61,30,31,South America,16,573.42
3a7b1d945f4741faa202028667b84d06,224,185,39,Asia,21,1635.51
3a7ce40b06894c4891ee6e9868363807,364,330,34,Oceania,20,1481.77
3a7d50eab7e849819c05aee9c8c7ead1,93,50,43,Oceania,17,533.77
3a810d69a2cf4d2a9eb2b4bc60860849,67,21,46,South America,20,351.67
3a81831cc5bc4e4eadf491e64ea169d9,320,297,23,South America,18,2207.7
3a81d8cf962e48fb84868dfb51284793,283,249,34,South America,20,1921.27
3a823952eb94475aafd83eaa0d8388a1,110,57,53,North America,21,871.88
3a82bb81182e40559c757574d5b455a1,336,316,20,Europe,20,2416.51
3a8350da04e34a548367d67888cb71bb,155,113,42,Europe,23,795.67
3a83620e54734cf2b2884ac99e0a77ff,120,78,42,South America,15,595.57
3a84c9875444416080ad574ff43012c9,171,117,54,North America,20,762.58
3a8538c4c48c4c449157ee327b62e0af,362,343,19,Asia,22,2177.31
3a870137313e444dbac9a1bcbee2399c,294,269,25,Africa,19,1987.58
3a87eaab2fc64a62af58615a4df41626,52,1,51,Oceania,16,178.9
3a89881396124b2b87590310cdcbc2dd,97,68,29,Africa,23,699.11
3a8c0bd2f1a147a9888fd42fa4475369,305,264,41,Asia,20,1942.48
3a8cc6c5c48a4d11896f3cf7d96ecd9e,109,91,18,North America,25,591.69
3a8cfc0515604619af3072e91d528dae,297,257,40,Europe,16,1509.59
3a8ebf2c0520443a88c024c0a4c5f888,108,61,47,South America,20,373.19
3a90050b16794d68b2e02239fcee3f9b,76,53,23,Asia,18,968.67
3a90147712a84861bfeeb1711a8a813d,74,40,34,South America,25,578.6
3a92c6f5bb6c48a1beb454c2a5cfde87,364,342,22,Oceania,20,2266
3a92ec8326bb474286dfb7b2f45d336a,331,295,36,South America,24,2559.48
3a95019423e344e18e82d789cda3da79,352,323,29,North America,22,2682.43
3a972bdf343c4ac0a3e7f7f2a2e57b71,67,27,40,Africa,25,487.58
3a98ed78716d4f51adaa03e9093dea3c,205,165,40,Oceania,16,1377.35
3a98edb00212461c8231654283de27c6,359,307,52,Africa,20,2022.55
3a994a8af79a468ca8cbbc1c2ab5f5dd,296,263,33,Africa,21,2660.75
3a9d7fc59ba841db9e136bb28c068856,328,298,30,North America,21,3096.29
3a9db60253ab4c6e96cf89f7b134f7cb,256,217,39,Europe,21,1122.35
3aa01caf150e4828968abe733fb56221,226,212,14,Oceania,18,1822.97
3aa02a6218a643eab3fb06b627c1028f,165,133,32,Europe,24,1254.6
3aa02f99a8f14bcc8830efe702e2c973,88,56,32,Europe,22,608.22
3aa1a895a1064631b29338c9d1c7420a,190,162,28,Africa,18,1537.57
3aa1ff153f654a3591f8b669c279dcaa,323,277,46,Africa,20,1425.05
3aa280a6cbdb4f5a95a62146c9c00a5e,360,332,28,Asia,22,3044.23
3aa46cabdde34329a916774cc888bd6e,261,218,43,Asia,21,1186.12
3aa473a7b6264f5496c2539d6a9db525,267,217,50,Asia,19,1096.62
3aa514e80d264039ac6cac3a8df8821b,305,265,40,North America,17,2026.44
3aa57708329245d59f1776909a693185,364,346,18,Asia,24,2846.27
3aa5c49f8a8241bd82fad6773a960797,364,333,31,South America,19,2068.68
3aa76851f13c4f1a903b81054902753d,160,107,53,Africa,23,897.59
3aa8144eda394d4290f1782f1f29c259,226,191,35,North America,23,1407.16
3aabcc39c5744bfaacc65a2e0e5a6c37,78,27,51,Asia,25,803.61
3aae7903d0d847bb976a1b8f4c822a2f,282,243,39,Asia,21,1996.91
3aaee7d06deb4cb7b1592379a37c6cb2,245,224,21,Europe,20,1942.62
3ab5565cd8404224ab6c771726bab96a,272,243,29,North America,16,2236.15
3ab78c683a394320b54d90be4c9fd107,235,210,25,Africa,20,1944.45
3ab87bf5b0cb44a485fc6b58898a521e,253,221,32,North America,23,1665.4
3ab90816ba2b43c7b542307e138b9463,152,127,25,Africa,17,971.19
3ab9d8320b4e4bc0ad5bf5277ddbb501,115,64,51,Oceania,16,277.9
3abab4d345f445dfad4520c99e796396,296,253,43,Oceania,21,2078.68
3abb2b2c46fd42c9b17e363ec0f53026,124,104,20,Europe,17,947.6
3abc6077cc58494d8567266d40ac408c,146,89,57,South America,19,550.83
3abd306ea2aa40c1b3e9fe72439a01ae,221,191,30,Asia,20,2134.85
3abe765fde5e46bbb84f49b215ae1ee2,254,206,48,Europe,24,1418.59
3ac04704da0a48bb8d225078c29ef90f,365,358,7,Europe,17,1977.34
3ac0797633b84b58815e586a08515e04,216,186,30,South America,20,1377.93
3ac427114147461bbba9c50665d0aed7,66,17,49,Asia,17,326.52
3ac576b2f2fc4d11b0590b09eb5c89b7,282,256,26,Europe,21,2111.9
3ac5b722e63a40bebb08057c30b0c226,233,183,50,North America,23,1430.87
3ac686525e6f4fe79f6d3b88d8ff2ee6,147,126,21,Europe,23,900.74
3acb19a71f414ff18266d6d86cffd82e,255,231,24,Europe,20,1782.98
3ace7b13a1e944bf932d28836bd8101b,327,285,42,Europe,23,1376.27
3aceb67a684c41919224153db441494c,365,360,5,Europe,18,3148.2
3ad0afb1c0b54af39004f0420c250018,120,73,47,Oceania,18,1013.89
3ad161572b4147b7a6e578c961bb2c20,352,315,37,North America,17,2040.88
3ad4cac2044147788a6c120c34ff36a2,121,66,55,North America,21,443.35
3ad5fbe7ac3a4c0bb9ea6579e046c8d9,223,173,50,Oceania,21,732.99
3ad69448fce24cd49e795870b815e0d0,236,196,40,Oceania,18,1605.69
3ad6c985cf6f4213adc4ac7c7dd2c292,46,33,13,Asia,21,357.61
3ad6d3ceb0fb4f01b2ebbbb66fb1ade7,171,134,37,North America,22,1098.67
3ad7b6dd5e224b81aa744e9fc4b83145,181,129,52,Europe,20,835.59
3ad7c7f87b924345820096b3164f1963,330,283,47,North America,21,1876.43
3ad7e3994e5c4e80a38bd25da021a3eb,105,64,41,Africa,20,535.95
3adbfac28ea244ee915b5ab22299b896,221,189,32,Oceania,19,1320.31
3added362e4744bb91df0fe1bd5bee17,285,241,44,Asia,20,1525.13
3ade36759de0428893cdfdac51122b91,302,281,21,Oceania,21,2294.18
3ae03aaf94834b408b83ab8703ce9b15,362,356,6,Europe,17,1357.97
3ae35d7453a34ac490b5de6658f6b70b,195,173,22,Africa,17,1463.91
3ae4c03e344446b7bedaaeabebe1b08d,247,205,42,Oceania,22,1352.2
3ae6b0145c5546e4a2e50fd4f5459b93,230,196,34,Oceania,21,1127.39
3ae6efcbd5b94d7db80fcd4ad9adb77f,76,62,14,Europe,22,541.76
3ae91badf70240989bf50a9ee1e8eb11,173,136,37,North America,20,1412.92
3ae9de15c77545cfb209672a1a68cc11,335,310,25,Oceania,27,2513.89
3aecd309a5fb478a9a667caef95014eb,258,222,36,North America,24,1637.23
3aecdff007d84cc3a234e51cbddaae9e,212,185,27,Africa,16,2200.29
3aee83a6d4244a238ccfc6eaab583b8b,120,108,12,North America,25,1037.89
3aef8e3c91164b88aebb9ae7bce43094,50,21,29,Europe,17,395.49
3af0487d757f41c58ac8ccf46a08b054,62,19,43,Oceania,22,198.63
3af2dd7092134c5dbd229fd89916a2ba,221,194,27,South America,22,1551.28
3af3d0b0baf44974b67d1f39a67c70e4,135,105,30,South America,20,1201.15
3af511a9ba174d939e684a86c0b586bb,52,36,16,Europe,20,533.39
3af8021cc72e44f4af5fdf0d14032561,365,347,18,Africa,18,2068.51
3af80719d0774dadb1d176ccc2de939d,259,238,21,Europe,19,2414.57
3af8e71e1faf46879b6f2b40c3583d81,154,124,30,Europe,19,908.41
3afabdb3d9954cd585214f115bca61c1,164,136,28,South America,25,704.29
3afaed68a5624c7ab17d44c0a220ec12,259,230,29,Europe,19,1778.47
3afb246170e74f05aab1acc4e8bdad68,364,345,19,Oceania,16,2924.77
3afb6a1aa01e4964b5e12a10cb1421e6,365,345,20,Africa,22,2906.29
3afbd738a4e74eab982d901e226c1f1b,303,258,45,North America,22,2022.42
3afc104138f647a9a9975f1b150b7143,321,285,36,North America,18,2599.52
3afcba4ccbb94836af3e8807340ca2fd,213,176,37,Africa,21,1622.34
3afe66a3988841ff9f71753cfc81e4da,353,315,38,South America,21,1498.95
3b036fd6007243a8954a89b47c8aa94d,162,117,45,North America,20,645.15
3b061bbbb62a43d99837bce8412c15a8,144,119,25,Europe,21,1033.2
3b096a746be047738b24e38bb4e580c8,352,327,25,Europe,13,1861.84
3b0a785d11de4bbc98c09a0612be855d,134,105,29,South America,17,1087.13
3b0ad34aa686439bbe2d17c2fa05f15b,255,230,25,Africa,19,914.56
3b0af88e490e490ea2ec9a13fb3c9b19,155,106,49,Oceania,22,941.26
3b0c690e5fae400cb1de1218732ff5dc,169,128,41,North America,20,1312.91
3b0c8967ca134b51913de47881e3a1df,22,1,21,Africa,14,161.03
3b0cfdc1d16f454f90b9d046aec1b6f2,127,96,31,South America,23,633.66
3b0f9a49f6ab4fe5976310fa5e7677f7,254,232,22,Asia,21,1668.89
3b1225d8781045eba5b38ed572a02cbe,39,9,30,Asia,23,301.5
3b14cb764c6b4f23bdf29999f96aa280,105,65,40,Oceania,25,715.68
3b17e1ff0c824a2892a66b9a600c5594,320,290,30,Oceania,16,2016.09
3b1817e8ae674953928dba53065c96c8,330,309,21,Europe,20,2643.04
3b1a8ec0ad574ed190826f3cf7fa217f,276,253,23,Africa,18,1871.67
3b1af0bb81af401c8eb9f891af173eeb,112,61,51,Oceania,22,715.9
3b1afde2df6b4faabb11a683dea1baff,277,239,38,North America,15,1887.51
3b1f39cbe125430b9794eb9a2abec483,126,79,47,Europe,22,730.45
3b1f91830b9e41ccbe1480123070b71d,364,363,1,South America,16,2522.12
3b21e829da004482bc21875744a356cb,179,134,45,Europe,18,611.43
3b2258000c334edba04d3e2efa8c738b,121,91,30,Oceania,18,962.27
3b22606f15494246a64e256369129a50,230,198,32,Asia,22,1525.92
3b226d8ae8c84c19a410384cfe14df55,365,334,31,Oceania,20,2760.64
3b25310eff584206b644bf42c5740f02,356,313,43,Oceania,21,2249.6
3b254f85ba414fae814af4cdeee24f35,288,240,48,North America,20,1123.14
3b27c20e067c40a99b31f553bfe193ca,288,244,44,Oceania,23,800.95
3b29e241a27d4ba7b81c0eeec39c2900,282,229,53,Europe,15,1497.16
3b29e48b2c014773bb12fdf330b76912,344,320,24,South America,21,2182.06
3b2a590430b044a1bd6ddf6d32905ac0,135,111,24,North America,22,1168.8
3b2ad2ef5ca443f48d6dae237ec7cc2c,77,37,40,Oceania,27,427.28
3b2bc5ec56814095aa4e9ff921badcf9,155,112,43,North America,22,638.24
3b2bd1fdd1dc419aa67cacb4fd1115a8,365,314,51,Oceania,20,2590.44
3b2d5099eabe4716b94c218e93b81a08,146,102,44,Oceania,20,957.01
3b2ebf83748a46839a63e4112bb633d6,155,138,17,Africa,22,1283.17
3b31abfde39b472b93ec9d6e8028a937,122,69,53,North America,20,556.68
3b3bea1d007d4c83833ebc26af8bfcfb,117,87,30,Asia,19,1049.46
3b3f0dd0a051487eb2c60c1172e49fda,206,170,36,Africa,18,1702.56
3b45253e968e4e59a010bc6167ef50b3,111,83,28,Africa,25,942.54
3b49b29534a842bd9a150b84b8bfa45d,356,328,28,Oceania,18,2168.75
3b49d61e33404b48925ca2f7c72baa75,323,284,39,Asia,25,1740.27
3b4b886689d140c9bb619af402175ebf,133,110,23,Asia,18,794.87
3b50aedd327145d8a2d2afb957ddda4c,64,15,49,North America,18,230.44
3b51be95dfa7409fbae8c65c89d23692,61,41,20,Africa,15,797.97
3b5438773bdb4d9ea0c0b68ac0301ac6,364,312,52,Africa,22,1740.65
3b545c6803b140ce8ea3a7de404ef6da,190,166,24,Europe,19,1871.31
3b572a44f5094568ae8ae7594a9acd7a,330,280,50,Africa,16,1605.74
3b57dd0af1284c149f7bfdd83a4f5f07,347,325,22,Oceania,18,2405.19
3b5ae53b4da3400e87d1bbda9fb7f24c,210,185,25,Oceania,17,1425.24
3b5ba64518854a30856e572cf58300ed,96,50,46,South America,20,281.26
3b601d85d16044a19e38232038438522,128,107,21,Asia,21,621.86
3b60691a2dd44165837ca9bfaa027caf,304,280,24,Oceania,23,2396.53
3b612fe4f1004397993ece08da0c16d1,306,279,27,South America,22,2325.34
3b622bc20bf84c3a87429c6b4c08c687,85,59,26,South America,16,981.64
3b626b05578d46f6a4241d37afd00dbc,272,238,34,Oceania,20,1950.6
3b631c6cd5ab48438ac665cd7dc2dadc,362,362,0,North America,20,1922.76
3b64973d192e41bf97ad439fe3102e3f,89,55,34,Africa,23,590.85
3b64b96d34d046acbec25796e335bd1c,365,326,39,Europe,24,1646.74
3b65059d8ff8484786a81d8fc6582aad,218,189,29,South America,21,1447.78
3b6561a4bc084d6fac47ecb0198990b2,265,238,27,South America,22,2089.8
3b66640f354740d88c2aa7c080dbdf75,348,302,46,North America,21,2008.94
3b68ed94184241d6a6f22025189b4796,104,65,39,Asia,13,945.47
3b6b87aa8f9c4fbdb8c34719109bb364,87,50,37,Europe,18,875.79
3b6c56e515b8479a9420784ae8ce0380,179,133,46,Europe,17,454.5
3b6d9d12605546ba85e31e74ee0e79ac,365,314,51,Asia,27,1683.78
3b708f1876b84fc29435637badbbbb19,283,246,37,South America,23,2224.13
3b709743e1fe4d6d80fda358cc0e6d1f,290,264,26,North America,20,2537.06
3b73430073734aabaf72e30fe4363c4d,95,47,48,Europe,18,821.48
3b74902e84a543819f02b1782b27bdf3,225,193,32,North America,18,996.33
3b757809fd17499583c5f0dfb6612017,272,239,33,Europe,17,1759.65
3b758cc0c2f6408eaa1c1f1d1aa405f4,297,248,49,Africa,19,2157.82
3b7907c066a74302a0dfcd55206aaf78,294,272,22,Europe,23,2852.69
3b7ad5176fe64ff0b559fc278335b013,365,358,7,Africa,11,3643.11
3b7b4815a9494b8fb522958c1eacd275,218,199,19,South America,15,1499.93
3b7df11d279847debc81dda8086259c9,300,274,26,Oceania,14,2949.75
3b7dfc12aff3461b8bcaf149c18fbda1,190,158,32,Oceania,20,1585.96
3b7fad1f846143d5a21282be62d0e24e,363,360,3,Europe,20,1961.62
3b801c873f2d4c1c9f4a77c862a50ff8,154,117,37,Europe,20,1190.18
3b86f6370b44447cb6e967cd592b6278,102,68,34,Africa,15,504.1
3b885b2990914451816e0d0a8c2711dc,245,214,31,Africa,19,1493.18
3b892088ebf441c09ff6cac392d04ea5,281,221,60,South America,13,1956.28
3b894697ca8a4205a825f27138d39517,122,84,38,Africa,21,912.03
3b8a991966eb4173914cb3f529d18bcc,226,195,31,Oceania,20,2127.36
3b93b1fe16f5412fb08801e2e827fbe3,167,143,24,North America,19,1309.92
3b94fd2869684228b3425b76a00236b8,252,229,23,North America,22,1580.71
3b95f6a1d3794ae5a75b939c173ae836,84,53,31,Europe,24,448.22
3b96d6e5202c41b29fd9a7454a923d6b,249,209,40,Asia,16,1675.17
3b96df1ebddd48ee8374bd5caa36fcc3,130,88,42,Asia,21,1026.67
3b972f22d9c3463a9213e908b9687b0d,308,278,30,Africa,23,1523.43
3b985b7ff1d444538b89afdc63367938,231,203,28,Africa,20,1900.72
3b9b7efe3ea247d9a3612373b49312c9,192,148,44,North America,16,358.72
3b9ca9ba31554e45bfa9d66398730b6a,140,104,36,Asia,19,727.96
3b9dc190ce0140c5b2bab8b5b17cf86c,217,191,26,Europe,18,1975.75
3b9fa4059bda4d82b5cecf7717746e41,319,262,57,Africa,19,1739.72
3ba140f84294422993739e0beb81592c,297,262,35,Asia,19,1508.58
3ba5af122d3f4c60a0e0c2cd66625b89,200,176,24,South America,16,2488.89
3ba66e75cd2143038489ea6bfa89be25,290,254,36,Europe,20,2096.97
3baa97ef035742839b9c795b43c9abc8,121,96,25,South America,20,745.85
3baa9caa17f644e4bf9442aae34a5100,97,67,30,Asia,20,849.33
3bab4f3eee454a73b0ee551f6fb821d9,184,123,61,South America,19,1011.11
3bae3f55d9a94db7ac50d91d03f86bc2,107,67,40,South America,21,1000.98
3baf049b46c64eb081ac62fd1a2ae9f9,333,306,27,Africa,16,2345.35
3bb242b0a59a4c848b9dc6f623f0f165,174,151,23,Oceania,21,1046.78
3bb34811690243918988b278b2100baf,365,340,25,Oceania,22,2329.75
3bb65c0274874597a0f3a51281d7a50f,287,239,48,South America,26,1381.64
3bb865fec55b43bda72cd4643bd05e3e,335,299,36,South America,23,2740.53
3bb871abf97c46d6ade92e28949701b8,296,248,48,Asia,26,1065.49
3bb9679209c846828ba9b2862b01550f,213,164,49,Asia,22,998.07
3bbf28885fdc4ceead569c00d97094e2,206,154,52,North America,19,934.28
3bc0578f4c5f4ccb80b7847dd96d6037,199,153,46,Asia,24,895.71
3bc160a79f394006853a544eb82c4161,171,137,34,Africa,20,920.74
3bc2ca7c5b3a4bbb9964cfab08de9aa0,272,235,37,Africa,21,1824.08
3bc76d781e044b82866fa1ba52fcc4ab,239,190,49,Oceania,20,1452.23
3bc91662471d40279f0293e456b9db03,348,299,49,North America,19,1859.8
3bcbbb90cfd340f1a3b4be3f642211ca,351,327,24,North America,20,2992.94
3bce68273d4c443c9a7a4b166006de7f,75,36,39,South America,21,1150.12
3bcf3b4a3e2e46e0b02f9e63f0418260,55,7,48,North America,20,318.06
3bd1ac3758a743a6b127d820bd637aa4,255,232,23,South America,23,1991.48
3bd3c02da5044cdeb9bd7299f173c20f,266,227,39,North America,22,1817.32
3bd5269e2ae34a0395a02e6a7a0b1d7b,341,316,25,South America,23,2510.24
3bd737f59e964d7c94b1dcec8f3cfffb,266,252,14,North America,22,2187.49
3bda119b44a14a90b70f56af11bc9723,190,139,51,Europe,23,658.43
3bdc7bbc4a9141b78c2e64f5af568848,364,333,31,Oceania,24,1770.22
3be1884f538d4958894ec947b2b1dcca,364,364,0,North America,19,2916.87
3be27f7ed4c34f3eaac872a2f5b375b1,187,145,42,South America,15,1387.19
3be3dd4f6d184a0390abf292782e66a5,246,195,51,South America,21,1189.52
3be495cf3b674c9293b09a3bd6ac58e2,313,288,25,Europe,17,2078.23
3be572c2ad534a849c3a7f31d7e12410,362,350,12,Asia,19,2035.51
3be5a3a92d7c455998392859b50c1069,356,307,49,Africa,22,1974.91
3be9674559914f16b969fa30865cb6f5,207,183,24,Africa,21,2205.74
3bea9b8038334e64a3df00cc73cfa164,201,157,44,North America,26,1146.56
3bef006b91af49e588f2663f3c799878,141,123,18,South America,13,1067.07
3bf0723c5f11449fb5e9a5569d1f7704,299,259,40,Oceania,16,2130.49
3bf30ad0dddb42c491ac3e211238322e,284,232,52,Africa,16,1618.81
3bf6f0b8c42b4ce9ae118fd8798d6c20,231,197,34,North America,22,1784.99
3bf8dfe55f8647609799b873591c1a1d,267,231,36,South America,15,1573.42
3bfa14bc062b424690e688a58cc81f18,164,120,44,Africa,24,1245.82
3bfadcfcb77d46d5bd40db0214eb8329,365,333,32,Africa,19,1941.99
3bfb99851a05440f8793916fb0494a5c,143,107,36,South America,24,714.12
3bfcbc1ad592412bbbb931b52889de5e,365,320,45,Africa,19,1683.22
3bfe9eb4212846d3836b414ace2a21e2,314,279,35,Africa,20,2651.9
3bff0864de894f91995bf1369e3419cc,275,249,26,Africa,17,1662.7
3c01a075e96a48749695c05804723ed0,161,122,39,North America,17,705.96
3c025ef43f8e44bc8d982ba85fa25c2c,117,104,13,Africa,18,948.57
3c033f8ef12a4580919699cde2c26ab0,207,159,48,North America,16,1040.85
3c06da3bca4b44e89afd9ec346ebddff,263,246,17,Oceania,21,2950.95
3c080b3f2b1940c6994e505ce0a1fddf,105,58,47,North America,19,402.58
3c08800b79ee48a5a14f72f7e2bfa547,364,349,15,South America,17,2562
3c08e3034c6547f596a09f062beacdfc,178,144,34,Europe,18,1377.34
3c09c7cf005d424ab608ad38eea57e8a,176,128,48,North America,24,460.1
3c0e4a28b530483db29938392cefabcf,28,3,25,Asia,20,105.5
3c0e5f8506e84fa3b42d9e6e281308d0,336,316,20,Europe,19,2811.91
3c0f45ba3dc649e5bfa5e9a8b52682d9,78,26,52,Oceania,23,477.09
3c0f5dc62a5b4820a73ed7082e4d2016,105,74,31,South America,17,239.09
3c1817a1bf4940ec84dc99f6b94a62e4,341,296,45,Asia,22,1418.85
3c192763d0624aac844974423fae91e1,199,158,41,Europe,19,1591.57
3c1b4b786fbd45ea9c4dd7c9c6e98f35,61,13,48,Africa,25,733.34
3c1cd9848bbd4e7d8f15ff8ba6f2fd95,122,96,26,Asia,25,986.74
3c1e9479e2164d24884e428da842f1c6,46,21,25,Asia,26,381.87
3c1ec33833614e6a97d82ee885a61bbb,271,251,20,Europe,18,1990.55
3c2043b117984c88a26838ec4fedcb63,227,176,51,Europe,20,1204.3
3c2066a226404d629b254213c578c07f,85,34,51,Europe,30,227.07
3c21f2a25d7a4d8b970f763a80aa31a2,186,155,31,Africa,22,1156.7
3c2373d3daad456bbd10ba19702a713c,190,151,39,Africa,28,1730.35
3c23bf1243354f40a6ccf67de48224a7,62,38,24,Europe,22,288.98
3c280e79ce034838a49b4fac695c132f,69,27,42,South America,17,324.56
3c29091589034b7781ac8e7b81d2014b,289,246,43,Africa,17,1349.43
3c291c4302ee40f9a8b9793bdf1f6d4c,121,69,52,South America,26,728.63
3c29ab3e1f5b4f4a925cf2bd118faf4d,342,286,56,Oceania,18,1644.04
3c29bbaf158b41698ccc3c6d8394b41e,241,204,37,Asia,18,1518.85
3c29c02eadf44af58dc20eb8802cdd74,155,129,26,North America,23,1644.2
3c3219135b054284a2aad52489820eac,69,48,21,Asia,17,574.71
3c35b8a0dead47a1baacea268b943890,274,239,35,Africa,18,1946.45
3c35e9edfd4a456e8ef73df759ec0d2e,85,55,30,Asia,19,450.71
3c35ee77dbc04bfba76f16252303def0,135,111,24,South America,16,1271.58
3c381a8188d141de8b7d88c3df315067,196,165,31,South America,21,952.52
3c3872ba23994f48bcb8655c17817ca0,269,240,29,Oceania,22,1909.91
3c3a6385e23a43c2965449337b79633c,346,294,52,Oceania,19,1932.19
3c3b154ce29743349b602e7410d2a6c6,108,71,37,Africa,22,852.02
3c3c3bb9bc1a49b383c5c6649602f440,80,53,27,South America,16,858.85
3c3c5e08d0d34d9c83dccae0d0ca623f,82,52,30,Africa,23,454.29
3c3c887851e24c7eb698ff34f0e41ece,237,196,41,Africa,25,1346.16
3c3d51eec4164f7d883df390852313b4,163,102,61,Africa,22,635.76
3c405bf673d9416192b72a967343dba3,101,63,38,South America,22,361.4
3c447404de5d4a4692aec1a3bf0aa3e9,306,261,45,Europe,21,1529.9
3c461eada6ba497e9668589d18b66f33,339,284,55,Asia,17,1889.97
3c4970fe31af4ecaa824d350a4600703,233,203,30,North America,17,1995.35
3c4a0fc5b2aa4d6bbabf6853b7d2f68d,326,272,54,Oceania,21,1120.13
3c4a2d8b2e5a4f51b6318a06294c4229,168,135,33,Africa,22,1566.91
3c4bc57b37e7466c9e884370572b4446,288,238,50,South America,24,742.95
3c4ce2fda820407c9cc17b56b4b1352f,157,125,32,Europe,20,1116.05
3c4d036a6a1d4ff08d1413904ab88bce,163,123,40,Africa,22,670.73
3c52fc7c36c747b5ba508676093c3677,292,231,61,South America,23,1693.39
3c5309fd61064c538d6f02655db7e033,364,345,19,Oceania,21,2438.68
3c549a949eb441479cb684adeaaf566b,227,200,27,Asia,19,1674.01
3c554ac696ff4ec09a9f27eac9f6b058,125,73,52,Asia,20,621.53
3c56e43f0c9d42079ece616f6d87c101,277,242,35,Asia,20,2350.09
3c5a069a82a340e298a58e4120f918a7,95,71,24,Europe,20,563.97
3c5b7854ce504f768937025c6c2876ab,133,96,37,Africa,20,882.48
3c5ba96763424e908f4064ff39e63a37,333,295,38,Europe,19,2208.05
3c5cb045b44d43ca852f178c4ba459ba,365,336,29,Asia,21,1885.26
3c5cb11cbd4946cd855cc6dbf78667fb,295,240,55,Asia,22,1163.92
3c5e4dca7f94424a9baaa636a368c21b,87,60,27,North America,19,775.23
3c5e91c6c0ab48e6aa2da516606a9a10,343,295,48,Asia,14,2508.74
3c5ecdcb50d442b69ec6378d9a1375e9,251,232,19,Europe,21,2745.77
3c661aca50484a4082d04391bb6ea8c3,53,4,49,Europe,20,330.29
3c67e70a4f2843848db2fa7d478a4edf,88,62,26,Oceania,20,871.12
3c68481549ea4ec4847ca08bf7278126,329,311,18,Oceania,21,2474.22
3c69cab8f5604e5d8a8c004808dca6f6,77,42,35,Africa,20,456.06
3c6c74037cc54375ae1d16384102e172,170,139,31,Europe,21,1062.03
3c6d2f017b8d4710b8e71dc847e32a08,283,238,45,South America,24,1481.93
3c6d49fb450340c3a5aa6714521fbe8a,323,273,50,Oceania,25,1977.16
3c6d9c6370d14ffba24d89c091a8eddd,116,95,21,Oceania,24,783.59
3c6da69dbbb943b881f2814aa1258bd2,192,172,20,Africa,20,1343.84
3c7290b2561047d584ccbc1a70803d7b,315,256,59,South America,19,1555.46
3c7546d9bd92499cb9b8253372c8e174,361,316,45,Asia,18,2302.98
3c79e9da9054435f9295ff89f43fee08,316,256,60,Europe,20,1281.52
3c7c1867f4394657a6aa9921dc93e23c,241,219,22,Africa,27,1941.23
3c7c91be5dfa45b4b06b67bf7bed39f8,93,65,28,Europe,17,331.25
3c7f1044f7fb4a288f32a8ca6534669a,265,230,35,North America,19,1301.16
3c815dc7ec9e4b6ea1d085f0b7f67e29,205,174,31,Oceania,22,1250.38
3c824fb7451441558ca11b98481ac952,364,328,36,Oceania,20,1675.74
3c82db073068475a824dfe31ab64cad9,133,105,28,Asia,17,1016.06
3c8547d114634bd4b034dd643e0ea8d5,198,158,40,North America,23,1179.82
3c85a280ddf6459684c48309705c3cba,214,167,47,North America,20,910.93
3c85e03c652b49c7ac0eca26eb9a544f,158,121,37,Africa,19,900.7
3c860a1ff11b496cb7d6db0739b6750d,71,28,43,Asia,17,874.89
3c86edfb080d4fbf9edf2861b21191ea,321,302,19,Africa,22,2019.59
3c8831ac02404b36b879ce04e465eecd,79,43,36,Europe,17,703.09
3c8a0ee3a9da4996b070838815792e1a,282,233,49,Europe,18,1878.08
3c8a12318bcd4216ad4861bc60fb3749,299,274,25,South America,22,2290.44
3c8ebd653dba4a2ca111793230d92e2f,146,134,12,South America,17,1116.73
3c8f798b51ce43bf9e72f8ab01661343,142,106,36,North America,19,798.63
3c9158065eaa447296a5eb1a5584ede2,210,158,52,Africa,15,1244.82
3c96e52e1f9b4343a19627fb8fcccd9a,104,83,21,Europe,21,707.77
3c97a7725d9146a3a0ee740ecfd925b5,172,155,17,Europe,23,1434.69
3c982877d350466c8aa79aee6c22faf4,197,143,54,Oceania,17,1052.96
3c9979a3dff844f1b1cb3a9f1dd648ea,66,26,40,North America,19,326.61
3c9c8a525e67428a830fb8f442b8af04,56,22,34,Europe,15,105.98
3c9cd30fefc94256bd0cf16cfad396a6,100,58,42,Africa,16,342.08
3c9e343b50ee4af4815104906ee51d88,360,351,9,North America,19,2964.13
3c9fcbfea13a4645bf1e28a7bb01294c,289,247,42,Africa,18,1586.01
3ca1712807e948e4bc5a6949b31a9db4,136,108,28,Europe,23,1084.47
3ca1ba4514684cf2a11e0ddeffae5567,101,84,17,North America,23,990.15
3ca1bf22ab91418494c4ed49310e5879,58,13,45,North America,21,327.88
3ca48a320913444ea93baf431537ad1c,362,356,6,North America,18,2257.09
3ca72c5c365e43eb9b8679f7f511017f,266,234,32,North America,19,2103.7
3ca7ad1d9baa4c9eb93b3b24b32b52a4,167,141,26,Asia,19,1343.56
3ca7c98166424b5fa4d2b46fec8f1bd1,365,353,12,North America,20,2710.23
3caa63645e7f4ce0993bde73f8ce8f70,261,219,42,Asia,20,1277.98
3caae17fdf7e483a9657b86d65266fad,363,326,37,Europe,19,1643.68
3cacb2c3790f43fa9716061d1dce8941,317,285,32,Europe,20,1894.91
3cacf4ab60d9482388846f721387e549,63,19,44,North America,16,456.43
3cad5e969c6b4d45ba4906992a594cb8,112,80,32,Asia,20,815.7
3cb2aafa71584d1f84b24dd1febd4d24,153,119,34,Africa,23,1144.8
3cb74b3b17e943e3832403213da7a8cb,171,151,20,South America,16,1877.94
3cb7e6dfd74e42d2afa9d41dd6c8417b,355,299,56,South America,18,1762.54
3cb923c23ff848998dd090d68cce9e5a,129,71,58,Africa,27,823.28
3cb92ea68dc74361a22a0e7ffd6a2bf9,216,167,49,Asia,25,1297.57
3cb9438f59fb488bb66321b174a14d86,209,172,37,Oceania,18,1877.37
3cbb6e528caa44c391d65763ffae8e57,324,281,43,Europe,20,1742.58
3cbbd5a837df490a9c56044eca6e7d54,354,302,52,Africa,15,2055.97
3cbdecb7294b4e0580caf06206a44794,180,144,36,Africa,16,1001.66
3cbeaf18efca4003a80ca48d1f65980b,97,54,43,Europe,14,685.53
3cbf163fc7b54eb9a1ed322082e78e6d,292,276,16,North America,15,2522.28
3cc0751db7d54e8ca9045669e698b03a,258,228,30,Oceania,17,1606.42
3cc12f7026aa4dfea63d620cccba0bec,81,53,28,Africa,13,577.67
3cc1be6e9e7e49e68b95eafa8c25752e,101,63,38,Asia,17,575.71
3cc1cc2146d44949a4926276ea959f97,122,97,25,Oceania,19,1032.26
3ccd027ddc684a14bd20562666d14232,67,23,44,South America,21,369.39
3ccf8659fb134b01aded313229450b73,210,160,50,Europe,20,1070.92
3ccfd25f02e24e10803b862680bd4a8d,364,361,3,South America,15,2114.63
3cd19bfe439d48629f87a46089f55fb9,365,339,26,North America,20,2362.36
3cd422600ec741468449fd90ee64a8a3,147,111,36,Oceania,16,1065.73
3cd522e5cf914f6a9c781a3b185e8739,365,351,14,Europe,23,2727.31
3cd73d68c0e94ecf889a155c5e18e5f7,332,315,17,Europe,22,2790.64
3cd8da2c003f4b2a9f6de888609672c4,170,145,25,Africa,24,923.62
3cda1a5ff9db422788558ae7362eda14,249,221,28,South America,20,1705.9
3cdb3671ee5d411199e9a71e0d3d1a80,332,295,37,South America,24,2036.58
3cdc534045094ec7a6e4c3d86a8f16b6,365,336,29,Europe,22,3862.41
3cdd28eda8c64ee4827be1ddd2462c71,163,116,47,Oceania,23,535.09
3cdd54ed18b84c38b786042dd516da86,365,363,2,Africa,20,3040.63
3cddf3d40e3f46459822cf05aa30d0e3,210,178,32,Oceania,16,1899.5
3cde3a0be7c645ecbdf3a93f784baf7f,144,112,32,Europe,20,1133.2
3cde7f4024f74aec88c4188deebdfa32,197,172,25,Oceania,18,1388.32
3ce0d40cc4cc4d2091a9ca40ac22bb0f,62,17,45,South America,23,281.72
3ce308af16404e779f83e88ee171571a,201,162,39,Africa,25,866.9
3ce3b2f2713d4fd797d4a5b2e258a481,309,264,45,South America,17,1720.87
3ce3c891f96841c28838a22697321b7a,239,201,38,Asia,22,2279.14
3ce65288490344d895f7ba81c6bf1939,318,289,29,North America,22,2214.41
3ce66ba226b7441e8b7d0ad000c661ee,210,194,16,Africa,22,1301.96
3ce7af95739e4ae0ba736fb125fef44e,303,265,38,North America,22,2096.59
3ce9b25dc5ba4f04b48608719b6ed373,362,332,30,Africa,20,2284.13
3ceac2bba24d465cabf5da065db8ae09,364,347,17,Africa,22,2583.93
3ceac42f684c4810b46062f5b3e79216,261,232,29,Oceania,21,1691.05
3cec389d365f40ed9eb44ef860d64634,334,291,43,South America,22,2114.06
3cec393447894bea93c4f63942b9f195,292,264,28,Oceania,18,2231.85
3ceec996ae5c496db452793819b0a758,175,124,51,Europe,24,809.66
3cf02e4141f448f583dde179704e7dc8,60,39,21,South America,22,530.86
3cf1277f87d442339b968fe136ff57c0,188,159,29,South America,19,1518.19
3cf2630e22614183981e11206a20a9ff,256,210,46,Asia,21,1565.86
3cf48b1e12cb45cbb3e5a1947ad5998a,109,82,27,South America,24,869.64
3cf4d7e5b1ce4dda893dc7ab6222eb5a,237,190,47,Africa,20,1633.82
3cf73941c7134d178781fe7f4e87cc0d,240,204,36,Europe,16,1271.35
3cf80d2ed0a8478183deae0c392e87d2,118,100,18,Europe,18,1110.23
3cf82de924cc455b8c75321983906707,228,192,36,Asia,21,1339.63
3cf89de0664f4d03ae9913af798c905c,294,265,29,South America,20,2183.77
3cfb6db8e3674e069c777d88d5d7b6ce,258,216,42,Asia,20,1759.52
3cfc463cbbe947b2ba844747de32850c,365,322,43,Europe,22,1711.13
3cfebbebbddd4f6f9290c95193c43ec6,146,113,33,North America,22,744.71
3cfec64e2dc64428b44f709f7737bacc,151,103,48,South America,25,350.91
3cff87d76f8a4740a3a70c83362bc58d,140,108,32,South America,23,1564.86
3d017daf44bc44ad8ba23aeabd2e7b60,142,120,22,Asia,16,956.91
3d044efd045946d4957613dc5d9346b0,251,213,38,South America,28,2031.13
3d05bae18e94435aa5c42f89a73ec5dc,103,70,33,Asia,25,1035.36
3d089fcbbb4a48bb86435e93c8baee80,225,189,36,Asia,20,1373.14
3d09120a31da44f7a028587627941c26,89,63,26,Europe,25,1113.78
3d09bd3f35ff4a4694d2fcb4c706bc5e,350,304,46,Oceania,17,2097.29
3d0b6b9c251e4028b70b383474c5d1ef,324,298,26,Asia,17,2542.14
3d0b7a7f2a4a49c2afd2c1f10c63ba0b,81,40,41,North America,23,459.6
3d0bae13c4ad42eb934011cf96d3d85a,153,107,46,South America,20,1261.87
3d0c513da43544a3bed314cf7081e363,80,42,38,Asia,21,655.91
3d0cf103d8c34303830cb5b8fbca4534,111,76,35,Europe,19,612.25
3d1230bb61c545bb925215970204b992,287,241,46,Asia,20,1435.81
3d13eab92eec47bfbb519b90c24f908c,139,111,28,Africa,22,1204.5
3d14ba28ad7b4acf8edf9120a5250455,172,128,44,Oceania,23,864.75
3d16aa83b670431a965e8e3685565f52,58,18,40,Europe,23,349.28
3d1726977da34c25854042c880d42bde,348,319,29,Oceania,24,2664.08
3d1a2fad83ca449c9ef754983410e7dd,98,72,26,Asia,22,1213.41
3d1b50b1dd3e485297d55f5f4ea747ce,280,250,30,Europe,17,1832.14
3d22a39ef1384fd0bdffbc01567b064a,262,235,27,South America,19,2362.87
3d297bbaaa0f4e549d0a4bce42bb60d5,360,304,56,South America,21,1403.49
3d2a17d9e33b4851b438b4b9f841f207,364,348,16,South America,16,2547.05
3d315f63aa6142c3bfc5e03e913bff9f,323,289,34,South America,14,2416.43
3d317e0e6e0a4aa68465bc048da7fb7b,43,5,38,Europe,17,250.3
3d32d2953cf946edabc8f7656e3552c0,112,64,48,Europe,17,494.77
3d33584d006042b0a492f0cd354431f4,316,296,20,Africa,16,2420.56
3d33d19e00b24b318d9dc86f02b11c79,329,295,34,Africa,17,2064.03
3d34154f2e4c4579ae7298d3a557fddc,249,209,40,North America,25,1670.78
3d34ba6534894b14bd2445f2c4d8b268,365,345,20,Africa,14,3136.56
3d356fd2ec8943d08884223fcd79f1ac,160,121,39,Asia,25,1499.05
3d362ded12654e95b07442e338273149,253,230,23,Oceania,20,2182.23
3d3c7b07bf8c42359b46a55eb74009c0,247,189,58,Africa,19,1545.22
3d3ca81095cc4a8db35711f5750da38c,274,260,14,South America,17,2249.7
3d3d9c7c6e30472a98d40b566dff1379,345,299,46,Oceania,25,1309.97
3d3eed30380340a1910d78d981855769,301,265,36,Asia,18,1953.88
3d3fad2fb87142568023bba13afff877,118,75,43,Oceania,21,383.98
3d3fcf300bda4eda9996732172b11eea,365,344,21,Europe,18,1747.36
3d40029522624236ab0cd60effe859e3,245,191,54,Europe,24,1205.31
3d421b7438434c60bacd9b3aa7ef2cec,36,10,26,South America,22,512.94
3d445765fea44039883a8b4cb30dcad9,97,69,28,Europe,23,1019.88
3d45925f9f7647b1af3051a00d96b44c,207,180,27,North America,18,1033.99
3d45f692acbc406fbf610ae26003204e,96,43,53,North America,17,391.84
3d46a7e7dda840c19f5498491c0ee7c7,169,120,49,Europe,21,567.79
3d46efed431447a58de4b3dae28eaa79,290,247,43,Africa,20,1363.73
3d46f9bf62d5457fadaac100717262cb,282,248,34,North America,20,1734.94
3d49846a68d0481fa5af6c7141e4ecf8,113,95,18,Europe,19,890.28
3d4b8eece8d141eb8a0ba5f4b7fff789,73,17,56,Asia,19,247.6
3d5072490c074256a2aed2cc8e8587c0,348,322,26,Europe,18,3194.19
3d511981d08b4adc9de9a7ecba026bc6,308,282,26,Europe,17,2206.65
3d51f2ff4d1d41ea8973bad75fff4882,260,222,38,South America,17,987.9
3d523503dea04e23bf1bfd2199d16fbf,365,362,3,South America,21,3481.81
3d526ec72e6e42dba6cf21d9671585c9,273,220,53,North America,20,1231.67
3d52e304cdb247b8a05f5109403cb945,150,99,51,Europe,23,763.47
3d54b36b7ac04ef881c9b7afc12a6939,267,220,47,Europe,25,1955.19
3d58963e31b849788eeefec8dc35ee05,363,332,31,Africa,17,2071.37
3d58e0f676614644bf79ef0df88ae1b3,365,325,40,South America,23,1665.83
3d59ae3870ec4155a49bc4dc3f54b652,363,325,38,Africa,21,3031.57
3d5a7af5ca8d446197677af9dea29290,123,96,27,Africa,23,532.31
3d5ba4474c4c4cb6be0822b3fc5243c6,365,354,11,North America,24,2335.99
3d5c54ae7bfb41dbaa5a06bee1d99af3,352,325,27,Oceania,21,2489.14
3d5f9fa13c034eb1adf68d00aeedbb42,173,137,36,Africa,23,1468.09
3d5fc53741c042cab2183d611478c023,126,97,29,Oceania,16,775.62
3d5ff0eda80141dfab9ab84dbae3f84a,175,113,62,South America,17,685.54
3d60fc5a9c474173ac97a202ed6a0cfc,241,220,21,Asia,18,1348.51
3d61060396e942b399636720efb840c0,360,328,32,North America,25,2939.52
3d6379b91fe1413abab079360b153933,364,361,3,North America,18,2123.67
3d64066861a24feca14b19b1281abade,151,112,39,North America,21,726.55
3d64ec021efb40388f2a8b3a9aa6b0c7,111,89,22,Oceania,23,1166.35
3d652416813b4b55a608a3bcd1629644,303,275,28,Oceania,20,2326.95
3d6bc71592404a949ca7a787600a62e0,264,214,50,Africa,18,889.12
3d6eddfd01584d04ac9e5cfe5119c8d9,243,210,33,Europe,16,1626.36
3d70732d4a284bbdaa3bba62d3058de3,176,155,21,Europe,19,1087.9
3d72a38d6dfe42f7839d1b1073cf1578,228,181,47,Africa,24,1380.69
3d7382ca8c464453ba9daf5d122be301,355,324,31,Asia,19,2507.11
3d73d08994144af4814f14cfb258156f,342,304,38,Oceania,17,2131.04
3d751ffcc4ff4cec87e39e3dd027403a,81,46,35,Asia,21,346.74
3d759cbf1f20455ebfa4fc75c5aaf7e4,363,345,18,Asia,21,2952.62
3d7636a6a5d3462d8bdc992aab75787e,144,88,56,North America,22,843.71
3d7c44daafb447148e54aa4bb11a6e7d,137,107,30,Oceania,18,1411.52
3d7c54aba29e41d6b67effbd63463083,332,300,32,Asia,18,2688.69
3d7d45078b364490b776fbd4f02260b9,363,317,46,Oceania,17,2053.65
3d7ea5875fcd4382bd859f8d717fa114,235,198,37,Asia,16,1634.29
3d82ac2c9c07482287780c4353c1fa3c,315,270,45,Asia,22,2888.65
3d8301c7df9043ed8add978e727d4699,364,334,30,North America,24,3329.21
3d834dad29ef4487b22a0411888f56eb,206,179,27,South America,21,2599.65
3d837100fcaa4361b9732b0fb3f09070,252,200,52,North America,21,1962.21
3d83cf58e1cf42e1b8a876636928355a,365,338,27,Africa,19,1811.59
3d84bb027b7149929ee8a4b32163d65b,150,107,43,North America,24,933.73
3d8a04634b924a5d972a8eebe4b8cca4,127,78,49,Africa,22,1209.96
3d8a30b2a4be49b09dff30ad65e04252,150,102,48,Europe,17,783.84
3d8dbddc4324433eb87dfcf284f662be,261,240,21,Oceania,16,1891.57
3d91fe7a307e4750acf0db98646ffd5a,57,27,30,Oceania,15,363.29
3d93ad35bac741e19f43dfdd6d481dff,240,200,40,South America,20,1627.43
3d94421fc9ac4d4a93c21c6763c9adea,228,177,51,Europe,18,1284.63
3d94eba59b2e4c948057bd627c199989,355,322,33,Europe,23,2263.8
3d954cff90df4f5b88ca9759ad34c9c0,320,291,29,Africa,23,2275.24
3d955b914b614573a0aa358e67c95ba5,359,347,12,North America,22,2515.05
3d9573735a714eb38ef20ac61a0093da,365,351,14,Oceania,23,2256.33
3d97e385df2b4c109c0894b013658117,193,169,24,Europe,20,1800.06
3d9847ebda08446995187e6f488b9e7f,87,24,63,North America,21,508.69
3d9aa688d626498f9af1e35ad4d22cf4,157,99,58,Asia,16,656.64
3d9abc7be3a941a0b2166379320b12b8,212,177,35,Europe,17,2059.01
3d9e47d1c7c54a0bbfac092e0b194eb0,286,227,59,South America,22,1280.26
3da0b4b8a1664eb18625874d2c221773,34,8,26,Africa,21,248.29
3da1670db5734a72aa90cdb7b64d9adf,61,13,48,Africa,13,474.99
3da22d3f13b148a1ab192a15df84d1a5,241,192,49,Oceania,24,1165.21
3da3bbc1c6614c09aa1eecd7eb43a24c,346,317,29,Africa,16,3244.59
3da5b8a1e0814b9fb3c57b4e2c58a56c,290,263,27,Africa,24,2924.83
3da652996c564d75bc5bc693e9dd831a,354,311,43,Europe,23,1958.02
3da88ced1c864aa499f8c60ef0d8c28b,261,233,28,Africa,14,1892.91
3da9f94f4f8247f08dcca0af9dc649cc,38,6,32,South America,20,155.63
3daa423ec13441859de06e8f0bb7491a,154,101,53,Asia,21,876.04
3dac607f369442c895e84858e983c97c,116,91,25,North America,20,1314.59
3dad3a03cb4b41188fefe1cc0a259a56,241,209,32,North America,15,1470.69
3daf1d1582a3457fb87db6ee80da542e,125,68,57,Oceania,20,765.44
3db18d5219584a5aa7b1b4f9d62a3995,173,130,43,South America,15,944.33
3db1993b790143f49ae61cf6a38c7f67,114,58,56,Oceania,23,617.77
3db337f35de142da8c868fafd3b4789b,209,170,39,North America,21,1627.28
3db5cc48cdcf49b8a281d4410937497d,159,137,22,North America,19,1071.17
3db5e0ce3d7b40558eda8d417c513180,277,222,55,Europe,19,1458.13
3db6176a5a854fc7a2a433891702879b,325,295,30,Africa,19,2207.49
3db8b0da091245de9757181a4607464d,267,213,54,Africa,20,1405.02
3db8b783bbd84152ab68f0ed8aa2fbc1,362,349,13,Asia,25,2069.75
3dbcaac11a6643f58d6e8eeb3d16396b,99,70,29,Oceania,19,927.16
3dc2b1b2a419438cb3d90cbd06ee58a5,318,271,47,Asia,23,1549.48
3dc4f4c072c74bf8977c2f024b8adab4,99,61,38,South America,22,895.72
3dc64db7984b49b3ace8c83a5f0806b4,242,219,23,North America,22,2268.3
3dc92dceac8a48c3a733d636d91d032f,341,291,50,Asia,23,2452.03
3dca42fd5d9a4ede9dcc0e31cbe23ba7,273,217,56,Africa,18,1483.07
3dcc3cc380b34fa4bd56b6ba24329ef0,231,210,21,Africa,21,1599.14
3dcc9381242e4c23888bbc6fd6bee43d,147,101,46,North America,20,1632.17
3dce595929bf4d74abd6e36de7f51815,271,219,52,Oceania,20,1526.34
3dcf9f04391642aaa1794301353de4c7,365,342,23,Africa,22,2275.45
3dd13bef9dd5465db7a9d22f5de3a26e,148,123,25,Africa,19,987.36
3dd5745f7d2245a09359f41ceaa09ef2,272,248,24,Asia,20,1807.87
3dd68581e34e41bb9c70792bf70ebd23,238,186,52,North America,16,1594.69
3dd764b89b1f407a922e3d48c0dbb2f9,364,330,34,Oceania,20,1169.26
3dd7fe593d204d61a18875af4d6c0f8b,276,225,51,Africa,22,1370.72
3dd915bf409241a09414b98f9adf933d,31,5,26,Africa,20,184.48
3dd96ea1e832488aa359c9604e022976,272,234,38,South America,22,1543.21
3dda1e8d457a42a6959c1654f8b042cd,160,109,51,South America,21,652.23
3ddd4b78c3984ac4aa6fa8241359259c,128,74,54,Asia,20,619.99
3ddd4e41df7241db9b2cbffde27278a0,69,44,25,Asia,19,657.75
3dde349492304505be8f475047e5a015,334,279,55,Asia,18,1805.3
3dde3e681bc54b8ab467e19e08047fe6,260,218,42,Europe,18,1123.75
3dde999a82e84743bd6363a56f0d92fb,238,189,49,South America,17,1045.91
3de215036aa24321b43be05f9a118f88,356,325,31,North America,19,2519.42
3de4454970ef4606b66dd4ef48155fcf,92,63,29,South America,19,1012.14
3de6211d9a93453882f09426d467c289,292,264,28,North America,15,2416.55
3deaece2080a407088fbba97ed5840a4,130,91,39,Africa,21,905.54
3deb0d39c25e4c1ea7df2d92d701b99b,364,360,4,South America,20,1895.21
3dec50913bdd4d98b7d639dce17f8d6c,365,330,35,North America,15,2917.41
3dee82fa00fa4352a1fd45ba966a8f6c,150,125,25,Africa,14,1213.61
3def891a4bab43d49e25540b44100df7,187,146,41,Africa,23,1263.01
3df003ab8b37470c9f4575b83a22e274,114,82,32,Europe,24,728.96
3df3b92207a9426fb93a701c9d383b55,164,141,23,North America,24,1500.98
3df44c118ab247468f8a6bdbe5127f5e,365,339,26,South America,19,2236.46
3df5c4b36e3345ca8907b56d9a824fa5,236,180,56,Africa,23,1356.26
3df6e40efa0449669a03947df7c6eb9f,319,285,34,North America,19,1404.99
3df7fbb75ab046d88d7f36fa607a5b35,81,32,49,North America,19,249.39
3df908f06b4b42e786a9408ddad9ab80,193,145,48,Oceania,21,1216.42
3dfa30a25f2846e8a784c451ac3fbbaf,321,275,46,Asia,21,1446.2
3dfa9b8e68354d739620c4c8535e668b,57,17,40,South America,22,444.15
3dfae6b17d1f4a7aa9a55f888bd4059e,308,281,27,Oceania,16,2939.1
3dfc253838474ac38863dc11da8485eb,287,257,30,South America,18,2384.28
3dfc5774ac994796b22c98959b70ad8a,157,125,32,Asia,20,1346.48
3dfce2c22e2c4448adaf19812f3d193d,200,178,22,Africa,20,1247.88
3dfd15189b6e4da2a2563c72128f2558,362,317,45,Asia,22,1564.84
3dfd824736884ec98a3a9dc1aa64e250,103,78,25,Oceania,19,300.2
3e002db2c4514802a3c171bacb83229a,162,135,27,Europe,26,1307.05
3e0058c6dc464d75aff5945a83b9dbd0,38,3,35,Africa,18,489.05
3e014d73a63943a583e19146c1f913a2,341,304,37,Oceania,24,2348.2
3e0548fbfff64e3bb97b8b26682bc0df,292,249,43,South America,28,1586.36
3e056ee331f94a8385b5d8c3cd375b7e,261,217,44,Europe,23,2620.26
3e05bfd85dad4a2b8cdd67cc2f629dbd,62,19,43,Oceania,21,652.65
3e0659969af64ffaba4156c52d576d9a,238,186,52,North America,19,1048.32
3e0755c7b70f4dce9bf90412a2a1e5df,193,170,23,North America,26,1709.68
3e08432967ee433ca35487de16d5c79d,68,33,35,Oceania,19,838.82
3e0b023b74364d43af4d468f71b43660,215,171,44,Oceania,20,1812.13
3e0ba73ea2084d52b7260937dfc1a048,338,309,29,Oceania,20,2800.35
3e0bca1602b34e878a5b096b752f69e6,172,132,40,North America,16,1420.8
3e0be2b9962f437dbfcc01f15383afc3,254,225,29,Africa,18,1746.61
3e0d4fb20b7a4067a268ba030b36480d,196,158,38,North America,15,538.93
3e0d726fb8f14f5babe3f2179bd923dd,285,244,41,North America,16,2003.24
3e0df15edbc64d8dad583fcd896975fb,303,286,17,North America,21,1775.76
3e0e1508ba214aebb66b80a0acd8bf50,304,255,49,Europe,23,1503.77
3e1039edd2424b2a83602cc6ca723c16,183,156,27,Oceania,17,1269.4
3e10784e42304fa59df14a6ca742df35,364,330,34,Asia,20,1797.75
3e10a06e039a46048d28918951009d8d,243,195,48,South America,22,1043.68
3e15c52a0ebb4fb1a65eca0aab6707c3,194,149,45,Asia,23,1000.87
3e16a5e82bd4448e9a91109d8548d11a,259,227,32,South America,21,2000.98
3e1b0e4cdb73484d98c7af49877b2ca5,246,204,42,South America,18,897.17
3e1c5cf197f7495d9acdff84d013493e,354,318,36,Asia,22,2837.75
3e1cdbb804dd431f9f3c7e0de99d3229,277,249,28,North America,17,1767.74
3e1d2fd8c93f4c5080705937a5f1ecfa,365,343,22,Oceania,20,3209.42
3e1d4516d9c043cca9f82cf396784da7,313,290,23,Africa,15,1732.91
3e1ee2d40ba944fd89eaa955c890a2ca,351,307,44,Africa,18,1637.64
3e1f7df3c12447d5a70babafe02aad17,288,249,39,South America,20,1712.2
3e20eea4d594463ea89ee370d0d4108d,302,274,28,South America,24,2185.98
3e22ac05fd1a43f0a7b367aa5689ca63,328,280,48,South America,16,1462.17
3e2351813800491c8f9f9d4f68a47d39,57,10,47,North America,13,502.67
3e2378d2ed024370b154ef781ea4e450,143,103,40,Africa,15,1084.03
3e250dbb8abd4524a502a2fe0522c69f,265,213,52,Europe,22,1598.34
3e25da8ea3994591aa0d8e46f872125c,318,304,14,South America,18,2456.34
3e285ef571b24faab4a68d851cedf86c,181,161,20,Oceania,22,1480.6
3e2923f8a71c443a96118ef438a6f3d6,217,194,23,South America,20,1456.2
3e29a56b5ab741efa36f491383c01c9f,170,153,17,Africa,19,1601.48
3e2bd239ff834b3ab318a33570e214ad,365,328,37,Asia,26,1336.69
3e2dadb82e554221bf05b76bfd877dc9,141,98,43,Europe,19,1000.7
3e2e4d49487f43d782fa665734996db3,195,143,52,South America,19,1214.89
3e2e7f0aae5745578b05c97a6cd10ac4,33,10,23,Oceania,19,287.99
3e2e9de3063a41f28bf71a77dca7022b,62,13,49,Oceania,17,290.58
3e30cfe9938b4c27b14187347aad99aa,67,40,27,Asia,20,459.21
3e3191a4cc6f4e7eb9bfc4cabf09768c,177,162,15,Asia,17,1553.85
3e3458bdfba744b7b02a509ae90469df,178,129,49,Africa,21,1306.69
3e34e7ff6fa042729beae893095158fd,203,150,53,Europe,21,1077.24
3e35ad6ef10c4f8baff20b3e1e7084a7,345,322,23,South America,22,2945.28
3e376edd021846fdb00c969bedd19cde,332,286,46,Africa,21,1374.08
3e38cc490dd64815a39326069b08a451,120,64,56,Oceania,22,709.69
3e3915fb499f4f34944b6dae99ae9084,129,70,59,Africa,21,785.1
3e3a54ecce0b44c1b0b327dea6011694,100,54,46,North America,21,1011.59
3e3a8465859c40b992e98f99db7b6c08,312,252,60,South America,20,1927.25
3e3ed23e20a64ae798cc5afd0bd33e85,234,203,31,Africa,21,1976.65
3e3f5526508f48f1865724699ee895a1,295,269,26,South America,18,1957.21
3e4049c8f5564194a5b7394d91c0d6c8,287,259,28,Asia,19,1817.36
3e42b428c3d749c98afd92264086b51f,272,219,53,Africa,22,1065.29
3e42ef25706b4745b565c31662b9d18f,265,245,20,Asia,20,1991.58
3e45eee490454d3b9e4fba3bd1589634,116,98,18,Asia,21,1119.4
3e47da55ad704718bc4b60e341a48f38,193,165,28,Europe,23,1119.54
3e4a46a9cbd449e0b8d2ac67bdec0043,232,182,50,North America,16,1080.27
3e4ac6a2e0e34beca876053e67784a4e,139,119,20,Africa,23,1135.36
3e4bf0a0ddeb4e76a7ba385361a21453,233,210,23,Asia,21,1765.43
3e4ce7c1137342a48dcd6840bf8988a9,110,91,19,Asia,21,1051.84
3e4ddf9647a44ec4965d46d30ec87a01,56,34,22,South America,20,437.24
3e4f652a0a3f496080f9b110d92d263f,45,13,32,Africa,21,218.56
3e544c30ce684dea8a75afbb16a4d7f7,285,262,23,Oceania,21,1462.05
3e5450f9e0af4f2e868543f89a37fa3a,89,44,45,Africa,29,616.02
3e5aa14879d74274863718f095a2f321,338,288,50,Europe,18,1236.01
3e5b79d957674c40ac1aa958573bf12f,354,297,57,Asia,17,1932.34
3e5be437740b407eb0951ed905278b62,328,281,47,North America,18,1841.19
3e5c2b5abd434806ac74d7f3e674d172,50,23,27,South America,17,721.67
3e5d1efb1be5449597a4bbda4220465b,306,278,28,South America,23,2506.9
3e5d92e067934f3b84423db0cb9b06b7,95,55,40,Asia,21,597.83
3e608b4431fe45a4a62bc01f911b2272,202,157,45,Oceania,24,1082.94
3e624bb9565e4061a78db698b37a8bd0,136,84,52,Europe,24,651.73
3e62ce71ad6e4e5bac181a92ea93ef0e,352,329,23,Asia,19,2367.83
3e6314e6b5f546789a439443fc72d538,267,231,36,Oceania,22,1801.6
3e645a44ff9142ce900c64a3a58ce3b1,254,223,31,Oceania,16,2082.39
3e64dd2852a242bca1acebfcc39273ce,61,12,49,Oceania,18,360.36
3e66f3432de749f697e9300acc771c8c,209,193,16,Oceania,19,1355.22
3e6790924b8140d0bfa429ae9521bcba,148,98,50,Europe,20,363.26
3e69a8f98c19401b8d2d43039929e2c9,279,229,50,Europe,24,1603
3e6b82e29cd7404bbd2014807be8a2da,54,6,48,Asia,21,288.99
3e70c9a0b1154ea9939dd0779a70673e,310,285,25,South America,17,2579.75
3e721af31b26479bbc4a38edb90d36df,219,198,21,Asia,19,1748.29
3e7233e1b9e94d3aa3282c80553cd312,365,361,4,Africa,22,2214.81
3e725e7a539149c8939be36d58ec6209,323,287,36,North America,13,2164.46
3e72e48946af484e8f0052e8c9f0ce55,166,120,46,Asia,24,814.71
3e76ccc62fe04c5ba75d7e723cac10d2,69,14,55,Europe,19,463.17
3e76e0b6058a4a71b300dc56ba56206f,270,242,28,South America,19,1592.08
3e776c24b15f486cad01b8518ad5aca8,217,188,29,Asia,20,2035.81
3e78664ab5444b738cdf6b37a4515c2a,175,144,31,Oceania,23,1300.75
3e79b288fc8b4046919441152599a9da,47,3,44,Africa,23,164.92
3e7b58d1ba064759901854c9e804ab3a,31,7,24,Europe,22,480.18
3e7efcbb5dbe4394b237c316acdae0b2,281,233,48,Oceania,26,1512.98
3e818dff3c164d07b5ce5ce0d713dc28,303,258,45,Africa,16,1492.26
3e81eed39e0642f6855d0d289c835fd2,365,362,3,Asia,19,2148.31
3e83935b625c42bf8c7735b4b5033c12,93,71,22,Africa,17,964.99
3e84cace6000413aa9569fa8b7af2e72,41,9,32,Europe,18,227.04
3e8686b52b44428ba52e92619d738608,83,39,44,Europe,17,576.9
3e86c391a076467c923e990a5526be92,313,283,30,South America,18,2076.95
3e86e5e2d9084840b36a0cc31ff654ce,106,82,24,North America,22,735.4
3e88cb04b6a54eb98749b00ae30dc99b,58,21,37,South America,20,676.97
3e8a4f18b42d4c4ca705742ea8d5bb7f,77,40,37,Europe,20,749.86
3e8b2462307f4992b9ea0854646ac122,149,113,36,Europe,20,1025.94
3e8e3fce765d493ca98b7cfade5001a9,269,246,23,North America,21,1654.97
3e8f1d9d77ad4d0e813bd6dd88988749,304,273,31,South America,20,2227.35
3e90de3677d74938a57074ce4c6589d8,364,334,30,Oceania,23,2492.11
3e9211bf3c4a407097bfb8dd8d60e657,364,352,12,Africa,18,1253.57
3e955fa1dd9a4352b2063c6d0908fe45,350,309,41,North America,19,1951.25
3e974ccb3e5a44ffa99fede6edfba481,191,139,52,Asia,13,1207.11
3e97a104e96e41d0be6c8514f21e0c70,364,364,0,Europe,22,2232.47
3e97d1551d0842528ad2fe24c971905c,286,250,36,Oceania,22,2618.42
3e98038820b64a0bb5990b4efadb68a8,262,237,25,Europe,24,2013.81
3e9b2728ab614337aed3f396c9bae1e2,83,59,24,North America,21,588.03
3e9dd36bea834f8f8c9e451186ea2423,222,180,42,Oceania,21,2059.18
3ea6340944914799be798e3a8347cbfc,227,198,29,North America,16,1440.22
3ea7a447006f4cf2bf1676ddf3307b48,42,10,32,Europe,22,248.69
3ea85f11f6ef4a4b8f5cdc285b96d3dc,248,195,53,North America,23,1298.23
3ea8f3d6198242a69618449bba91a217,60,11,49,Africa,18,434.73
3ea99155cc84418789eea6e7eb31c66e,361,340,21,Europe,20,2462.81
3eac5d0bc85144dabc5eba7201e32e0b,250,219,31,Oceania,19,1707.24
3eaf3e4deaed4e848fa2f34acc2dcc20,341,310,31,Oceania,21,2561.59
3eafa3a215544a2498a8b3f5d8bf8ee2,365,334,31,South America,18,1782.23
3eb0785a1e8c497485d2de3612462caf,344,290,54,North America,20,1920.23
3eb0ac668d264c01989ad6b007a8566f,95,41,54,Europe,21,337.9
3eb0f0b1f1354f629d48dd8b6d162ca6,186,130,56,Oceania,21,1396.33
3eb2668d0c8947cfbd34aff524d7d7c0,224,178,46,Europe,21,1776.76
3eb33b550865481686829e4f3a89dad0,333,275,58,Asia,19,1621.24
3eb36567c6e541e4a1ae473a22907943,295,256,39,Europe,20,2180.12
3eb3d22d75574537b673f958671b6459,361,311,50,Asia,19,1975.15
3eb58bc4cfef45589decb232b9f80b26,363,338,25,Oceania,15,2177.57
3eb6aac8e7c148fd90fa7394656ee56d,200,162,38,Africa,19,1079.15
3eb6f35f0d634fc4a1c12e535c7264ff,237,203,34,Asia,20,1625.31
3eb7ec332ea0430abf191a098ffbcc64,154,131,23,Europe,25,836.13
3eb8d9e08bcb476b8d056b4485a61405,52,17,35,Europe,17,295.98
3eb9d761e5fd473ab480946885f671a2,151,98,53,Oceania,25,912.03
3ebdf536acb24a21adf2a9144f147aad,82,44,38,Asia,22,402.61
3ec221f880f348b0829e095f6cfb4027,130,79,51,Europe,24,604.83
3ec3fd5176044fe4bf9fac7e72c9be20,305,246,59,Africa,20,1308.23
3ec5abf8f94846a39597887762e6d87e,142,92,50,Europe,18,999.53
3ec8127b3e984e259659243ad3d8c5ea,145,99,46,South America,22,507.28
3ec9c19d30954eaca4eb7db9a57ea016,311,258,53,Oceania,22,1796.99
3ece151552fc4e63879ac3492408692b,267,230,37,Africa,16,1907.15
3eceaeb79c8545ca82980b1fa49677a8,100,77,23,North America,24,400.85
3ecf479de9e84f79834f2d155feb02ab,358,341,17,Oceania,19,2518.33
3ed256508afb43eb8ec08562a45769d6,220,161,59,South America,18,1008.07
3ed36863905147bea7ef70ae8a4a616c,161,133,28,Africa,22,942.41
3ed37c90377d46558a411cbd4b5f0aef,58,30,28,Asia,17,667.24
3ed47a457c064a0c8ab258df120081ba,365,340,25,Oceania,23,2538.34
3ed494de3024467fa377c98b30270da1,133,83,50,Asia,20,494.53
3ed9118aa64b42b8bc9fcd7a3772a4cd,66,29,37,Asia,23,582.3
3edabb11c4284f0097d90b9416d724f2,318,295,23,South America,21,2453.36
3edc0183b6204e4e976608b0cebe4d62,336,289,47,Europe,21,1762.45
3edc1c8cde1845abbd961303d0a4cb46,249,196,53,Oceania,22,1036.79
3edd317236034535a3bb34ce32ae607a,365,328,37,Asia,19,2979.52
3eddfd7bd18a4dee8f46215e233acd91,48,32,16,North America,18,179.43
3ee01599ae6444a6a1ff914c719e6afd,40,10,30,Africa,23,371.96
3ee05631e1484fe4b9e3d79b9ec07530,53,5,48,South America,21,206.65
3ee1f38b42a14014bc67245254277b21,290,260,30,Africa,23,2068.16
3ee414e6039d42b5b4f213111051d029,155,117,38,North America,24,842.51
3ee8ca493df94fc6afd75767e1bce7da,365,364,1,Europe,17,2303.78
3eef40e5dce54fcaa95c56fbcf04ed6e,51,33,18,Asia,19,370.57
3ef181b4615345dcae0f802f56a189d1,214,174,40,Africa,25,1084.8
3ef1a4b82ac242219fa35efd78677c4c,365,355,10,Africa,24,3404.28
3ef4cf4ae3ab4b6589fa7bd258405ee9,114,85,29,Africa,18,978.99
3efd02a7198e4abeb9f9ab7e8dc1af0a,297,268,29,Africa,20,1669.46
3efd1df4015942c486e48c20abb772b7,127,101,26,Europe,24,1188.08
3efe5e8a7d384d569fc7c261de1c8bb2,279,239,40,Asia,17,1495.44
3eff4bed073c4b07ba7ae0cf4e9d0f7f,57,17,40,Asia,17,252.9
3f002760a3b046b2bb3e78bb130c1a38,214,174,40,Oceania,20,1261.65
3f01b3a3189449ada17c2de535bc165e,365,363,2,Asia,14,1671.25
3f04b635d9ef4a60a035c215572e1ec1,364,340,24,Oceania,22,3503.91
3f0571a4c2144e499b637da015703691,103,70,33,South America,17,813.09
3f077fb154af4b6eb1de2bbff9b51ee8,199,170,29,South America,21,1485.62
3f08bba17bbb450fa20a18199a1397bf,121,69,52,Asia,25,594.74
3f093ab1fe694dcd925a8c9deed5eb77,263,216,47,Oceania,16,1379.02
3f095b52a3244f3eb4e6fde28d00b875,166,148,18,Asia,18,1222.79
3f0adfa7fa4c4268a9cd1fec58cbc166,215,175,40,Africa,17,1736.06
3f0ae3dc7b8e4a53beda86e317c9f262,57,17,40,Europe,20,703
3f10038bb2324ad7a11b222f9d95e0a5,164,123,41,Europe,23,603.06
3f12d58c18bf4610aeb607f22882fc8a,69,26,43,North America,15,513.02
3f13027247724760a351000bfb22985f,203,162,41,Asia,22,1089.16
3f15ae40afe94f85b50f5588ee55b832,69,12,57,Oceania,19,222.74
3f15d067b0c64a378628640ef55bacc8,249,227,22,South America,23,1517.34
3f1926a073514a4892167619d44d8f4f,361,313,48,Europe,21,2104.56
3f1aa5d7d754434f929883b69a05af94,353,298,55,South America,19,1324.87
3f1ab44e2d664654982107b75170a67a,75,41,34,North America,20,607.85
3f1c93dfe9f14e28bdcba5ee364816ba,46,16,30,Africa,22,268.61
3f1fe322803f40678872579100c1e773,149,119,30,Africa,20,1163.32
3f22702430a442d2920a4cc120d78395,273,226,47,Europe,23,1206.96
3f249014c4b84910b2daed51a5597121,364,342,22,Oceania,22,1717.58
3f252c34d6b64edd88193a7f86b83ba5,254,204,50,Africa,23,1404.88
3f26f547a53e4050b1b8f1606ab542be,212,163,49,Europe,23,1161.85
3f29511b680047ffb45c9cfa5daabccd,205,171,34,South America,22,1584.46
3f299e2921344e70bf7c5b2e32adb571,118,91,27,Oceania,12,777.1
3f2c8a6596e94d8e9618b14ef49627a9,279,255,24,North America,25,1650.77
3f2d47123b2c4b7db627eea2358e6503,351,318,33,Asia,25,2840.6
3f2d775114a94de6b0b8ae7a70d2e355,365,346,19,Europe,23,2400.04
3f32718593fc45259c1346c8a8747948,122,83,39,Oceania,23,845.88
3f34150360644163960d5d79bbb4dc2b,321,277,44,North America,23,1643.74
3f3428173eaf45249225a0ea1770370c,87,38,49,Africa,22,299.26
3f368f8c790344aaad71ef04f981fe06,43,5,38,North America,17,553.86
3f38c048d8694f84ab0033b2c2e8fa6c,327,288,39,Europe,24,2296.04
3f3a6af6989b42f3a68377582766c8d4,105,49,56,Oceania,16,683.74
3f3c53fae5b349d688675270339e72b3,365,360,5,Africa,11,3183.65
3f3d54ae28b346e3a9b4a3a45400838b,343,323,20,Asia,19,2673.37
3f3e098273154d778144bc8006faa8a4,114,54,60,South America,23,640.45
3f3ff68b3a7844538e301b58075c5e42,157,120,37,Africa,19,733.94
3f446cae0b4e4146b3aaccaa5cbce8cd,287,237,50,Africa,22,1568.7
3f44d3cb373247c889174c8c77636875,354,304,50,Africa,19,1242.91
3f455bfe0ef74fcbb312ba566c57b945,227,180,47,Oceania,17,958.53
3f46683a4fc94ee0988016a0aeb2449d,294,248,46,Asia,21,1663.8
3f4e142c39d04adbb4fd6886862aad0d,274,228,46,North America,20,726.23
3f4f61650acf465c9ce856504d728ff6,116,55,61,North America,19,632.56
3f501e2cb081491b889d2a80e00fb3cc,99,45,54,Africa,14,737.84
3f5132f9e5724e8096c821f5f013a434,287,253,34,Asia,21,2364.09
3f53b3880e2540ce82e79b3e3aea4c0d,186,172,14,Oceania,14,1571.97
3f53ea26c5b24747b19d679b05521e04,212,186,26,Europe,22,1620.66
3f545a14bfc0428ea99e79179bf5cf9f,313,278,35,Europe,19,2223.31
3f57b4a6fb834096840477ec6044d228,178,132,46,Oceania,21,920.62
3f5b0bad12c743b7aafa1da53369adbc,291,247,44,South America,14,2173.37
3f5cd1945f4e4f24a15d25002fb6c724,69,44,25,Asia,17,241.42
3f5eb0b337fb4c958ae8f2c37d840dad,295,282,13,South America,20,2408.76
3f60801cfc8b4f15b98227ac14e57279,174,137,37,Europe,22,1079.49
3f61820a160f4f238aec46a936d56136,348,332,16,Asia,19,2749.3
3f6263e3c5e2423d9c819ab45914662b,67,18,49,Oceania,20,43.8
3f63aa1b33dc442ba2ae650556cd8c59,86,48,38,Asia,23,311.39
3f67f09626564639869f4732b407aab0,178,124,54,North America,18,1249.47
3f6a65cba11b45078243b67c2e404994,268,219,49,Europe,21,1751.42
3f6cda2692e64f1d9274ea4d1e4391ff,328,282,46,Africa,14,1494.9
3f70427953bd462ca7eb5ff4e37ff72f,124,86,38,Africa,24,860.74
3f705fda7c69401ca9336ee2b5a51edd,66,36,30,Oceania,19,708.12
3f70ea88b94641efb3ed7116bde36117,170,141,29,North America,20,1171.24
3f73ceb85e19459387435a6b783ab448,68,22,46,Oceania,20,644.35
3f74a5c5704d415c9a0b7e688dffb877,167,123,44,South America,20,1503.09
3f77d357f9bb47cca6563a985a4c4876,341,290,51,Africa,24,1931.7
3f786cca2b92453e8d4c7aabe089f60e,365,336,29,Asia,19,2851.97
3f791533299f4ca5990b177b01666d2e,304,257,47,North America,23,1058.01
3f7ab5c06f664ea2b97ec918d6b713b2,106,53,53,Africa,19,739.8
3f7e42b61eeb44149b4af3ee04ccbb72,84,34,50,Oceania,22,173.83
3f811dabed9b44b8ab9e254343f4cbd0,259,220,39,North America,18,2325.86
3f816440fffd4299aa92f38368f69b1a,56,9,47,North America,21,271.37
3f8382ee8f42466baddfecacd69d9fb9,259,224,35,Oceania,17,1724.03
3f8480d14b9f4f3ba252817c96b97a3a,220,178,42,Africa,22,1359.35
3f89820b20854e94a6e68fded2f8ac6d,365,354,11,Europe,23,2176.51
3f8ab1ee7918458495852e71c9311934,51,3,48,Asia,19,111.99
3f8b9cd05c11413f88b356e84bda8acf,244,209,35,Africa,22,1309.68
3f8fe35698cf478d91ad78828c7dbce3,207,175,32,Asia,25,1121.41
3f9229bcf4a64d25a40838901a847163,79,45,34,South America,21,221.21
3f942edcdfd04ea19936e6d10cc483c8,55,11,44,Europe,18,86.69
3f953e6ea0ed4419be9e3db1f35c97b4,275,236,39,Africa,18,1845.55
3f958a1e4f0c4497bd7953ba55900d59,209,177,32,Asia,18,1048.2
3f959170de70496890d2e14c19442149,226,169,57,South America,22,848.5
3f97e33c604241ecbe7bbbe1f9ae59aa,365,353,12,Oceania,21,2871.78
3f98cac5e355411aa2ba67085e4f624f,167,116,51,North America,23,637.01
3f98e5283ae4454b8ebd860e36c9c8fc,31,5,26,North America,20,244.19
3f9aa194375a4ed1a63fb85259b3cf16,119,80,39,South America,25,978.65
3f9c9c89b64c43f0a7ad981b6e415ff7,186,147,39,North America,16,1004.74
3f9d6c5648e54d4587686eb10c0747e1,113,80,33,Oceania,21,966.32
3f9e9b6cdbd4489f8021381285999d5e,351,319,32,Europe,21,2970.56
3f9fab7634894a1b9f04a2cc846b44eb,365,330,35,Europe,17,2101.92
3fa046eedc3d457093b3f44af2e01c01,288,227,61,Asia,21,1472.92
3fa2577f3bc844899267c412a2abac1b,130,81,49,South America,22,375.97
3fa516ff4ef14e06a1428f27150d6677,102,58,44,Asia,22,904.19
3fa8a28ad2f448bb8a1242224fd08b27,323,293,30,Oceania,22,3043.65
3fa90b7ec1134283bec9ccb36cffd42c,294,275,19,Oceania,25,1759.63
3fa97f607d8549d4b9ae189dfeae97dc,347,313,34,South America,24,2061.97
3faab240682747d8b66fc2d55f54ecbf,365,318,47,South America,21,2204.55
3fac171737e2449ea8ad01ad046a8389,364,346,18,Oceania,22,2578.39
3fac4feed0e448b18cf3c68dc3b465d1,152,121,31,Europe,20,1062.78
3fada8fa8f264ae190e94bf0b4451e6b,358,333,25,Asia,24,2100.39
3faf170c236c415ebbb45cf33f8c9e1a,140,87,53,Africa,22,634.32
3fb111421fbd445893e6287930b717f8,365,354,11,Asia,17,1920.44
3fb31cd3b6684545a5f7248da5e057a6,197,156,41,Asia,19,716.23
3fb51fbd3df54a6faaaa93c40da2fdca,192,145,47,South America,16,1371.72
3fb6723855f34521961dc98da5d893c1,317,298,19,North America,21,1760
3fb807c402ba4d77aa7898340de184e0,356,328,28,North America,22,1579.29
3fb99d01c3364c3c864088df92942a64,365,364,1,Asia,23,2457.05
3fba1b66cd194bcbb3284c7e4df2f616,245,210,35,Asia,21,1345.26
3fbcfed994b04ab3a962fbca5da10ce4,292,259,33,Oceania,22,2077.37
3fbfb27eef36410e8f9702c8aebae46a,113,73,40,North America,24,826.98
3fc0ea4a887044bebd03900835e4c539,232,209,23,North America,21,1568.28
3fc14ed5d6de49f6b2bc5ebdce5efd1a,365,347,18,Oceania,23,2910.31
3fc1c590e83a4ac09d6bb3e5492fb8e2,299,259,40,North America,21,1951.38
3fc459c9e9224663af9d12a748060dc9,345,291,54,Africa,24,2303.01
3fc4905cc9df4ab69d1c78b8cfc84c74,94,55,39,Asia,19,722.66
3fc4da2a4d25495291dbec9d6fc0ea17,341,312,29,North America,25,2485.84
3fc5db73fc4f4c7f834c0a2564cb6e4a,112,76,36,Oceania,29,837.77
3fc6faf07c024414bd0cc9ba1ce02dde,229,179,50,Africa,21,1004.9
3fc8eeb9df5645cab9ee6b1185599feb,114,72,42,South America,14,1011.07
3fcb23d2a094482a9271f8d99d44d92a,351,324,27,Oceania,21,2293.33
3fcb89a70d0b4441919b4ae5dd300e7f,182,143,39,Africa,21,586.06
3fcba9a3faf64d4cb951faa034cc926b,136,91,45,Africa,17,1036.72
3fcd2149682e49dbb24b09b410055edd,365,353,12,Asia,23,3038.71
3fce42b37db04f71b0796c3c482ebebd,159,112,47,Asia,20,517.42
3fcf67e31c0c442d8b9d228dab9f1a34,313,294,19,Asia,23,2309.33
3fcffe2c55fd4bd8a20b611be0c03f64,321,291,30,North America,24,2880.63
3fd06b163f2c4fb7909cf293a12fcf09,353,304,49,Oceania,20,1223.89
3fd0ed9cb0164fffbbab870e4262426e,163,116,47,South America,16,478.2
3fd12b8d076e48758257cd5deb7bf561,364,349,15,Europe,24,2152.18
3fd554d8d8694d61b4e72dea10a3d70b,364,352,12,South America,18,1507.16
3fd61d3b2671495282c9dfbcba2bc21e,361,316,45,Asia,25,2072.92
3fd779b9bf934b9b8e0b72e91688df3d,175,115,60,Asia,18,1216.93
3fd79c89af6d4edf84bfd77c278fa2fd,97,47,50,Europe,21,587.76
3fd96a1cadc044b2b5632517a5923657,64,29,35,South America,22,366.88
3fda95d5639e489383f87035227fa4d9,188,154,34,Africa,19,1571.34
3fdb53af87374294b123232c7c51ec56,180,128,52,Asia,25,1039.46
3fdc18e834304a1aafa4ee01486549c8,267,219,48,Europe,17,1320.26
3fdc87c085bd46a88c31a204c28ef32c,364,331,33,Africa,21,1315.63
3fdca97199fd4e70b5cd6a4da857e7bc,159,123,36,South America,22,760.44
3fde6a212ef9468c8a1df8950e0d7bd2,219,171,48,North America,23,1586.85
3fdfc965b0664f758e9aa5da0251b815,88,50,38,Oceania,23,592.28
3fe0088901844a2db1197fcff4e83e9e,111,92,19,Asia,13,706.91
3fe0e06158ac427fab9f5c2781e25883,36,5,31,Europe,18,190.11
3fe11a83512e4d77a72ff1b3c4742c35,228,206,22,North America,24,1697.27
3fe38c130f194cbaa6521815578c9c83,289,244,45,North America,19,1348.68
3fe457d1ea1241d5ae5958238bc05542,157,106,51,North America,20,895.1
3fe941fec80942ca9d1f105036e30f2c,170,117,53,Asia,18,509.14
3fe94bfceca149d5a05a585765c17819,163,144,19,Oceania,17,1200.82
3fe9dfa64fe6466ab60d1bdfc264810b,76,37,39,Europe,17,385.98
3fea6295f636499aa49482938149b44f,137,97,40,Oceania,23,992.74
3fec21c9759d4cb9902058a79d514044,287,257,30,North America,19,2061.19
3fecf81df082406e8d74c55324442bdb,162,124,38,South America,17,854.3
3fed5d5b4d01475083c7d19a8a801ebe,104,59,45,Asia,27,502.61
3feea60d28b5475f84014f12aa4d6052,285,257,28,North America,18,1970.48
3ff29b6d34bd42c984ad85db557299de,187,149,38,Africa,22,1335.48
3ff326bb0a38456284cc2f23e4f247da,365,359,6,Africa,22,3093.32
3ff3730d1c644a3788d6a65351a721d7,139,107,32,Oceania,16,630.41
3ff3fba834f14b6dbdcc98f2eed10cbd,61,19,42,Asia,21,413.42
3ff612d0008e43f992a7844c6124c41b,343,305,38,Africa,19,2365.03
3ff645c4d828415097983c7bd04808b6,185,171,14,South America,25,1236.38
3ff905f9397f422ab38e7d372c7a8934,151,122,29,Africa,19,903.56
3ffb0cf5bba0475ab6dab924e771226e,261,246,15,Asia,22,2172.75
3ffc8ee66be94571bc8de7fe446c44a5,364,334,30,South America,19,2496.47
3ffd6fe8cf384830932eb6ff4b596844,240,211,29,South America,14,1904.39
3ffd99d434d642fd8aafe19f4efae34e,258,214,44,North America,22,1422.51
4000e206cc674eb4a0106a42815febe5,244,219,25,Africa,18,1795.03
4001efc189c347dca3f344a1adda6fe8,203,180,23,North America,18,1348.65
4002751d9da5462a9c28d6a6110196c6,275,226,49,Europe,22,1055.15
40028a6066794a1c9a5a004313737904,107,61,46,Oceania,23,511.24
4003f825bea742c0b78397a8a598644b,167,130,37,Europe,23,1141.48
40049c31866e43378d6421bba576574a,168,138,30,Oceania,21,1290.27
400c5110e31547f3ae6f7209c7839146,121,91,30,Oceania,24,592.82
400d3e1a831a420cbe01fedfe397298a,200,169,31,Asia,24,1338.18
400ee26e32b6431e949eb2744a0e4f5c,321,305,16,Asia,20,2251.43
400f1d706e304fd8804eacc9d160e00f,365,346,19,Europe,17,3129.91
400f2b99913b4c218cb94b4cb7288917,364,359,5,Asia,17,3119.14
400fbd1bf29c415b8b3040a28bab76da,365,365,0,Oceania,20,2680.83
4011523944604d4188ec61eff97f22aa,52,24,28,Europe,17,273.99
4012cb6c22dc459b9dfb96df815a68a0,278,253,25,Asia,20,2133.62
40146493203d4476baaf83acaeab3855,245,220,25,Asia,21,1827.36
4015e75a463e43f59f2dbcd98356a03f,48,10,38,South America,17,397.96
4016e6baff8d4415ae00a0c3b898f583,130,77,53,Asia,24,738.4
401762c93afe41268db59f4b34a9e802,267,235,32,Asia,14,1901.04
4018544eb380475d855f3ea5c7cbb715,164,140,24,South America,22,905.18
40190cb7828445c29a133fe192611fa3,365,334,31,Africa,20,2215.03
401a152601814415b8fd0e2b058d8755,315,264,51,Oceania,24,1566.02
401b736859ec44beb41343f885fde205,338,321,17,Africa,16,2679.54
401b8ba40cac4b3e9dfd4f476b740a12,219,178,41,Oceania,24,1532.4
401c0734c26d46eb9c2e1fc7eddca6f2,228,175,53,Africa,13,1207.35
401d885ed3534d3e8772ebfc475d87d2,179,145,34,Asia,22,917.85
401ea29691f64dbc927211bcbbd71e60,321,271,50,Asia,19,1551.7
401ee48358264164813d03f66690b403,195,169,26,Asia,17,1368.1
401ef79161324f6ba0dbc7d54cccc195,128,72,56,South America,19,608.81
40207e2f60bb46fcb3edabdb4e3c6711,359,340,19,Africa,21,1943.25
4020f2d71afd4b31a17881073b929fe1,91,39,52,Europe,16,1017.47
4023745c631d4f6b807a1347292ee2ce,241,191,50,Oceania,18,788.8
402924b964444d5b8bc6034efecc9719,303,259,44,Europe,17,2407.3
402ad7f7929a41c1b421925b8b547fd2,311,275,36,Europe,16,1776.81
402b03d42d154fe2bf86fdaeebb11670,217,175,42,North America,18,1550
402d60097c9d4085848897089dead9a5,29,4,25,Europe,16,309.28
402ddc01ac57411286e8fc55dc0a831d,289,232,57,Europe,18,1586.86
402e75cfee794222846318e95abcf48f,187,165,22,North America,19,1001.59
402e89412af849f0ae5cc3e0840e79bb,70,58,12,Asia,22,666.01
402ef2acabf946c88cbd1cb9d9c02ef2,62,44,18,Asia,20,218.74
4030876899654b6e968afe22dd0f16e1,329,301,28,Oceania,17,2742.1
4031a4f4a1314174b70c8ad100667978,137,95,42,Europe,20,928.08
4031dbdd7c74463b9d4ef70615c0e71e,222,167,55,Asia,15,1345.31
40327a2c364c4e4da3e964f4c2b9a163,64,41,23,Oceania,21,495.79
40327e7d3d1f456bab079afc621f7d33,87,39,48,Europe,16,430.98
4033413f9f4c40e0878a69c3ff3f5e9d,364,326,38,North America,22,2763.89
403441eabf5d44f8922f98355cfe5f04,126,88,38,Oceania,19,674.56
403618c7a0be4447aefa9151c72f6709,265,226,39,North America,19,1950.22
40364bc829cd4258a483583a77c6bc02,187,138,49,Oceania,19,831.42
4038b28fb96e4690b7dec89a561255f8,365,316,49,South America,20,1527.86
4039476b73e945379e8bd2973b960ae1,362,320,42,South America,23,2290.05
403b6bd24114488f9f58ab9f32103478,239,184,55,Asia,23,1089.47
403df6086fd842feb253b684823b94d7,221,186,35,Asia,24,1939.45
4042aea15fc24bb7b585123acec8d95d,216,181,35,Africa,22,1530.7
40448fcf67944886914cb7a5b6e95c80,364,308,56,Europe,21,1851.56
4044fa7b1b934f68b721be5df86ee946,220,180,40,North America,18,1373.05
40466fd227c143f789b22e9d05e66029,80,52,28,South America,21,289.08
40482a291a4e4c729e9e26ac9e56fedc,199,155,44,Africa,25,1201.15
404b60bc078f41b3b78ea929bf622567,224,192,32,Oceania,24,1763.79
4050c051e96740bb8fa2723c1e9eac4a,128,98,30,North America,22,1303.75
40528ec01f7640eea057f1a67e2e62b6,285,250,35,Europe,22,2286.76
405450f27bd04f118e18eb3f0dc0964b,143,100,43,South America,24,698.62
40546c52bd9443d98dfb44972963927e,184,133,51,South America,14,1117.67
4054f1dddbdc4f47929ea1d33c8e98e4,336,301,35,South America,16,2237.7
40554175c6014e81bb4e26f9c6e74e76,259,214,45,South America,17,1277.13
40576da9d4194262a844e1c20665f83b,177,156,21,Asia,19,1082.47
4057fa7a4e9a4c25ae97aecec0339b88,359,338,21,Oceania,18,2508.78
405909819cd5409cb11e3942ca6226ec,357,304,53,Asia,16,2085.03
405993f10d3d4f8fbfa86d7b89ded6cc,316,286,30,Africa,22,2850.43
405d54b985784d00a2bfdef286ab7576,98,45,53,South America,22,373.63
405e49e3cea94ae1960f1ff7d7358a4c,363,361,2,Africa,21,2056.14
405ef1992a064c558bcdfdf77ef8bd73,323,268,55,Europe,21,1251.95
405fe51742ad4c21afd651a9ca559e5d,330,292,38,South America,19,2351.23
4062f97cf182497aaa916d6e548772a3,222,165,57,Oceania,19,906.42
4063bc3f78ad4bc5af85a3291990d600,365,318,47,Africa,21,1528.12
406487c8e5c342e1afec9f1735dd74c7,63,21,42,Oceania,18,231.16
40654c1479e44abbac9031ab8570a6ac,297,259,38,Europe,21,2541.18
4065eababdce4e0db42ec91b429e57d5,313,277,36,Africa,18,1399.84
4066c9f3425249159091f5dd1b68a96b,79,45,34,Oceania,22,472.52
40672d6becb846ecb740a92033d858af,220,174,46,Europe,21,1194.04
406769de23dc48c18e401bf796a7354c,37,10,27,Europe,19,287.56
406c9c0663e445e493849f094b1d890e,246,219,27,North America,21,1611.35
406ccc3be4084015a262c878e4e33279,233,201,32,South America,14,1366.41
406df23669d042a89b4498eb81336e30,362,324,38,South America,17,2337.81
4071493f11314a529fc78d9d31136d17,114,75,39,Europe,21,903.21
407170dbdb1347e2af0dd551703d78a6,209,183,26,Africa,18,1858.68
4071728a25884a85a9d7e43b8a0b69ed,314,266,48,South America,15,1316.17
4074ad9ec32d4111b5a051d081496c0e,237,204,33,North America,16,1268.81
4076b04530a248709ac649fd0920befd,332,295,37,Asia,19,2246.78
407739d1cf74410ebb936ed845c662e6,51,28,23,Oceania,21,193.54
407879a3bd46430fb626bd8327bbd2cd,220,169,51,North America,24,1253.28
40789f3f61dc43dca4467488f5679393,91,56,35,Africa,20,961.23
4079d07c5f6e4949a16ace87d105f6b6,364,325,39,Oceania,20,1881.73
407ada82af024fc3a9b5e4e3e5b5be07,365,353,12,Asia,17,2501.63
407b1d9bc1524042a68249ea0b335820,345,307,38,Europe,21,2202.67
407c4899d3d4464ebd22eb8d832df42b,293,251,42,Africa,22,1615.86
407cb3633f114e549e567992e10dd9a6,365,364,1,South America,20,2017.78
407ea35351f849bf9b1e3b0bd4b45c2b,363,350,13,North America,20,3183.63
4082167d857842ed94d18bb1ae3152b8,38,16,22,Oceania,23,219.82
4082ef8e164341e69d706520891b8077,206,183,23,South America,18,1393.41
4082f3a13d334d749e16026700ad6a32,357,328,29,Africa,22,2590.58
40831fad5f5b48c9b282a1456ecd232f,361,309,52,Africa,23,1698.73
408341d18cb04db2ad7b24bb99583901,323,295,28,South America,13,2292.97
4085e919f6e947c8ba1b16b8aa6a3877,236,189,47,Asia,27,1192.58
408702ab738040c1b9f4060038a10d97,270,215,55,North America,20,1434.87
4087fd8fc11945e9ba6d7c5ad293fa36,216,190,26,Asia,14,1311.82
40898c938cc04a118ebb17b9b3a5aa93,110,69,41,Asia,21,1215.76
4089e8d03567413b8e247ab31c1a4493,319,301,18,Oceania,17,2528.7
408a3bb3ac90441fa6386afc41e2959f,231,206,25,South America,20,1810.91
408ab0bdacea4aab985f3b8564bf88fe,310,288,22,North America,23,1423.57
408adccaa75544818cca8fd97b89fba2,51,2,49,Asia,25,388.83
408bdfaaf25644f7b4e8c2c179567f5a,362,337,25,South America,24,2588.91
408e011ef9ef4ed3aba06e11c60fea3b,183,156,27,Oceania,22,1313.27
409183a8016f467d8c70af97ae7fc5e6,200,166,34,Africa,16,1050.48
4094429a50e742908910c7f3ab274356,327,298,29,North America,19,2174.19
4096903018be419cb12b5894b6cf72c4,204,183,21,Africa,20,1526.52
40979124b30645a7a01f45c8623a48e7,230,205,25,Africa,19,1825.24
4098ca60a6b645d8b1c2080efa39ff95,214,178,36,Africa,20,1365.29
409a55626d3245228015883a8ac594e9,302,284,18,North America,15,2103.28
409a79fab18447cea39a08a3015fbea5,332,314,18,Oceania,24,2468
409af56d802044e6a459a00f0349abd9,296,250,46,Asia,23,1532.55
409f3648c7ff4852a3dccd623d5d3317,77,56,21,Europe,16,768.87
409f92c2741c4ffb876bfef831b46626,37,4,33,Oceania,21,187.94
409fac8cc39f472798e7de0fa8443aac,365,363,2,Oceania,24,3293.2
40a033b603b24d168e86a946cddd98ab,222,185,37,Europe,22,1064.57
40a052f75dcd4f62b74d35c425bf5c3f,216,187,29,North America,24,1377.2
40a177cd3d2042e4bfa35050e99d2eec,176,135,41,Asia,17,766.24
40a2857fe13c4bb5b083883b92f2e722,353,298,55,Africa,24,1998.51
40a2b2b2352c4afb89d4ceac706ece28,255,204,51,Asia,23,1743.5
40a407c707c04cb5b39e2ac15e3c423b,52,26,26,South America,25,724.63
40a42834988a4e0a880fecb6b45cd277,319,274,45,North America,21,1476.51
40a42b5b5ee147e9a9ed32af88b6e77b,307,253,54,North America,20,2277.95
40a568895d6c4ad0bcad52f0b0761ea0,173,133,40,Europe,17,806.76
40a570a24c04411abd9769791c7f18b5,202,162,40,Asia,21,1270.58
40a58056b3cd41a98b93cff906083cbd,362,319,43,North America,16,2795.96
40a668462aa3420c977f12f77991119b,55,12,43,Asia,20,392.91
40a82492debb4321b2285215d23a7891,276,238,38,Africa,19,2010.1
40a87eab279d42499435978164a55f38,61,14,47,North America,18,227.83
40a941225bbc4acfb1b1d7ee96ecc590,308,272,36,Oceania,20,2250.58
40aa0bfdbc6541579af88e7c9e3de8b5,295,280,15,North America,19,2145.88
40ab0dfca3dc40ee8da77935fa4d22b1,364,361,3,Oceania,16,2385.85
40ac598e685144b2a05b73f2be4b1a54,104,75,29,Asia,19,762.38
40b35f697fe54e02b5607e34c98c71b3,325,275,50,Oceania,22,1030.11
40b3881cb70e4a09973fc44d18cdef84,309,284,25,Africa,24,2335.37
40b43c9542a54e9a84fe0b48ab99bdb2,138,89,49,Europe,22,311.77
40b474f18d60407498608ab9d9398135,365,350,15,North America,18,2556.68
40b5274090e34d0099b69cb476f96c54,161,126,35,Oceania,26,1260.59
40b5341b6ea24a5db1402eee42e16f70,317,265,52,Africa,21,1453.78
40b5b45f581d4e0e922d7ed50db3b7ae,186,156,30,North America,21,1306.68
40b618cce2b6432c94a684b35c4074ec,230,180,50,Oceania,26,1598.2
40b8285097524d42ac960e1cad62381c,168,115,53,Europe,18,1010.02
40ba0e48f3764784a1d4d41cb052e7d0,167,143,24,Africa,17,1151.56
40bc7cfb89284760b71098c05a328c41,250,232,18,Oceania,25,2388.37
40c0beb2f1ac4d6798f7b5f852f2482c,267,236,31,Africa,14,1786.56
40c22ecae234498b8a75513283b8580a,150,104,46,Africa,21,442.28
40c584d826664487b92811cb03186b50,365,346,19,Oceania,21,2954.53
40c58993f95d432b8020223c9a571975,352,304,48,Europe,20,1676.72
40c7c85e85254c8e8eabbabeb24f993f,298,269,29,Europe,19,3012.77
40c7efd059c64bff8fa23f25dc203922,151,125,26,Europe,17,762.3
40c833528f4c4b3ca7a0e75d78978233,316,292,24,Oceania,19,2871.66
40ca0c313c4f4fc5adbc8a4e4fc5150d,200,148,52,South America,19,874.33
40ca7dd5fbd04ffab2f8bd8e34b498ea,42,18,24,Europe,20,364.85
40ce7517f8b444b8aaa65046d0a9f16f,218,177,41,North America,21,1212.77
40d1027207cd46da978f4d3683998615,365,350,15,Europe,22,2112.4
40d2cca92ea64be98e365eb8a84ffbf6,199,165,34,Africa,23,1101.21
40d47c2df39349aa974a9f59a50d0d82,315,264,51,Asia,18,869.86
40d4cb3b49044cd5b388f55a5fe99a98,179,130,49,Europe,21,713.1
40d4e303aa42445682350f04a460e51e,324,281,43,Africa,21,1906.03
40d563a0a9df4fa1bf1d9b6697114282,182,132,50,Europe,21,981.22
40d58f9485464dee8b9cb19e0443c8b4,126,109,17,South America,22,1007.89
40d6c15350dd420ba4182494e9fb31d5,193,148,45,Africa,20,2102.33
40d7ec1bf02b4fbfa76d1928041e3941,284,251,33,Europe,21,2374.3
40d8143f679247c28ce8f3fb65ad04fd,284,250,34,Europe,14,1795.25
40d9194ae8974453804e996b0268969d,142,121,21,South America,21,634.6
40de8e9f58f745388b1e5ed976b413d8,72,33,39,South America,25,623.46
40e06940f38f4653807cfe3acc2b0ed1,365,327,38,South America,16,2346.15
40e0d18073cf4df3b2f948a7d6a440d0,161,118,43,Asia,29,842.63
40e16492420849e48a0f7523d9cbc05e,351,310,41,Oceania,15,1800.72
40e355f3932d4396982e171caa6be6da,267,229,38,Oceania,18,1436.16
40e37bc67c9b43399ef3df478a469d12,350,290,60,Asia,19,1967.81
40ec81a722cb4122bcd9a4567e2642b6,203,162,41,Europe,22,1421.05
40ecf108943f4025950154ade91e31ad,135,105,30,South America,21,728.31
40ee1e09816d4f97b052707019bf1dd5,294,244,50,North America,18,2172.36
40ef562264eb4d76b4273876e5cad1ca,139,109,30,Oceania,21,994.34
40f233c11c474fd2adc47e4329bf493c,302,268,34,South America,18,2139.75
40f5af2640034ec395c35d548afaca06,163,110,53,North America,20,717.28
40f618d720b94c5885290375270c6187,302,263,39,North America,17,1753.44
40f6e572397e474c93657bcb8402337a,170,116,54,Oceania,28,896.35
40fa8b638792448dba81f7142e1ada70,186,153,33,Asia,29,977.25
40fbb684aa9645938ca58b4204de42a9,274,238,36,Europe,21,1586.95
40fc100a5d64443a954eb1ecd6653d26,249,214,35,Europe,19,1586.59
40fd8339e97742ceb8fd82cc11cd3444,62,16,46,North America,20,233.98
40ff99981ba045e698152f1068b90175,188,164,24,North America,15,1610.45
40ffad94b2f04547b3717c1a7ac4a1d3,114,81,33,North America,21,927.97
41005485516842b186c09ce1996b633f,317,277,40,South America,21,2065.08
41011f757b5947b0b3e8bb39e9590794,362,332,30,Oceania,21,3522.18
41026ade5542497ca5e1afa8ff549c9b,158,137,21,North America,21,1519.59
41035c7e5a9646f090f570689208bf1d,57,17,40,Europe,21,130.61
41054393a5fe4f8f86e756b48c794207,251,214,37,Africa,15,1503.21
41059a79b4cb4f8fa5994980cbd81e10,77,46,31,Europe,22,619.37
41063e6ceeb546b8b365f259e89eb787,121,64,57,North America,21,463.49
4109c28ffdf94a54a43dea4264d77d9e,201,171,30,Asia,17,1067.57
410a40c8b3764ca9be91a0ff4c3793da,29,1,28,Africa,22,141.71
410a6fbf98424a16a06ca86567968030,361,342,19,Europe,22,2308.29
410b42d9f6cc44e99d62fff95d20b86b,77,33,44,Europe,22,237.33
410c2d679abf4918936ef07e4709bce7,294,250,44,Europe,22,1122.21
410dab4ac97e429dbba4551ce1c4e5ad,200,170,30,Africa,21,1425.22
410e92d91ec3498eaf8d04c5a55cba98,166,134,32,Oceania,22,1282.85
4110518551d34919afbe7409507454f5,226,175,51,Oceania,19,1647.18
4111d6b3c3c146c4b86ead0f7321a786,308,280,28,Europe,21,2669.13
41121fa830fb4abb81a06b18254e11c4,282,232,50,Africa,19,1317.27
41136cb48c794b669ae1817836837465,115,84,31,Africa,18,627.63
411390f8bf1f4d1abd1ea3295a959d38,74,50,24,Europe,20,635.43
411a1f707bec4119a79f710a15b2c163,177,120,57,South America,17,1014.49
411a6da86c244da58cdcd05dd9885a37,302,268,34,South America,14,2246.91
411c78d0f2e44d3ab0d234c6034e08ae,149,104,45,Oceania,15,394.22
411cc273e3b94bf3a36531762df24a0a,251,219,32,North America,21,1866.11
411cca48a0424401a641a9c417f188a9,40,21,19,Asia,22,293.36
4120f645778e43aeacbb964cbf302d90,38,10,28,Asia,24,438.67
412193f6deb545f2b4c3462ce0562367,301,254,47,Asia,17,1432.69
41240c0d18b741ecac3f94f50bd4a8d6,324,303,21,North America,22,2879.42
41242858042043c098f356dc8d519f8b,227,188,39,Africa,19,1461.16
4127864626c44127aa517cabd11267e6,199,155,44,Oceania,17,998.19
4127d7f042314dd8bb8904e912faf7b2,278,229,49,Europe,23,946.95
4128ca8433ec46198894dcaa0dc4f6d2,363,327,36,South America,17,2697.51
4129318564294dd9afd757fa78ae5e7c,292,257,35,Asia,20,1915.76
4129be61d0404336a8a3bb53dee367a2,181,145,36,South America,18,758.94
412b6de860b9494b89581edfca2551f9,331,306,25,North America,23,2415
412c348e34f1498abd5e2c7fe7749815,351,312,39,Africa,20,2283.58
412c86cc04c441148d58a735971dfa29,91,74,17,Oceania,20,678.61
41302d40e52e43ed9e48e3a70e10b2ec,279,224,55,North America,20,1092.64
41318e9635584047afe6e8658cbbef58,183,134,49,Europe,17,734.15
41378c7e9cd64d57b2a5d16557e977c9,336,303,33,North America,18,2601.84
41388bd8c0c940b98817a6989fb9b686,365,351,14,Europe,24,2178.07
4138e204bd8f42409cd4ed755f96069c,207,179,28,Oceania,18,1236.99
413d26da0b114c058297cd1c0ca32629,271,228,43,Oceania,24,1244.63
413d61940370447f91e836cdd9c088f3,175,132,43,Europe,21,1603.33
413e132da4c84571af781b896972445c,345,295,50,Asia,22,1596.97
413efe6c7d1d4e9da41aa2636f52e0b3,115,87,28,Asia,20,932.73
4140ac5be1014cf8a9d1424a86cfd78e,281,223,58,South America,23,1369.34
41450ec75c33436d9ee11afba05ea93d,216,175,41,Africa,18,1451.95
4147252fb9774d8cba9167be2ebb8804,167,139,28,Asia,18,1057.37
4147364aa63e4bec8296e83dd0d6f101,198,150,48,South America,20,883.34
4147a7e99acc409c9a77c332bde1d4a2,302,264,38,South America,22,1589.52
414a23fcb5924466b328e32768ea0459,303,261,42,Oceania,26,1790.94
414a774e28674cac9ac003682a2efb22,198,159,39,Oceania,18,1307.83
414f9409b69349d284c3b9bd9172b123,365,343,22,Africa,18,2681.31
41500a0762f74e838a1e078525f33084,127,107,20,Asia,19,1147.43
41513eb9e10f4194a4cd1efd100c4628,78,58,20,North America,22,872.68
415156a5ca3644b1b69e3a1e810f1814,143,90,53,Oceania,21,1099.69
4151eacbc5b34f22ab570aa916883420,227,185,42,South America,21,1342.33
415285dcb3f846d1b7e8c6d8ee8d26ff,244,203,41,South America,22,1629.06
4152cd007457472ab2d565296fe8c9e7,201,149,52,Asia,19,1208.19
4155ff3d112f4a21b771b7bc123f0721,184,142,42,Africa,20,1145.77
4159c86e52a344b28be4f7500718041a,52,4,48,Africa,20,387.74
415a2e9177b544668737c75a69a9e65b,339,299,40,South America,20,1515.76
415a522384664a6097f7d0d2fa9f356a,170,123,47,North America,20,753.46
415b902dd10142059e21accce87f3e87,364,344,20,Africa,24,2751.4
415c82fac1734d23876b0f6ca21dbf6b,207,182,25,North America,21,1731.76
415d154c14fe4cd1b42de5c6a051d0ff,205,153,52,Oceania,22,1216.63
415d7edcfa4b4b168039a6cfd1014e99,263,206,57,Europe,23,1522.92
415dc97107bf4fe5ae02ca14e580c9a0,230,187,43,Europe,18,1742.99
415eae926dea4522ac5442667e9522d8,280,245,35,Oceania,23,1514.2
4162c4d5c3f043a5b6ca337f31f0e9b5,210,168,42,South America,16,1162.38
4163266d803a4967bcc99827c638a58e,127,82,45,Africa,22,654.47
41661e7664324067903d0d65721ba072,365,329,36,Europe,20,1748.69
4166d2980745405aa2df0eb088049067,363,328,35,Asia,19,2278.09
41673404b4de4dd2ac876b1206d8da6f,86,54,32,Africa,23,469.19
416753e7ad1848028c1b04bb0920a023,198,142,56,Africa,18,1388.07
41692d88842d42d7b8b97174f8d844d7,363,356,7,Europe,20,2481.82
416b1c33182d4aa1b08b4d480831bf8b,180,155,25,Europe,21,1268.44
41703ad5a50944ef9dd144e716f6037a,96,64,32,North America,24,522.73
41710320697140c4bcc7d0d497a4a71f,351,306,45,North America,21,2795.21
417242c73c07442d8cc0a01c47ecd92f,173,140,33,Oceania,18,1327.55
417453aaab38403db9b0ba618e4d3e58,337,301,36,South America,23,2301.99
4175abea0187441782fdf2d590dbcddc,262,223,39,Africa,24,1045.6
41762d1418b74d5c9f5cd40371958dfc,109,81,28,North America,24,929.41
417721e036274eb29bce0a28c0a2538f,365,359,6,Africa,17,2448.73
41795648c5ec46b597c5c08d87205358,236,198,38,Europe,19,1388.25
417b00afd8a34a0c82aa6939774fe618,129,100,29,Asia,21,1084.46
417b974270514f848fcc3a7cc67ee01b,119,85,34,North America,20,829.63
417d205b4a8848e9bdc4638330ca1a6c,67,25,42,North America,25,286.1
417e5207885e43cbb32da57c59babc45,158,102,56,Asia,18,983.69
417f1574a86c40de999ae3e60521fe63,356,327,29,Asia,24,1562.9
417f1d8def2b4cc3af3c744be02d1d93,359,307,52,North America,19,1616.03
417ff420f1b04ffb9137b96873924b34,138,97,41,Africa,24,1006.74
41813a5765234b10bfc90175d9f5f1dc,365,355,10,Oceania,20,1553.94
418193fc56d148059d23f6d4d6ac20a2,260,208,52,North America,21,1276.92
4181fae0a6764f60a18e806ef84ccb30,227,190,37,Europe,20,1331.88
41820421b67c4b3da59e552ef06072c0,270,247,23,Europe,19,1971.78
41839bc170b9413aba9795addb740792,116,78,38,South America,16,758.26
4183a77db7c74b639feb9eaa54174b70,226,195,31,Africa,20,1520.64
4184dd1914614f4487325a7b132dbccc,264,216,48,North America,19,1592.79
41854584b43941a78e9f6c0ddf6fd8e8,365,360,5,South America,16,2194.96
4185d545ae69404ebc56f0dccbf57eed,230,185,45,Europe,21,1150.47
4187823793d844c6b4c5068c6544ddb7,161,119,42,Asia,14,1126.65
4189d3e02eae487f81ddc422a9c441a6,172,146,26,Europe,22,862.53
4189f91d63cd4e57906f04c68a551ce1,365,347,18,South America,24,2017.57
418ec0e404014be4bad8f8d342b231a3,88,36,52,Oceania,17,812.72
418f135993cf49da95e25ea310c53248,185,156,29,Europe,21,1360.57
419354fdf0f94f20a6e5496229cc93b3,139,120,19,Oceania,23,864.53
419450dd86b64c62962a051be3c28761,160,124,36,North America,27,1266.36
419567aa047e4b1a9b3215abd8bf50f2,365,308,57,Africa,21,1521.36
4197eeaee98743debb35aecd1c13aca8,186,153,33,Africa,21,1203.25
4198b757503f453c9fea6e6051560ce5,152,132,20,North America,21,1325.77
419af6f9571846e79978dde92b22a29c,113,66,47,South America,19,642.56
419d75b05b514324bcfe8ab15ed028ee,102,65,37,Europe,18,409.82
41a284f6c06d45a7b78ae41db1a1416c,232,190,42,Europe,17,1573.46
41a3c9df1b4b4129b3117ce95e3e5997,193,157,36,North America,23,1044.88
41a4396b54c44bd18176a1cb225ddd22,272,224,48,Africa,21,1096.16
41a8713bf73e4980b94431b66dc07277,355,330,25,Asia,17,3101.48
41a98965e13540d7b5809790e4fe1734,210,154,56,Africa,23,961.16
41ac7bf8624d4a22910d5a95911b1b32,67,11,56,South America,19,340.67
41ad6994fb3749f6bd6c6d86db32bf4e,322,298,24,Oceania,18,2653.44
41ae0a9985594089bda99b938ce07b0d,32,6,26,Africa,16,293.12
41ae0f7dcd194b56a321d12a90c0cbe1,303,288,15,North America,20,2248.63
41ae38eb5d744d45b5048015f24e2f10,365,363,2,Oceania,23,2471.28
41aed056651f4913b3724bbae09aeaa7,308,259,49,North America,20,1734.49
41af4c2274ee433194d839f7a2fdd74b,312,267,45,Europe,16,1542.35
41afafa4763a4c89b42e6e6b9f7f48dc,316,260,56,North America,17,1658.99
41b00cd1121d469cb8af5f4c599a74b9,258,229,29,Asia,10,2136.69
41b5c90aa6a84b24baa2cfad2cc10437,349,317,32,Europe,25,2453.12
41b6854975c047d2bd0e98b913e399bf,121,75,46,North America,18,500.66
41b887f76b3c4ecd8feaaa4d2749171f,101,73,28,Europe,18,801.72
41bb10cd32f7452294893ef93ebd6704,365,349,16,Africa,13,2714.66
41bb8abe38544314ad75de40ebf264ac,96,69,27,Oceania,20,474.55
41bf5b3bda4d4f54ad910f87283ecf06,226,200,26,Asia,17,1472.97
41c06ed330de4ca78977f6a62123ac97,181,151,30,Europe,18,1455.32
41c11b067732497ea3553cfb2e525a4b,88,40,48,Africa,21,211.22
41c13fc455d94adca843bc3ccf74dfb0,238,197,41,South America,20,1487.14
41c3f206cd384084b7d31c32dc6d8796,363,359,4,Asia,20,1528.09
41c644deb5c64801802fe2c932ac3ecb,178,125,53,North America,20,1086.13
41c64f81f18146359870053830332607,334,302,32,Europe,20,1772.56
41c9c9fb98244532b30386a446fbd07d,210,191,19,Europe,16,1831.96
41cad8fef3414ed0b49046e47213d4b2,355,329,26,South America,19,3249.47
41caea480dc4446e9314d05295a9c391,64,18,46,North America,27,330.3
41d1700c84524f3f99f62da0d9ebeea8,254,214,40,North America,18,1465.13
41d230bbfb0748fcad1d8f8b36e0c6b2,89,53,36,Oceania,13,483.36
41d2ce65f66b48d7b5def433c7752bca,184,143,41,Oceania,20,1417.57
41d3d23001944cfaa85d5fe6e7f445b9,70,25,45,Africa,20,538.6
41d4b03e37fa4d41baf72ea2313a8b56,300,271,29,South America,19,2677.42
41d744af69724207a46bc4f9d0495288,324,301,23,Asia,18,2889.18
41d744dd95524b338298c745f4e3fe3d,272,248,24,North America,18,2298.9
41d7c33045e74d55afb742d459e2b1b0,365,339,26,North America,23,2089.42
41d875cffea34585821745ef0eb2962c,351,320,31,Oceania,17,2423.16
41d8904f73714da7b98bb5bff08b4e79,310,274,36,Asia,17,2013.21
41d9328b79ce4a67a4d1bb70741e4c31,151,116,35,South America,23,2023.1
41d97e4bb92c4e36b49f27cd2f411c1e,59,33,26,Africa,23,225.5
41dac7eb02d341398ce55642a82c802e,364,356,8,Europe,25,1574.64
41db9ab98c5a414ab960a9b04a36fd6f,284,225,59,South America,20,1077.73
41dc76c4384543609e65cd38673c3b00,319,306,13,Oceania,19,2268.9
41df49e56098435e9bb6d35dc008229f,365,336,29,Asia,18,2600.47
41e167cc6cff48988e5c4b88559ff978,74,49,25,Africa,20,448.89
41e26c794cc243cfb4c9f803b7ad64ce,200,172,28,Africa,20,1388.83
41e6b1e35b1b4963bd18d12094ef7b9d,125,97,28,Africa,20,1226.48
41e6eebe61534b83a8845a1e612c213f,330,290,40,Europe,24,2298.32
41ee97f3b00642acb8db7f2f39cfe4b3,140,124,16,Oceania,22,954.74
41eea38ccc3b48ddbe223274505b2389,51,21,30,North America,24,143.52
41efcf98bbd647d3813e67ec8f89fbc5,323,289,34,Europe,23,2510.38
41f23cd548744c84b4bcd8626d3c2168,223,198,25,North America,17,1832.25
41f2aa6a3ccb4f268dcfb9ca598cd5f3,262,227,35,Oceania,17,2137.15
41f336ce939d424db0e6971f0f5ae6cd,245,214,31,Africa,17,1496.07
41f34b002ed7465b9c20cd07078af083,215,196,19,South America,19,1872.88
41f45d455e83476197b8511ecbf93d5e,51,6,45,Europe,22,677.37
41f46df9a0234ab3a950c1f59fc3143d,160,132,28,Asia,24,1253.84
41f7225fb88247b7b863c142b068f7ad,315,277,38,South America,21,1872.72
41f90b0c2f49456aa80dc7800e3c3ff1,226,198,28,North America,20,1046.37
41faaf162e504d41a7aa2a2c22072ecf,196,158,38,Asia,22,1461.22
41fc71fdcb53491eae334cd1f75f6f8b,101,51,50,Europe,17,609.82
41fcb7113f074e229dfe28641bf4523d,104,68,36,Oceania,15,689.64
41fcd58f5e57408d83e09092aa98157d,94,55,39,Asia,25,679.42
41fe527ced704aaebc5574b1bbc34f7e,365,345,20,Asia,22,1704.65
42009521ab84412aa9f79f9f39874168,35,13,22,South America,19,330.77
4200d03fd9fc49878e5793996743f7b9,337,288,49,Asia,17,2124
4202ed170f034409a65942b3b01bb38b,356,314,42,Oceania,17,2327.11
42066d0be9d34bcfa2063e4bc4489507,103,71,32,Africa,22,615.04
42068e08fa764524b2699ea05eba01c1,267,230,37,Europe,22,1822.38
42086bc961f847d6bc7cb9d01c449cb8,151,101,50,North America,19,615.07
420e02c6b26e45d0b5b7fad9b543066a,246,188,58,Africa,20,837.57
420ea66a9402432b825cc74bc4915bff,108,79,29,Africa,16,568.58
42101063f0664a8ca35121d0196f9c87,246,233,13,South America,18,1617.5
4210e8f904e94cc98e78cbd8edecc062,255,197,58,South America,16,1139.49
42115d03e9e2433b8545bb773ae34c9d,89,41,48,Africa,20,517.92
4211f6c2a44d49c7b08b8fed75a065aa,259,217,42,North America,17,771.21
42122cf016e54063a6f11ae0ea4ebd83,209,182,27,Oceania,17,1801.35
421290f4d8be4e2fbf6b7d60f6edaa66,268,242,26,South America,19,2302.72
4215e7a1ad504d079814f0abaad8f2ab,289,243,46,North America,17,1434.99
421640d923c64e969dfc3fd76b3e4868,242,216,26,South America,22,2008.46
42179d900db14243baefd98a05f100d2,365,322,43,Europe,21,1577.44
4217cb03724f4bbab0aafcc73bacb87e,166,146,20,Asia,23,756.7
421874d3819c4011937cd1a4fda99707,285,254,31,Oceania,19,2646.25
421948ab9ed84edc85c1af08e6146b51,28,1,27,Oceania,25,67
421a44806aa6411a8e06c383cc655f32,138,97,41,North America,18,1076.73
421a6de3963749a8b8ece38b905feec9,340,316,24,Africa,21,3351.86
421bd75b76f1408f8fa61a386543e65e,181,146,35,Oceania,15,1147.66
422073d152e8437ba47567b0e4ffb48e,132,104,28,Africa,17,1163.2
4220f6fd366d44a0adbe9764821aa007,199,174,25,Africa,14,1500.71
4222428e39ef4b9f8e3c1b156e4878c4,156,113,43,South America,20,829.03
4224e4a4fe0947258fb35ca8479b9112,227,188,39,Europe,17,1428.87
4229f354edea4dc6afa89a3d5a7fb936,87,63,24,Africa,17,476.74
422a2a57ed3f474896e5f7537afccd52,328,280,48,Asia,21,2137.9
422b5e84a3f2456eae5331b9d8503099,365,336,29,Asia,18,3207.61
422c1036a20a4c508cfe91d90224fb42,130,99,31,South America,21,1065.42
422e5ad10f9c48b3bbd72613595045f2,365,363,2,South America,21,2303.53
422e5d487c154478b61166b385c12ee3,254,216,38,South America,18,1743.55
422ed13d0ea04a4abe26d7bbfdbbf489,314,266,48,North America,22,1946.15
42326c0ecfda4b939a788850f537c4dc,236,196,40,North America,19,1808.59
423366571bc242b69d7468c9c3dc6a5e,165,134,31,Europe,22,1264.7
4236cc6181b84196821d68409a782acd,351,324,27,North America,17,2164.38
42392610104b45a892b08a37d7f02a0d,294,247,47,Oceania,19,1724.76
423a2b49bb5646c2bc553ef27964c0b5,258,221,37,Oceania,22,2212.82
423afa4539534624b6cf551aa257a49e,87,58,29,Oceania,22,518.09
423d48728f1745729b70f47288b5a062,336,303,33,Europe,16,1869.44
423d4bb3d20f4645b141ce2c9b567bd8,99,67,32,Europe,21,548.19
423e73ba1daa455d92d576d5fb934389,219,175,44,Asia,18,1042.1
423fa70f9f994985a2527be8d6525408,128,107,21,Oceania,20,714.79
424080f51d124323b76691562454c7c4,119,92,27,South America,21,1162.65
4241a0d819f845beba792a2ac205045c,198,167,31,Africa,21,1503.36
4241def26a3640d29430978ad12ca936,342,311,31,North America,20,2328.02
4242651258394be0927fd6d04ce149f7,186,158,28,Europe,17,1132.9
424540dd600b4582a20bd498bf60de3c,199,150,49,Europe,21,887.66
42486c0b36974cd9a8b83a768cfe65d0,85,60,25,Africa,21,691.04
4249f104e9c141a395a38f0d2c98bf2b,263,217,46,Oceania,16,1151.25
424ce9a519cc48848409fe95b5ae003b,117,76,41,Europe,16,1018.95
424dd17da84f49d8a53a177f68e3acc5,165,142,23,Asia,20,1416.49
424df341efbe4cf484651cb8e761c893,310,274,36,Asia,19,2063.65
4253f6d1b2d94ab286bc871570d651dd,276,252,24,South America,21,1670.04
42546d31f8d2454595545eaea442481c,207,178,29,Europe,19,1527.95
425512f4b4f54910a2b8f3d854481b22,44,26,18,Africa,22,245.78
4257491962b047f3a151ee60077da227,362,332,30,Oceania,22,2839.47
4259bb8a40e14c74b2a2456442a9aa64,121,74,47,Asia,20,687.97
425b244b6a1f42eca6fe99b91ffe8e5b,82,40,42,Asia,21,638.3
42618b73335546d0aac089ca6557c34c,364,360,4,Africa,20,1701.36
4261b349b8a04217a261bbcbb58483fd,95,48,47,Africa,22,856.15
4261dbd87e8942bd815e6d6c063d75c5,365,358,7,Europe,19,1972.73
4263ca33f0bc41d9b4e7336ce9f2125c,169,136,33,Europe,24,1140.4
4265799f07874e39a391e0297aa9eb81,127,74,53,Oceania,18,815.62
4266463cbf88428cb811fa9f1d55fb7b,315,281,34,Europe,14,1754.19
4267008d8e86490ca274fab1ba3af8f0,305,286,19,Oceania,18,2566.44
4268ccaba0d640ff820fb29064479394,321,294,27,Oceania,18,2521.74
4268db32909a4f56ba7fc95c3ccb933d,292,241,51,Europe,19,1251.4
4268fa166ff249738b5c899463e22edf,283,240,43,Europe,18,1164.13
42699eb664244e1da3c75c3444c1fcbd,276,257,19,South America,23,2710.32
426ac0ef0e0d4d06aa8ba9a3bb791804,211,166,45,South America,23,1213.25
426c703e63694fb48a8631f07210fe22,43,16,27,Europe,18,368.96
426e220bbb864d44b6c529d8634a22ae,279,244,35,North America,22,2331.79
426f1240da9d4c85bd8953677d8a6e46,36,10,26,Asia,24,160.23
42719aa00ec04b43958ac5bb3221f7c4,61,11,50,Asia,21,462.81
4272d79636a84690ae27a3db0460dcd3,128,109,19,North America,20,1330.32
4273cfe7bad744ccb11b833ea187363c,216,166,50,North America,24,941.59
42743d3241f74a679be3d352d5b4556e,48,26,22,Africa,23,208.82
42758fa633e74b0a9623aa8c2be18ae5,77,47,30,North America,23,564.68
42762414060f469696f883eec6f98d2a,197,163,34,Europe,23,1315.96
4278cdf89e9349b7a14a7607c043d1c4,330,292,38,Africa,17,2345.51
4278ef5a6b5948ba9639dcb6a426bd2a,116,73,43,Europe,21,1108.45
42792e5a6ed948e9b344b663c7760241,224,187,37,South America,18,1301.31
427932111b354de6af40a5a8577edc22,304,279,25,Oceania,26,2056.67
427a6dceaafc4858bddea7be0a686781,190,150,40,South America,17,1582.73
427c0d6b5b7544989eee958eb3cb3ef2,238,215,23,Oceania,23,2058.24
427c3c7249154bd4aad865a7be6bde4d,106,70,36,South America,16,503.83
427c97455c3d4f5e86fa9bbbaf1f70cd,132,96,36,South America,23,1010.19
427cd863e1c44f588c34cb01948248f3,362,336,26,North America,18,3009.87
427ddd60760248d89c531c0df19963c0,136,87,49,North America,21,613.55
427e51f566f54023a784fac82a082dae,192,166,26,Africa,18,1906.16
427ec357550a42cea9a606317137bd43,249,202,47,Africa,18,948.94
427fe4f94ee54bb4a8092f7a3570abf7,291,248,43,Africa,23,2148.29
4281e53c57744b82bca3d5015d2ddc24,257,224,33,Oceania,20,1866.31
4283407c2b65415282706b4e2ad403b5,304,256,48,Europe,20,1751.42
4284e6a782004688b8e375e5fdadf911,269,252,17,Europe,16,2132.63
4286ed66677d4809bf9422852113bc44,216,186,30,Europe,19,2096.91
42872e72a82848e98ca58645d78cd134,325,278,47,Oceania,23,756.09
428829f0aa894f9c962f055f48bed5a4,292,268,24,Africa,16,2168.57
4288af2329f9435c87fa2037a77e6ea9,307,267,40,Oceania,18,1223.64
42899efdb0b4460ebf782b34824fdd6f,53,14,39,Oceania,20,497.89
428a9f912a8043a8962a45774d0be3ad,365,333,32,Asia,20,1496.03
428c2ac8f7a24b69ae3cf6aee285e8ae,258,244,14,North America,17,1628.89
428c5f0b34fe4fbb9b15b0cb72752713,365,349,16,Oceania,25,2962.35
428e0253359743fea0bc5dca73ec686e,285,252,33,Oceania,18,2195.1
428ece044ed64d6bb511d05e22f934a8,125,99,26,North America,23,964.5
428ed07e826e466baa35b7af599f50ff,189,155,34,Oceania,20,1341.73
4291902d6766483b888b4953706023c0,287,265,22,Africa,19,1656.63
429422224df54d22962ad2e9b5e2f2e2,75,50,25,Asia,20,623.22
42950cee32ed4618acbf0201c2634023,95,37,58,Oceania,19,586.84
4296133a90bc4f4eb226965d4357e5f7,86,41,45,South America,21,415.48
42981726a1c44b118283a67313dff2d2,152,117,35,Europe,22,901.37
42982b0045df459189bd3e253877d4af,229,166,63,Africa,18,859.09
429e383eaf4b4c3bbcfa6d39d700e71a,180,140,40,Africa,18,879.04
429f2c31ef874ab5870d78f617623142,269,241,28,Asia,15,1371.93
42a20f8864b24d41aff11808fa1cd47e,103,74,29,Africa,21,1004.98
42a24d1841144c25afc2be84794e022d,124,100,24,Europe,18,839.74
42a378d015ed4e56b2651e92d10aa615,349,297,52,South America,16,1217.88
42a3c672a6fc4ea993574e46cb25eb46,147,93,54,South America,19,359.69
42a3d0b3591445218b8b42f8558680cc,83,47,36,Africa,20,331.82
42a411cf9c5b4c5d83cdab094ec301cb,234,207,27,South America,22,1204.02
42a452c11cfd4d718ef2dcc015910a57,274,220,54,North America,18,1443.72
42a6ac748925419eafa433da188a4561,305,272,33,North America,20,2578.3
42a7de5d6f734ffd83c7d0c6f188939c,205,156,49,North America,22,1829.39
42a7f25e931749438675138557f3b378,350,328,22,Asia,20,2733.63
42a9e28e6fcf4a0ebc5df08fab8add6c,318,274,44,Europe,23,1629.4
42aea65e44a344759f668bc48ae16cb2,365,342,23,Europe,19,2452.6
42aec17f11084e4789248b0e0ecae810,151,135,16,North America,26,1819.78
42af50768eaa41de8e55a10eecb94a9f,365,345,20,South America,22,2876.12
42afe68d0d914b55a1e18af75bf7d907,365,341,24,South America,17,2914.87
42afe9748bda4c9fb741238d44164d8a,325,270,55,Europe,19,1439.2
42b019f112be458bb38b191466cd0c68,175,139,36,Europe,20,845.23
42b24d2248634cf4a4ab605e8fa1e5fc,133,103,30,Asia,22,506.32
42b5654bfb7b42ec85a2c85eb96c5218,322,291,31,North America,16,2333.39
42b9053d5c514746a55afb7b531cc072,363,348,15,Oceania,23,2974.9
42bb8a0e8d3749f6b86e88cd45e34e0a,365,355,10,Asia,18,1857.48
42bd3eb8716048438db8f23fe3e53b15,298,271,27,Europe,21,2502.85
42bda66d9350424aa35d64bac834482d,301,265,36,Africa,18,2255.49
42bf2a2d174849e5a5358c09aed69243,135,87,48,Africa,18,345.02
42c224c41c294cbc8f5b8dbc6cdca5d0,67,43,24,Oceania,19,488.42
42c39a0f907f447b846024a9f4432025,360,345,15,North America,27,2508.01
42c8874bc8be447c97e4819d5508ee6e,278,226,52,Africa,24,1869.94
42c95e99f1e0488a8884a0c4fc8f78df,62,30,32,Africa,20,306.88
42caedda8181499c8694cbc2c9632a3f,253,239,14,Africa,17,1450.21
42cc42c0d6cf4ec7b0abb445dd6493b9,309,277,32,Africa,16,2053.84
42cd4db808ad420880f64da5c2ebd18a,316,276,40,Europe,16,2058.4
42cdf109952642d6870c6ab93be0010f,364,340,24,Asia,23,1905.8
42cf283b9e17462da7114cbe62fe16db,247,217,30,Africa,22,1151.14
42d0c218cc964cbeb071ebbef64ee104,338,302,36,North America,20,2733.58
42d196ff73b34def8d6e64916e0cb948,130,65,65,North America,24,579.85
42d672747810410d9dbaa19850b35837,125,96,29,North America,21,1000.22
42d6fb08aa1e4a8a97f4e2396a67ccfb,306,286,20,Europe,20,2724.5
42d740810ce448089161aeb3bb663799,126,102,24,Europe,14,668.37
42d7ed62dc05498aa0f864d1e50e7dc2,19,5,14,Europe,20,93.31
42d7f007d21244fcadf2573285dbe52d,363,356,7,South America,19,1680.13
42d829d0fae24ae09cc9dfab8c918dc5,68,24,44,Europe,22,273.95
42dcf7544ef14f8dbe350607139c63cf,172,146,26,Asia,22,1875.32
42dd4cb70ad743e8b0a390bc71db0e71,351,317,34,Asia,16,2639.97
42dd5dc0c9ab498490a318924890dd7f,43,9,34,South America,17,431.77
42dddf4d0ad14a249b5572753d4c87c2,169,121,48,Oceania,23,532.42
42df9626ce6f4110a3c5595cc339815b,290,237,53,Asia,19,1456.04
42e03efcb2e14f04a0cfe227e29837c2,363,353,10,Oceania,17,2682.9
42e2a49eeb4c4079843244eecaeacf39,183,156,27,Africa,21,1706.56
42e2f0fba826477f9395d0aa0174090f,87,38,49,North America,21,231.09
42e39bb901914240b63a5066da03a645,354,316,38,North America,22,2407.03
42e4c645725e4769890ae4752611b35e,321,285,36,North America,23,2200.21
42ed1c8e4b794a969fa82b9e8552ca4e,358,327,31,Europe,20,2877.57
42edd8386791442a90d4189120f4f3e4,363,326,37,South America,18,2164.19
42f12bb88eb74283835aa878b3a63476,342,288,54,Africa,18,1686.9
42f40ff3bf7b42a8bdb2fa2107f4af5c,58,22,36,Oceania,20,556.43
42f63a6f46a5444c9e6f95d43cf38a6c,116,82,34,South America,19,900.62
42f719a01da64804bdce0ff78b13e0de,204,167,37,South America,20,1422.3
42f7d7b636dd41748cc3fcc70913e69c,174,149,25,North America,17,1024.56
42f901b022be468b88f38ad9b387a557,348,330,18,South America,23,1914.43
42f9f9344650485fa23a3b876ff15a8e,360,348,12,Oceania,26,2254.35
42fccf186dc4439b9381cdde5b5f0b60,96,67,29,Europe,21,540.72
42fdbd85cc9345a8b6e6241ff8c2e857,265,227,38,Europe,18,1383.99
42fec6c26ca84cbbb5126f09ff027c2e,61,9,52,Oceania,23,283.95
430270299f9a4067bbc0a38b976ff108,345,290,55,Oceania,24,2066.36
4306b964a2f24bbca6b5426d7575ef29,166,140,26,Africa,24,1547.04
4306e9e1315746d7835edc1f02adedcb,365,358,7,North America,21,2577.1
430a66c3231d441182e528594b985bee,353,316,37,Africa,19,2657.39
430b2e09934c4e508d7b99a667e07d21,169,119,50,North America,20,621.87
430cd8d7e99747d19bb4c22e73e7f145,192,141,51,Oceania,25,1084.81
430cf282a83c4b279e18f397d4c99b3b,114,73,41,North America,18,694.07
430e563a5d1c4285a0edf1a93b01e9f5,115,70,45,Europe,19,627.44
430ea83e9c964e8eaf87ee541e585bd3,207,176,31,North America,18,1484.32
430ef9f09f1940c88dc2f0b413f50127,160,113,47,Europe,20,775.14
430f54d050e4446c8edb2bb5d78defa3,363,324,39,South America,25,2116.68
431050c3664f424eae76180ca694162a,285,252,33,Oceania,21,1628.58
43126e2528404afa8b7c0f4c7018d330,351,300,51,South America,22,1914.1
4313fdfc73c94d5c88e2adcc96e24b05,122,65,57,Oceania,22,669.18
431656937f254e0499f5aac623ee7ca0,365,329,36,Asia,21,1927.19
4319f4c98ac1417ba2f6d87aced2a370,194,153,41,South America,19,1306.36
431a07608b5f444c883ec1192cbaa9d3,108,73,35,Oceania,23,834.23
431aead4f24d4432b8460e894ed173a3,347,317,30,Oceania,23,3107.66
431dae0b92424cf1a91f84b4d1a55e14,343,309,34,Europe,15,2066.74
431e0d237c30402fbae3099b56bc9485,260,217,43,Oceania,23,1400.4
4321f2b17c60442e845133fe75b87726,48,15,33,Africa,19,244.26
4323adcaa3c24639bfff45a430aa40a1,236,208,28,Asia,20,1401.76
4324266f80414eb9a0aef9a89d2add58,183,154,29,Europe,18,1553.32
4325201c176f473fabb9b7f54d4efe6d,122,80,42,Africa,20,877.17
43252647c5fe421f8d9bd8d56e89e686,142,113,29,Africa,23,1383.76
43274635e64e4323a4543ea1b037c891,365,347,18,North America,21,2252.37
43278cdc314c43b2bb7ddeb49c25937f,353,306,47,South America,21,2261.19
4329f15e6e874993867824f16723c64b,157,121,36,Oceania,23,772.22
432b6459c37b41aeb909cd13ff2a14ed,283,259,24,South America,19,1817.75
432c8d6dd34f4c108c61cd5fcfd6a0b9,111,79,32,Africa,20,762.85
432cc5119e114e1aa3e4ed4c0e5a72a5,364,315,49,Africa,20,1365.94
433109a1b60147c0bbda7eb692b5d258,61,24,37,South America,19,292.44
43329c0e6bfb4861b638c5486fe0505c,363,337,26,North America,17,1911.46
4336150795ad42649c83a59d09797625,69,40,29,Africa,20,362.96
4338e31b7878466db240d8b79efc9651,330,290,40,Oceania,22,1602.8
43394535aa664074bf1fe9e8caec52d5,214,179,35,Asia,16,1561.72
43398f2cff5c4fdeb04d63431c07446c,355,332,23,Europe,26,1899.62
433a38bfcf354f609182c2958d0b764a,364,326,38,Asia,23,2083.43
433a67d5859d4dacaab3ccc65cc27503,364,360,4,South America,21,1767.2
433bbd56853448c1beb7028ed7c8aa0e,337,292,45,Oceania,22,2218.58
43409ba891904a478622c2a25a2a1bc2,144,88,56,South America,15,755.67
43418b29510d4a538f22bc39a5420b7a,106,67,39,Africa,21,927.86
434370215dfa48789bb3b5bcf9bdc9c1,364,349,15,North America,21,2929.29
434546b077384e39948229c21288ab45,37,12,25,Africa,18,171.92
4345b7d421db470db46d9d289e777966,95,53,42,North America,20,495.35
434669b6338c4cfcb92a8feb677634be,182,151,31,North America,21,1381.37
4346d9786687491bb383a7c2bf4d30f1,86,69,17,Asia,23,323.94
4347b40feae54ba5871e2a1a9bf152d4,154,100,54,Asia,18,1118.45
434c4540d2894f869f5fbef1598e3820,93,65,28,Africa,16,669.26
434e37cdc3d848ad97c2a5ea4bc4979b,135,92,43,South America,15,938.05
4351fcce7f40439eb454e56b4df50d84,293,244,49,Oceania,21,2034.09
43541fb1767941ec9f5fb2110e1b0624,296,273,23,Europe,22,2070.01
43543f387b3946fc9d7c6e32a3e4a227,96,55,41,North America,19,856.86
4354ab4def3b4971bbf5f18f0a52a025,296,252,44,South America,18,2012.8
43553513ac22494cad11ac97fc16e246,242,179,63,Oceania,18,672.11
435598b241c44370b82fe81454c7dea3,363,335,28,Asia,21,2614.99
4357cdcd127c49558024b84b5f887906,174,141,33,North America,19,1017.86
43599eb4f6d840b0a3968d23300ec41d,342,307,35,Oceania,20,2292.61
435effa0f072440588425262ccd8e430,253,206,47,North America,17,1060.71
435f0cbf8083495d9f2b1fa820a56a36,310,287,23,South America,21,2987.79
435fab4e0b5c4f0ba3b4f7af65c2cad3,284,253,31,Oceania,27,1750.09
4363cf56d205416f8aecd164e11bb78a,233,186,47,Africa,23,1575.35
4364c4e37ef249bb9081b3af43be260c,257,233,24,North America,21,1833.1
43655c1447804f36b049c864e6df0a65,81,45,36,Africa,18,457.84
436566738832426fbf71ff86593422a0,343,302,41,Asia,20,2517.43
436880dc17ba4fe8ad006f6a6c6440a2,202,174,28,North America,22,1574.84
436b61c70dda41909e1f3ab664bddf10,57,17,40,North America,18,186.64
436c0b1148d545a2ab577352fe4cbdff,350,312,38,Oceania,28,2079.23
436c7d47abb64629a21b6742f2907cf8,299,255,44,North America,16,2094.06
436e53ded5b94586b1edbf0783a7abcd,89,67,22,South America,17,534.6
436ed0d98f2847359b06e489beb8352b,333,292,41,Europe,18,1390.47
43716d60ac704988a3bdcf61d88c18f2,76,28,48,Asia,23,687.19
4371afdfa9d948b09e9ec78c6eb842e7,99,47,52,Europe,21,668.13
4374d2b23d414e8eb650b135a9eca20a,274,243,31,North America,19,2289.52
43784228d99a4e5a94fd90fe27992912,134,91,43,South America,25,1227.15
43787844d6fa42ceabf0fb1ea8310b62,118,70,48,Oceania,17,303.06
437b8fadf65644d6ba6fcee6a0d37857,86,49,37,Africa,20,325.39
437b9573381540d0a37dba0a5e992535,322,288,34,North America,21,2440.19
437f9e7de8024ebeb808ea17da723850,70,21,49,Asia,17,276.9
4380f89311514a898ca6f204dc0f9ede,354,315,39,Africa,18,2196.37
438243aee4f24e1fb6fb3ce1091f7d61,191,156,35,Europe,23,1208.04
4384939180e84921a2edabd1d0bc188e,307,256,51,North America,22,1381.09
438804d3ecdb4674870add22c3490c33,183,136,47,Asia,16,1490.25
438833b58659457690810d7b8e3a558b,120,87,33,North America,22,599.68
43894fd54d0d4061bf60e280fb54087b,295,279,16,Europe,20,1788.97
438a1e71b9974fd0b9162e774e46dd7d,217,174,43,Asia,18,1253.56
438a33558d424466b93e51bcdd21140a,103,68,35,North America,21,359.07
438b9fc90cc44dcf9f6fa9996583dfc6,350,303,47,North America,16,1140.89
438cbbab626d4ee69afe4241306e47b9,279,244,35,North America,20,1897.14
4391ec79d8f340249b795c98f3a495d7,117,94,23,Africa,18,375.34
43944269cf324ce39c83eb578327c6b8,243,197,46,North America,24,1287.22
43962aa865eb44d6b1c5832985493f1e,78,39,39,Europe,20,260.83
4396971780ae4e6cb85e0bd1e92c35e7,206,161,45,North America,21,899.21
4397ab8eb0384d6b8b245488bbfa1df3,342,295,47,Europe,24,1431.02
439907848f0d44f78f27014e60dfaa5d,287,240,47,Africa,16,1431.46
439961c0cc08475e8f5efac2f2986e9e,365,340,25,Oceania,18,1508.42
439ec66555884bf8bfe1ad734f6c4c25,64,28,36,Oceania,21,273.52
439f0fa4c6ed479b83ad73728753afc5,215,172,43,Europe,17,1270.15
43a1786575ae4309b4fcaf9908842e95,309,256,53,South America,20,1868.39
43a18b2a41534e04a14fc45908229073,106,68,38,South America,15,776.27
43a1d3769dc547fe9df235d6a88d4418,301,252,49,South America,20,2014.42
43a7a131406e4504a88890ed64456d4e,362,332,30,Europe,18,3097.7
43a80407e0644bb4a5cd58b9944daf31,265,233,32,Asia,19,2128.24
43a8cf1929a949ab8fc47fa8a040fb7f,230,187,43,Oceania,17,1892.22
43aac8a16cf2455aad736943b56ab0e3,250,215,35,Oceania,24,2025.08
43ab96f99a4d44e6ba28a82c36824966,240,213,27,North America,21,1634.29
43b1be0d0b9d45d3bb160354a66028cd,54,14,40,Africa,21,118.96
43b22c003f954d56993f9e76c5ef4047,244,220,24,Europe,20,1362.01
43bbca360dac48f59ab61178574060cc,349,318,31,North America,16,2662.61
43bc12dfefbd4ef5a4e7768d7755c53f,112,70,42,Oceania,21,904.85
43bc27e3511d49e7b6761ee2006dd395,343,311,32,Asia,25,2012.35
43be46e77f5a4b3bac9af30cff2d1f52,312,288,24,Asia,24,2589.09
43c01a26d4404f11992f29d7ef38dbd5,169,135,34,Oceania,21,1799.82
43c16b7a3cb84eea9ec9d07ae17086a9,362,315,47,North America,20,2119.28
43c1e1112e804b55bed6b45b62a82141,95,64,31,Asia,22,419.27
43c2a926889647658a00d60f7ff12859,365,343,22,South America,29,1860.2
43c36d69596144ec9eada6ad39902bbf,231,206,25,North America,18,1824.82
43c45cb74c064282a1f2f4b24453aa37,102,81,21,Africa,19,706.51
43c57b4ef1504df89ab61e91a5fdbe15,365,345,20,South America,19,2460.76
43c5eca35191429586b9dd035d80fa90,212,154,58,North America,21,873.47
43c823019ec346c5b8171245f2536b9d,190,168,22,Asia,22,1628.17
43c8d2840db1455ab3377cb0b910a98d,265,225,40,North America,23,1239.96
43cba0ef4e6048d799f265f52f615f1d,58,28,30,South America,19,437.98
43ce808a9fe84f9cb2946b10cb426013,265,234,31,Oceania,18,1986.05
43d04804500243e0bd9b90545dcb60af,341,316,25,Oceania,16,2997.85
43d04e10eaf048daaf364922032eafd9,313,276,37,South America,17,1295.41
43d25e98ab57498bb71aa622d956e3d1,36,6,30,South America,23,262.98
43d28324de8d49168c209614384bbcf1,187,161,26,Asia,25,1376.96
43d2db2c78084ae383847896ad7780f2,261,244,17,North America,20,1930.98
43d9617c749b459b8d3e2155347d12a6,221,180,41,Oceania,23,693.8
43d9bd3b161d4e209e9345a0f7043f8a,97,65,32,Africa,16,511.72
43d9d3edbc1a49598e00f5ddcad90ef3,40,2,38,Asia,16,198.74
43dbdf1d4d1d442fb3fee3c41d6ffa7c,364,354,10,North America,19,2709.35
43dbe76f107b4e53bfde2c0885915102,270,235,35,North America,24,2020.75
43dc1c2b643241868e1035a26ef0f6d8,228,213,15,Oceania,21,1489.87
43dc5030abde46cea6fd965a1e783d2e,115,65,50,Asia,18,539.56
43dcf702a46749caa5fb9590990d1275,196,171,25,Europe,21,1709.76
43dedfb276a24c45a4c37626080881a2,39,21,18,Oceania,17,96.07
43dfb54d8983405597c9df00b39c289c,79,31,48,South America,20,496.73
43e14d249bad42238e130be5784774c5,360,312,48,North America,18,1950.13
43e1be10544749fabc050d36a2a39d22,365,361,4,Asia,14,1893.05
43e21410b5fc43eb84baf99fcf36d474,65,38,27,South America,20,637.34
43e35a360dbb41bc8de476805fa81e70,74,19,55,South America,19,325.07
43e709410ba64ee0a7d99aa12b5b667b,362,355,7,Europe,22,2657.83
43e7231af8124856b8259b67de44384e,195,175,20,Africa,19,1968.01
43e82a00e65a4783bca31a2683c9a524,293,261,32,South America,23,2160.96
43e9e514d63f492ea71fb91d1975eb14,273,228,45,Oceania,21,1286.39
43eaf2e56cc946baba748e6ec6a47648,290,263,27,North America,18,1829.39
43eb9deed86b4ca8a983321081cc63ca,280,253,27,Asia,22,1821.68
43ec77f1955e4e8ba82421e29e1f2db0,212,180,32,Oceania,17,1137.87
43eda364ae2f4d448843718d7db2f45e,227,182,45,South America,21,1375.69
43ee1709d318435da642566480c1b315,224,204,20,Europe,22,1665.86
43ef701bce6b41aca9da3810715c7aa8,315,278,37,Europe,19,1866.8
43f023c1573a47e5ab568d38dafac6d8,136,77,59,Oceania,20,554.82
43f3f455e37a4217b4e4258813d4be8b,197,140,57,Europe,19,1163.7
43f5b10192cc413a8c6dd2e28839eead,253,202,51,North America,19,1615.68
43f7859fbbc0411b9af105e08338e71a,356,308,48,North America,23,1902.12
43f92c3111a7471a82fbf860d95083d7,144,119,25,Africa,22,796.28
43f9cb137c344c2ca1b083faa9bae7ef,284,262,22,Africa,23,1357.87
43fafcac25ac4579822b3ceb2897bd30,365,349,16,Asia,23,3289.21
43fb2b1d39dd4e24bc4a1f144b83dd6c,310,277,33,Europe,20,1852.92
43fb34f5ced547d4b6dceb65c5e2f8c6,79,61,18,Oceania,24,795.08
43fc9d0774d6409f816e2073ae012d6a,354,327,27,Africa,24,2797.65
43fe418a218f4daea079c1707e4f67f6,231,197,34,Africa,22,1782.78
43fe7148cd064d07bbc610a60eaf5c9c,328,308,20,Oceania,18,2933.28
43fed133c4ca45498ead2bbf5c05a31c,107,54,53,Africa,23,440.55
43ff99af95b04504a26a1d6311e517dc,41,6,35,Europe,19,504.31
43ffd7bbf61e4a97ae347bf48c1abac9,110,70,40,Asia,17,469.09
44011455d89844bb86b2d97f6fe3c9bc,22,2,20,North America,16,136.26
4402ee7f522c4dcbae6c127638412b51,169,146,23,Europe,22,1158.64
44034a35aaf344268a533facd1a5ca50,296,274,22,Africa,29,1575.05
44038ed80400484289476d32628a0791,46,3,43,North America,23,400.17
4403e2f7108b461d9513bc64862c5ea8,263,216,47,Europe,22,930.25
44049eb0fb30465c9e348210dc468210,109,83,26,Oceania,15,736.49
4404fb4b36b54fa38cb859a9e94b969e,164,118,46,Oceania,23,1275.02
44076c44b44249fb8d78757ca78b3c12,360,324,36,North America,13,1806.03
4408f365bfa84009845a4b1d3905ffd6,149,120,29,Europe,21,944.84
4409d939220d4aeb9d8a50776489626c,215,176,39,Asia,16,1152.73
440a7816757e4ac0a4e5b91cf2a23ea8,127,99,28,Oceania,21,1085.08
440be401a4c64b699526b913af7f88c8,307,290,17,Oceania,19,1988.19
440c6b64b9514c5493f70b548a80cbf7,30,2,28,Europe,18,44.52
440cc1d056254dd7afb2d70f3f6e7fbc,149,83,66,Africa,19,621.18
440d0f3439b9454aaffe24a07949200e,77,26,51,North America,20,343.9
440d5bc1ebd64461bd07076268dd38c2,80,57,23,North America,18,361.32
440d74fd220d4116b75182f67cab5281,255,211,44,Europe,15,1562.22
440dbc13a51b440cb3c88ce77c4d7245,323,298,25,Europe,18,1985.23
440f2257dce54d628e9784cb2b7d8f48,364,332,32,Oceania,17,3340.08
4410f58ebbd94a71ac3a290baba4f505,364,343,21,Africa,18,2371.85
4412c4cfcdca4c43a82bb4fe7ebc8cbb,285,243,42,Asia,18,2261.99
4413607253294312b2e883775ef57f18,365,354,11,Europe,23,1630.39
4415bd6cd8b144559b62ac437f34fd53,96,59,37,Africa,14,586.7
44166b55671347718cd45354b00b9b00,69,18,51,North America,18,644.38
4417148a0e014d13ae0413ed2b96b251,149,107,42,Africa,21,1115.64
441a48b3d4484f70b571298b011dcb76,141,122,19,Oceania,21,1181.69
441b8371cc0847e0b2e7f123b7671f14,81,33,48,South America,21,147.7
441d3f3efbee467bb97867121271cbfd,48,4,44,Africa,23,285.56
441de7c684574cd48844a2f17c038b82,53,5,48,Oceania,26,293.97
441f166bf97a45d5a3e7028a7c8e11d5,363,316,47,Africa,14,2187.66
4420eda6d5f048838a0cba6f0abbbd80,344,296,48,North America,21,1835.47
4421601892b344ec99545e81eb29c32c,365,330,35,Asia,23,3379.51
4422ce98a0ae4503bdeae09cc9d72db0,249,220,29,South America,17,1330.59
4422fa1d19a84953aa3c5e3ffdc88a52,309,267,42,South America,11,1946.26
442345a8e009449aa2e63d8e0fb8f5d7,98,69,29,Oceania,21,775.48
4423f60a333e486eaacdc15a7ad723da,50,30,20,Europe,21,432.05
4424b62bbd11427e99550eff29fb1df4,207,171,36,South America,14,882.57
44269a8e0ea5495393793882630f3bbc,320,285,35,Europe,23,1720.77
442aca6fb88e4e43af98a0887bacb7cd,171,144,27,North America,22,1832.42
442c28a8a36a437ebda34c7cdfc66711,313,255,58,North America,21,1706.89
442cf7132e84479784d8a2f528026d46,333,281,52,Oceania,22,1743.21
442d681a9e894640babc5ca68172d9da,351,300,51,Oceania,16,1960.72
442fc7e60f7f4f04842362fddc50a6e7,348,328,20,Oceania,19,2502.76
44306ea3fe9f4f6a8a827edd3fbc4def,298,265,33,Asia,27,2175.8
44308091c16c41d28c19ad23f20d1a9b,142,105,37,South America,20,921.07
44309ca4f94f41eb9766e4c9d4c37c7f,330,281,49,Africa,19,1735.37
4431ef44ad414bffaa9a1b135dee0a59,358,313,45,Africa,19,3214.1
4434228ed344459bb14957f7f5edfd69,66,19,47,South America,19,506.5
44344c7403624879bf3196bf8bdb71d1,126,100,26,Asia,22,471.04
4437bd3e39494d34ba0f5468d1e0f7c9,124,100,24,Europe,19,860.72
4439fbaabc414f2dbbbdbbb575c33b00,115,56,59,Asia,17,771.88
443ae28d539545408bb8c62da81ced7b,180,154,26,North America,20,1331.81
443b68d810af43dbbe55a9d63b0ec65f,109,68,41,Europe,21,785.24
443eda214fa14064915febf647ce5e82,90,48,42,Asia,18,468.23
4440713b229c41b38f8c04079cea76fd,129,83,46,Oceania,21,915.2
4440f74eedcc4b87b11424a6336cdc40,47,16,31,Europe,18,298.34
44424f80ce2649ae967dcc634403ec35,245,209,36,Oceania,23,1849.07
44425b4bdbc14571bcddba650b2dabe1,281,237,44,Oceania,20,1032.58
44434e2ea55c4759a942a0e008006581,307,259,48,North America,16,1362.01
44435891de6d44a9a2588800e710e65a,126,78,48,Asia,22,573.33
4444014ad77f469cb6b531a4ce33c848,300,272,28,Africa,21,1922.39
44451e02495b437080b6cd1c4239c87a,355,310,45,Europe,22,1327.34
4445b61d26aa40c0be20f7ef90affb71,258,225,33,Oceania,17,1726.77
444779ab22ad4f749cf2cbc7aeb4e58c,85,37,48,South America,20,387.82
444894cf68494e16af0ccc48103fa212,163,145,18,North America,20,942.59
444aed1b3a0e4b96b417fe4f7124c2fb,125,109,16,Asia,22,1318.42
444f8fcf0ea4427c858c59ad4fe99b7f,218,173,45,Africa,21,1244.91
4453b066a5ef4f2885dfcff36e458882,73,44,29,Africa,23,702.85
4453eb230028492dbffd529f6c74c78b,341,290,51,Africa,18,1250.65
4454e0d96b6542b1b676791d001e4150,340,310,30,North America,24,1985.62
4455b9b8a4364302be64c2191da607ef,84,33,51,Oceania,24,469.98
4457ddd5dc4744188c0daab41624922e,69,30,39,Asia,16,460.66
44591859183e41f2923fd1a8980d3537,189,159,30,Africa,22,1352.35
4459c838f89844688dbf4daf4953e8d6,117,94,23,South America,25,1223.67
445a269800b146a5aaeeb54ea5b27357,291,247,44,Africa,19,1028.03
445ac253279149399a58392ebddede4f,364,354,10,South America,21,2738.08
445bd1c0a7224f5fba4e7fab276e29b1,153,117,36,South America,21,919.05
445be66533d14a3a80c7fc0c8ad89e0a,365,338,27,Oceania,20,2559.54
445d65e080cb4959aa4aea4588909c70,244,206,38,Oceania,23,2045.97
445e04553b48495b8db7152bf512e7ca,261,217,44,Asia,25,1196.12
44601415b6c742b498266987084593c1,143,109,34,South America,17,1139.38
4460453644a549e59192e1a572fde2a8,114,57,57,South America,22,388.07
44612fc70c4042a9940ea8cbd2b36093,352,303,49,Africa,19,1994.68
44613650eaf24f43b2d82d0a72fe3333,251,198,53,Africa,31,1142.12
446584e611364fd2b7995047fa4f542a,103,69,34,Oceania,19,981.75
4465b30856164a6d9cfe32c2059c28ef,365,325,40,Europe,22,1647.61
44662440a10a440180e19750c048679d,365,331,34,Africa,25,2174.93
446696ed72b44fc198ebecbaa7dc585a,253,206,47,South America,17,1194.03
4466f4595a324cb9a3115632ac795a52,206,168,38,South America,24,1156.48
446a88a1d10a4d249eaceaaa7b204306,363,325,38,South America,21,3239.21
446ad27edc08418e91fa996c2846e3fe,315,279,36,Oceania,19,2077.25
446e0725a65d462bb9194d0cbca5945f,183,144,39,Africa,14,1246.27
446ee8d34fcf47a5a22654ded13be8ea,248,198,50,South America,16,1181.79
447172ff2bc54e0682c2ea7b7f3edc77,256,219,37,Asia,13,1791.16
4475bdd2d21d4df3818e4f6397df31be,346,319,27,South America,15,2885.85
4475f0c49f4b4e7e9160a675560b5a51,179,138,41,South America,17,1311.09
4477007a34c348ae8da3ffdc9cf33c29,339,314,25,North America,22,1996.1
447bc780f2ba49ac8c3be18d1071db98,217,171,46,Asia,15,1105.29
447c5f09bf2f481b9e879b3eb3cb5e06,240,200,40,Europe,20,1747.71
447d91a44c2446fd983a9c03c8c274a4,212,168,44,Africa,16,713.53
447ddec8b7de4933988a64ea789ec641,333,290,43,South America,21,2232.26
447e8776c1d747bd999c98ed765bbaf8,62,32,30,South America,17,620.1
448092981f8a49e585492adc20c565f3,115,92,23,Oceania,19,761.11
4482c7bfad4744268aa31306dee35fc1,281,224,57,South America,20,2023.75
44833f8401e54d6ba0bb7559a90c2aa3,330,299,31,Oceania,20,2149.34
4485a6dd5a0a46cead07c6307100c80a,269,235,34,Africa,23,2030.04
4486ddf97ff147a6ae5367ada5556229,72,48,24,Asia,18,379.12
44878c7dc13c422a825d0f15117fa064,363,325,38,Oceania,15,2354.55
4488ed961fa54c6d9c7698316c29f056,61,15,46,Africa,22,126.43
448a865bf25243a697a31e024250aff7,335,293,42,South America,18,2633.91
448af7a355584779bf0c5dba53b61264,208,179,29,South America,21,1405.23
448c1f7f183549f28ffba5e1861a0710,286,257,29,Oceania,21,1547.41
448efd80a6e54f9da27a5129c077f86b,324,289,35,North America,17,2198.14
448f653c68654a2a8f41c61ca95f6076,40,10,30,Africa,21,418.45
44909692f3ca40f693b50c82501bab7b,162,116,46,Asia,21,846.38
44929f46b8144a3f809d0d6a5e9377dc,289,234,55,Asia,19,1587.66
44951536c14343ea8db2522df35081a8,234,189,45,Asia,31,1161.8
44970240fd124caa8e6ff059bcbb8da8,365,336,29,North America,17,2221.38
449824b9bd614b0690f3cfc1e29058e1,361,337,24,Oceania,25,2291.12
449d72ca0f864fcf8b4b2075d2730f82,319,300,19,Europe,21,3577.98
449f557b000c4a3687af956c7921ec86,274,224,50,Oceania,18,1153.39
44a0db0e701048f9b52b5af0af314d54,78,10,68,Asia,20,332.38
44a26878fdd0454290cc99e5ad2175ea,325,278,47,South America,25,1896.36
44a2f75682e44c96ac21780af4589722,312,300,12,North America,20,2324.11
44a4562250134e2a949b8b728319df8a,168,124,44,South America,14,1167.78
44a4ec48995e492d90106b5fde18b2cd,361,356,5,Africa,24,2200.68
44a65d64702947078fe83493f8624292,214,173,41,Africa,22,1404.16
44a65e42b064467aaf8920462b952935,148,95,53,North America,27,980.42
44a75dd8f09a4afcad82b264ad3740dd,243,216,27,Africa,20,1869.68
44a952d6af4c4a4fbb55dcd441fceac4,89,47,42,Africa,26,719.75
44aa603527324ddf8455cee79cbe2627,134,95,39,Asia,22,544.79
44ab73d9327a4da29ecbea5b96036694,325,283,42,South America,20,1761.98
44ac09d6c8a948d5b989be0985892bd1,148,101,47,Europe,22,859.97
44af7fe325254c9884b8f4e2855385df,43,3,40,Africa,17,102.02
44afc9ed23d14811a97f411fd9f9f0fd,326,297,29,Africa,22,2053.03
44b1110223bf43f5a50ea7507a892ee9,87,31,56,Africa,18,522.2
44b32b745f8a49f68509dafbb771c682,198,143,55,Asia,23,1026.91
44b40560c5a840fb84afdcfa00d18b0b,220,197,23,Africa,18,1517.65
44b59b1ff99b4684b4d128aa453314f2,144,98,46,South America,21,852.19
44ba2ae1bb9e45019f5c9483314cea1c,363,358,5,Asia,21,2643.64
44bd3aa0a8714ba4b682d380ea3a6ab8,353,307,46,South America,22,1556.69
44c0c860881746dfad7db86f7736e341,293,253,40,Africa,23,1209.22
44c2aa9700ea45c2bfb652c636d03dcf,334,307,27,Europe,23,2462.3
44c2b813f14e4f889c8f953b5ce95f01,365,340,25,Asia,14,2059.83
44c345c158354a54acf3c1e7417cbe61,365,338,27,Africa,19,2561.62
44c49054915440268089443258065d32,84,37,47,South America,18,271.68
44c6473e90a84ef188c195e434069698,331,290,41,North America,17,1867.34
44c72a18f66b4f80bfb1509d18a395a2,363,339,24,Africa,15,2575.54
44c7fa7992e44c7c8c50720ea3575883,277,250,27,Asia,21,1562.43
44cd0d908e7d450d87416a8665f8c352,276,238,38,South America,24,1852.52
44cdbd5281f946f0902c220f049d3fb5,193,143,50,Africa,22,657.58
44d463ace2c94c3eb76a4c5cf9fe896a,86,38,48,Oceania,24,512.84
44d7a014642446409866d08438483006,211,172,39,South America,22,1248.25
44d8e755e510463ca011de3e74b32669,219,202,17,Asia,16,1125.34
44d92f60a4bd40659c9356bc92f6c334,67,32,35,Europe,22,185.55
44dbdadb3eb644c1802e926f87b4075b,361,327,34,Oceania,16,1499.63
44dd63bfd72c411ebe59a6c0965af3a6,341,320,21,Oceania,16,2750.84
44de3e628d6649c0a37925a3895f35e8,269,229,40,North America,19,1897.48
44deea789ab84540a81bb101ebd05dab,130,97,33,Asia,25,660.26
44e04a7cd7084fcc9e3721e9f7043caf,363,363,0,Europe,25,2938.59
44e1c20f64554a3883d66b49f57a7022,207,179,28,South America,18,1774.69
44e476026da946149528bd436f473b7d,331,292,39,Africa,20,1932.67
44e67f34ca7c47de874efc90fa6708ae,266,241,25,Oceania,23,1926.6
44e7ccd03dd3402baca2b866f17c1ad4,364,337,27,Africa,23,2219.4
44e80098a5e9446da753654b159a03fb,284,245,39,Oceania,12,1942.14
44e876ee9d0142399bcfff64e00f085c,321,274,47,Europe,19,2082.87
44e8d792dbe142df8106a8756c355dd6,42,11,31,Oceania,21,183.37
44eb4dbf7f044a6db4df2264b8e6db6d,317,264,53,South America,24,1927.51
44ec49f26c48429984ad6a312896829a,114,95,19,Europe,22,1164.24
44ecaadf100241249783ff8685141982,353,322,31,South America,18,2762.79
44ee5eb625d34d978fb6b7fd86c9e5c1,82,36,46,South America,24,290
44f102db535048778461525a5f4ec1b0,104,70,34,Asia,22,941.5
44f2767adc8f4793a8405737f1ea5394,205,168,37,Oceania,23,1178.62
44f2fed5c32345398156c776ae7f3d92,123,91,32,Asia,22,1426.8
44f4cf3bf03b4a4ba96a1df2627abef9,336,304,32,Asia,18,1919.61
44f53fa7a2454a50ae9f83d8f9ccf493,118,100,18,North America,19,781.24
44f93f9231b44fc7ad884582b67bd8ac,263,221,42,Asia,21,2115.79
44fa88997c18479e9bf7efa467547d37,267,233,34,South America,22,1726.67
44fb71d918784a6ea04c11391948a1b8,306,258,48,North America,19,1181.63
44fc38512361417b96c7e2f245a73030,29,3,26,North America,18,60.53
44fe8646628441a5b5ee49b134832609,365,330,35,Asia,19,2642.19
44ff54b144934a8dbff67baf16687b32,179,152,27,Africa,21,1473.94
4500eb4b349e45c5b69c809f967a239c,218,167,51,North America,24,1335.42
4502d13989d44ea39c810738638b4b7c,272,248,24,Europe,22,2804.02
450339d9ed8e46adb7003361c0e944fd,364,336,28,Europe,17,1696.77
4504c6158f2c4c72a94d0b2d8562f8b9,73,32,41,Oceania,24,284.49
450897e58f534c428a59b86f6f30f636,50,5,45,North America,20,113.58
45096dd098194b00a43cf08bb83eb02a,173,131,42,North America,20,1115.93
4509eea4286147bf82793c857a4c004a,142,96,46,Oceania,16,1024.37
450bb851846448ac9f1c334f9a62b68b,248,200,48,Asia,21,1583.81
450bf725bf7d4948b300af073c44422b,72,41,31,Asia,22,716.18
450d190d130a4fa9bf3d0433c7b33143,74,42,32,Oceania,23,550
450dd06ef4ad43d1a0a10dc43b95e333,246,225,21,South America,13,1537.86
450dd5a5e6324f27be52bcd649806c23,323,272,51,Oceania,22,1720.23
450fc07ae95847529f43273cacdc80d0,359,331,28,North America,19,3203.69
45107761bac847d3aefb0a4db3022321,109,95,14,Africa,21,759.18
45108ce0c0a545698431cd89c8d9454a,131,109,22,Africa,23,939.3
4511724d308a481cbfd66ac7b833a08c,170,121,49,Oceania,22,730.64
451320e61853416e8f5fd5bdd7067325,144,102,42,South America,16,765.32
451335f1f1664c0d9bb16634d0921c74,283,263,20,North America,20,1335.36
4513d5d4fa414059b8b21bd2c8524e35,94,40,54,Asia,23,254.63
4514de068a704818896cc09c8bf4d69b,173,135,38,North America,19,1366.45
4518ae55727f471e8d842ba81736aded,248,213,35,North America,23,1042.29
4518c47659f445d0aef839727969786e,346,321,25,South America,18,3621.25
45190521590c48a395a797823373e126,62,18,44,Asia,21,679.95
45190abac1514daa9d6373b60835e0fb,241,205,36,Oceania,30,1193.46
451c7a5b2bc049fb8aff2bfc3086059c,98,57,41,Europe,24,1154.81
451c8f90a2534afbaf1efc9bfaf36064,279,238,41,Oceania,22,1336.81
4521302d5be845008699c384df9190c8,182,136,46,South America,20,1078.1
4522468e29534626bb3e7622c8aeaecf,158,115,43,Asia,19,547.28
452289e91b94481893185dc1e19fdb31,180,147,33,Asia,20,1744.63
45230f533fe5470e8f0a0add1e602dda,289,273,16,South America,21,2298.06
4525895dc7d641099ca531b4d8e94892,228,210,18,Africa,19,1924.79
4529530de7a84a5b92c8cd358ce7bc91,108,88,20,Oceania,18,1109.92
452b8facd0c14209a8db7975984beeb0,298,253,45,Asia,21,1589.68
452c05d2cea74cdfa4a82761f565985b,46,9,37,Africa,12,76.81
452e32f9b50b4c23ac5ae9dbad209424,80,21,59,South America,22,190.49
452e913af8714131870a6f31cdd9d3fe,348,327,21,South America,27,2589.1
452e94779d564a7b9918479d5c51dc8d,79,23,56,Europe,16,591.24
45307d869dff47acb77a442860fef44a,88,53,35,Africa,20,493.3
4531b5b2db224e3c90e7652508d1806b,264,217,47,Europe,19,1345.7
45335bf5112d4cf9ae6f6b9ca6e04155,326,289,37,Asia,17,2245.37
4534c0e8711f4b139509a8ac1e50e21d,346,306,40,South America,26,1838.89
4536cb3718634141ab3d76e6fea69728,204,165,39,South America,24,1537.56
4536f874e58c40098fb08b92b4ce2e30,356,308,48,North America,13,1496.6
4537559af7a14c4fa39623b84fbbf795,364,317,47,Africa,19,2025.71
4537cb3832a64f07afa0af223b336fac,139,102,37,North America,18,601.91
45384252d2e54b7cb394057df7990837,206,160,46,Europe,18,1250.54
453a112203714f269aa1330b33cff948,152,115,37,Asia,21,1097.2
453bbe6966f04914b0844ca27c47f6bc,363,350,13,Africa,14,2394.29
453c13073953413393b8d4b6dd34401b,337,311,26,South America,19,2261.62
454001e1c4bb4df6a5cb2e42734044da,271,221,50,Europe,24,1126.75
454076a5b7594f6582e4d4edef20b609,129,91,38,Europe,19,990.96
4540f4166d2d4ac1ba189827fd5b833b,257,214,43,Asia,21,1048.06
45410220aba94cbc8e56fa2fc1206bc5,45,2,43,Europe,22,373.4
4541b439a70f4b0b8e9f81f850d08caf,149,108,41,Oceania,22,431.62
45436142f6ee4600a1dce4531470ab2c,350,325,25,South America,20,3196.76
454393cb2438495699ae49d9f0b56d1f,124,86,38,Africa,18,1174.9
4543acafb17b4615859838dbfc1d5b7a,354,315,39,Europe,16,3141.63
454447f54814449a91662927053e92c5,87,46,41,Oceania,17,694.89
45464ab1fc994c098088aff715857d7e,42,24,18,Asia,19,545.4
45489b0a29eb4b0d9f0f08d1112d3b08,292,243,49,Africa,23,1687.32
4548d2cf36694285bf6269aed4e1680b,191,164,27,Africa,23,905.16
4549341de55142efb81a03f4b5202971,124,71,53,Oceania,18,863.66
4549fd5958e2404296b9d84e114b3b31,111,85,26,South America,24,331.45
454b8449508e403aa529291731e4ee81,358,347,11,Oceania,19,2412.44
454ca87a2ac64e2f8fca476fcce98ad1,318,275,43,Africa,20,2542.89
4551a04aba45419e9ab33d1c6713af54,312,268,44,Oceania,22,1440.92
45538c0c22794a63bfda484a3f4dd877,76,55,21,Oceania,18,438.49
45595259b8474772ab511a1d1bc1df53,252,201,51,Europe,20,699.59
45599b567b264aae8608bcd530408c42,38,10,28,Asia,22,122.9
455a6c463f764e32afc55116efa40aec,362,339,23,North America,21,2775.46
455c2ff9343a4712acb82b49a260cd1d,362,356,6,Asia,20,3384.97
455c32aa943943a7bff9b3b0da77757c,316,277,39,South America,19,1524.05
455c7a2907514dc5991cbab7bef1c447,48,26,22,Asia,24,164.33
455e0f19ed4b464b8af7871d5a5b09c8,338,298,40,Oceania,24,2522.52
455e95edee3a4e928ce5b57e7abd08a5,123,99,24,North America,21,1035.8
456002611e5940c19f7aaeb841770864,48,5,43,North America,16,501.7
45669f8b9a8f41cdbf0e7bb18ac07730,285,246,39,Oceania,15,2008.84
4567251cf1464f9f82b357ccf5b14d91,350,324,26,South America,17,3231.96
45682ec842f74b2986970c7341862ccb,363,345,18,North America,23,2375.55
45688255a80b48988211f9c03efcc2eb,45,3,42,North America,20,194.13
456cc1d65ea1430c9bad1d8c757b1dc6,364,361,3,South America,23,1938.56
456e00dc5a8349eab87ef166a27c59c0,88,39,49,Asia,18,386.93
456e541c51504757b05ef52b6477e20f,28,6,22,Asia,21,298.86
45724a9199ae49d88d572a7f68ab17ed,115,96,19,North America,20,567.39
4572e413935b4a8aa1a0412fbef73957,329,300,29,North America,23,2303.57
4575d15b85cc4d578e4790924068913e,60,18,42,Europe,20,505.93
45783cb9253341b8b3b753cbdb568f16,365,325,40,Oceania,14,1905.77
4579389063bf48f08fc41354a871fef7,175,147,28,Asia,25,1399.57
457a005b4be2481db3ac20701a4354b2,219,179,40,Africa,23,1477.45
457b129f11c342fba6b02dbf8f77e18a,357,340,17,Europe,19,3259.84
457d6ef5b2464c73a60743a5eb69dcdf,309,298,11,Asia,14,2395.29
457fc678f32b49a1b2d910ebd5301b5e,200,194,6,Africa,23,1580.64
4582dc8aa2ca4b50b4142ef8aa256fc7,179,142,37,Europe,21,1217.25
4584010f3dfa4ed0a5970fc9571cd802,124,74,50,Africa,20,787.89
4585a8047e4043ee95b749e26acd4d60,269,228,41,Africa,21,1668.41
4585ef279114470396da7b98ed20f4cd,138,103,35,South America,18,686.67
4586a2e565d64cc59d110ec518fae623,239,204,35,Oceania,27,1514.1
4586abaaf3d4454eb6c4b0eff0c18fee,91,67,24,South America,21,685.86
45893cb443264df1a66d40c3254aac18,229,213,16,Oceania,24,1975.92
458a4ec1585b4ab9829575d91b720f79,167,146,21,Oceania,21,633.1
458a95f1e8194d739ffb7a065985ba58,210,175,35,Oceania,23,1019.75
458b450b50a34f53bacf66448c69add7,295,268,27,Africa,21,1351.15
458d2650690f4bc88dd15f599dfb2545,155,112,43,Europe,21,632.56
458df031a4844770ab84687aa3f0e9d5,65,38,27,Europe,21,447.86
458e2b552b9643adba36a0cf6610a4b0,108,81,27,Africa,20,814.64
458e4fa49afb4a52a0dc50575d8d147e,364,360,4,Africa,17,2012.27
458fc796db7c445da9017e92e76d6a37,173,137,36,South America,22,1265.7
45912a01137445afa6b2276ce7947b12,272,227,45,Europe,21,2272.86
4592cbb9caaf4a89b071014848b8f076,101,67,34,Oceania,23,537.12
459587b64600413b96432c73482062a4,221,174,47,Oceania,22,970.73
45961ff772e74e84a6976fdd0574f302,321,273,48,Europe,26,1426.35
45977fcafe8547718ab008a853ef8ce4,127,69,58,Asia,25,818.36
45993d4f8c2f48b999e498255b2b9826,123,83,40,Africa,22,508.47
459c52a1988f44d0be238a5f2ec32675,115,81,34,North America,22,1042.12
459d47abefab42af9ab0aa6b603ea4c5,162,123,39,Oceania,14,1237.45
459dff7a5d714cfebda5dad1e3132572,158,120,38,Oceania,20,917.11
459ef91e247b4e4fbd2d0eb1909aa28d,273,248,25,Asia,20,2431.58
45a059189949464cba86d1c741c7f2ea,190,153,37,Asia,21,1767.1
45a346a6f38a4990ad5842620226d476,364,351,13,Oceania,23,2371.86
45a6d6eb2de944ea85ad2b12b03e8e9d,58,6,52,Europe,23,313.92
45a8bdf5079b448c90613ea8dd65ffe9,101,61,40,Africa,19,1160.39
45a95a9892964a29ba3785bbfa9d1f62,362,324,38,Oceania,16,911.53
45ab45c6b2844f6fa48cf54efdffa510,189,167,22,South America,13,1578
45ac9ac46e5947a49362ae5a13661ac8,361,316,45,Africa,22,2504.8
45ae311350604cd69d945880ccff5c50,102,45,57,Africa,26,585.6
45b19657c8074df9b982f8a5d4d80001,190,160,30,South America,15,1305.48
45b1993b9e704716b3bef71f0316b84b,43,11,32,South America,17,286.37
45b203345eec4ccea160b2c785bdfa36,251,211,40,Asia,18,1667.7
45b29ff22d2b457894cc1dc14fe8f3a8,99,60,39,Oceania,21,661.79
45b5c0e1410e48e48abefa03a84efeb6,341,295,46,Asia,19,2557.93
45b61a4bd56b41afb35a35a2318da956,185,123,62,Asia,17,899.28
45b63f93f2db48f09914a90154d6c052,216,188,28,South America,19,1624.36
45b77f4b99fc44bfad6a3d5fe6623998,206,186,20,Europe,19,1468.37
45b797b69db64e8fa8e61de420304129,145,106,39,Africa,19,707.13
45b8d249403a43aaa6f5d437e6ee6832,47,10,37,Asia,25,489.1
45bc6bb3e1984f078c220ba47f4b4c29,351,307,44,Europe,19,2867.46
45c0046687c749f08999b3238cdf7991,244,224,20,North America,18,1926.19
45c2a62a2fd6433ab4963a09560913d5,135,99,36,Europe,21,1204.63
45c8e39c60344e02bcac04dad3f36a8e,155,108,47,South America,20,1183.4
45ca6dff44234dd0899f06f3179315e6,155,132,23,North America,16,1220.27
45cd1dc4fd5d44dd8d0d4af829eb2640,346,313,33,Europe,20,2782.71
45cda0fafb834f6890b5b967644a7c2e,272,244,28,Africa,17,2279.03
45cf155dbf274c06a5c046e82bf0f3c7,365,332,33,Asia,22,1843.77
45d06fb2a51f4fd7bfcfb650174c4cab,177,144,33,Asia,22,1424.56
45d3c2af81c74ffcb6b5660faf9cffdf,302,261,41,Oceania,14,2043.66
45d429524c014a84a74507472a57d3df,343,316,27,Asia,19,2741.1
45d5b8baaf614552bf2ba89c3658663b,101,52,49,Oceania,19,657.42
45d7ceccdc05427ab7ca11d96612f630,289,235,54,South America,23,1498.73
45d8bd44a419451a82a698948dbec01b,133,108,25,Europe,20,743.59
45dbecc1661b4c729e7566a988e75bab,98,73,25,South America,24,844.84
45dcb943f3484af3832d8a1d8ecd6c0a,365,344,21,Asia,22,2517.49
45ddd7cb97864a93ba3b9143b51e548e,305,269,36,Africa,19,2195.61
45df53bae8ea403c9a65e78e8392b3af,59,35,24,Asia,21,363.24
45e086437afb4d48882885481e5a44e0,358,337,21,Asia,21,2587.12
45e18f58848a4e359f03af8cf4578431,109,84,25,Asia,14,601.26
45e1d7ab1c0f40148e8a28ec14660722,188,138,50,South America,22,859.5
45e3ca29b3e345faa7858ed737415a0c,312,288,24,Europe,15,1965.41
45e817d8add644188be7e988a79f3d5b,344,297,47,South America,16,1294.79
45ead85f69a24b49b5ba4f118162c544,98,51,47,Oceania,19,647.85
45eff54a4dcf4c85ae099da9383d487e,188,164,24,South America,18,1657.61
45f0bb06402341bc9dce2b1a0b19db56,135,73,62,Africa,16,398.21
45f1dc2890414f869c828c0df5c422da,329,293,36,Asia,18,2312.48
45f2759bb6bd4da5b8c0bae2531e6d1c,36,1,35,North America,24,298.07
45f2ac1862a34d0fbfc610bda6cf92db,220,191,29,South America,18,1354.62
45f3a539ddb04597ae87d58212a9f3bb,178,141,37,Africa,24,1054.65
45f53c48daca40d6b1263afa586a5095,96,79,17,North America,19,592.95
45f61d9063f640f8ba613873dfd77c43,357,308,49,Africa,22,1362.46
45f8b4182fc04e32838c6447f8cc79ce,360,322,38,Oceania,16,3116.22
45f8c66369d743188bc0579bc121250b,246,205,41,North America,19,1725.59
45f914d9a6624888b8c9b60ca76ae3e3,218,177,41,Asia,17,1520.27
45fa9fa4dbbf4925ba5fcc679c50f1db,363,347,16,Africa,19,2005.4
45facf3834e3497d92c9edbed5b5180b,273,248,25,Africa,22,1759.72
45faf5bf32214c00be294c0e2a920cf8,188,148,40,Asia,15,1569.93
45faf8aa7ff64c459505253ecd4ff50b,299,251,48,Oceania,20,1674.79
45fc58ca596c487480fbeda57b736e83,123,71,52,South America,24,402.03
45fce6616f574831b23938318526913b,318,290,28,Asia,20,2444.68
45fd0670ff6347dca37af2f52aa5d246,365,339,26,Oceania,23,3125.07
45fdcc3129584df3bbdd300441e77443,88,45,43,Europe,22,424.16
45fdeb96bb9d4f188da5d0cc3cec2a86,338,285,53,Africa,18,1081.54
45fe984defd1415d943cf26ea20010e8,138,103,35,South America,18,672.04
46002efb0fee46449b91652944461571,91,55,36,Oceania,17,596.45
4602e73874ce4dca81545c6f0d57d842,279,239,40,Africa,24,1275.3
46035690678f41a282a320a7888b1ba7,360,307,53,Africa,16,1354.43
4604eb174a8642eda8b167d993a4ebc1,347,326,21,Europe,21,2500.05
4606812d46be4b118d7353104b9f4f2b,176,149,27,Africa,22,1286.08
460692f7584c4070a3a03d6892dc0b6a,271,230,41,Asia,22,1862.3
4606c8d9b17143e78cd19d02b8adff6d,175,136,39,Asia,21,704.97
4609fd03f5fc4960aeb8f85ce23b7364,297,264,33,South America,21,2070.82
460aac2027d24fbb9bde7f3fe5719df8,155,103,52,North America,23,922.19
460c8b6ebfdc42edaad000a8c9be22cb,110,65,45,Europe,21,177.97
460cab42973447119104301ef3142c28,189,148,41,Oceania,18,1766.83
460cf3dfeb1b423ca140998f71fba0f7,246,199,47,South America,22,1571.89
460e096193524905a304a7a9ad5b04b0,58,12,46,Oceania,21,269.47
460ec693adb2447d81b6665fc46dccdc,203,188,15,Africa,21,1191.16
460ed7c98fb942e995a8736a46224dcd,351,326,25,Oceania,19,1802.55
4611bf3485c5475bb64f06136147bf2b,174,120,54,North America,20,817.13
4611dc4ea3ab41bd9e5fa9a02a7cbf2e,188,162,26,North America,21,1235.2
46129de5126141a7a9f25992e8643cc2,220,178,42,Europe,20,1465.67
4612bc31c0a3457caf28e2cc7106dcde,154,120,34,North America,21,828.85
46170afce94e44bd93f082dcca3a0228,360,319,41,Africa,18,2300.18
461712a298d04d43afe1cc8639e38da0,22,4,18,Europe,22,270.75
4618910b1c76477bb082057a29ade3ef,125,95,30,North America,19,681.72
461b574076964b8586d302e1a4973407,273,249,24,Oceania,23,2046.97
461d8936c1eb498db1e09b0750acac7d,355,321,34,Oceania,22,2736.03
462164f7039f4e31be4b677085955db1,302,279,23,Europe,18,2411.58
4624559ee1464ba996486fc01a351ee2,336,318,18,South America,17,1959.77
4626c2ed6f3047fb9e6e1a62ce2e701e,121,100,21,South America,19,859.76
462744c9d8334c4d8cded05cdb49e6e4,31,10,21,Europe,22,280.73
4628ffa320af4a3fb19e42eeaa727335,42,3,39,Asia,26,364.22
46308b4513434ee7b7a36a3a3f7e142d,246,216,30,Oceania,22,1497.91
46325cb6a2d94740bca11892d62ac646,363,349,14,South America,15,1570.21
463390bef91f4108a06735e4027eed1d,322,311,11,Asia,18,2891.37
4633ce68a723432aae72de24e0dc6f4c,218,162,56,Europe,21,896.81
4634d98cc4da4fe885a9583f83c85358,365,316,49,Oceania,20,2186.28
4634eac9c9164b44947d46bfb8f69bf7,201,171,30,Europe,24,1011
463a00b81f914912ae6165087c417941,216,185,31,Oceania,22,1415.82
463abba5a8bb48419837050418081fb1,103,81,22,North America,20,838.19
463b409765cf46deb03ab3a397e162a2,157,128,29,Europe,21,1194.46
463b4f5f2dec4e7cbb722857e877cf50,61,39,22,Oceania,21,300.69
463ebe8c1de94f09995c0c0e73d40f3d,365,343,22,Oceania,20,1910.72
46406cba0d5c4aabba9c8284a0643827,103,58,45,Oceania,17,918.66
4640e593849f4edfb4161bb54cd0f8ec,308,290,18,Oceania,16,2188.08
4641c9172fca49dbb56278811fd9567b,100,46,54,Asia,18,689.27
46422a8f7d354f3b90ddcdb7895e3f83,351,299,52,Europe,21,1692.85
4645d9ccbf0a4929a015e1e5a4380cd3,63,25,38,Oceania,17,345.06
4648fd46560a472498350f45a97d3218,193,147,46,North America,16,898.65
4649be316eaf45f7ab6ac5940c49df26,239,216,23,Oceania,18,1912.9
464a0eeeffed4de4b695c906c434ede9,295,271,24,Oceania,23,1872.8
464a6570621e41df82097a385f03b104,34,6,28,South America,19,104.33
464bdb66f51a45af888b807ba7ef1440,356,304,52,Oceania,17,1598.24
465175f85f8c41cf8ddca4654385881b,243,207,36,South America,20,1197.01
46532a789fa1426ea85724026c542a1f,213,180,33,South America,12,1522.17
46556fead6a847d1a49090705ffbde84,352,337,15,Oceania,25,2881.24
465657abea7347a39f3c704c74231d59,222,199,23,North America,20,2263.27
465869ea4c9a4a97adae550c97023ada,175,132,43,Asia,21,1209.92
465add448d774b32ad1593921d8e9bae,187,155,32,North America,22,1297.59
465c368abc4f403ebf4d42e631faf96f,365,364,1,Africa,20,1443.72
465cdcdff58f493fa9c74c7a74bdd270,136,87,49,Africa,18,500.93
465d4895da3d4b3c83a95e6c86e7729e,152,108,44,Oceania,22,1155.48
465ecd079fc24a8daf29f99a5035192b,363,352,11,Africa,21,1880.73
465f6b0d9178447f8c67126d72548753,262,227,35,Africa,18,1544.8
465f6cb5a85c4e0a8d7f9ad5c973b4e1,61,5,56,Oceania,13,436
4660c5c0878541e08836dd29ef51c459,345,314,31,South America,23,2952.72
46649c60d83e4ed38f387eabce7417f8,358,328,30,Oceania,23,2622.83
4666b3274b78497d9d0eb74bc3fab500,365,316,49,North America,25,2249.72
466bb70b684546ccaafec7cb7c06037e,202,175,27,Oceania,26,1762.11
466d0f0a1a5b46c08f1eb51d58a2dfa9,112,93,19,Oceania,22,961.21
466e2ef067e14e8ebe914b27d2dad9fe,62,23,39,South America,23,318.33
466ea84a93f94cf39d1db5967c587ee5,364,340,24,Europe,24,1689.28
466f5fc84ba14111815463477ba7ace0,189,155,34,Asia,21,1912.69
4670999627cb41409ec9c78a65850423,364,326,38,Asia,20,2728.76
46709e55fd9d4340987080fdc0cc6a3d,208,173,35,South America,16,1073.42
4671573216cb402e96e0ca3ef924757a,365,329,36,Africa,20,2032.78
46729196268a4ae08fa0fe969dec08b0,90,43,47,South America,23,583.58
4674c6730bba4db4a8f27f6b456d739f,192,154,38,Asia,16,1020.82
4675e311e8ff4cf8aeb5b65bdb2f8b29,365,364,1,South America,27,2384.72
46766bd3ac984fbfb4364a510f81e4d1,232,204,28,Africa,15,1392.83
46769dbcf64b42db93344deedb3ca2cf,41,17,24,Oceania,18,425.1
4678061870d74fa4be8d867ba7af2996,339,293,46,Oceania,18,1916.12
46783498ac8348189bfdd0e9055ebfdb,99,65,34,North America,21,980.14
467a31656ce54a12b3068903d9b4833a,191,145,46,Oceania,21,669.65
467b4cbfc0154270b9943c3f3b7320a5,164,126,38,Africa,14,949.24
467ce7f9f614463c8d28c95d3385e63a,202,167,35,South America,17,1518.27
467e47e5c1c443b9bb67ccf59b6dcb07,194,170,24,Europe,19,1144.36
46816da5144b4146ae6cb905ff68df0d,323,280,43,South America,18,2281.27
46821db48ecc4303aa37c7e3d70d7e80,364,339,25,Oceania,24,1972.18
4682e904c7f24ad4944e862fdfebad50,253,213,40,Africa,22,1909.39
46842d38f0574f8789bd18a664e3513f,361,350,11,Europe,22,3192.06
4687083ab34e41a7bf65dcea2a47b0d1,250,192,58,Africa,17,1187.7
4687b44ca2e34802883755e1cb1fc099,363,334,29,Europe,21,2749.22
4687ddfd83b54387ad4756bc518453a1,237,202,35,South America,18,1729.45
468825e3cb45494db7baa06d6b35e697,339,298,41,Africa,17,2536.87
4689b432602f421099145562764502ff,123,107,16,North America,26,1051.04
468a50452d1a4aefaaed0b99f6261499,279,259,20,Oceania,20,2239.88
468b85821ec54b7498e485b855969252,68,34,34,Oceania,24,437.09
468ef69b13884fe4be9da62cdef59ece,161,139,22,Europe,15,1319.77
4690ba7e80574f14bfd7d7451de0ac51,182,134,48,Europe,17,1121.86
469691580bba4fcb884a2bf0472cbec1,348,321,27,Europe,20,2373.44
4697b715098742138a1eabbff81e556e,136,91,45,Asia,19,662.76
469a6b585ec247ce997c161997bbb9db,321,277,44,South America,22,2303.29
469cc745d1024aeb8035f7e1d1fca229,54,15,39,Europe,20,462.38
469dfa1053264dd79c30699cb2be22b2,199,165,34,Oceania,17,1413.31
469ff95a875f47788d2fff5be3cc7613,67,37,30,North America,22,591.59
46a00bc1424d41b195eb090bc0fea93b,105,79,26,South America,23,821.12
46a0a0210004460797da843757f5340c,302,253,49,North America,20,1982.54
46a242b056c245569456a56480cf7c4e,248,195,53,Europe,22,1150.22
46a24ed9b2874819aec917d3ea54fe51,61,41,20,South America,20,519.15
46a425a86e574140b64d211873ab83b1,186,151,35,Oceania,20,1439.17
46a56b3b67c54356a2b5fe986ddc645f,53,26,27,South America,20,166.34
46a6cc328897465f84cc06a02e76cd13,364,349,15,Europe,18,2461.83
46ab25364bcd481a9e154f316243cf82,196,141,55,Europe,21,959.81
46ab3a8f42aa4e4aa4ce7313e2a10019,235,174,61,Europe,24,1025.74
46abcd6be29941acb4527d1c2f53a10d,362,361,1,South America,24,2392.11
46abf81b879748e5acf80eb2f99e50f9,118,79,39,Africa,15,720.58
46ac83037b674ae686c2bbd9b125eb20,340,308,32,Europe,17,2964.41
46acc210d41e43f6a689c410a87d4881,254,220,34,Oceania,21,1787.07
46adaaf70b9c49f09cdb1b8f8833e553,160,109,51,Asia,17,667.87
46ae0dc2032042f7b53e798f6ff6f40f,114,101,13,Africa,19,777.67
46ae93962ba7490d83d8efb346707747,318,271,47,Oceania,22,1615.11
46af1527b447495aa9ebe39f5ca7a236,135,81,54,Europe,14,412.86
46b0b35e641849b7871c4f55a445c308,75,17,58,Africa,20,600.96
46b8a03b2a054d35939d4ca5849687f2,55,32,23,Oceania,17,571.35
46b8ae6c53a14325879260e5295923d3,144,96,48,Asia,19,635.69
46bc12e301da4bdda7a5adde638ec919,301,264,37,Europe,20,1780.34
46bcb4862d2d49628f6a41b8e7e27436,129,94,35,Oceania,23,638.23
46bd34dcb7474688860941a554bcea99,238,212,26,North America,24,1578.72
46bdc0a633c4498abf353c595aea6433,121,91,30,North America,24,1124.34
46bf344e200d40aebc378b1ac78dbbef,80,51,29,Oceania,24,556.84
46bf909b06e7499d8d68ec0bb226b707,202,148,54,Asia,19,1241.6
46bf95a3cb8b41be9ba0e8470cbed049,364,344,20,Europe,20,3105.47
46c2746f5056477c88a93efcabda9cc0,81,29,52,Europe,22,608.73
46c3508034be410ebc0bacd5e936d288,352,324,28,Africa,19,2188.56
46c363c964cd47379d07329d118a358f,89,61,28,Europe,18,1032.82
46c919ec5c38450cb3e30cfe6e4cabda,364,364,0,Africa,18,2756.63
46c956f58e954a59b7f3c1d3c8e761f9,187,161,26,Europe,20,1562.99
46c9fc0d59034b4f9ff942fd500fb4f3,207,170,37,North America,23,1863.83
46ca4971d8154368a139a8d645193d6e,306,268,38,Oceania,19,1688.79
46cbd806734344bbb90947fb4c2a78a1,280,247,33,South America,28,2466.47
46cbdad4be21433d9681736db65bebf5,255,213,42,Oceania,27,1266.57
46cf5860143c41039c78cbd35d1f0da6,117,60,57,Asia,18,611.66
46cfe7d0db1c436cb95c5d7dba364e60,297,253,44,Asia,18,1830.7
46d0a52c380a4e339b74cae50339ef12,107,66,41,South America,19,612.34
46d112bc2e0a4d7e9168e0ff957c1a3d,233,198,35,Europe,19,1587.26
46d533e26ccc4c579ce2593e7b8ef242,105,83,22,Oceania,18,1013.33
46d547a903aa4d01826345bcd1f00b85,233,202,31,Oceania,22,2356.16
46d6c555106640d9b45aaa5745724698,346,288,58,Africa,19,2102.27
46d95f3bf30f4b9e95a173101ab25e44,352,298,54,Asia,24,2001.16
46dbff68d91f43beb9e6c06843f7de67,138,102,36,Africa,17,1118.28
46dc9a63efaf4e159a88be99a2b4e22a,131,95,36,Europe,26,982.37
46de782d793c40f69a12a949bff660f4,196,136,60,Oceania,20,1191.51
46ded917e5514afdad431bfadd31e245,365,320,45,Europe,22,2175.52
46e05af17f2741eea23582cda1532a03,316,262,54,South America,25,1571.69
46e73a97b0dd4c9bac6e71118a38af94,268,235,33,South America,18,1477.9
46e748a14f8b4c6b891eb8bf5579265b,364,340,24,Africa,21,3041.38
46e760cfa69347bc9a5538dce5f7f46c,122,88,34,Europe,25,1125.57
46e8ad63da8e4e249a048c9e62894a47,325,286,39,South America,16,1752.24
46e963fc6172453a9ef74d07e41f56e1,96,75,21,Asia,23,623.9
46eba277a2b44250ae17c51a2d8ee516,247,225,22,Asia,18,1721.35
46f186d476b04c4b8465a5eb6bbc84c6,265,252,13,North America,18,2012.36
46f1bb9d0ba14c64b9f4b255603bca61,365,358,7,Africa,17,1532.78
46f37d2ed9ec4236b139a5810e255a3a,116,64,52,Africa,25,800.94
46f857f7b75441e19cf031f0cc485205,147,91,56,Asia,19,487.57
46f8c8adf3144c87ab6e067cc678f8a5,341,298,43,Africa,21,1944.49
46f8f30f22994be9bd361453dfa11dc3,270,239,31,North America,20,1547.94
46f930410e9240b8815b6508dde54221,348,290,58,North America,24,1478.01
46fa7955ce4e494ab745daf480a27ece,256,207,49,South America,19,1546.08
46fc7a1912f54425b8dc96b4c253c1c8,72,34,38,Europe,19,175.77
46ff2423f96843b081bf6d61defb4908,202,149,53,Asia,18,749.29
46ffe01aa2f3411986f263301a75eba0,266,225,41,North America,27,1310.91
470051283587464ab426a8f0e5883204,109,48,61,North America,22,272.93
470105163118457e849eb2e3789d39e8,353,321,32,Oceania,19,2384.66
4701ce7fb9844f378488c4641d5cd48d,55,31,24,South America,15,579.25
4701e8437a644b92af7f5bdcd67f0f12,193,141,52,Africa,22,962.81
470230facd254c80ad0d3c30d04a2bdd,292,240,52,Europe,24,1527.44
4702b11d262c44be9261fb5f1ffa6e2e,112,61,51,North America,18,723.61
4705402dd69441de97a359f988d27885,154,106,48,South America,25,1042.18
4705892de0ec45b28105175a77a90756,223,169,54,South America,20,1271.51
470739467ff64c01a4ecc88afc869b89,229,203,26,North America,17,2250.45
4708882a55f1448f90357e646e4778f6,191,148,43,Oceania,21,864.28
4709d14b4a23414eb5456110b37d5f7f,223,197,26,Asia,19,1131.01
470e3c1622d44c029144cadd4b195873,251,206,45,North America,16,1445.2
470e520a985c40969a770aef6b1446d8,220,186,34,Asia,18,1161.31
4710440c028646ae91434f7983418aa1,320,280,40,Africa,19,1517.19
47128aa42464422ca1a26d11e3d62f05,257,234,23,North America,20,1543.99
4712b332473442329a49a0a37579366c,363,333,30,Oceania,17,3041.64
471337c2a1884649aefb98ec1617d159,101,76,25,North America,22,791.1
4715e354dd3f4f67b53ac1360b85b732,39,8,31,South America,20,181.16
471655ae89ea4b27b99ef4e64ae83b36,53,3,50,Oceania,18,244.14
47170ba9a20d47d786cee7e31237c27f,75,47,28,Asia,20,625.63
471844d875564e92ab62e15a99125587,361,336,25,Africa,18,1652.94
4718878970fa4dc281aed0d65bfadbe0,124,98,26,North America,16,999.69
471899a9534c4f6c9e7a3a9d1a22232f,151,124,27,Oceania,18,1801.91
471a168dc21641cb8ea7019574a2354b,85,59,26,Africa,23,445.1
471c2d9efdec4f1bac63c6c31216979c,272,217,55,Europe,22,1802.38
471cb219bd3f4ee1af2d6e8153655453,114,88,26,South America,24,944.54
471d86c318b4490aa312caa1398d6cdd,97,50,47,Oceania,18,380.32
471e378bc2d0430a9375ae2481bc902e,138,99,39,Europe,21,840.42
471f18a42767408e9456ceda41ace9c0,262,231,31,Asia,16,1139.74
471f9ac19b684b61931edda1c70e7069,359,315,44,Asia,14,2847.61
4720d81361ea4497b0adab956c36e985,365,356,9,Africa,19,2041.06
47215f46dbea4014b3ba24a931157006,68,20,48,Africa,21,225.26
47232e8200b94a0391ee128426e519a8,88,40,48,South America,20,178.87
4723a5b2a9ac4e8abc530329a0777464,189,149,40,Europe,21,1430.53
4723e32e60254f1f803baddad782f45f,50,30,20,Asia,22,133.59
4724782ce81e4d29b00afa003edc887a,218,180,38,Africa,21,1500.52
47281d4c6f8d458fbb5f2795b5085533,334,306,28,Africa,18,2861.23
4728b53bf2d84a49a2810746e600dadf,346,320,26,Asia,15,2574.13
472915b6dd90437cbdcc664a44c1bb7a,69,19,50,North America,20,382.76
472aa899b7c64dbc95527195119d957d,95,55,40,Africa,23,690.66
472bbc1828c0463a852e9f182564eb54,364,343,21,Asia,21,2329.99
472c0eda0ba84042b18efe4d1d5b15df,273,230,43,Africa,17,1524.93
472c1113eaf54b69b24adcc048f496b5,365,356,9,Asia,19,2438.44
472e94f9ed38488987abc36b83b3eac7,284,230,54,Africa,17,1492.4
4730af376d804bb39bfba1b9881de7f5,162,136,26,Europe,25,940.52
473476c0f00049798e6ab4e7102d0c66,269,240,29,Asia,24,2494.03
473666dac6af47f6b1379d1cf6f12778,73,28,45,Africa,18,620.95
4738aec048124503abb00e97eeb29fab,360,326,34,Africa,18,1752.56
473911503fac47c19460e785ad0c77a2,143,99,44,Europe,17,906.44
4739788c78914cb693d69d694333d945,230,181,49,Asia,18,1587.66
473c6b0a956a43ada68acbf1a8400b9a,37,3,34,Africa,20,343.79
4740a2c1edd14e478b6e5ffeee1c7a89,182,144,38,Europe,19,1451.73
47412b6d538b401189fcdaf3bde4cf4e,159,123,36,Oceania,18,604.95
4741cb8b171141af8a134fbdd5dcf411,365,332,33,North America,22,2666.83
474309ba1cbd4cd3ac2f6546ffa9e4bc,280,230,50,Europe,14,1231.94
4746c466d7c6437b87b669d4328856e3,144,105,39,Asia,16,617.07
474aad397e4f48a291f159e1cbc7def8,249,201,48,Oceania,16,1507.66
474b86fb527a4aecb81693493b8e5fc8,108,59,49,Oceania,17,475.86
474d3107058e48ab98f5755ee706d2c3,326,281,45,Africa,22,1465.08
474e34f013ca4bf591d1518b60bb9a40,287,261,26,Europe,18,2107.15
475117e61dcb4be19efe327d4c705d47,337,293,44,North America,23,2110.56
47567d4e0297452396d82452226afa35,78,50,28,Africa,23,206.75
4756d038ff8640429e1e53574cf4c5af,364,336,28,South America,18,1953.51
475767c2e38f4bf5ab7d662c3e7a68d5,360,304,56,Oceania,21,1589.58
4757ea7ba232449d9b9abe005e95e1fc,185,138,47,Africa,21,850.72
475a2f71c1234631b056969e5d5a20bf,169,117,52,Asia,23,948.77
475ad9202ab64e1298119512ce8702d9,271,243,28,Asia,21,2246.62
475b3544c8a444078d6a44b1a0c1922e,162,116,46,Africa,21,606.58
475c89c242604a5890fb919ca88c5dc7,59,2,57,Oceania,23,575.39
475d631d808d45f6b1496e00cc52ef44,59,6,53,Africa,19,324.3
475de4d8c5834c63ab8a45be5c0233d2,196,153,43,North America,19,918.84
475e51231ca94c3caa529f30e2a0d794,78,60,18,North America,16,680.93
47611c92444649148139d71e530fd423,278,233,45,Europe,21,1970.08
4766754766d247869137127fbea229cf,73,33,40,Asia,19,548.21
4767c2ff3f91427fb51b6d3cca88bba0,281,254,27,Asia,22,1979.3
476b557d60ae42f6b547e0fe34ac50dd,212,189,23,Africa,20,1801.57
476e555071e4473c94a75f858f25c6f4,239,211,28,Asia,15,1842.94
476ffdb4c58949058104ef92f4149272,312,250,62,Africa,17,2223.98
47719a6dab7c4b62a606acb080388933,324,288,36,Europe,19,2289.05
477225a751734fe39216bf05127c884e,263,218,45,Europe,19,1736.97
47745e53403c4ee8a5903f9fc5ffa810,266,225,41,Oceania,15,1555.4
47748500aebd4956a19b2a75be4422d4,299,264,35,North America,23,2141.53
4776165882f24995aa3e31fed3539d74,146,90,56,Oceania,17,378.98
4777ea70eb3a46f2846c90ac7ddece43,246,210,36,Oceania,28,1926.06
477a7f9d8eb1497d81fc77a623a29b76,332,307,25,Oceania,14,2520.91
477fbc67ee4c4869b202844b93937ce7,364,316,48,Asia,17,2156.7
4780426c9633404ea89bb5c70356407a,255,220,35,Asia,17,1656.7
478097dfe5204bc29d9ad3d900d26069,84,36,48,Asia,19,288.27
4780e315d4cc4b4aad518bb3b254df93,352,307,45,South America,16,2176.66
47829b52a50a4cecab7035d46c522f31,38,18,20,Oceania,20,428.15
4782f97f6ee34ef6b21b73719ee7d11f,54,12,42,Europe,23,595.51
47842fd9c709434e8a5e6aa68d3ce2ac,164,113,51,Europe,18,665.11
4786205ce6ff468a8b6d772a452cb7bd,364,338,26,Oceania,20,3206.55
4788e490136e4998b551a8dfc61961d6,254,227,27,South America,17,1154.21
47893d30839d41e8aef28128aeaaa802,317,278,39,Europe,21,2032.7
478a21d0c6974b88be45d734942bb6a8,281,254,27,Asia,19,1997.19
478be116e949486eb2d0b2b3e279ceb9,185,150,35,North America,19,1208.2
478cb1a7e8db49e199e69e6c143f75b6,127,90,37,Asia,20,614.97
478e64411a33431baaf5a3b1f1b46f42,291,247,44,South America,20,2387
47910b62a3694ac9b0bd27d2acba35a8,200,163,37,Oceania,13,1385.37
4791323f61ef48228baa2cc5dd8cb840,275,218,57,South America,17,1718.53
479163103c604f66b8f3b6dbfbf3d4ea,246,229,17,North America,21,1671.32
47922200cdb4480380b4469bbeda209c,150,115,35,South America,22,1213.12
4792737478cc46719f89cc056783b9dc,259,233,26,Africa,19,2294.82
4792f33089be4fc6961d64d8bb478f9a,352,322,30,Asia,28,2380.03
47964596fb6f413fb3fef6ffcc17261a,343,296,47,Europe,22,1936.25
479781447ab94c5d897b490b4fd186a4,157,110,47,Africa,16,623.96
4799e022d15d4a469fdcc01e63fbe50a,354,321,33,Europe,19,2130.09
479a972036874284b8e32ca3585f82d9,52,15,37,Europe,20,399.1
479ddd9c7b9445aab935ccd6831bf52b,282,259,23,South America,17,1557.46
479def77e8f9457abd8838ceb0c184b4,88,40,48,Asia,18,453.02
479f158f654d474780fafa477c884d5b,133,110,23,North America,16,1243.52
479f8bbcb07b4168a8f5e8260ecd0bc3,360,333,27,Oceania,16,2618.39
47a03423927f4b2db85c95ac404b63df,352,322,30,Asia,20,2796.11
47a0f4337fe14276a823c22f6879b0fb,365,357,8,South America,23,2677.66
47a202568293402a82ca3478d4c175a6,363,336,27,Oceania,20,2990.71
47a28b8493b14862841f25cae6853b0a,244,201,43,North America,19,1304.99
47a5433f47c34607b49029f6f25e14d3,291,236,55,Europe,18,1932
47a646aaa7a64566ba7c7eea373b5f2f,123,71,52,Oceania,21,688.13
47a91c6bc7ae4430b315c8745f855d3d,191,168,23,Europe,18,1705.76
47a9b4cd499c4ee986358834806a4076,227,203,24,South America,21,1307.03
47aa390b44c9485a93a52a046a7f89d9,131,94,37,South America,18,849.65
47acc4f730f04d05ad1465f958ce745f,151,122,29,Europe,20,1355.37
47ad196651c14e659d429027e962e286,132,92,40,Oceania,21,815.03
47ae6e9a089740d0aadde18184081e95,364,360,4,Oceania,26,2109.11
47af8d9bbf6d4f53a8f70819eacb6757,365,360,5,South America,23,1655.67
47b4ecb6835b43b6804d7a6af406d2c8,365,350,15,Asia,23,2780.29
47b644788d2c4c84b097de344e83cf70,365,347,18,Asia,15,2055.66
47b6f4f1ab2f4c498998e654b414116c,93,57,36,South America,23,382.88
47b8758c4e3d4d8f9760fb8eb7a9adcb,211,173,38,Asia,21,1388.71
47b8aa7b4318487088b6cf0fb022ed85,264,220,44,Oceania,18,2072.07
47ba7e3b95e94461a261aaeba8f7e653,190,149,41,Europe,19,1035
47bc69db402846c0a52cd094850737b0,351,306,45,South America,20,2956.03
47be7283019d4d6fabe2fe9c0e091737,239,220,19,Asia,16,1612.17
47c07ae0096b432b8c02b5c16bff51be,355,315,40,Africa,21,2139.49
47c0c5be51624c1596eef55067f6ae47,278,239,39,South America,25,1816.26
47c282794b4d4d36b141b288a1a7737b,341,310,31,North America,23,2347.27
47c3a44e5354479c86778cd9ceb984f8,145,104,41,Oceania,26,897.18
47c53804b8f241b2a69c8adbc91b1933,69,50,19,Oceania,23,617.47
47c66136c152473081f065eb7c867302,262,221,41,Africa,25,1847.22
47c71dd60d3143198727063cd9b9e94d,364,319,45,South America,24,2943.54
47c734f948ae468fb3fc257ca34df284,40,17,23,North America,14,194.93
47c9487680df43f3b32e967bcb7d1134,37,12,25,Africa,20,316.92
47c9e3d93c524328a39b3d81baae0647,123,83,40,Africa,17,980.43
47cb7478a0af42609c5da68aa3b1e1d1,289,240,49,Asia,16,1240.14
47cc44311fe24412b1702be1d35d40b1,365,351,14,North America,19,1868.16
47cca4c170854c47bbf15f73d15df8d4,293,254,39,South America,21,1960.64
47cde157b8544cc1a44601e9b290a187,127,84,43,Asia,19,931.12
47d01f7d3b6644c586595a4307cb5d75,361,349,12,Africa,21,1649.74
47d072f5d51c415a828f354aef56cb64,309,296,13,Asia,20,2662.52
47d0b2f141a343099f4140c56c8b2011,325,277,48,North America,21,1902.28
47d1f32f1f25437cbce7fa140d8923d3,73,47,26,North America,18,294.64
47d24c19e15e4172870071777c755817,365,361,4,Asia,19,2640.23
47d2b34795dc4435bb5194db0f4d4d44,92,71,21,South America,22,653.05
47d2e40ef90d4f489bbddd4b17cebffe,295,237,58,Asia,20,1699.44
47d35b8b00d546d2b0308bd7247afc50,90,77,13,Europe,22,569.39
47d47c816c5b4f7ba1c9e62a069db3ce,92,45,47,Africa,19,430.96
47d5445b5a104a7c8a6199f8dc4079b4,161,125,36,Asia,23,1138.88
47daac61ceac4f2f99a14d2d9fd3f42c,365,358,7,Europe,23,2078.79
47dcdad73a7e43a2a181a94a26368cd9,159,109,50,North America,22,940.15
47dd99bcdac8493789bf43e6854a2101,193,173,20,Africa,17,742.63
47de9668ed8f466899a369f88a2c5cb5,258,202,56,North America,26,1169.43
47dedc85058b447ba34d43b675069fcf,229,197,32,North America,18,1683.89
47defa81ee50474cbb5c355a842fe4e1,241,195,46,South America,17,1429.6
47dff97609a24b6284ec83cb08e49c46,119,81,38,Asia,16,765.67
47e00d32fee749498237c3d4d463a06d,50,4,46,Oceania,16,314.23
47e389f460944062bcfaa0309916d2eb,348,314,34,Europe,19,2448.13
47e55f4b9fdc4c38bb23948555f8270d,362,337,25,North America,21,3427.91
47e60cba182644d2a8e16738e9ff413e,49,19,30,Europe,21,346.62
47e79590d3764b32b4168ff541e318e2,142,117,25,North America,21,898.56
47e92b8a9c0d480d87240b9b8ba2cb54,168,129,39,Asia,20,1410.55
47e9f61dea7d4bd88999741857108f2f,105,52,53,North America,18,544.79
47ec30101a91422887dee371bad78b1b,47,18,29,Africa,24,381.7
47ee0616a4ac437fa2ad70c8319d6520,53,21,32,South America,23,424.98
47eea43f26094eac81966f680da7fd0e,265,223,42,Europe,23,1862.64
47f190deeefb47ea9bd3e329d642d30b,40,7,33,Asia,25,311.38
47f1eb3511234a3087dec71088f7d774,282,238,44,South America,21,1342.9
47f288dfc2d14ee685d639659478d5d1,275,231,44,Oceania,15,1619.36
47f3404e30bd4fb78e5073c76aad5a24,196,169,27,North America,25,1647.03
47f432e64d0d4716b55950b18fef86b9,133,112,21,Africa,20,1350.66
47f4fcbe60e141569ff3bdea750066ab,115,88,27,South America,13,625.46
47f5bf472a8744f0ab7801a0c71c1567,299,250,49,Europe,24,1783.55
47f698a1e46b4c1bb859345b4b7783fd,365,349,16,Oceania,21,3101.07
47f76e179af34fc1a0d94e7ca29f3b58,340,313,27,South America,21,2589.76
47fa852e307b45309ff2d7754ca0b09e,181,135,46,Asia,18,1152.46
47fb505630b74310a64775478e1a9b85,199,162,37,Africa,18,875.46
47fb72873f4443dfbc9b436cecb2630c,289,235,54,Oceania,19,1833.42
47ff0d0f9e2f4cd7b35085913cf61cf0,223,194,29,North America,23,1321.15
47ff99060e264017b48d9ed6b3ab286a,338,325,13,North America,25,2492.41
48035aa20d674532ad99a5d605fe95db,86,37,49,Oceania,20,680.1
4804cb7480994dd2960f851231c51de7,55,5,50,South America,20,276.42
4808581e7f524ae596187359f9724cfd,353,299,54,North America,22,1156.51
4808c429632545f2a96c579a94256814,109,73,36,South America,19,738.06
4809c99ba96542f5a2800f11135a401b,70,27,43,North America,23,296.37
480a8e89e09842918edbcb1a018719a1,196,148,48,Asia,22,1543.38
480b648addd449b6a5cd131e13fdb0b2,135,107,28,South America,16,1146.38
480d0d2dcb28434785d863308b8773b8,156,133,23,North America,17,1248.53
481182df7d004307ba4e479ea805ce1a,259,209,50,South America,23,1854.95
4813ef08fc0e48dd88f71a3e38ab006a,47,16,31,Europe,19,392.05
48147c6c00db48e3b80970785b8c80b2,234,215,19,Oceania,23,1800.82
48161f90f8884b71b85ca894bf9af21d,214,169,45,Africa,21,1156.23
48164847ce024a1bb617982bc8a857f2,362,330,32,Asia,23,2323.25
481736a64546444f98464aad809193a4,318,279,39,Africa,25,1770.04
48183ab1c4bd4d75ab72c68035b3f22d,312,288,24,North America,17,2464.09
4819991cabd8472796ca37b288dce577,241,210,31,Europe,21,1412.89
481a40d2059f40118f445d53950642cf,301,260,41,Europe,22,1863.65
481b98cd6d154e4b9f151fe69263a3ee,365,340,25,Africa,18,2348.41
481c275d7ee74b0a9bec74a3f1ec9202,323,289,34,Africa,17,2017.1
481d104dc8c049ee8a909249903160a1,69,43,26,Africa,20,496.07
4828bec4b63646999beea74584204759,283,258,25,North America,21,2255.97
4828fa2a3a7f415281d119d6d00b144b,128,95,33,Asia,22,659.93
482d988f8756434d94e87495502b309a,171,125,46,Africa,18,768.12
482e23f543c54e0f85e4ab9b364df8c8,257,209,48,Europe,21,1523.77
482f873da13f4a3f9b6c87cdd7175bd2,363,355,8,Asia,20,2940.83
482fad4858d4423184c2e6f10f18d4bc,361,334,27,Europe,18,3099.1
48304ecbded442ba84594aff594f8996,172,149,23,Asia,25,1239.46
483088f03c90442ebc845e55fb91a860,333,308,25,Europe,23,2726.29
4830cc0a9cd641e89719693c081ca73f,92,55,37,North America,27,499.46
4830d153519548bea2e6a8eeaa5290b0,364,351,13,North America,22,3043.36
4831e2b8f326429ca5c1b645fd458235,190,150,40,Europe,20,986.15
4833b0a7082d44bdbfe155c2756494cb,120,73,47,Asia,21,752.85
4833fe5ef3f84a1b824e0151cc2afa07,94,40,54,North America,23,558.54
48344fc5a7434958a5894daa7738c11a,300,256,44,Africa,18,2297.61
48358efd4f074d49884c36c01f40bf5e,95,35,60,Oceania,27,338.61
483c6ab137cf4bed9d8a9192f57286d4,364,323,41,Europe,20,2707.79
483fdc62bde54959923a37bb43faed37,103,76,27,Africa,22,376.13
48410214bf8b4bb096359ff6cde649f0,334,313,21,Oceania,17,2926.78
48441447907145fd8e61310a6e8b59d7,215,156,59,Africa,22,1139.81
48456ac074ae4396a148bfc7eb6a44fa,116,75,41,Oceania,21,653.99
4845e9420e07402da3be8c2ff0f8df89,364,350,14,Asia,23,2603.5
4846466fc2db4773b9de241039e87da2,242,211,31,Africa,20,1561.88
48468458f58a4197a0fe0b45ac56ac60,109,86,23,Africa,19,729.63
4847250e52bf49fda1090e98d65ab96c,299,250,49,Oceania,18,2030.42
4849276bd7d04bb2aa2866f0479a25ed,60,20,40,South America,22,445.71
4849df110f3941188a28564c8f22ff16,83,61,22,Asia,18,552.93
484a2bf96ba44b5da5d829dcb6489eb0,266,241,25,Asia,24,2049.92
484bdabafd13491e912ba49f01907093,361,321,40,Asia,20,3040.01
484c2e2ebe4c4b0aadd46e65e0d428cf,28,7,21,North America,18,261.33
4850f29abd6e4f1c82f04c421a2063bc,110,74,36,Asia,18,845.05
4851aa1ddcb34f978981adbaf7b4b885,80,37,43,Europe,19,693.13
4851ca7e5a0440ccbff7ce2bc2c1c6be,201,178,23,Africa,18,2017.21
4851e97e3cfe4ea98369ac107a07adfb,143,116,27,South America,20,1005.81
4852b110c3eb4e708e93ccf68654e771,155,104,51,North America,21,659.53
4852fb0fc77946bf8dd4854c04e8ce4f,227,187,40,Oceania,23,1492.62
4856ed55fbd34d6f9432d6ff3d38b7fa,72,39,33,North America,24,477.05
485792ee4e8443899e433029da43e826,206,182,24,Oceania,22,2243.22
485ac51ac4af4600b43b2d25a0c3b067,335,309,26,Oceania,17,2605.24
485df8cde5124d749cfab69aa8f9ba64,95,63,32,Europe,23,939.34
485e958295e84d7e9447b5e6455c0b1a,79,27,52,Oceania,23,402.11
48607e07106d4a4e83e126897cd5ffe9,289,249,40,South America,21,1653.1
4865258b5b7c4effadbac1f8f503f96b,156,129,27,Asia,17,1174.59
4865a74edceb42ae9ac76865642d75e3,117,81,36,South America,24,582.1
4866bc1f104a4871a00cfd594e9aa6b8,365,360,5,Africa,21,2710.15
4866c8aa01634680a125e181a92bdbdf,214,156,58,Europe,20,1258.19
486820212e64436c8882f767c5f89de2,113,65,48,Oceania,18,1054.06
486848e30d1b41f69a2db2e9f779cc61,272,227,45,Europe,16,1945.26
4868cb648b994cd3ae439965de98099b,105,52,53,Asia,20,390.24
486af97ddaf448a093554708017b08ae,361,353,8,South America,25,2614.6
486b35f6e5444e99b64c6cd73bcd236d,77,47,30,Asia,17,500.06
486b37007d924c23aa7cd2d13f7f20aa,274,233,41,South America,24,1811.85
486bda0535c148f99fc7a49cd6de083e,335,285,50,Europe,20,1502.64
486bf3d3c0c04a618e71b55405014858,296,256,40,Africa,17,1951.84
486d33b758f14525b9985a6e43596675,269,237,32,Europe,21,1726.22
486ddb4b4275481b8df458b5a494f6cc,292,268,24,Europe,22,2723.46
48716a995e8c446495ee7d24acbddc23,94,47,47,Oceania,21,429.98
4872b2497b6643f1882ab41b74e6b1b6,275,232,43,Asia,18,1122.08
4872e15ce0024354a6f5be3456f83031,283,264,19,Asia,14,1722.19
4874e5ac5de6488eaafce635220499ee,305,261,44,Africa,20,1651.79
48762401ed4f45ce9f82764de29e1b76,107,89,18,Africa,20,830.54
48771e50904e43d2a796b6e38a6d45d7,230,209,21,Oceania,19,1612.21
4877a195563d44f98b2047d5c6c3dcef,249,224,25,North America,24,1496.21
48790949cf324ae096b3976cad17a24a,54,3,51,Oceania,22,300.49
4879a3fc50c443349b791d7b96190e3d,46,22,24,Asia,24,646.26
4879b046d61b4d9dad52d7ffa90eb3ea,180,129,51,North America,17,853.31
487be66953004d7c83b191bd88097fd4,178,145,33,Europe,18,1387.73
487c24108c57478db9ff0247c6ae6d3a,183,149,34,South America,24,1385.58
487c27a44bfd4227a0c1a613a189de2d,43,11,32,North America,20,529.13
487eafdf7e624ba5964ebf5982447a3a,179,136,43,Oceania,19,728.13
487fd7c34a994d4f88a58de6ed557093,268,213,55,Europe,21,1386.22
48806cb52a4e460885af8eb7bd4060c0,269,237,32,Africa,18,1724.3
4881445eb3e3442eb96852de4abad198,363,350,13,South America,21,2078.97
48827a5b1edb42378292e9ad6d9db509,362,321,41,Europe,26,2472.42
4883f4e9d56645e394fb2afc10d31dae,78,41,37,North America,17,402.88
4887d64a5bcb488ba92ab39cadf28629,170,124,46,Oceania,15,1356.96
488803b902904b809b1246594175302f,63,21,42,South America,17,438.08
4890aeddc7a8493f98ac7a3885cf9549,122,91,31,South America,24,571.77
4896d6cc7a2541f4a51de425c5866d91,92,45,47,Oceania,20,366.71
48971a3720e0408092599532e8fee5f6,101,73,28,Asia,21,824.67
4897cdb2ba70461dafad29582f7607c4,302,253,49,Africa,12,1623
48989d81817f4ec383b59b60cf46c8dd,265,215,50,Asia,17,1506.25
48991577281d4085b2d38ab1971d4ba4,211,158,53,North America,20,928.35
489c59a596b64429a406f867f8ce315f,78,57,21,Oceania,26,411.28
489df4b07b1f4ad78255abca5a12869a,160,124,36,Africa,22,1238.98
48a00a9ac9d5416c80f38137697f79ac,298,250,48,Asia,24,1642.57
48a0e5f2ea164180bf16849119d2c192,153,106,47,South America,18,998.52
48a22da609d549649918e7b1a2eb1589,365,347,18,South America,17,2667.6
48a4526517d94ebdaf6f0ad942bd3eea,265,237,28,North America,24,1622.37
48a4b82d39d4464d9406a2a298e06714,335,307,28,South America,17,2132.3
48a52c851d1d4056904a98b4a6f584a8,279,244,35,Europe,12,1910.75
48a63abba3c849f0911650b4ebae1ded,95,74,21,Asia,21,422.62
48aa3fa6c0e44e048f2ef4bb61e7b74c,163,148,15,North America,24,1403.94
48ac02eb4fa743c88dd439f19435113f,263,224,39,Oceania,25,1767.28
48af2a9ea1f64a6b9530211e98b2b5be,336,309,27,South America,20,2138.04
48b025d1568f429cb7c122b55298c7e1,116,83,33,Asia,25,982.63
48b2245a1e614614a991dc8957b88dc6,266,231,35,Europe,22,2526.37
48b537ac0abf482a9dbb1e6606a92225,364,352,12,South America,20,3232.57
48b6923abfbb43c990b32079f4d0cd19,286,236,50,Oceania,21,2019.5
48b781e2cb0a4cbda8a856c5cd6cd5fe,230,210,20,Oceania,23,1666.03
48b86e06d62c4d7eb3e8a625f42e29c0,237,189,48,Europe,23,1260.48
48bbf47f3a3a49c7bfa84f3be4698b92,87,63,24,Asia,20,1107.81
48bc2be5a9f346f7a7d1035b6758a92f,211,187,24,Oceania,23,1738.74
48bcad98195b45f393da020480250f05,111,76,35,Africa,21,876.47
48bd089d9b0e446aa9c1b97f7a25618d,245,222,23,North America,20,2112.84
48c0fe3c78e4470da345ab4725b654bf,351,306,45,Asia,21,2470.21
48c12fe856c84f689414eda686131b8b,201,152,49,Africa,18,850.05
48c3b0a9c7a545a5ad00257693b95e65,232,189,43,South America,21,2130.13
48c47fbe123f4a6987296bef0892a768,229,189,40,Europe,16,1690.53
48c82bf81571454ea2f55955965d8915,82,31,51,Oceania,21,297.65
48c92c276e294da4a6aceecff87d86f1,232,188,44,South America,15,587.41
48ca6e7a0f1848a19e0945ffcb1b53c2,320,277,43,South America,22,1345.22
48cab6942da146d38a04f88940051d58,176,134,42,Oceania,17,959.14
48cbf5a1fa154c0d82db1aa84a1a8781,200,161,39,Asia,17,1375.4
48cc33b58d1e42c8b25609bee5689912,216,169,47,Africa,20,902.68
48ccf82cfeae4001a960306cb9534ce9,114,73,41,Oceania,15,1053.87
48d05d7ee37c481eb779c870b7e31b11,164,125,39,North America,21,1099.16
48d62d5a480941d8b0e90f3e27119480,48,16,32,Europe,21,265.6
48db6711c2c2473f988fec24c13aa734,307,262,45,North America,18,1634.06
48db78fbe8d349e4b930bd8651489391,208,166,42,Oceania,16,1592.75
48dbc33cdfa04489b17bf464728bcf77,304,251,53,Oceania,26,1644.15
48dd1722416244c28b1684f30eccf64f,173,145,28,Europe,22,1101.8
48dde2c0d5fb4fa59bcee975b1113bc2,365,330,35,Africa,20,1548.24
48de56509a0c4e50ae7fc8346489adff,171,155,16,Oceania,23,1435.3
48de8171156b48b2bd0a45939907d5e0,168,151,17,North America,21,1697.45
48e0dbeb3c1a482484d2443789a7717d,60,30,30,Oceania,19,568.37
48e1046058f445739f93d15edae448a2,77,56,21,South America,21,763.59
48e249d5d0aa40d5a74efe38999b6160,187,162,25,South America,18,1868.06
48e49781ddf345c1a3426abb85907c26,264,225,39,Asia,21,1647.22
48e53c3060fa4087b75009211ac33b33,162,147,15,Oceania,22,981.34
48e5f592ae1f46879dc7a1c63b68ae85,37,13,24,North America,17,356.17
48e86bcc4c8d4504843f19ba8a3e3a5b,107,84,23,South America,24,1197.94
48ea66f8853b464d9a6005abcfd49fdf,151,122,29,Africa,23,900.58
48ef9ccc1ea44b678ab67191fbd42230,201,145,56,Europe,16,765.5
48f003b5a34848d495a95b47fa5025b4,54,6,48,South America,17,416.67
48f4224bd34c47f191bf466ba3a8ebe2,201,160,41,Europe,24,1771.91
48f60f08691c4a0a8dccf5176257fe82,252,201,51,Asia,20,1339.18
48f6bd1fcad048b598c8ea54881f6200,63,38,25,Africa,23,365.59
48fb18c778e244609f7b7ec185304cbf,289,248,41,Europe,16,1819.34
48fbda9ae37b4e7c9e93794176460f3b,103,71,32,Asia,20,738.62
48fcd08d9691492f8e8f325078d2c5b8,191,143,48,Europe,16,1086.31
48fd6704fdae4f4ca4a3ebf51bd93be1,252,225,27,Asia,21,2024.47
48ff977c82e84c3ab4aa52f99977b743,276,225,51,South America,20,1139.82
4900a073e7974952a6720e40df300044,77,26,51,Oceania,25,234.13
4902380682b148c29158b3415fefcb1d,363,354,9,Oceania,22,2316.01
49038c26d3264d978579c28403e3b30c,91,35,56,Europe,20,311.61
49045affa9fb4522aff9ea3dd28d38f0,356,320,36,Africa,23,1852.05
4904bfd2d04d4b93821efd7c7311c5e0,36,6,30,South America,14,442.15
4908088d9582446c86b0665a00dc31a6,153,117,36,North America,21,1052.74
490d1e1f6abc42bab0b77cf17e1be573,284,259,25,South America,19,1707.95
490dbe772ef1480d9faf6a7ff4384b8e,265,232,33,Africa,16,2341.15
490e6ede0ef544b892b83c178e1e3f7f,76,24,52,Africa,21,520.17
4910342d936d4599830acc0633e39439,360,348,12,Asia,25,1871.26
49120767f44e4e478249e3957b4ea33d,363,357,6,Asia,23,1822.51
491383f3a1aa45fa8b2f4e67d8248a92,323,275,48,Africa,23,1348.34
491767029a074cb691cbc8b84b27fc17,116,81,35,Oceania,18,552.07
49188a46ac1b4d9f9bbb5e19538844e6,365,332,33,Europe,20,2023.31
4919d75c02d5463480f9f208c213a50a,349,309,40,Asia,24,801.21
491f0460cf424a59b418a1240d9f7a0a,55,9,46,Europe,21,323.61
491f5cc28df6419c8d59f0ba1f361ac6,250,220,30,South America,18,2101.73
491f92ea14a746f7b77e3881a92ff3ca,139,111,28,South America,22,836.13
49219e8cecf64f05beeb4257904b51c5,156,121,35,South America,22,1188.25
4923c7cf2f8a45e28383cb1e93d2ae8a,62,12,50,North America,16,474.54
49245662c7644ece961474642b478db8,326,281,45,Africa,22,1831.35
49252260be9e4a21876e84cb717efd2c,172,151,21,Oceania,21,1364.93
4926dc05d7214a97b5efe668a0f65b3c,305,258,47,South America,20,2090.01
4928321504374f5ea6c37244cdea8dbb,189,159,30,Oceania,21,1796.61
492b626fb1a34554831eff2a67aa3c21,303,273,30,Europe,16,2479.19
492b9b85c3a64657a87a64fb27644493,233,185,48,Oceania,27,793.09
49332a6086c5414096b18f323c7fdae0,46,17,29,Europe,20,179.47
4933921d7f084824852cc100314aab75,75,47,28,South America,23,627.43
493513c274d240cc972e0edb83cfae4c,342,325,17,Oceania,19,3397.71
4935aba2e08a4e4184dc16bea1523d34,224,194,30,Oceania,14,1211.04
4938026335cf4d789e0ab6cd2af45112,140,115,25,South America,19,1395.62
493995b76a5f4a59b5ac28b2cfdc9228,364,355,9,Europe,25,3134.96
4939c1610b6441539a8ae14cbf1d9667,362,331,31,Asia,23,3290.87
493a4481cf9d40b6a493897611026043,205,178,27,Asia,17,1980.85
493a6d166099451faafa2892e0ab31a1,280,249,31,Africa,20,2877.04
493be6d75d4d421682c668d7aa9a2e24,364,331,33,Oceania,19,1972.34
493c2fad3dbb46faa1ea3beed477aaaa,189,156,33,South America,20,1367.13
493cc9ecfb214f1c8d77e28e0855924a,148,109,39,Europe,15,1183.63
493dd96f26754e64bbeec37cff68cab0,182,141,41,Europe,17,1219.19
494449910e064e48934201ff561d168e,236,198,38,Asia,23,1705.5
4944cef46c7e4b90bb2366d084a31f7a,87,33,54,North America,17,271.06
4945248fe94d4fb287fefb74880d4971,191,171,20,Asia,20,1192.23
4946dfdb3a7f4bcbba0b193190694b9e,264,225,39,South America,18,1291
4947f9c8bd744d96835876a809a2a6a7,207,164,43,South America,20,1430.83
4949e9f3699949e095c418bf2b1f2044,247,189,58,Europe,22,1055.7
494a3a645439499190d05901b68d41d3,149,126,23,South America,25,1117.25
494aa2baeb6b4536a22e36e8337abc1c,172,116,56,Africa,19,1051.42
494cfea53f414efcaedec72f6f238abc,365,352,13,Oceania,24,1346
494d54a81d7740888921d433be15339a,364,351,13,Europe,21,2386.69
494ff21de62d4a98a6061a9564212742,365,357,8,North America,19,2642.62
495139a3a84e480a83910ba681583dda,69,48,21,South America,16,635.32
49516d06f7dc4a068cd463dc5280aada,247,225,22,Europe,14,1849.72
495440ddb68849b69ef106eb33c8d25c,61,29,32,Africa,18,459.13
4958edaae3dc4a25a4969ac2cc648c69,315,275,40,Asia,16,1594.67
495a4cf476ee4f30b3e3f7e85e3e6128,315,288,27,Europe,15,2351.71
495bc8aadc9c438e93105d17537d70f3,271,246,25,South America,21,1903.5
495c5bf2a53045d99db23803d5250806,211,173,38,Oceania,22,1553.72
495df6c9726d462295a681372426a14a,252,213,39,Africa,22,1836.51
495e54b4aec94d31a3a047235102639e,96,55,41,Oceania,18,495.21
495f299f0c9a4e16a52664a35632a911,179,154,25,Europe,19,1271.45
495f8435d0ba46dfad37327f0b38da12,64,43,21,Asia,21,618.98
495fb75fd77249c490cd2d59120c38ea,55,4,51,Asia,22,287.9
4963477dd5ba4c538594214e7cd3ab2a,229,176,53,South America,19,1182.42
49640086e67b43b9af01144654f78bf3,187,156,31,Asia,16,1456.4
496411e7f0d347209301d6b3ac811d56,276,252,24,Africa,20,1774.4
496481f4cf394df0a41ffa9a7ca2cab8,364,337,27,Oceania,21,1584.05
49653d1dd8734f9784bc680f6c0428b7,214,161,53,Africa,18,724.68
49655eb98edb488aa21aa24ab487a78a,113,71,42,Europe,19,526.51
4966c7f2b1484a68a0f9b823a567b45d,80,56,24,Asia,18,482.83
4968af776b7e4c6383250e97d65fb01e,100,57,43,Oceania,17,93.65
496b783750524551b0124f6adae9ae72,229,185,44,Europe,25,1380.09
496bc5c89091476d9ea0459310c49275,364,325,39,Asia,21,1391.01
496bdeaef77a46e19db0d01a8d5d8327,287,246,41,Africa,20,1791.98
496c94e77b33479dbddc3d1d8d553246,180,131,49,North America,20,590.87
496e679bfdfc499e8913689797547ad9,277,239,38,Europe,20,1558.61
4970ecfb71af48708e444a0e78e4cd00,314,260,54,South America,20,1441.97
4973ddad9dab429f95ed161e7478906f,163,143,20,South America,22,1190.63
4974bfa849054de89492a4815d6020b1,322,267,55,Asia,24,1881.29
4975231dd9b44352bc7517b45c397fff,36,9,27,Africa,18,509.16
4975db7316b94c2888781b72fcefc67a,64,31,33,Oceania,22,236.68
4977d59f64ab4dacbbf21f9c33e44d32,246,218,28,South America,23,1750.2
4979740a542b404eb68b32a3b8821f52,168,111,57,South America,20,1138.01
497a0755e92b4979836176560b4af191,365,360,5,South America,20,2882.1
497b97d3fd8f4c2c9fadbdfc9702730c,359,333,26,North America,19,1945.29
497d7dab447d47558786ba94ddd95cca,221,184,37,Europe,25,1485.09
497d9e9f11fc440887d5c6c9ef55d439,120,93,27,North America,22,758.21
49811d36890e45168667026a238e2353,306,266,40,North America,23,2865.23
4981aac2553f49bf8bee38f271c846d6,250,206,44,Africa,26,1788.66
498335bd62e44b26bdfcd1d5b996c895,79,50,29,South America,21,549.12
4983a57a67a0408fa89a17951b05639a,93,63,30,North America,24,807.01
4987023d4d6f49f5a1b8b05d575563bc,106,57,49,Europe,17,670.94
498b0b9130eb4fa688e35b37961d8f59,188,164,24,Europe,18,1326.91
498cf32fcfd04e78848cc6c488fb1d31,131,86,45,Oceania,22,830.53
498f75d411444ef6b9af6a07868aa2fa,86,67,19,Asia,20,617.3
498f75fcffea4f7390eb82493225479d,149,106,43,Europe,17,639.08
498fcca2d6df4359982174c052b20151,348,302,46,South America,17,2357.07
49901a640c57498487c4ebd48fc17e53,271,243,28,Europe,23,2297.81
49909cb8fe67422280319bbbcad62431,256,219,37,Oceania,25,2197.92
4990b1677dc94d25b29dbd270e1a5e21,351,302,49,Asia,16,1847.03
499669cb1b0c4b8fb60eb0f7193f9383,269,244,25,Oceania,28,1809.9
4996efc422e54bdea25bbb1091860b03,117,84,33,South America,30,660.76
4997c740aad74eadbea10d668984555d,259,213,46,North America,24,1413.52
4997cbaf69e140619d372e2b869901c0,278,256,22,Europe,20,1702.3
499937f8e5eb4695901f952315c1cddf,351,330,21,Africa,19,1808.14
4999952ebaa34c14bff900997ba7e71c,53,19,34,Oceania,16,421.41
499a658071c94188a0d44e4173a3979d,325,281,44,Oceania,18,1636.59
499b877b7340499989dbfdd450cb36d1,65,27,38,Oceania,22,583.69
499c9102cc6b444b8ec498485aef2701,192,167,25,Oceania,18,1428.08
499ef980650546cfa5ab6b672e3d99f9,333,283,50,Africa,18,1848.59
49a15898afbe4c70873bf02e74d84f47,346,319,27,Oceania,18,2727.43
49a2b3fe23de4af3ab8dac4183982018,41,3,38,Europe,17,470.4
49a3a5e91edf4116ad843ab461b462e9,361,321,40,Africa,21,2664.95
49a3b7a2f0b4447880625993d8f8f26c,179,151,28,Africa,21,1179.85
49a4f49d6db340d9a69ec4a172274034,213,166,47,Oceania,20,770.36
49a66c8876054796bbbd0e40d4b063cb,320,274,46,South America,18,1561.55
49a81d9467684543876824e794010d46,320,280,40,North America,22,1971.34
49a904d049fb4b72a34e5dcbfa3600d8,220,182,38,North America,17,1059.9
49ab257b32de4a35854aea7d3539002f,264,205,59,Europe,18,1546.95
49ad32103f56435bbd01c5bcbc68baf8,174,115,59,Europe,24,1078.48
49ae33e9e9aa4c02aeaecb2ccf8f1cca,364,347,17,Asia,20,2295.81
49ae59a6713a45db9118c91bb235824f,169,115,54,Africa,20,687.35
49af71656e50446a9db8b304519182f4,122,76,46,Asia,18,847.72
49af7f3eeacd4b1da7f0e3c063df7b86,363,330,33,Asia,22,2448.9
49afcd0f40a6421ea1f8f2f3a5026723,364,326,38,Asia,21,3008.43
49b04db0ee204a209ea4b43111ab2680,243,216,27,Africa,19,1872.5
49b0f99084924ad08f30b1ea4701640e,71,23,48,Europe,19,437.01
49b175182b294d07b828fe41fc3e7bd5,138,84,54,Asia,23,716.51
49b8abafc71d46f3b273fe83b7738eb4,255,231,24,Oceania,18,1736.38
49b97d6447924092bf72e4f15ac35595,186,149,37,Asia,18,1389.28
49bd44587b4f46e2b617da9e2a6293ab,308,265,43,North America,21,1860.5
49bfbcfcbc514d8fb3f47c7e79a6a326,198,161,37,Africa,20,1658.22
49c0770cf116490a8738a7566fc38d95,241,186,55,Asia,21,1385.11
49c1afca7b484c98ab94b873e4b78c2e,326,274,52,South America,24,1360.99
49c21c9171d046b995c424942863c428,105,48,57,Europe,26,436.51
49c44da555434730aa03c2bc9e2d6f37,363,314,49,Oceania,12,2118.04
49c75c25f47d44a7988a9194ee1a0ef5,56,17,39,Europe,26,481.55
49c766f3176547a8a5f4b54d3cefd1d8,343,292,51,Oceania,18,1674.51
49ca763eeffe479ba232faa4037387f4,365,349,16,Asia,25,2015.42
49cbc8b1c932487390a1c4e0fb32f5e5,201,163,38,Africa,19,1499.33
49cbe22c25684aa4b211a5eb76e73a93,296,250,46,Europe,19,1577.48
49cc8e241035457ba8623b58313d751d,344,316,28,Asia,24,2413.71
49ce5b7a41ea4fab9914741045a353db,277,237,40,Asia,18,2029.81
49d1151dae384efbaa173f0f56b91722,364,363,1,North America,18,1063.57
49d5190bce40461c81a6018c7c57a355,360,309,51,Asia,16,1707.64
49d65c509df8421884b4165070ae0e37,275,231,44,Asia,17,1174.28
49d6d49de12d44c8bd67a55c32823677,92,55,37,South America,24,1003.96
49d72f9525634212990a49fb4fefaa65,188,155,33,North America,24,1452.02
49d8a6272ec54dbdb0f34f16c1363f4a,188,124,64,Europe,20,732.9
49d8d749d8a74e8bbdc006bb56ef71b3,55,17,38,North America,16,562.04
49dd1081684140e8bf305bf29d6d68ef,126,90,36,South America,18,1162.32
49dd5691470e401384025a893c195ab4,365,345,20,North America,16,1962.94
49dd9cd4578842a0b00b8955781a5bb2,321,280,41,South America,19,1293.82
49deb01bfa4244bc93285109be2788ae,279,233,46,North America,18,1517.11
49def930dfc94be08927067b1c4c4880,271,220,51,Asia,21,963.28
49df7801ed8d4d87a5be4e0779285a3c,124,104,20,North America,16,773.69
49dfcd358a6c4b4cb2c3bf7c50cd6d67,212,163,49,Asia,21,1024.82
49e09b021ddd44da95e8a2b92ec020a3,111,75,36,Oceania,19,780.67
49e42fbbd93d42f2aa49266983ad201f,243,201,42,Europe,23,2415.76
49e5391c5dd84aaeaccc7be654a9e709,257,231,26,North America,20,1241.44
49e638d4411a477bbf65307454934b1b,154,120,34,Oceania,18,1460.42
49e6785948bd4f438ed9ec8f8b8a2a9c,363,336,27,South America,20,2960.98
49e76e1677a84128bd103d20f02ee47a,194,155,39,Africa,20,1198.13
49e7a808573f412799f5f87db7053bbd,332,284,48,Africa,19,1370.02
49e8957459e2470ba95eb09a07fc92f5,275,248,27,Africa,20,1845.14
49e94326343442deaccaca4259274dab,340,291,49,Europe,22,1712.76
49eb5bfc8ade422485a36b3de2318b51,124,92,32,North America,18,627.12
49ede36efbc54c21a70bf0a0eafdbb3d,364,334,30,Oceania,17,1438.57
49ef234d757e4f0eba4051d2e4fe949d,306,283,23,North America,24,1481.84
49ef64a0bbb7415789b7d3c17c83a256,66,46,20,Asia,26,538.72
49f13dff19e64b458f87169d22b931f7,163,140,23,Oceania,22,1002.45
49f33f92bbd242ff973894b77f4b899a,364,351,13,Asia,19,2816.68
49f410fad0b140dc8b46e5437faab38d,144,110,34,Asia,21,1207.28
49f9f375967241ac9a8a897a01c97c46,147,116,31,Asia,22,1336.17
49fa5663315849f3994f4fdd0e114319,94,58,36,Africa,23,762.69
49fb65cdde7d44aea69af6120f1cb9b2,166,113,53,Europe,20,717.78
49fc0e3a6def45889bc7f04a8720d9d8,179,128,51,Asia,26,1103.81
49fe2c3cedff4d6bb3032c685a01a232,352,322,30,Oceania,19,3722.98
49ff95cbc8b94484957e460e3aae2683,53,17,36,Africa,19,215.52
49ffac3b7dc249989ab457ceb19fd2a6,329,279,50,Oceania,19,1979.97
4a03b59c13e54454b3230d914a148b1e,344,311,33,Europe,20,1727.74
4a0591b79f984281862ab5ae23d7e9c4,249,233,16,Asia,18,2108.1
4a069e8039114426b4306b2e1259b8cc,76,29,47,Asia,17,223.83
4a06c7e108e04cb79f1828e1338d36f5,360,330,30,Oceania,19,2793.84
4a082b9a08cc495aa666eec3708c5d9d,342,319,23,Oceania,17,2513.14
4a084893e26840a2b2ec3f8bbcdc625b,163,115,48,Europe,21,637.29
4a0c0309435a4bd8a0fc06cdb34a04dc,34,12,22,Asia,24,195.67
4a0dfb5a49d145049088f15eca56a0ef,172,153,19,North America,17,1888.36
4a0f90aaa52b4f438e913316512f2fc0,188,157,31,Oceania,19,790.58
4a15715b3a82454bae964d10f68c6000,365,332,33,South America,23,2030.58
4a15a0be201e4d34ae766bdc9c9569c8,362,357,5,Oceania,19,2765.34
4a163a852d8e4179a5dc941c14a97427,363,331,32,South America,18,2071.35
4a199b237f1641edacc59f7807a05cfc,271,233,38,South America,19,1770.53
4a1b397f4fbc48e68f21c0818d4f8800,150,101,49,South America,19,461.43
4a1f0fb5305a4da3847a02c385de6a56,365,357,8,Oceania,22,2505.16
4a1f456dd3f14f4fa76866ecf710e348,349,300,49,Europe,17,1717.65
4a20ad18f9a2456183e4b77f4f07e303,286,241,45,Oceania,11,1780.81
4a21d550a15a47ac81fd1e4b612d895f,239,205,34,Africa,22,1526.45
4a28721d5a13432daa08f99af5f475a3,183,125,58,Oceania,20,1240.31
4a29d0e4aa9440ad9fd12932dfa4e39f,94,58,36,Oceania,21,200.14
4a2a5d49220740a883f140d546634e9a,286,250,36,Asia,22,2405.8
4a2ab498c1e64f0bae9b273ae8bfef3b,317,262,55,Europe,21,1679.7
4a2b9ad6fa4544a48a376cb1c94d8028,363,339,24,Asia,22,1636.9
4a2c8df0e19f4eb296aefdf6ef3ed41a,298,256,42,Oceania,19,1378.11
4a2dd2684e3d4adba7ea636466158c6e,234,198,36,South America,17,1640.76
4a2e22fc2a8d4edd8e6647116ae4ba33,365,365,0,South America,22,2308.04
4a2ed84437094a19bebf429a844adc23,363,316,47,Asia,18,1165.12
4a32c4a9b292493c92d309abe0e995bf,364,364,0,Oceania,21,1950.26
4a33f710b09e4340a3f1f82e92edc76e,101,78,23,South America,20,731.92
4a34ca7095ea45d7b6b34f2a1f285981,264,229,35,Africa,20,1935.1
4a365d6efdc645efa7ab7dd931d8bcd7,290,253,37,Oceania,18,1150.42
4a3a1beebd1042b3b7d7d01b61864459,350,312,38,South America,19,2126.73
4a3b8d324ee24a9ebbc9a940b52e34b5,71,29,42,Oceania,21,297.79
4a3b9a3b11354a13aed921104b2cb2bc,33,8,25,North America,22,146.31
4a3d7951a50e494287a0a7e4be4275d4,72,21,51,Asia,21,428.64
4a3df366587b464d92a684f92c26843e,56,25,31,South America,22,236.98
4a3ea5a8796744e484da6213a007a541,214,188,26,Oceania,18,1832.5
4a43d202df564d528b6a36d22e3d949d,58,31,27,Asia,13,466.08
4a45486d3f9446f290e20b057f1b5b6f,129,97,32,North America,17,867.68
4a454b75035340278e30abe5d6cde251,329,278,51,Africa,22,1563.93
4a47cd63616f47048cc7aa833ce6a315,361,336,25,Europe,22,2309.94
4a49eb9cf9ce43a2bf3de2b661e62ce3,78,24,54,North America,14,250.16
4a4a9ac127ea46df989f53cd25445cfb,171,126,45,Africa,20,695.4
4a4ab49b14e340a0af039a946ed62b7d,268,249,19,South America,19,2036.27
4a4cadb1cabe416ba8eac2bdb5fe6dd5,243,221,22,South America,19,2199.42
4a4e168e5713414f8ba4e6b60a7b0ca6,171,133,38,Africa,27,1129.66
4a4eba4e9e0d48339e47be588a203f69,159,121,38,Europe,28,917.08
4a4f0a74dc2d4f85833b614d7acd6a92,362,331,31,Africa,16,2085.66
4a4ffeb8a5414d4b8724e8d52016e324,268,231,37,Oceania,17,1630.11
4a514d61ddfd4cbdacd9ae7acc948d3b,99,80,19,Asia,20,716.75
4a51ed52cb0d418da9eea5fef4fe45a5,177,140,37,North America,18,1241.31
4a534e79ccdd4248aa60c22319f452a5,317,275,42,Asia,18,1596.51
4a53dd33868b4e5ab09101d394b6ff4d,351,301,50,Africa,23,1547.33
4a58452611944120a530af1f55a0f476,209,175,34,Oceania,21,1784.2
4a5962c2c6c44c94858cb20ee19aa505,136,85,51,South America,13,543.03
4a5b1c224da54b33834349cc61ecd3b0,329,277,52,Oceania,20,1468.62
4a5b8c28f02f400a95bf93e592095c1d,295,247,48,Asia,20,1649.82
4a5c23c7a57f423899e19c12e1704781,212,179,33,Oceania,21,1297.53
4a5ca7f29ab143b79bd22403bb32bf6b,134,115,19,South America,21,712.91
4a600736cd944751a3ba5df2e3ed15ba,363,353,10,Europe,20,3196.79
4a6153a59bef45788458aa3f949be4a5,221,169,52,North America,26,712.55
4a625324c9c74d298330fe0572a625b8,352,302,50,North America,20,1724.19
4a658615258c48f5930225c195fc66ea,319,292,27,Europe,23,2017.47
4a66af055fb84b968d25db8099377383,77,59,18,Africa,21,462.22
4a680525d17a429c8a683b3c24063c4c,306,273,33,Oceania,23,1685.45
4a6829dc3c704015913289cfb46fb973,205,185,20,Asia,22,1593.97
4a6afe251b31465caad95e970bfcec7c,112,50,62,Asia,20,655.79
4a6b399ad1f4446fad7ea8ec188baf7d,76,25,51,South America,17,774.68
4a6c5abf6dd04c81adc4de1191ef274d,216,192,24,Africa,15,1842.04
4a6da80692914ed2ab8d3c5403190133,365,319,46,South America,22,2263.12
4a6ee27ff59a4ef59c411b90f9fa51dc,333,298,35,Europe,26,2820.2
4a6f609e6bf14d0ea710c5c423630f96,363,347,16,Oceania,18,2708.22
4a70525aa5d44434bdd8855236be2da1,86,38,48,South America,24,509.33
4a71696819274fc29ffe4feaaa01032c,207,192,15,Europe,15,1261.55
4a7260759a4140a093ee193f86e0b936,63,29,34,South America,21,541.72
4a7376f6ccef441da59c7d317337a531,153,122,31,Asia,23,1021.41
4a740fa406594b69a77656ef74d274ac,323,274,49,North America,23,1754.38
4a7543bf30f44101909d097762c55074,213,176,37,North America,17,1282.33
4a758a6cae3a4b39acdc278068fc647e,351,305,46,Africa,22,2630.87
4a77b45a1c544ee3a65d395edcb3ecd0,26,2,24,North America,19,177.61
4a78d375b9a749e29ff76f2affd05e6a,110,61,49,Asia,28,574.98
4a7c32a22a29414fba69d60d4d440650,223,187,36,Oceania,17,1421.45
4a7d6baa30c94191807e0e21560edbdb,45,17,28,Asia,23,340.61
4a7e3d9b6a4a4e43b53c937cdff63a83,175,145,30,North America,21,915.41
4a80971eec5d41e9a877e203dc078b2d,149,109,40,Asia,22,1356.2
4a826ed3849a43a7a5c9d5870508a6eb,127,95,32,Africa,23,746.46
4a83ba4a77914e659d1e5956d912b666,47,23,24,Europe,20,401.91
4a83e8f74db14cc19fc36a99924892ec,297,274,23,North America,22,2276.69
4a863d3b9fb2464aa5dcff098f81bf83,316,274,42,South America,22,1414.48
4a864a7e81e74572bb504f7675aac5ea,267,211,56,Europe,21,1409.21
4a88b9f0fb094882a80b4b7d7e9f5118,240,212,28,South America,22,2007.21
4a8ee801a68a4fa380b14d4756a9b988,288,234,54,Asia,24,2312.73
4a93c4a984a14bc49cf9a513d66dd6f3,168,137,31,Europe,21,1253.71
4a947a796f694f7fa444fba4a66d8b77,301,261,40,Africa,24,2334.26
4a94dcff6f08498086b23bc8e480cde9,321,301,20,North America,20,2217.33
4a9690c4c78d4080ad120b7a3f0fba93,51,1,50,Oceania,17,441.96
4a97db5ef8c54ffda608b04ca5c0b14f,175,150,25,Africa,18,1384.11
4a9a9d0b13c14e96a5f4c2917916ec03,196,151,45,North America,22,931.63
4a9af8112e174652982714843777d8bd,309,290,19,South America,15,2012.4
4a9d2cc7dfb74c9c95f9ba478816198d,239,199,40,Europe,16,1787.79
4aa202ae924d4d049f2fee5268c388f1,142,117,25,Africa,20,1479.17
4aa26b4a7e914b7fa7df665eb7bbda8a,175,152,23,South America,21,1242.95
4aa2f5750fdc4550844212b3a354db3c,244,209,35,Oceania,25,1346.41
4aa7a4beba1544879e0d32f6374f4383,210,185,25,Asia,20,1612.47
4aa8a3dc9fbe4434a0237b9cdba5693d,362,309,53,Europe,15,2007.82
4aacf758cfe04105ac90adc25a8ccceb,212,180,32,Africa,16,1290.37
4aad52ad466a4a0e85f8235980d2041c,165,123,42,North America,20,1139.6
4aae172df3094bfc954b4369b6399e93,304,259,45,Africa,22,1985.67
4aae91e3bdb947cab60e3a962b6d475c,82,60,22,Europe,20,1071.65
4ab27038985145e3aff16d8cdc9bc0e8,170,135,35,South America,25,1584.64
4ab436e716954226bdd9e0bdb8ffe283,365,323,42,Africa,23,2048.25
4ab91614b34f4375ad7e468032a1349d,365,359,6,Oceania,22,3002.19
4abf0f5ca59148ca96b98eae4dc0dbf5,30,9,21,Europe,18,237.58
4ac2ba41c4c84d319f365e4f15b06f82,328,271,57,Asia,27,1746.13
4ac607faac2d4a5c9a4e0cc535e6b279,159,140,19,North America,19,1807.79
4ac6413fe1d347b59da7eefaa12e2f1f,230,191,39,North America,23,1351.89
4ac7be85c869408699d7961597cd129e,277,227,50,South America,19,1495.11
4acbf2b528644dd9b45b0c1043a0d4ee,162,141,21,Oceania,23,1550.9
4acd5556bcc845f083541f4d56f8e420,359,330,29,Asia,26,2361.45
4ad20248874a4d239db3cf615a58c246,365,325,40,South America,23,2559.69
4ad5e1b228704f5eac34f11e984cfbdc,226,200,26,Africa,24,2041.99
4ad76b83b3cd4ea18037397b653164d9,60,21,39,Europe,19,294.4
4ad95a9013d6476a9d2739a166d48211,200,172,28,Asia,19,1297.74
4adcf7b35d804ac5a1b5f1d41a26af2d,365,362,3,South America,17,1841.26
4ae16d39892e4a78a8f076676d72a488,74,37,37,Europe,23,234.76
4ae424bc90214d04a1cf73cf7f690843,240,186,54,South America,18,1176.85
4ae452c8cd624fce92c522233126e105,344,295,49,South America,16,1906.39
4ae7dcfa380c4cb9b26c7201cef7dbe3,246,203,43,Oceania,23,1457.08
4aead92707d249c0b21a5c4bce21863d,291,238,53,Asia,19,1175.33
4aebaae20843409682471c9050cb3bd2,118,88,30,South America,14,686.76
4af286538b7944068f3daeb4ef0e7c5f,242,187,55,Asia,22,1803.21
4af3cb316eff43d093b0a246751367b4,225,178,47,Europe,22,1740.33
4af614f534b84d768ac3ad9546c935aa,225,205,20,Europe,15,2863.55
4af6a90112ee445485e63848c36b2058,56,16,40,South America,18,614.3
4afcb61fc1b241d39f8085556445c9d5,298,248,50,Asia,17,1009.56
4afd7bbef3814461b09e5758f5915468,156,112,44,Asia,21,675.71
4afd96b8a07f4a66b4b26bc77109518d,253,216,37,Europe,18,1877.39
4afe60fdf3dd4bfabb086b4212ea69d2,343,318,25,Africa,19,2658.88
4affc79ec8934c8a8ce59db23ed19fcb,56,14,42,North America,20,387.89
4b00ccff52d64890bb9e264bb3726ac3,281,239,42,Oceania,23,1775.79
4b044a7f7d3d49dfad8d14aaff864aab,43,18,25,South America,24,605.26
4b05faabef0145d1ac23a7725a3efe81,297,256,41,North America,14,2033.46
4b0665cf249345979dc5eb5835bf6a04,94,53,41,Oceania,23,911.96
4b0ad130dd944c7b892505d12ae4b3c4,347,296,51,Africa,17,2122.63
4b0bb0b99b114a0085e2265225012580,364,337,27,Asia,22,2719.03
4b0c389af1cc4982b6d9eec912d10a8b,358,334,24,Oceania,19,2401.59
4b0ce0e05c554923bd6fccc836fe7ece,115,91,24,Oceania,22,1263.36
4b100f9b36e6413fb6b5f563261bbbc8,55,27,28,Oceania,19,435.66
4b106da310024557907cadd029fc67bf,88,38,50,Asia,30,693.42
4b1333dc0a234426b3c3208f2a0a83ab,178,155,23,Oceania,26,1328.3
4b142f54a94f4fa6a99eedd170616aae,365,339,26,South America,24,2797.33
4b1578caeec64522a4712ca4a3064014,58,17,41,Africa,22,174.63
4b15d3d26aa74a8885be503206b17f19,321,287,34,Europe,18,2100.31
4b167146b752480a9855b45204ee0623,81,57,24,Africa,18,853.48
4b17558465ff495c97c5a2a1e2b05225,99,72,27,Europe,20,652.13
4b1c0309a6a84217aae2c844f98a3d06,331,276,55,Europe,21,1278.79
4b1ffd985c3c4998b7569a04e7ff3d9b,82,34,48,South America,25,263.35
4b22104b8cb6428bb58826c82b222455,169,131,38,Europe,16,1249.24
4b23f340b7fd46ad94ad47241dbde250,364,348,16,Oceania,18,1744.4
4b24d53b3dbb4ea6a3b706a0866512ff,117,88,29,Africa,17,974.09
4b25069aae774419982d2a790a8c1a4d,51,15,36,Oceania,23,127.62
4b253960e66346a9b6b1c422e5d3d451,95,62,33,Oceania,22,455.14
4b258ede210f4875a1f3a32d142c3b07,146,119,27,North America,18,850.85
4b261bf18d744ceba71ea717620ad406,169,132,37,North America,17,1299.39
4b268e026d7041f2a9ce05c75c4a13ea,341,290,51,North America,27,1744.6
4b2714a4cbba49a9b248c898cbbc8336,365,318,47,Africa,18,1819.88
4b27513040684f498cb23340262d1051,76,54,22,North America,18,546.14
4b27ee8d92774348b376dd659543a3d6,263,216,47,South America,24,1609.79
4b2a3d0dc4704179a7843ba68775ba10,310,291,19,North America,19,1943.99
4b2da21edba2487e9a65ad78e453d12b,35,17,18,North America,20,237.7
4b2e0b6964a84d7abce426fd9223e7e5,241,214,27,North America,19,1712.39
4b30698805f84a5a935c807351425e8d,29,11,18,Oceania,18,148.7
4b30e7cfc3844eda96ee51458d200297,52,5,47,Europe,16,529.25
4b311831fccb4231bb7727505ecf4524,136,110,26,Africa,20,1371.76
4b3670201a68438f88891f3f51cd7683,82,40,42,North America,18,424.5
4b3908821a7f4c6d8e39339eeed09e27,261,217,44,North America,18,1675.58
4b3dbb1d4576479989a782b11d0c214d,364,353,11,Africa,22,1807.33
4b3eee50d34d4988acbb292f8f9ceb5c,139,91,48,Oceania,19,840.54
4b3f10ca24874a16a926b4227f0fdab2,347,331,16,Asia,20,3044.4
4b3f5e66b46f407fb888c2f45fe2282a,131,108,23,Europe,25,854.76
4b3fd7e3e98e4764ad23d3a20a12ecf3,180,148,32,Asia,27,1740.23
4b431b678f9c4764b5ae7e8239f31520,262,227,35,South America,23,2231.91
4b462d060a2649c1ba5aa5f74ae03fe6,279,247,32,Asia,19,2009.78
4b47dcee62dd4d0db3f8f6898eee9815,115,55,60,Asia,16,671.9
4b4889c076664c63b854d7a7d0c92872,229,173,56,North America,23,1244.83
4b4961633b7448d696381e52d7235aa9,311,259,52,Africa,18,1244.71
4b49ee4e688f4264b495aaff0a6a3538,68,46,22,North America,23,192.5
4b4d1c47af9344b0944aed3d56c31e8c,133,91,42,Oceania,20,811.89
4b531a5cd6d84dd4b73bebc5683a76d1,298,277,21,Africa,21,2255.27
4b564bb02af64c5f91384741f9fe542f,274,241,33,North America,20,1604.01
4b583b3ca49f46e79750c7ececc7861c,238,213,25,North America,25,2340.25
4b58ab01e8de4c9abcecbcc363b90351,155,109,46,Africa,20,748.46
4b591e908a454a2ba70bba25e3168e3d,207,158,49,Africa,16,1187.15
4b59814f45a14aec8f2d86ca9462e53e,121,70,51,South America,22,469.95
4b5a1a6fa98e4968a59efcfb197a6a2f,109,53,56,Europe,16,382.53
4b5b4063da1b4b198bb1c5c4f451890c,274,252,22,South America,17,2189.09
4b5c6c5d653b4e05a01027a37d02d77a,363,338,25,South America,25,2130.71
4b5c85d4fca245c9a73ed113a5ba08c1,247,197,50,Africa,19,1412.76
4b5ca9a843324ef3a29a1b7439d00f92,153,137,16,Oceania,22,1064.13
4b5db2cb44074512acaa571cf78fa4de,318,279,39,South America,20,2957.22
4b623923cdab4622a9f7e435bfa38932,68,17,51,Oceania,19,179.2
4b64b62708b84b5db4d098738444452a,245,194,51,North America,19,1184.92
4b66f30ebbfa421cb4cf7695bd859df3,248,209,39,Europe,18,1145.41
4b676ce4441b4edd8a2580eb32cfb6da,256,224,32,South America,21,1587.37
4b69c9ecff3f4ec58ac2317e0429e7b5,157,119,38,South America,15,1019.5
4b6b4858f32040db8e9435ce900bbe29,148,121,27,Oceania,16,918.57
4b73b8a4250a4112a484111d35bd7537,173,137,36,North America,19,1434.53
4b74729d35ef4e3c97f4012afebf16a4,84,34,50,Africa,16,378.81
4b76af0a826a46f7a3ec9f111a4d9c31,190,152,38,Europe,19,1314.03
4b77fefa1bc54013900acb085c15a783,330,289,41,Asia,25,2085.41
4b78134d461f4c4ebe69417c6133873d,171,152,19,South America,22,1122.16
4b79e6c0bff34068af1581539680dc07,347,322,25,Europe,22,2184.65
4b79eb1fb4ff4a2ea191c5414c71db6b,279,228,51,Africa,17,1476.69
4b7ae92ab7a44f269c31d2c9c32f553c,33,6,27,Asia,19,403.84
4b7b4b39380c4e6eb53fe5a4d42b364c,62,8,54,Europe,19,331.84
4b7c178b69ae45e692b66a1af4576572,226,168,58,North America,21,997.98
4b7cb85a4639427baa0f0941691ca6e9,364,355,9,South America,16,1415.2
4b7f475e0dd04057b5ca6c153d0c1b0e,216,166,50,Africa,20,1210.09
4b815ac11a9c40068746cc7e6ee50c09,248,208,40,South America,22,1914.89
4b821a1336b64c25b87fabdbcf2ed674,365,319,46,North America,19,2249.18
4b84065d382c48ffa6a3d252871852d3,304,267,37,South America,21,1589.36
4b84c06fd8134d0cbd27797732bcae50,294,249,45,Africa,28,1673.64
4b86866401e54c4195125350d31e88d9,111,84,27,Oceania,21,470.22
4b884661be184dcb87c3496b4019da2c,50,23,27,Africa,20,77.01
4b8ac0610714453fb62d7b66f656da30,260,233,27,North America,16,1796.36
4b8da157ff884515a6401da97e1a4bb6,233,208,25,North America,16,1288.37
4b8f770f0bbe485899ecbe628ebf207b,360,325,35,Europe,20,3034.19
4b91f84bc2fb4e7786aebdf9d74c9e0c,230,168,62,Oceania,18,1336.52
4b93343832e64b7d9f72b9fe7c547a00,274,242,32,Europe,23,1711.92
4b976bc2db4a4c0b8ef4172755dc766b,132,99,33,North America,17,994.09
4b984b416e204e1e86314cbcd7955ff5,358,339,19,Asia,17,2409.48
4b98cec4eaa74421aa2c519cc7517264,339,291,48,Africa,20,2117.42
4b9afe9e5c754eae920cdb145516057d,231,181,50,Asia,23,929.62
4b9b54f7857c4cb796e351ce535d7871,364,352,12,Oceania,21,2709.39
4b9d043fb51f4570a0a4f6cf8a2adff0,248,205,43,Oceania,18,1949.18
4b9d7e91b55046098a302d2945a8759c,276,244,32,Africa,15,1883.64
4b9f0d7d491f4faaa1dc8a1b3ed3b0a2,218,193,25,Africa,19,2050.78
4ba145805f834c679e839bbd12ee110f,53,33,20,Oceania,17,385.17
4ba1e956f0d14c8fa004c790a5396c20,79,56,23,Oceania,18,433.66
4ba31d77c99447e78587885fd4dd59af,350,316,34,Africa,18,2576.13
4ba436b8af2b4d0ab886e917f4bf1a41,308,269,39,Africa,23,2603.07
4ba4826e235b4e13b121092a2e24b55f,248,196,52,Asia,22,1189.58
4ba6fc73b0af4a9f8063ef57c431377c,217,183,34,Africa,23,1573.53
4ba738f52ed74ee2ac511f3a1f1abe7e,242,211,31,South America,28,2064.04
4ba909e023c646aa948f8e8767c656c8,79,56,23,North America,23,965.12
4ba9dc6c3e944f76874eeb4e71b9490a,364,347,17,Oceania,25,2014.47
4baa5f46273247c59b2a16c6f24667a4,320,298,22,Africa,19,2619.38
4baacc25075946f49b48ae85ff013998,263,213,50,Europe,16,1183.4
4bac50576bcb44acb118bf8a9193ab4c,316,299,17,Europe,22,2604.94
4bac694c713a4a3a95c566c7c0a2b994,187,150,37,Africa,23,1450.09
4bae5d8365cd4a4ca643ad31a60aba7f,90,66,24,Asia,20,763.8
4bb133072e3c41da93bc95cfcf40e532,81,28,53,Oceania,18,451.07
4bb1674e86eb4c1d84133aa992c616d2,29,11,18,South America,20,221.76
4bb401bdea9a44a7bfeb9a57ad579c00,96,44,52,Africa,21,103.18
4bb5338eae7f4c76b607ba151eadf524,89,48,41,Africa,20,373.82
4bb70c9cdd11456ba0aebc2972506a70,80,64,16,Oceania,24,549.11
4bb8b969d8fe414dbc0dddc45d8db691,346,312,34,Asia,26,1916.75
4bb927b343f646afba09479227a6bd73,108,74,34,Africa,20,594.53
4bb9384102ee4ed9ae4de356f33909ac,174,122,52,Africa,21,552.4
4bb96b3fc3f14290a51fa39ea6420467,159,112,47,Asia,19,974.27
4bb97c7d88ce43c68b56d37c7c061443,267,233,34,South America,18,1437.81
4bb9bcc6cea94a498d2e6736614dd5db,83,28,55,Europe,22,355.53
4bba237d0e954cad9ca2b79c0bab8a29,258,218,40,South America,17,1903.96
4bbeaee83146414a97d9c6d9cd31c8da,127,76,51,Africa,17,844.81
4bc12b417ecb4fc18b8c7fabec956af9,356,317,39,North America,20,2027.87
4bc2bb780b4c4bf19bec0c3b91f0b0ce,152,131,21,North America,22,1495.56
4bc334a2867a47779cd6f9e98913982e,359,304,55,Africa,17,1705.1
4bc464fd31034036995565bb5758ef24,298,243,55,North America,26,1604.54
4bc4ab61058943a38e54ac90bd1d9818,128,97,31,South America,16,1082.8
4bc575b43177490ab405c9808401b454,364,329,35,North America,23,1692.47
4bc586c99bff46c49a7f8f1accf667d6,365,358,7,Oceania,21,2018.98
4bc72345691f4866a9497e449bd79544,128,97,31,Oceania,25,836.41
4bc72788aa644533860717bb61691556,355,341,14,Africa,23,3326.46
4bc72795b68641a99e6329a30615d429,47,5,42,Europe,14,677.71
4bc7827ac8fe4b7e93f6fcf40c779d0b,118,79,39,South America,22,674.03
4bc9fa36c84045e48a4d3bdc18e801ee,193,170,23,Asia,21,1561.85
4bca6b890f604337b3f36c5cb7fe2b1d,52,11,41,South America,20,344.95
4bcc8d57910144d7bf4e02bce9c72df5,90,65,25,Africa,23,314.31
4bcd1783ea344c539f6f83049cf06e18,365,336,29,Africa,20,2232.29
4bcf5d63e58f4f3b8825d56de60129c8,142,94,48,Asia,21,260.07
4bd128951bde49c49f2a50c8a518a00c,167,128,39,North America,25,1202.15
4bd12d0d61f24edc9a3ba4679aa3c6dc,195,164,31,Oceania,22,1308.18
4bd1d31ac04c43d8b652f6776800b88e,313,292,21,Oceania,21,2093.86
4bd3a70d263e4d2d9b19837cfac85b4e,164,147,17,North America,17,671.11
4bd42c5b854c4eba98821b3c32731e68,136,95,41,Africa,20,728.65
4bd68847bc404a07a7ceb417ca0f6199,117,76,41,North America,18,669.56
4bd9c730472a41e1aed61d9fe9e80200,109,65,44,South America,17,943.97
4bdc53f8b7f24a1f89e56844ba67c169,301,257,44,Africa,21,1350
4bdd25a208ed42e4964ff1b7307f0d41,46,7,39,North America,26,369.18
4bdd6ed9e1e545dd886f35d1236ba53c,365,345,20,Europe,18,2368.8
4bde16fe833b4d18966e55861e4e235c,111,53,58,South America,19,360.85
4be10a9c85564ad5a0d53c99a2c2eba5,38,10,28,South America,19,208.9
4be122c3c5954efc978bb16975c6f58b,355,308,47,Europe,21,1367.18
4be1cc9baba64120843660fb615a1404,363,359,4,Asia,19,1740.76
4be21fd163c94a858e534b92e0ca5de2,144,118,26,Europe,18,1375.81
4be37229885a49eb810ef101894990d4,108,62,46,South America,20,548.79
4be49633d2af425bb754b24d7fa384b4,338,308,30,Oceania,27,2543.3
4be8743a15c44c16ab4f3c37f8f72124,283,252,31,Asia,16,1720.67
4be97f0c3e72426bbff36ebcc673417c,350,314,36,South America,21,2381.48
4beedb6cf954439fa4ed40ac297d0b6e,305,273,32,Oceania,20,1257.07
4bef4bf7093d41b0a7f1ad26df385565,302,256,46,Oceania,21,1606.33
4bef6d89a3e04a8c88bd7126c89294fb,357,303,54,Asia,22,1600.08
4bf4da167a3a4a8f86bd8c67b03b8719,365,326,39,Africa,19,1753.12
4bf5452c1ed64b35919fb7877eb530c6,166,119,47,Europe,17,835.3
4bf54d81b6084ff9a028b50ce3096d31,127,69,58,South America,24,711.23
4bf6d6899a8a4122856a88b05d2260b0,150,100,50,Oceania,19,1006.36
4bf889972e9e46c399f0c226111c7f95,184,135,49,Oceania,14,575.21
4bfaba6c3d434d63a1d3e0e6c7459d80,309,258,51,Oceania,19,1964.34
4bfb5d1e78604376b8113909447b73fc,364,339,25,South America,23,2886.99
4bfb5e2fb323430f9150a09f26b5bc60,87,58,29,Oceania,24,609.48
4c006f636d3743b7b38b351e8e9e9c87,362,356,6,Oceania,23,2217.99
4c014fba06a74815b558299d5ae8524b,363,335,28,North America,26,2019.28
4c051892069d45b29d74000f01ce7f36,153,110,43,Africa,16,875.09
4c06bd413f52475698ed1726c378a78c,107,75,32,South America,18,687.78
4c0cf69574024b39a9b8c3a5608fa650,32,7,25,North America,21,300.81
4c0e673138ef4283aa2aeae244ffde0d,190,162,28,South America,19,1873.24
4c0f7313acbf423fb7fc189b68dab6fe,157,106,51,Africa,25,476.33
4c11dee9329548b092a6a239db25432f,365,326,39,South America,22,1631
4c128b18b37f4b86b43121c732acbeac,364,350,14,Europe,23,2860.19
4c14de3ff1e84f41b8283e12297cfea4,123,71,52,Europe,22,1016.87
4c157cd22c6c4053900514ffb3b6368b,208,177,31,Oceania,17,1275.6
4c18d768cb444611bd60ca0a8b9ae5a7,260,230,30,Europe,21,2148.76
4c1c0e57c84d416ea1601f7c60846ac4,69,32,37,Asia,20,301.46
4c1f696c006843069a3cdd5ab6f7d72f,62,19,43,North America,18,417.65
4c2430d2e5d346be8165e5f89e240c5c,237,219,18,South America,19,2161.98
4c266b79afdb4479a1f71c721d78f4dc,300,245,55,Europe,23,1295.15
4c27065c7e1648e785b3449f669dff01,364,345,19,Asia,25,1840.4
4c2765be5d824296b6e8955ffa2d2cc0,96,45,51,Oceania,18,537.76
4c2a96c12e724ad5ad26b51999020388,89,72,17,Africa,21,893.84
4c2c1bacb14d42229ffa69c4c2f31214,151,99,52,Oceania,15,792.13
4c2c5a77f5e6472cab2f45398166d022,178,132,46,Asia,23,773.56
4c2d682de7394635b3bf8bd9f661b6c9,141,91,50,Asia,19,739.59
4c31d2c1db0b4720b2a5022b297adea3,93,55,38,North America,23,316.49
4c31e68f8b684a8d94a794d072a06d7a,174,157,17,Africa,21,1160.36
4c33273f82c04a338f7fb9870d02da74,57,25,32,Asia,25,395.56
4c33ad46caf3402ab4d35eea23683d9e,363,343,20,South America,20,2956.29
4c36c1c6a43849bdae0e21c7ee2baedd,291,270,21,Asia,25,1652.13
4c39eec12f544a75b74ef0ece809a653,221,161,60,Oceania,23,2051.8
4c3b4e6718e14cd7a5736c523c397d5a,308,292,16,Africa,24,3325.43
4c3ca7877efb434da00a385bc806097d,74,62,12,North America,21,419.98
4c3d6100d84a4c70b28016b2b278026f,211,165,46,South America,22,1103.29
4c3e84596d4e49fd892869f3a172b8b0,239,206,33,North America,16,1350.72
4c3eb225501441a6baf8194011009391,66,42,24,North America,22,277.18
4c43df63fb8843ba92c813bcf7a54873,143,112,31,Europe,19,1514.28
4c44d0b79fa24afbbf1728d30245d11b,277,257,20,North America,19,1990.92
4c461ed91e9d4fcab4cdd2367d9bb3b9,365,334,31,South America,18,2557.56
4c478ef8cdbf43b09745ab05b9730331,209,163,46,South America,19,1590.59
4c4831b1ae4a4ab38a73850bf8e436aa,351,330,21,Europe,18,4398.68
4c48f060ab4d453086033633be96e683,98,71,27,Oceania,20,606.17
4c4d61bd6c2e4e63abd586f1e09d1361,207,179,28,Europe,15,1119.84
4c4db4eec2d74d188141da244aa23690,71,21,50,Africa,21,344.43
4c4e4a46b0504cc1bea1209b0ae03168,64,41,23,Asia,15,916.68
4c4ff0a62ad045889582de3cdc403c51,284,247,37,South America,23,2089.66
4c505ee3164049639a67255c9e752563,361,335,26,Europe,21,2673.21
4c525f9e0fae4bb9849615b584762747,121,73,48,Africa,19,820.34
4c52e0099d694d4db46542b0520ade95,327,290,37,Oceania,24,2670.58
4c53b1bd2ef74b4db5d27db33d20cd26,291,269,22,Africa,20,1612.06
4c5a735742884ac19eb1a038a44408f6,88,56,32,South America,23,896.33
4c5b08cde4114dd5803a8c3725b4677f,288,257,31,Oceania,20,2255.18
4c5c224fffb749118901c8def1b942c1,349,325,24,Africa,20,2710.06
4c5f9adb95f8463289c3261d3d6e3083,232,190,42,South America,25,1414.62
4c61123539bc4d23b55349c67aea4c5d,106,67,39,South America,16,704.73
4c62932720d245e9b7874139b38f993b,138,99,39,South America,15,1131.84
4c67178cc429480bb34e7e31a5710a0c,317,266,51,South America,21,1637.17
4c68d1538fb34fbf86a9d4f1be0d5b04,340,302,38,Africa,12,2591.3
4c6a06e622174515b0580f6840bfe094,134,94,40,Oceania,22,1535.8
4c6a22765df4419da201608498e23820,87,58,29,North America,15,869.39
4c6a32779a6147c9bb9fd3fc5321306d,352,330,22,Europe,19,3112.67
4c6a784041b243a7b2d2d7e95ee38dc5,319,277,42,Asia,19,1410.57
4c6a86906aaf4e6bbcc2e2dc32a6b711,249,203,46,Africa,21,2021.04
4c6dc32426f347bbb4ffeb6d8dde9c55,85,58,27,Africa,22,872.93
4c6e3514a9ab450b8650396bcb1165d8,240,220,20,Africa,18,1916.03
4c6ed261420340cf990317c093a7b15d,93,55,38,South America,21,365.18
4c7372ae3d4440f68de34ea675cd2b18,113,73,40,Africa,19,1037.63
4c7573230d2b41de90eae559c2a5c7c5,363,354,9,North America,20,2328.12
4c779be3ed5f4a538ff84dc22b272a78,215,158,57,Europe,21,1127.96
4c78374307744ee0aae4bcb984d11841,54,18,36,Europe,21,336.96
4c7906816d24404b9590e60bef83842c,154,97,57,North America,20,575.78
4c7f11e7a1d343218bd358c42c178807,60,16,44,North America,16,425.01
4c807a7cb6b3466796a9f0c0a7a62a43,190,160,30,South America,18,936.03
4c80bbfefb5943bd9c96838c08842b95,120,79,41,Oceania,19,625.88
4c8472fde512471a991d46d485ac7b6d,365,324,41,Europe,18,1813.72
4c853b945a96460486b1c5d515846656,219,169,50,North America,22,948.58
4c8552cda65248eb9a068755746ca106,49,11,38,Oceania,23,180.62
4c855fa4ffad4304a246d4151d211bad,335,299,36,Asia,22,2233.62
4c8755058f504efd960a9d1c3a6ff56d,278,230,48,Asia,19,2391.31
4c87f01aa1f04a5a883e7832e9a7e63b,162,121,41,Europe,24,1143.17
4c88033a35d04262a27e25c74e152c28,137,92,45,Europe,18,713.09
4c88cc2b58e34efc8d4b8887a9a38ca0,308,260,48,Oceania,20,2015.05
4c892210b0c5459c992e2738efacabeb,348,292,56,Oceania,18,1675.45
4c8ac992c6bf49be9638ef05adab8042,146,112,34,Asia,24,743.49
4c8ad6e0de4149119e00cbf533a104fe,364,325,39,Asia,17,1848.42
4c8adbe744f64583939777642dbdc121,215,191,24,Oceania,25,1876.78
4c8b2a4671734925a0b9a772226f584c,138,99,39,Oceania,25,483.06
4c8bc592552144348390739ddbcc0aff,359,343,16,Europe,23,2467
4c8ca9ce2f104ea7a9f4a5c76cd7688f,279,237,42,Europe,18,809.17
4c8ce2b2f4f748f783f12025c1819d0e,120,74,46,North America,20,812.14
4c8d9249a06444499efc827673561697,189,166,23,Africa,24,1155.25
4c8da11090d74f629ff687b48a62498c,177,133,44,Asia,17,1499.21
4c8dbb2bd19b4447a76f831cfef4bfee,309,264,45,South America,19,1552.12
4c8ddba17ded41d59f73ee12852791da,175,134,41,Africa,15,1110.85
4c8ebe2b8dbf46e4a8a5ef12fdf10940,182,130,52,Europe,19,939.01
4c8f6fd4017849b39a343929d87cd161,364,335,29,Africa,23,2427.37
4c8fc6983da149de81d1d7e9f9bf3710,156,139,17,North America,18,1318.21
4c91da5ed5dd420dacd547baadaa1da0,305,262,43,South America,21,1603.22
4c93c81319e1497a87f53780854219e5,310,259,51,South America,24,1368.58
4c9587485f804f3983496340c0beeb66,267,231,36,Oceania,15,1407.38
4c99e0345b734ea195eefc04d0f31ba6,138,109,29,Europe,19,1069.11
4c9a643fdd5a4708b5df4acf299eac94,152,126,26,Oceania,17,1077.82
4c9b85fed00a41ab977c8d06afe76b88,333,280,53,Europe,21,1483.32
4c9f634a05414306b9955703de49b9f9,318,274,44,Oceania,23,2137.56
4c9fac65e84d49e596fd18d61354b9a5,91,55,36,South America,20,676.83
4c9fe2dc1d3443f09a994733c5db352c,161,124,37,North America,18,848.22
4ca7610c635341b3b31d8c7ec220de06,229,179,50,Europe,19,1104.33
4cab9f0e705a462cac8c423f9bd185a6,354,310,44,North America,19,1892.44
4cac6d96e18b46e69b8fa8c84f4ef891,227,201,26,South America,21,1965.38
4cb0985acd794e648436818bb635c072,249,198,51,South America,25,1493.51
4cb0b023d5b14535b7305be664afa7b8,262,220,42,Europe,17,1700.91
4cb29cbe14124404a8b85ee818e3a540,193,164,29,South America,18,1517.04
4cb45145ce714898b96f053b177d6575,289,257,32,Asia,10,2608.08
4cb8c5b90b9d4fd893f3ddc1c16ebfbe,111,83,28,Europe,18,932.81
4cba792f2d66408a9afdac89259bbb54,302,248,54,Europe,17,1011.08
4cbae49801dc4246a38f2612a128b0ba,363,355,8,Asia,21,3090.86
4cbb99b2d166444891f0f3f1bd4e499c,202,150,52,Africa,27,1532.45
4cbf34cc7c5a41139fe10610d990c9cf,60,22,38,Oceania,23,532.66
4cbf7baf62334b70aca37311c1f6bf42,337,306,31,Africa,15,2222.93
4cc34b7d104d407684f02424ba9ed3f0,172,145,27,Oceania,16,1520.45
4cc3637f1c0e43f083c5410d83b7acdc,44,6,38,South America,19,254.59
4cc3a1b75ba84ee7a00aac8bdc99a081,61,32,29,Africa,16,646.73
4cc4f0b5ff4d41d5bb9c8db6d8587625,35,8,27,South America,15,278.06
4cc5536decf04da488e6301c6a870744,336,298,38,Africa,23,1769.41
4cc7752fefea471eb4d2d7184bb968bd,310,290,20,North America,18,2605.54
4cc77ba69a2c421f9a40ac635be2a1e1,139,106,33,South America,19,443.24
4cc7e77726884c269049219dabcdaa50,134,107,27,Europe,19,628.17
4ccb1a35bf4a4f4ab1b1f9f8e0655169,34,4,30,North America,17,86.04
4ccde435c32f4603bbf4987cf6f1a978,170,118,52,Europe,22,845.42
4cce45145cb44c6aa9cbd5a6c058dc43,365,346,19,North America,20,2440.65
4cd01d86b8a94de89d88c9f27796ed23,187,138,49,Africa,16,973.54
4cd0d7d5a33546a1b2f6648270172eca,336,306,30,North America,17,1945.97
4cd17e155f444b70a6589cfa986ab8a7,208,182,26,North America,20,1394.38
4cd2abbb898c4aa694eeef211db5dafd,333,297,36,Asia,18,2504.8
4cd7614e61a742b8b952c218c0b3e347,69,26,43,Africa,17,619.46
4cd9446e29314c61bdbab530a2ca9f5d,79,45,34,South America,18,533.19
4cd985a930064fe0982f5fb677b8161b,337,276,61,Europe,16,1603.43
4cd9bd9fb36e4ea097bd2f91281c949b,321,276,45,Europe,15,2156.37
4cdaf11567914b81bb1508ff244bdb25,205,164,41,Asia,24,1164.54
4cddc6eef8f941d184a47f696bb7f66a,365,334,31,Asia,20,2247.39
4cdf6cb99e6c478286b771dcc48dd61e,140,99,41,North America,21,608.01
4cdfa1951bd14e318c800b6207a4433f,364,342,22,Africa,14,3384.47
4cdfb3642d80487380596d05aca0546f,201,151,50,South America,22,930.83
4ce19a8bdc2d4c82b689053826062ed6,182,156,26,South America,15,1278.93
4ce25560c7664f80ab88bd7e2d47ef7b,362,349,13,Europe,22,2703.16
4ce476e0a00143d9a2252ce53fc30321,82,66,16,Africa,24,747.63
4ce7f87566ab4981aedcf6b2467c65a5,90,57,33,South America,26,417.88
4ce98570f7934b70b6b495265cc21390,247,210,37,Europe,18,1262.44
4cecaa7bb59b4651b3dd47ce48b435d6,345,322,23,Africa,19,3057.52
4ceebd609f174b3fb79719b32eadf6bf,325,284,41,South America,20,1901.2
4ceec3186707413c916287cc717f810a,237,210,27,South America,23,2004.23
4cf27f402b1b4edba06d82bbdbf19f25,365,355,10,Oceania,20,1597.37
4cf29c7d1fab4cc8beff1b198e2d9ee6,283,259,24,Europe,24,2143.09
4cf49d7dc12247ebb7253c37b07149df,363,328,35,North America,19,2015.08
4cf7edf6337147c0b68f97a6998471ea,356,307,49,Africa,20,1520.96
4cf802ef28a64e3c97743343a19ee9ff,362,340,22,North America,21,1102.8
4cfa016893204188a24aa8ff192d6cae,365,360,5,Asia,23,1854.27
4cff1aa6957a4ae9aeeee68901de6db4,197,144,53,North America,22,735.9
4cff364f4fa6446c9d1b4d11a74be75c,213,185,28,Europe,13,1634.74
4d00bfd4464e413aba084de076bc25df,277,232,45,Europe,27,1652.47
4d01433b6f204b938e656a84c9e6935c,215,187,28,Africa,19,1760.33
4d025ccc082e441eb0effcddbe6dfdc3,138,93,45,Oceania,21,810.76
4d05ca2719754d04ab0c892ca8ecc2ad,127,103,24,Europe,25,1049.34
4d06b6d6050b41429061f6b5ff3c498b,297,259,38,Europe,18,1505.8
4d06bd430e9641df955d0aaa6bf207b2,281,225,56,North America,18,1537.97
4d07061dd9b04e6d9ccdf0b17df29667,123,79,44,North America,21,592.35
4d07696bff77468f9deeec937884a72e,199,175,24,North America,18,1250.48
4d0eb1a5aff4497dbe48008d7572251d,216,169,47,Europe,14,1747.26
4d105dd0ef1d4a4eb3e18e9fdfa50343,362,356,6,North America,26,2203.56
4d108251dbf74aecb9ad3b944d2ea0b6,179,149,30,South America,20,1621.93
4d13a6e9027f4dac8806fdb690d6c94f,118,64,54,Africa,24,729
4d14a33fcf2c43948e1ec1b9207cb1c8,59,14,45,Oceania,21,479.96
4d14ad38f302415780e94c1a0974e5b2,360,356,4,Africa,16,1176.41
4d14fb5f731b4434b9dca87879070103,38,17,21,Europe,19,442.89
4d1529ac05e744c187b1489024822cb4,342,320,22,Oceania,20,2778.08
4d16642ee05743c490740324f4811829,331,306,25,Oceania,22,2241.33
4d19a0b717714883a687650b19b8f3bb,256,203,53,Asia,24,1183.76
4d1c87e08e0042fcac38b6e20cdd0603,232,209,23,South America,20,1876.63
4d1d60a246c94186b974096bd8c0b699,149,130,19,North America,16,1407.02
4d1d98a46f274cf7b1edcea0538cc0c1,59,6,53,North America,21,270.22
4d1fbb1ff4924bfaa166c8c171ddd7ab,108,73,35,Europe,22,644.96
4d20cd618fe44a8cbc4f55cf4da0d37a,365,335,30,Asia,23,2448.97
4d21cffc2a454556ad847f7927e35fe1,209,173,36,Asia,21,1132.53
4d225a871a6443af9f6b7a82ae02790d,331,307,24,South America,18,2709.77
4d246d41d8784bbaa16b6c7b6fd2d3d1,207,185,22,North America,18,1492.79
4d2518574ce44ccc8dc273fdb0624039,338,305,33,Asia,19,2556.85
4d27db4865b94a95844fce12bb324e86,96,49,47,Asia,18,545.22
4d28e182011f4a1b98a9b90d7be1a8b9,181,135,46,North America,21,1259.27
4d2a440e15d7486fb746097428da2ced,167,134,33,North America,19,870.42
4d2b6c3f84414a07aeb889010191971c,84,57,27,Europe,21,839.61
4d2cf2cb6e1546d8b609466dbc93cd31,252,215,37,North America,20,1233.96
4d2de066089247e49eb0679d6390144b,336,294,42,North America,23,2426.55
4d2f84430bb24bbca2391cd41f80e448,91,31,60,Asia,21,392.09
4d2fcea602c34e109125a38ebd4a124d,163,124,39,North America,22,1038.09
4d30eac9bf124edc881e27174e3c3122,122,97,25,Europe,23,951
4d32bbf9fb4549848e1dacb434e36414,304,262,42,Oceania,24,2020.94
4d33a8fdcd344b288b05b6c86f2d031b,66,13,53,Africa,20,200.92
4d3492c6db9243fca6350f7009670ade,98,41,57,North America,22,444.62
4d366e9589ec40608b240e24420ebc23,364,360,4,Europe,22,1714.64
4d39009aa8b1432fb250e0d880c24ce9,161,133,28,Africa,20,1429.1
4d3bee9408e444629d754c90643db350,364,344,20,South America,24,2565.56
4d3bf8df83864904a28fdfc9ddf0ac1b,110,73,37,Oceania,18,563.98
4d3e0561c0c649e19e03406f3eb7b297,127,87,40,Oceania,22,1012.65
4d4353e5829245cf84bd9d28c4b1a37f,137,107,30,South America,22,1326.26
4d456e46acc54509b6206433c204e76f,277,229,48,Asia,19,1209.34
4d47390f1d4a4483ac1c0d8df627dc68,240,187,53,South America,23,1515.27
4d477ee284cb437d803975100ecf2f91,256,229,27,South America,17,2337.34
4d4d9ad490294389becea8bdc6e5f0b8,92,60,32,Asia,18,797.49
4d516f8f87e44cde8b62e461198a2ba5,182,157,25,Oceania,22,1350.61
4d524e10fc9741ce9479341818ee9141,363,334,29,Asia,24,1731.96
4d52c2177cdc460bbe824d9a2c7ccde2,261,216,45,Europe,19,1640.92
4d52ea48c2a94f5f85853ee107ae2dce,331,290,41,Oceania,18,1971.23
4d537388ae4a4327985352b20e6e593f,213,193,20,Africa,18,1356.8
4d5543e2f5af4fe194b0d261be958e96,340,298,42,Africa,19,2173.39
4d568ccd1d31411e9d80cd0a9b72e85d,108,73,35,Asia,15,812.43
4d57c599594143e293836e11e1f75d9e,270,228,42,Asia,23,1296.8
4d5aa32c69844d878defc42ced9f7e80,278,232,46,Asia,23,1196.72
4d5d4ebe728e4857a5bba38ee3ca6568,365,354,11,Africa,20,2018.8
4d5e3286d3eb400a988dc0be5abfdbb9,51,2,49,Europe,19,370.41
4d5e3e281c3b41d9ad771a6acdf28662,157,104,53,Europe,23,964.13
4d5e420eac4744e084cb625526544e0f,290,268,22,North America,22,1835.4
4d5e98fd34e34f93a0e09411020c4576,261,230,31,Europe,23,1438.22
4d5fba4df66949bc9145382cd89e0259,321,288,33,Europe,21,1507.29
4d607c71a5bd44ce8b7a7e2f851a9bfc,152,106,46,South America,24,1122.14
4d6226a5f4fd41d789e22a265b1caaf3,173,138,35,North America,23,1103.61
4d64570dcbb342bea41ec0ccd80601a4,250,199,51,Africa,19,1693.57
4d6755f4801849f4b0514df73415134f,280,235,45,Europe,20,1513.97
4d6795708f534dd8b7b23b04c50ebedf,82,31,51,Europe,20,633.4
4d69e9609cda4e6787bd6237c3c85efc,320,295,25,Africa,19,2205.13
4d6ac94ffdfd43fa817e6e4d39927b10,251,201,50,Oceania,21,1619.51
4d6c3e6ff3d44b9cbed6642296d90c75,274,237,37,Africa,19,2153.71
4d6e05e4e2bc4be0a5142d6b38c9b224,165,109,56,Europe,22,731.58
4d711ce4ebaf470aa9324c742e6e97d1,200,153,47,Africa,19,1701.57
4d71d7d30775485f91b8a9bea1fe3eb0,297,252,45,Asia,20,1755.87
4d72645151724ff78b041361525cb5f1,104,50,54,South America,21,434.42
4d72ea6683504de49a4d76e51dbec95f,365,344,21,Europe,19,2032.86
4d73d0ab23f746249ba591f97eb59874,178,143,35,Oceania,17,1069.25
4d7513d51b6c4d60bade897b21e01b46,135,116,19,Asia,20,1418.2
4d7538ea57624a5294077d285b872bb8,156,131,25,North America,24,1203.73
4d78a901c7a84702bf92c65cff810969,108,80,28,Oceania,25,999.8
4d7a14ccb2ae46a3a7f73760f0f3485d,142,104,38,Europe,26,601.3
4d7b119f716f4837a244d871089030f8,158,126,32,South America,14,1384.52
4d7bc781424d46a6a1153d30d4224a50,363,345,18,Africa,22,2312.78
4d7c50bcdb70452ca27c8e6997a6356d,341,314,27,Europe,26,2814.89
4d7cef3c922c461fb9b0c31349f6b5ff,170,151,19,Asia,22,1409.94
4d7f6845422b437bb79292728945d3d0,285,246,39,Africa,22,1290.82
4d81d01da20b4d1fb8a8cb69100c499d,232,198,34,North America,24,1385.99
4d83c1c345bb40b184d12350bb0dfacd,126,87,39,Oceania,21,443.38
4d845cc83f30419dbe8a48826eccc25a,108,54,54,Asia,18,423.77
4d84be6af92c480780f564a013b0838e,356,334,22,Asia,18,2831.29
4d85698278894a55aceceaa92b673979,262,218,44,North America,16,1005.35
4d85d9a69ec148a3beaf5ec750473fe4,44,10,34,South America,17,255.76
4d8a2b37db544434862308c5a0e9d20e,151,97,54,Europe,16,689.02
4d8acb5997bd4e57b41c863d54621738,126,96,30,North America,21,1092.14
4d8eda174b2a48749262655ac49b2540,271,237,34,South America,24,1939.4
4d8fd54150734bee9aa4792bc3ce8491,243,222,21,South America,18,1881.13
4d916a04c0084884a080924780ead496,162,119,43,Oceania,19,1134.7
4d921e3ef8b0452091c760fbb28e695c,239,189,50,Europe,20,1064.47
4d92d01cf83f4e92ab038c2287236c16,283,262,21,Africa,19,2013.7
4d939d74872f450eb6301b231ef42821,318,271,47,Oceania,22,2269.16
4d95e62eb8e04734b806ed01614b5a1e,70,25,45,Europe,16,452.75
4d97beffc9b64780830a9fd434c6ab7f,365,328,37,Oceania,20,1965.41
4d98dfe8afe64ea8be1c0f27c992d233,109,81,28,Africa,18,827.72
4d9b59834f854c819bffc9d954dfb1f1,213,188,25,Africa,19,2338.65
4d9dee40308a4883b3aad6273f034301,169,139,30,Asia,25,1321.08
4d9ff76ae89f47bdae6e9df4dbe07c18,314,287,27,Europe,18,2347.91
4da1ab7ed57746f396f3c680a3383764,159,121,38,Europe,22,1235.64
4da663a807a8493f9e01e46aa3a8d548,276,229,47,Europe,17,1569.2
4da82a90987547c4bd72e7fa92804c47,116,81,35,Asia,18,679.55
4da8d158e5474195b6d77a461bfa8ab0,262,217,45,Asia,19,2069.59
4daa9899ff8b4f6c9cdacb73769fab9a,296,255,41,Oceania,14,2308.98
4dab7918b23e4191b640ae34dce56955,297,254,43,South America,22,1814.99
4daba502d73f4558847232f6b0ab5f5b,341,316,25,North America,26,2550.47
4dac765dad014f248b631b0496e2e543,197,178,19,Oceania,15,2008.66
4dad4f6b326e4051b516f392aa549a94,364,318,46,Africa,19,1983.77
4dadd9ee37e34279b026f3d4a56d4e67,96,54,42,Europe,27,416.12
4dae9159ce17428298b19be4f5c04fe5,318,280,38,Europe,17,2288.18
4daf2d3fa5504977bec7cf7c9efc4a2d,298,253,45,South America,17,1664.23
4db02e6c77a44ad391d75ac1612bf0a5,363,322,41,Oceania,13,1702.82
4db131ca440b424eb30fc69c6b59af27,58,22,36,Asia,23,366.23
4db2ffc786184840867f5ec17b4bfb25,144,94,50,Asia,22,1029.56
4db694b1dda94d98990e8b4c8354cad9,220,160,60,Asia,22,1022.26
4db7813a43334cbca5f4ceeb6ece7235,56,34,22,Oceania,17,449
4db7aa584af447d0965e2d7918d7ff10,365,346,19,Europe,15,2046.27
4dbbfaef0d324997a0c12b084eb4d47c,50,1,49,Africa,19,330.15
4dc0417f731c44ccb338b72917b277b9,85,44,41,South America,22,576.23
4dc16dd6fe224d7ea571167e71574b8a,70,28,42,Oceania,19,617.67
4dc1effc45264c0381dfbdd541c585ac,270,246,24,Africa,24,1607.77
4dc3faf081854207867ddc30ecb15939,255,214,41,Asia,28,1418.37
4dc53655febf431fb8453c698cb7d1dd,333,280,53,South America,20,1952.73
4dc57888bb154788b43f7cd856876ca2,353,324,29,Asia,17,2476.93
4dc5d5e7bbd24e6298a84b1f5ef0e153,207,167,40,Oceania,19,1708.72
4dc601b58fd1411ba041580e1e9dae3a,75,59,16,Asia,16,823.93
4dc69d868f0048688c401afc956913e2,365,323,42,Africa,19,1605.71
4dc7c8986fa34b34a1075feb1af5fff6,288,269,19,Asia,17,1933.95
4dc92d1d966b47baa72abdeab61809f0,82,46,36,Asia,19,775.26
4dca2a4c59c8457a9d658853f0992f4e,365,354,11,Asia,17,1613.22
4dca8b57254e457fadc5b4c911d1aed1,66,25,41,Oceania,19,623.5
4dcaf65d8d3f45d79e4eea2079aa6ce7,364,332,32,Europe,20,1963.04
4dcc1b76894b41538545a94f2a19813c,142,104,38,Oceania,19,662.64
4dcdc61c4f9a4a28ac6047fbec757894,171,120,51,Africa,27,986.98
4dd12172576f48958208794a179cb619,191,143,48,North America,27,864.99
4dd5050e9ffd4f359fb72f8910da70b6,309,265,44,Asia,21,2157.65
4dd5619b65f0467d8feab27f9ff10622,338,317,21,South America,17,2581.27
4dd5794ecf824436a39424594f0a1007,106,74,32,Europe,21,695.01
4dd58c7d36de4540a3690262dc554ff4,302,267,35,Asia,26,1726.32
4dd5eeb9b0fa4c9fa9aefccf4ad81f00,114,82,32,Asia,18,952.39
4dd624d9d7d8472d8163424c9b968d93,364,333,31,Africa,22,1435.7
4dd72df8d4324b129fb938723ada6526,216,180,36,Asia,20,1692.11
4dd73292faa441559fe1ec1fe6e6d058,254,216,38,North America,19,1594.91
4dd7995099b54d829307f17d0ebabc47,335,286,49,Oceania,16,1987.81
4dd7ec2b697649bbb4eaa8b1f690bee7,205,157,48,North America,16,993.5
4dd804b88522492bbd8815336271967f,125,87,38,North America,22,972.91
4dd84e7cf3484444977c2c72479d3ec1,273,253,20,Africa,21,2222.44
4dda4463dde44592b8900f4edda93054,166,118,48,North America,19,569.41
4dda803a704a4355a8f876c5395b9893,181,156,25,South America,14,1650.14
4ddafc06364047259e0fa151af6f852b,110,60,50,Oceania,26,999.31
4ddb375b11b34540a770ae927e06cfbf,186,144,42,Asia,18,1482.95
4dde50370ea645b990269280e316d610,69,22,47,North America,19,474.46
4dde9ef842d24138a54e2c9f97947bc3,339,318,21,Africa,22,2675.89
4de13ec5595a45f8b8d59f10b34cd784,115,80,35,Africa,23,445.28
4de2ef738dde4b48a2e3bff0a94f06f0,95,64,31,Oceania,16,599.74
4de3326c370b4abfbb128aece361e063,307,276,31,Africa,15,2174.48
4de50acdb455463fb35276d60e8070ed,365,352,13,Europe,25,1420.36
4de626423a5d48d9b6385009f2d41379,329,291,38,North America,20,2114.94
4de63a17942d40e693d9add5bed54f23,337,305,32,Asia,23,2532.97
4de909d355e846299e7eb91d9b85d31c,133,93,40,Africa,18,924.1
4dee6560e7a84e52981fe3536c1e5f23,124,90,34,Asia,20,499.11
4def3a5dbaba41fe9706c32730ebb1c4,322,305,17,North America,21,3271.34
4defd8b2a7b34c3987db32df774c9dad,348,304,44,Europe,23,2159.13
4df1e1af32474b79927b293282abc9ab,169,127,42,Africa,16,601.24
4df2f7ecb36e4ee9ad47f84cce1afc4d,133,83,50,Africa,19,932.89
4df6cad72a404c4db083a15a26985f37,325,286,39,Africa,21,2280.83
4df958a4608f4c8fa339da37ed297103,335,294,41,South America,19,2956.47
4df9d9925dbf46d8ad9efdf221e88e75,189,136,53,Europe,20,997.36
4dface2f714d449a9ff0ce2def91450d,255,209,46,Oceania,24,1417.76
4dfb69c9b17542dc86288fcdd84f7f48,331,298,33,Oceania,14,2368.49
4dfe798af87b4aeb8fe2c2fa2d6d0535,128,100,28,Africa,20,1136.03
4dff7d930d0f441b89f44d2f98b3251e,285,236,49,Asia,18,1499.2
4e008e7ba4ac4316803ae4b9e2ba2303,364,325,39,South America,26,1937.65
4e009a51be9f4e5ab99042b3f7f3d0ec,364,356,8,Oceania,21,2376.31
4e0327a017e34000b7e19adbd7713b97,363,334,29,Asia,19,2250.66
4e047b27f50d45489e600738a10e295a,126,104,22,Europe,21,926.58
4e0768eb52744ba28912f43984a78130,96,47,49,Oceania,22,286.45
4e085c872131440aa5ed88a333ac8e14,100,69,31,Europe,18,573.43
4e09cf1839fa4a4a83b6fa685b4d6248,235,200,35,Africa,23,1741.52
4e0a5c2517604609810a82e4f3f13f3c,101,63,38,Europe,21,923.43
4e0cbb764b19476787a20867350f6885,348,296,52,Oceania,22,1522.87
4e0e42213d09448a886a36f82b27c4d9,289,248,41,Europe,22,1933.26
4e102f3b7403413eb92c4f1bc30273a1,260,234,26,Europe,21,1832.85
4e1181d8565b478eb96cfcf284e68325,292,262,30,Asia,17,2780.04
4e11cdbd1efb4002a764d5a2862ff185,141,117,24,Africa,18,910.46
4e12ae786d7b4f099d1654e9b5345714,143,97,46,Oceania,21,609.6
4e13413f1a5a4cc086d6886191acab0e,79,35,44,South America,17,659.41
4e1bb7b1df3d4cfeb9677ea74a3bb974,228,189,39,Asia,15,1205.07
4e1c5ec14f83408d8b7c32ce6805676b,365,323,42,North America,22,1355.62
4e1f36171f8a4547ac0075621f196c0c,44,29,15,South America,22,360.72
4e20207b930d4d36a692513ff532ffa3,188,165,23,Oceania,22,1149.3
4e20e32392ff4e079a66adc82de8b1e0,226,184,42,Asia,20,2079.85
4e236473ee9b4171a4356c65737fd6ff,186,151,35,Asia,19,1161.03
4e2497e1f1004fdcb45f35efad9c5d12,309,273,36,North America,25,1764.02
4e29007f43ea4f028e6e520c65713b66,235,205,30,South America,26,1984.75
4e29489052554736a0f8dfabad1d7a64,167,139,28,North America,15,1265.77
4e2c41d702e24720a17bc39f00d3f38b,268,224,44,Oceania,17,1721.97
4e2c7aff5b4f43efad06797f30c75c7d,352,316,36,North America,19,1808.92
4e2d30aa12c248a58b3bcc326378b668,217,194,23,Asia,22,1754.14
4e30e174c6044f8394985f7fdafed610,136,92,44,Oceania,24,683.99
4e32107dbe944b589113d7fc1b4fc5c8,326,307,19,North America,20,2658.49
4e324a61e6224281aafa37dca6ac3aff,219,171,48,North America,16,1222.49
4e32bf23d0dc4b25aed49c944cdbb88e,182,162,20,North America,21,948.12
4e349c24d2ac441fa014cb06c50c10dd,141,94,47,South America,23,863.81
4e34bdda42af4d3cbff388e19300c3fa,130,108,22,South America,19,1085.74
4e35803a8bdf49bf9d59de3d9ef2c3c8,213,163,50,Europe,19,1123.05
4e36452239f44b40b3c12d5e40c5cf7f,193,144,49,Africa,19,1013.36
4e39557158314e10bf08039d2db8c34b,365,335,30,Africa,16,1849.62
4e39f10c02a84291849787c76d89e86a,254,226,28,North America,21,2286.23
4e3d47f5c0a943e5b455dc046095085c,98,46,52,South America,22,307.74
4e3d6df0d1de4fe1938dbb5b52d23f53,264,238,26,Europe,16,2505
4e3d80a135b34cb58e26be8c3d8fe74f,202,163,39,Europe,18,1453.56
4e411eda393147bc9f15df83b0422f6a,229,201,28,Oceania,23,1327.17
4e412fe1cfc64afab79bd248c61f864a,172,142,30,Africa,16,1173.15
4e428d3035534a28800dd8446018de37,365,317,48,Oceania,25,1621.6
4e4350a710524fc49d1b0f126ddbb75f,59,3,56,Asia,22,118.5
4e4373d1bfe3466d993c1b05f06d1f43,211,166,45,Europe,20,1246.75
4e43ef78703c4dd2b9d4cb502521a2f9,198,165,33,Europe,16,2058.37
4e44a154ea1747d8acc3427e2a1c778b,124,73,51,Asia,19,467.71
4e44ef98f8584f13b8fb5d95b4862d5d,234,183,51,North America,22,1629
4e471e779ade4c89a7e04229cfa40680,359,316,43,Europe,19,1947.02
4e47f14ba30a4d94b6caea57b28b7f49,347,328,19,Oceania,22,2289.23
4e486e24e4e940edbaa9b1cbb214904a,30,13,17,Asia,22,243.99
4e4b99aaf9cb499a963ca9d8f79977f0,142,107,35,North America,24,1112.34
4e4d17d037094dac8f92db7c9b9e39e4,120,71,49,South America,20,531.97
4e4f805bf71f45d999c46b7f1374d3fe,36,14,22,Africa,22,494.31
4e50b585bdd1411787f1df3ea1a72bb8,267,221,46,South America,24,1280.22
4e527902dada44ca8c40ee599234f29d,359,328,31,Asia,26,2521.45
4e54f550f4f64b26a8522434cfaa4226,264,227,37,South America,24,1473.07
4e5570f51f0b4c1c80cb3f35e438cb12,249,224,25,South America,26,1674.77
4e55d75211804b82956e8f7a6ce829e8,168,143,25,North America,14,1495.19
4e5708da38754ba38f2a3818a86bcfe5,227,204,23,Europe,17,1999.52
4e59a5b2cef04bb38bf6da6680dab7a4,365,353,12,North America,21,3197.64
4e5bfe011ea84fe6bdf67a44e0e202f6,63,23,40,Africa,18,559.96
4e5d6c74dde446b7a1dbe04ca3ce4c49,364,317,47,Oceania,14,1794.96
4e5f0ac44ac54b01b7840902e01c5923,268,220,48,Africa,21,1155.95
4e5f488a902e43828f213445b6008990,337,313,24,Europe,22,3052.29
4e5fabec750a41c4985c2572386d4230,266,238,28,Asia,24,1417.02
4e5fdfc4e8a34f18ad66144afe22391a,362,350,12,South America,14,1948.56
4e63105ddecf464b8636afe839028385,257,214,43,Europe,22,1794.16
4e64e490d1994d9eb699c9dfc7dfb30a,71,21,50,Asia,16,548.05
4e65c3ac905e41568949801e30f19e65,159,106,53,Europe,15,1000.2
4e677db431fa44d18f0ebe1251f0f356,72,46,26,Asia,24,205.48
4e68f6e1896d4e91a202809dc3d3f007,161,121,40,Europe,16,1624.33
4e6d5997b28048aaa5ecfcec62d9d76b,365,351,14,Oceania,14,1598.35
4e70febbbbab47caa8b4d69b0433fb09,228,180,48,Asia,17,1132.69
4e75a513fe0f46ecbff54660a5f6b168,225,176,49,Asia,21,1346.01
4e7772b58fcb4abb9e420fd592d56247,281,243,38,South America,14,2105.65
4e7944a800d546538f8c9234d70eb699,322,283,39,South America,26,2132.11
4e7db4defcd347a79efc488ef4a426be,40,14,26,Asia,23,291.14
4e7dc2b01f844533b30945299781699a,334,288,46,Africa,17,2016.7
4e7efaa4486b4729b49f159f558c85cf,263,208,55,Europe,21,1473.93
4e8135478cc747f9b2cf6cc9a40e02a8,364,353,11,Europe,19,2138.95
4e8187f19f0f437b9e03a0f85abbdeae,259,226,33,South America,20,2520.15
4e81eb8d4fb24cf09583aa0ead7e4960,300,246,54,Oceania,18,2017.88
4e825286183d41098a3ea481d02ce8de,126,94,32,Africa,21,1350.58
4e83a1930a7b43beb11cd9d48a414476,144,120,24,North America,19,1405.94
4e84166127fe4627baabfa7cb1d93575,283,249,34,Europe,16,2248.97
4e84186f88f240e8a30788287a7680c9,119,85,34,Europe,23,997.45
4e844005e0b243b0b864e9094384bb58,136,105,31,Asia,19,885.85
4e850c340024493694bedd65ce6e9e78,231,201,30,Oceania,20,2081.76
4e876652e6534b0491a5db720d1dab5a,326,277,49,Asia,17,1591.17
4e885754da43438d9d8208a90a13d91b,330,318,12,Oceania,17,2592.82
4e88e2d543bd447282c6a943f9a8030b,143,107,36,North America,23,1284.62
4e88e369ef1f4342af44ec74a39ae56e,284,239,45,Oceania,19,1786.09
4e8a3491f41b46b3a9f4fa8b07142d57,343,305,38,South America,21,1826.06
4e8b9e8434654a7aaf1d8984a4b45f63,150,129,21,Asia,19,1279.73
4e8bb5d6a5964ff094a50e96ebb17d7a,317,296,21,Oceania,15,2205.54
4e8c296df5a748af92e37baaeb7e991d,323,286,37,North America,20,2577.6
4e8c93e1ac1f4aa6acf3a93393d5be8b,190,172,18,South America,26,1704.5
4e8e3526b94240929d96b7e075948b1c,114,69,45,North America,23,550.79
4e8e981631ef4f31ba991688cdbf8c21,55,23,32,Africa,17,340.89
4e8eb3dba7d545f0afb7c2e50c3219ad,233,207,26,Europe,22,1734.24
4e8fe58a2c9b487cbaad5b462094c927,356,319,37,Asia,13,2328.79
4e9023a3dd5b46508ec97b3ffdb56715,364,352,12,Africa,21,3004.55
4e906aa58d3148338394aebef2d33051,280,239,41,Europe,19,1774.46
4e9082b91b684a97bec214c372d6f62f,333,317,16,South America,20,1845.61
4e90f2b03b75454fb1cf5544b40e8272,78,51,27,Oceania,18,509.94
4e921deb82d2423cb9d8fedcd74276fa,115,61,54,Oceania,24,673.23
4e93610cbd9a489aad99614fb7c9c117,137,101,36,Asia,22,582.39
4e95b4f0be81445f88708f8e813e6912,333,286,47,South America,20,2066.88
4e9a0c7a502b4213805927d3b9a87d2a,364,359,5,Oceania,18,2740.66
4e9ac950556d46f99027d503883e0676,212,169,43,South America,19,934.25
4e9b0a885ae7458fa5059cb5bade037a,296,273,23,North America,15,1915.19
4e9b411f87964444ba48b0d028e0e77c,362,315,47,Europe,16,2112.66
4ea025a88e88461780dafb70f8d2cb76,364,334,30,South America,20,3160.09
4ea19da78f804f3e917a2152bee8c07a,365,343,22,Oceania,23,1897.24
4ea205db979b4e0f93bccdb467a87edf,320,290,30,Europe,19,2477.38
4ea3e611b8c640d59334cd6e47c19a24,133,88,45,Europe,15,892.15
4ea4ce5f4d4f467181077034406e241e,200,156,44,Oceania,22,1806.94
4ea7b604cf51431586ce0bd391a851dc,332,297,35,North America,16,1972.77
4ea7f2d1fd9b42f4af6e55749fcf3c87,80,39,41,Oceania,18,625.16
4ea8e3f5bfdc49098b4b0dc85b8e9010,94,39,55,Europe,24,432.31
4ea9478295c64a029b4cf268d1e2f483,128,99,29,South America,16,942.68
4eacc0daabb746f4afc990e045384c8a,204,186,18,South America,23,1867
4eafd3197cc5404893692b98da49d052,299,267,32,Asia,16,2190.19
4eb1e6d5f84b425d8bb38c2ca353ff85,179,154,25,Asia,16,1745.71
4eb39aa0f8b240e78191a43333f5c3e3,92,55,37,Europe,19,619.96
4eb558edf5154761bac122599b6ab5cc,262,239,23,North America,20,1831.71
4ebab78eba7748f781ca9b3b868fe58a,104,77,27,Oceania,22,1051.78
4ebc99a64c0448d987c585f6d0cce872,268,225,43,Europe,17,1629.58
4ebd81f329d54769ba7609d0e1901587,189,141,48,Africa,17,1472.15
4ebe499f543a4f679f417092b7c80616,96,57,39,South America,18,936.4
4ebed10f8c6c4af69ff445d5c2fb9039,81,26,55,Europe,19,885.79
4ebff0582f5b4572adb4d346b9291acf,321,300,21,Asia,22,3454.9
4ec326b76e414bfc894b1ad5378f8588,359,306,53,Europe,20,1709.09
4ec4dcc8c4a54944936f8fab51568ec9,364,347,17,Oceania,18,2598.03
4ec5bdf53388439ba886cf94fda460a3,70,19,51,Oceania,19,371.31
4ec7aac297854e098ea5ce5512ab9088,41,11,30,Asia,24,446.67
4ec82a26094a412081942f7dde35b27c,267,238,29,Oceania,20,1917
4ec8589c97c84b89b5056bc72c6c2697,208,181,27,Africa,20,1854.64
4ec8bff2b8174defa424ad922f92c5d8,241,217,24,Asia,16,1888.3
4ed0d1b13917489498743d91f48ce555,337,319,18,North America,19,2411.81
4ed0e3fcdd354707b8eae88ff38a0d60,89,37,52,Oceania,21,330.01
4ed36c5624d44ac48e70141f4804b246,212,181,31,Oceania,20,1661
4ed4ca01808d4b3888f51a0a77076003,228,186,42,Africa,20,1819.15
4ed656fd3ae3412ab63785ee19a1b2ba,290,242,48,Asia,23,1648.51
4ed70a4f623a4e24948f92284d4d648e,365,365,0,North America,27,2322.44
4ed7967861c948af9bf3a39d466f50ab,149,115,34,South America,20,697.11
4ed901a50d7146dd8fce38903cdc896f,226,204,22,Africa,17,1853.99
4ed92c3010a6487f95a0ee98614a3570,245,210,35,Oceania,24,1869.83
4eda273133b64798a10e61a42ffe006a,248,218,30,South America,13,1444.31
4eda77874cca4237acc4737c8c76fe99,28,1,27,Africa,20,222.46
4edf328dcb314b75b3e981beb8f5c1a7,246,203,43,Oceania,21,1568.16
4ee2a995d012472ea7854e107b0412f6,276,236,40,Asia,26,1862.44
4ee42024285c47ebbaa392b8736bd7a4,161,118,43,South America,18,1094.19
4ee4227f0bfd48b489688f458c8523a9,316,297,19,North America,23,2053.75
4ee62e4f7d4a4d71a8db81e565fb2e81,100,63,37,South America,19,550.26
4ee7657d96c8409eac91d7d01ed9b8cb,129,82,47,Europe,18,375.85
4ee905a90e9640958d9857883c2ef118,104,49,55,Asia,17,746.99
4eeb55f2fca54c968f8f0e7807ed5823,364,322,42,South America,18,2711
4eebb36cad964dd0afe8456d7c46cc35,247,200,47,Europe,15,1086.55
4eec1c2de8b44abb8c6df4a647af5480,337,299,38,North America,19,2074.67
4eed0b11b06a4b33ad86d86ae7a275a0,167,139,28,Oceania,18,1811.77
4eedaaafa0df47d996bf0a2c691b231b,97,45,52,South America,23,507.93
4eede26979d3419eb9f13f79dd240846,53,15,38,South America,23,513.04
4eee71a73d0a42c0ab284aa00db2c153,254,224,30,Asia,25,1017.07
4eef21546e33402dadffa328c75c8211,244,189,55,Africa,15,1315.19
4ef10dfde3d94d328a6879fee52b3825,291,260,31,Asia,22,2231.13
4ef1fba640a94f28a837d0608320d06f,206,179,27,Africa,25,1397.52
4ef2844bd50143fe863dc42a21fdf644,120,91,29,South America,22,855.54
4ef2886012ce49c8ae2e55c5a1bcd211,363,340,23,North America,19,2681.52
4ef28c4a87104e4f9a5d487fa500cce9,224,196,28,Africa,20,1205.23
4ef6f71192af4535be064a068ad42f3a,199,189,10,Oceania,21,1588.35
4ef7223fde3d417fb799c89369ad9fa4,102,57,45,Oceania,22,667.58
4ef7c3712a3d42a88654f2c5ae9387f1,122,102,20,Europe,21,885.27
4ef7cdc8350149e4b2735db96d7dfa73,269,245,24,Africa,21,2251.79
4ef86c5c713e4bf782f81bb77776d645,316,287,29,South America,17,2212.11
4efb02498d9645778169f71c7e040174,150,120,30,Africa,15,1190.36
4efe54f3584f4d0391b9d3b5865c266e,273,220,53,North America,23,1231.05
4eff321beea14982b3b15d5637bdfb5a,314,276,38,Europe,16,1811.3
4f007d84cea7497c8e6506d5fb414a3c,76,23,53,Europe,23,407.31
4f00e0ff0ac947df87d9152d20946edc,365,350,15,Oceania,16,1818.37
4f01a38e74a34d458170e77bb4aabc0c,319,283,36,Africa,26,2330.54
4f01f5afc7354104b85320f4cd004e69,49,1,48,Asia,18,243.04
4f062680db9646c6aede5d68844b16d2,316,280,36,Africa,21,2066.24
4f06ffa5e0c449beb273ed37f6951e3d,55,11,44,North America,24,335.18
4f077ae0902448a9ae5e61d8e619e41b,143,92,51,Europe,16,743.19
4f083c8eb0b44c729b533edb424db2b5,88,36,52,Oceania,20,239.93
4f0e660903294c0cb037c7afcb81535b,201,146,55,South America,22,1190.61
4f0ec923185d457ebff4a596b14f872e,236,209,27,Asia,23,1478.48
4f0fc8bd977b4b9ab8833cc354ecedaf,156,111,45,South America,20,1048.61
4f100448644b4b8da22d8f565e64e82b,123,80,43,Oceania,24,726.14
4f1053b3a76a4399a75a604fc7dcd1e5,364,347,17,Oceania,16,2017.6
4f10d3216b2c4db99b5b8d3b45ad0027,96,61,35,Europe,20,912.17
4f111862bfe64f0bbc736e3d97b35354,250,206,44,Oceania,16,1158
4f11f7f1263046ba837d2df222bd5711,316,272,44,North America,23,2357.2
4f12cadc4cf341a0ab6de6dc875b9163,255,220,35,South America,24,1828.95
4f16a811a1ea465fbddf5c49f378c34c,50,28,22,Africa,21,264.08
4f16cf98124340e0981d4d0f90d09cbc,363,363,0,North America,17,2994.15
4f1755d574e74eaa83fba3540b32ba55,277,232,45,Asia,17,1353.9
4f189606f31244ab8eef269529240ee8,365,324,41,Asia,20,2068.5
4f18e210c2bb4d5d80a19c95780f9ddf,69,32,37,Asia,25,611.03
4f1a05fee17f4782bf4174e288589f34,185,138,47,North America,18,1408.93
4f1ad3a461204d15bb3532ede63ae5ca,233,207,26,Asia,17,1949.26
4f1c23d3704e4a45888e13324e5c665f,121,76,45,Asia,17,668.93
4f22c8dfb31048a59f162da7ef47c66c,365,333,32,Europe,19,2446.83
4f2796ec0fb3478dbb7d84b6f29a0dab,365,356,9,South America,21,2503.04
4f282886eb6b46169ec6dc955c4863b5,74,46,28,Europe,21,691.07
4f28cb94bc524927949c2fdd4fa08be6,357,333,24,Europe,17,2695.52
4f2d4152ec6647cd91ae690ba002850d,138,100,38,Africa,22,631.04
4f2ea31713364674aca85fee6137e62a,247,210,37,Asia,21,1344.06
4f2f741b150a446cb4bda195daa58f83,358,317,41,Europe,23,1204.16
4f3388010ab74a30aafeab28e1f7c8c1,264,218,46,South America,18,1296.05
4f33aac623bf47669b029f6dedf22f85,228,206,22,Europe,19,2367.27
4f34cfed394b4bd1951e3134bd387d78,109,78,31,Europe,24,1058.91
4f34d08f61b241d38bde66a8b1b9391f,236,185,51,Oceania,24,1236.98
4f37c1a2fdd040149c46bc122ac40637,310,277,33,North America,23,1888.89
4f38cd9b6d7e4820907cb4d96bc25735,357,317,40,Oceania,26,1663.22
4f3c51bcffb44925bcc63bdbfd2086fa,203,148,55,Oceania,19,1218.68
4f3dfcb713ed47f28f57f6aafdf57210,302,265,37,Africa,19,1968.01
4f3e01aaa6574cdab54a23026f7c5397,339,307,32,Oceania,21,1813.39
4f4051a4c86e48709d74887416d88fd2,81,64,17,Asia,16,900.71
4f40a5b52e7848eb9d467a5fc5bcc05d,98,47,51,Asia,18,303.96
4f428c152dcd4dcc893e76d8d71b3bf6,71,47,24,Asia,13,628.34
4f42ef63539f456d977dccf3bb2992a8,220,174,46,Asia,22,1658.72
4f44f43a791a4d5b8c47be8ac3699b79,251,206,45,South America,16,1586.73
4f461a1331444784b60149a4bc25a1d5,355,319,36,Oceania,24,1744.83
4f46335c91174149af41e0d35b5dae9b,47,9,38,North America,23,208.67
4f4a8329bad149c591976f316edf6dbe,141,105,36,Europe,18,1122.47
4f4b3ad2476e4001923bda1f18f077d7,152,107,45,Oceania,19,747.65
4f4b64f5d28148b289bc39a9c22c58e4,341,296,45,Oceania,16,2656.31
4f4bb828dbe3427ebe8e1a03fd2d843c,354,323,31,Oceania,22,2983.08
4f4c195da4db4eba92907a330f263edf,79,28,51,Oceania,22,450.98
4f4d15c54da547c291f0140759ab1efb,241,211,30,North America,20,1775.01
4f4e6b8cc76949159a889c0bdd0dc65e,291,250,41,South America,23,2508.84
4f50c4baf1e749208038cf0753139131,166,121,45,North America,20,970.61
4f519e7466664751b514a2bde9ba53cd,299,250,49,Africa,18,1400.05
4f53e9432d114a51a8e717d262679310,244,186,58,Africa,12,1121.23
4f5630f17b534cc49d7c3b85a6e2e4a0,118,83,35,Asia,18,653.49
4f57de59e838496c8e8af92262753b7a,89,54,35,Oceania,19,399.47
4f58319b545b4cdeafb92d831b5fe2f5,163,115,48,Oceania,19,573.55
4f5877b8c9124bce957294014d2f104b,190,162,28,Asia,16,1388.27
4f59166cf8494bf3861e6115cda33a0c,235,198,37,North America,21,1166.68
4f5964b3d53b404eb7975d1caeba4a4d,82,32,50,Asia,17,446.68
4f5c1f31e75e4555aabc215265c9bfcc,42,13,29,Africa,20,336.41
4f5cdf942c4142cca5fc21d5c45733a9,163,113,50,Europe,20,970.36
4f5e45c8f01444029970e378b0294b59,342,300,42,Africa,19,2539.67
4f5f4c9ad76643e786609f0e65fdadc2,101,71,30,Europe,21,785.98
4f6677f98435482d9ff10c7194856b38,154,106,48,North America,23,884.54
4f69daf155b34199b212726a1db2f8bb,267,225,42,North America,24,1810.97
4f6c1a4b7c674e69b476cc7f6d7dd2d8,73,56,17,Asia,16,807.34
4f6c63e660a547e1991b0d68060e4b32,107,58,49,Africa,16,993.16
4f6c868ce27d4f01932d02e4dfa44fc4,117,69,48,South America,19,719.07
4f6ee22fc4c9413b84bdb1430e779dac,93,58,35,South America,23,878.69
4f6ef1303a884d3cb3bdf3acd548fabb,313,267,46,North America,21,1858.36
4f70d56c3c1446c2918257c06bf28cde,79,55,24,Africa,25,596.99
4f72160ebb5b486083e97ad454874fd0,167,139,28,Asia,23,1312.57
4f74f3c8dec24876b6e559bc82097c00,232,206,26,Oceania,20,1125.5
4f755d65e985484ebad7dda526e966f7,228,184,44,South America,23,1914.37
4f7589d26bd5401a945fe5ca649039fd,298,258,40,Asia,22,1939.68
4f763937e44c4688aeb9ad8a5936a14f,323,267,56,South America,18,1830.14
4f76b80852b247789ea8058e7184b08b,253,197,56,Africa,17,835.76
4f783b704f2c46228adebadeb3e87212,127,105,22,North America,20,1347.78
4f7a37c8b8a348e29ad6fc308b351ad5,135,106,29,North America,21,981.47
4f7a5d0916554d9cadb4e2ec338d0cee,219,183,36,Africa,19,1700.95
4f7aa91fff3244729f750896d7991d5e,119,74,45,Asia,28,440.96
4f7b5276a5b944dfa8f886e56d313579,124,100,24,Europe,17,1038.83
4f7c71d7a0d649a0bef1207a44efcd36,116,90,26,Asia,22,873.49
4f7cae9f3b384446a256fd9e6b9a5a14,37,3,34,Africa,22,531.29
4f7f7ab0315d4884bc449eea0343f9e2,286,251,35,South America,17,1928.68
4f83499bd80349b7b636fc6cc7736502,318,288,30,South America,20,1518.08
4f843fcac2d64c6f85f7edb2a77b54eb,85,42,43,Asia,19,494.14
4f87ee849f6248968bd7e922411fb0fc,137,92,45,Oceania,16,718.18
4f89611110ba4f0f8a6d1aaf15540e10,72,22,50,Europe,20,317.69
4f89d1e22bc745e388a6bd11282f3ce2,257,225,32,South America,16,1730.54
4f89e8dedfe54a93ba975e9b67290043,237,194,43,Africa,12,899.34
4f8bee93d3714ca88f08b146f55ac089,33,9,24,Asia,15,123.6
4f8c7f6b21df4e5182fdda791e463fbd,264,214,50,Europe,25,831.77
4f8ced19019c41aab9e1d82a8ccb830e,179,133,46,Europe,20,988.13
4f8d092c90eb44e9b306b0d83c604666,292,271,21,Europe,17,2903.82
4f8df12358da4785bff8960e8408a3df,322,284,38,Africa,20,2961.2
4f8e2ce7c92f4aac8a0d674cdd58e8be,224,189,35,Africa,15,1084.14
4f8e475559464f148b74213527c5dbaf,75,51,24,Oceania,16,431.05
4f9a06aad42646a894b43ec55ecd6161,172,150,22,Asia,22,1110.48
4f9b24bed82a40c4a9145a601c327968,258,221,37,Oceania,18,2019.03
4f9e90b0c433412796820606eab437fa,228,180,48,North America,19,1202.78
4f9fbf94c4324412914e2ba0a3b75bdc,152,131,21,Asia,23,795.96
4fa261918543461f9e6772850e2324db,238,216,22,South America,21,1933.59
4fa328850545464db18f17404b99eda0,336,285,51,Oceania,17,2474.34
4fa3e2e7c53a4ce89dc03ff2bc980fda,365,355,10,South America,25,2625.16
4fa741d2471e40c392e85ee1ea7e576f,324,286,38,Europe,15,1939.65
4fabf537744a41799bd62e3d46d7d97c,192,136,56,Oceania,28,742.87
4fac82c3024e461d862599558d89fd7d,124,105,19,Oceania,25,774.25
4fad9e1d9ecd475ea1cf037b35dd57c9,310,275,35,Europe,19,2112.07
4fae2865bed44535b0bd2f45f0048f7f,69,25,44,Africa,20,369.37
4faf056ec4ce4b5b864b11db1881ce27,360,330,30,Europe,21,3439.7
4faf6aa3045840d6a094056688dc1a2c,363,344,19,Oceania,19,3167.71
4fb2c5a57f9b4e55826b86542502255c,80,59,21,Europe,21,643.9
4fb33fb02417499da3708897018af75f,207,161,46,Asia,21,970.61
4fb35d74849249d399292a6558ff6d3a,288,248,40,Africa,21,2153.58
4fb4939002914a0cb29f39178c13b3d4,339,300,39,Oceania,20,1508.7
4fb71edfb9ee48dc931350c274a32a3a,169,152,17,North America,25,1531.23
4fb750823c814ff8b7a17d3f5a558eb3,216,195,21,Europe,22,1007.48
4fb8c6f81c58449188ec3bf103c8e6d4,362,356,6,Africa,18,2039.01
4fb97968e3fe40c1b595fccf735a6659,335,307,28,Asia,19,2224.93
4fbbfbbf367c48e78114b6f734d7ef54,59,39,20,Africa,19,656.3
4fc087146e3d47088baa2a832435cca4,79,36,43,Asia,13,365.67
4fc3d37a695a44eda74f5386d0f70e75,142,123,19,Africa,15,1162.53
4fc55c2b9d56486d9106e9b282cc11f3,218,179,39,Europe,21,1219.24
4fc65c4ae81a43d2903438a989402003,248,197,51,South America,20,955.57
4fc70ef326c64a8ab882ce77f2c14c56,364,339,25,Europe,25,2028.14
4fc84279713b4015b4343935d9b9f09c,179,142,37,North America,19,999.71
4fc87a35356d4da6a6df1a239910a1d4,362,328,34,Europe,15,2093.93
4fcd4f1f0be24f9ca7bc3fdbeeef09bc,317,261,56,Oceania,21,1620.11
4fcee0926c4e45daa60c275e90caffe6,193,172,21,Oceania,22,1334.47
4fcee3dbb80c49e7af5069212aee3ab6,185,139,46,Europe,26,743.71
4fcff7bb0c084b5191c2f0f29013cb80,215,171,44,Africa,19,1178.25
4fd01d56f7624075b46c47e300d48730,261,224,37,Africa,21,1770.82
4fd3adcc41c744f391076f21a33a4fc6,192,149,43,Europe,24,825.3
4fd44d96f18b4ec38d741eb6b0a307aa,143,113,30,South America,18,634.3
4fd7aebdf8c74f45bc783b7730748ddd,49,24,25,South America,14,82.16
4fdaa801de7d4a36afd311fe4b7c3915,147,107,40,Asia,14,862.08
4fdadd20d7814667acd1abee97afcfe8,78,51,27,Asia,22,548.3
4fe2cc24353d4166806ccca83ef910df,22,1,21,Europe,20,81.97
4fe430e7075445f1935b0fe103d6ebf6,193,163,30,Africa,23,1833.9
4fe4943d565648a6b81e3481ea30d312,363,337,26,Europe,18,2296.32
4fe6af44e3284a2d9709cf95aa5a4817,361,349,12,Oceania,20,2830.62
4fe73270449345ac94acdbe04e8fbcde,365,363,2,South America,21,3155.8
4fea1ffb14214381a003e228c5d88909,356,306,50,Africa,19,1626.51
4fea8101a0054d938d7e1bc9bd9e2a64,365,331,34,South America,18,2316.75
4feb01387b3146a6af019518d67a0659,282,230,52,North America,16,1448.61
4feb1e0977ee4b7a9b46c9cf810827d7,230,182,48,Asia,17,1172.52
4febff1ad473446bb44a605a2aab45e5,252,205,47,Oceania,16,1731.32
4feea6fd950c4657ace99a62a43ece92,218,167,51,Europe,19,838.77
4feeff4d2c534ea7b79ad99611a27644,360,356,4,Africa,22,1872.13
4fef17afc00c419596a2d8dac534a090,351,330,21,Africa,12,2889.77
4ff0e6c53b5e4c988db6549ffe34db37,126,82,44,Africa,17,711.15
4ff1f452d2d147119dd7f94bfa33a641,208,185,23,Oceania,14,1435.19
4ff412a9ca3e49d0b40d7a21569d6251,260,230,30,Asia,20,1916.11
4ff4eb16f70447cdbcec8eed1e370753,109,77,32,Europe,19,247.12
4ff5be5328514e9bbb99d8486c907da3,85,41,44,North America,22,260.24
4ff79562c8134d22aae18ad10f7d9c06,260,211,49,Oceania,16,1438.79
4ff7f39aee254b5e8a015965cf752c47,199,176,23,Europe,20,1364.1
4ff9247ed1654934a3d71832dd934d07,33,10,23,South America,18,155.05
4ff9db0b67544af585ec70cc0d30719c,262,224,38,Africa,21,1879.59
4ffad814bf564d69b163d70a49963dab,250,209,41,Oceania,24,1896.15
50002d8e498445c4b764427a0f696ea3,86,59,27,South America,19,761.54
5000aa16bdcb40049813c376be5a4feb,338,292,46,South America,20,1570.8
50018cf366684a889824d0192649a2af,191,145,46,Oceania,24,830.97
5001bfd9e2b64a95baa36442f1ee64eb,361,321,40,South America,21,1724.04
50026a11d4f04d25a66302d9d3db4451,229,199,30,Asia,20,1701.95
5003c876cd374991ac860e0781389685,98,80,18,North America,24,565.9
5005e06790df40ee8a831d663d917bdf,120,88,32,North America,21,875.26
500ce072d990436e8d9060a8113ccbe7,117,70,47,Europe,25,821.81
500d61a26b8148f39041eaf07c41448b,136,88,48,Europe,16,742.47
500e34cf01ed41ef9faf8c0544e074d7,98,49,49,Asia,24,348.39
500e70312b9f469cb53a83e333ab917d,150,98,52,Asia,19,738.06
5010e07a200d45b981a227e1f8e341eb,75,29,46,Asia,21,391.07
50114df3bf9942329085f17fc8b5e40d,314,283,31,South America,21,2473.43
50137036998f4be99f9c7b2833fbaea2,236,191,45,Africa,21,1103.44
5014901e421147d1bfc0fe767616aae2,204,154,50,Oceania,22,874.77
501597682c834c6b99dbd3ed20cb84d7,285,233,52,South America,15,1492.63
501739bbec4f47138b04c7b6ba38634b,365,345,20,Europe,17,2826.58
5017a549f1a348fc9dee982cce53418c,356,312,44,South America,27,1863.42
5017a961a4704ad294e51aa85ad436da,272,229,43,Asia,17,1495.21
501c86726d5b41008cbd0e41705ce9b7,45,2,43,Africa,21,405.43
501c88edf37f4e5985c8a3896fd14051,218,198,20,Europe,22,1405.22
501e25a4ba6e4d689ec323db7b8372c5,218,191,27,Europe,11,1637.5
502193f4ec824cce8e3a6920e5740da9,343,304,39,North America,21,2332.01
50225fcdaa87450896dea86de802aab5,364,333,31,Asia,23,2490.43
502507dc1afb4a3ea74f6920d6c26871,201,189,12,North America,21,1882.71
5025fbe47f0e4689ba481d895ef65393,121,80,41,Africa,23,521.11
502625aa46d54a1faf5990b96040a9bf,253,228,25,Africa,17,1685.62
50263dad048443fa8a8548b66aad96ae,317,282,35,Africa,21,2947.18
5027dc32d2ec43759b630da785e8d4ac,201,145,56,North America,23,888.64
5029e5a684804c6387a7e442ecfdc044,274,224,50,Asia,25,959.38
5029f0f72d1947caaae888be8df7382e,299,255,44,Asia,23,2074.7
502adec5d511469b9f334fd22a27382b,200,160,40,Asia,19,1522.7
502ebc2182eb4417908fd3eaf9dcfd9b,241,186,55,North America,21,1277.93
502ef794998047dbb1b3469e5b3f3553,221,191,30,Oceania,19,2005.11
502f31109afd473993a412db2f52dbc0,364,327,37,Europe,19,1928.35
50322558b6f444298bf85b156c7758fd,222,175,47,North America,24,1201.98
5033a120c365457dbc8955c663f9d7e7,81,21,60,Africa,20,200.16
50355680398c48ad8c9e5a66744d356c,301,270,31,Europe,14,2076.76
50361c933ecf4acc91409a7ef45e37c7,132,99,33,North America,17,727.14
5037d30b78774ae492d3b43b2b010f77,153,100,53,South America,19,577.95
5038ab33a1a94fd38f2a714f86930cfe,365,361,4,Oceania,22,1065.73
5038d34c50974aeeb33004fa6815e668,172,140,32,Europe,19,840.86
5039f829a36d4164b7fb84235bf30605,234,184,50,Oceania,23,964.42
503c4d363e614206b9b057153fc06819,321,285,36,Oceania,23,2637.8
503d119c8f10411989a59560e76ec6ae,311,274,37,Asia,23,1998.9
503f3dbb4d414dad92e6514989864ca1,309,299,10,Asia,23,2192.26
503f557f32ad4cf7b7a83a351f91722a,207,168,39,Asia,23,1104.63
504082f648eb4a7d9e5290ac3dee6171,58,34,24,Asia,27,672.83
504128a2c96f43caa7278a98f575d159,138,106,32,North America,21,794.12
504174b1c6064578b6ff82d27fa70c85,86,64,22,Asia,16,856.15
5044d9f628064a1ea135202ea758a4f8,222,196,26,North America,18,1470.7
50481da6c25c4b09b2f01a5c75a0ef04,89,64,25,Europe,18,573.12
504b51616c4f42f58b5b106f07df7c97,254,226,28,Africa,22,1943.75
504ce087084f4a26a3378021b6205bda,358,308,50,Europe,18,1996.51
504f0e2d8f284f7cad6b1da5c3a2882d,290,253,37,Europe,21,1903
504f3e4a63f24b728aed15ef57b9105d,130,80,50,Africa,19,764.25
504f58496220495ea1750e5c60e0cc1f,260,206,54,North America,19,801.25
504f86832b9d477f8c132c632b562eb2,328,304,24,Asia,14,2035.23
505007a742204279b7be154596944a94,365,327,38,North America,20,2087.91
50503b05a886458f8cf85ffa5099e986,252,208,44,North America,19,1492.54
50550568c55341d9afb3de8db310429b,237,179,58,North America,22,1305.71
5055089858844ad1a8bd7dcec224b811,283,255,28,South America,15,2881.95
505a47ecc80f42edaf58a5e75ce2bbb2,155,124,31,Africa,18,1447.78
505a6ce00e044e1aaf78e2868efe28bd,75,62,13,Europe,20,583.69
505aa6c709aa4535b2668e4f764a1ed9,130,100,30,Asia,19,1284.93
505b50e325b5474188eb83e83d8ce7d6,363,354,9,Asia,27,2278.81
5062c871ef854c97abbb07b87ecb6672,187,169,18,South America,22,1733.45
506315f02db64801af67dec8facc3695,84,56,28,South America,19,305.92
506459627f07462cb012efea9d27945c,192,161,31,Europe,22,1218.69
5065278211724e1a8167ad024e581e5b,225,183,42,Oceania,20,1521.46
5066d1742b4c43f3b83d6f3c42b61ffa,236,199,37,Africa,17,1273.1
506cf552671b46ccace33e0e86045223,60,1,59,North America,15,142.36
506cf8bcd0784736b317a603f4f6da85,245,216,29,Oceania,17,2202.77
506eb333cd104c66a97fc845341f40b7,199,149,50,South America,19,786.43
506ec520a216402a8267372a0dcf179e,55,20,35,Asia,18,307.97
506fc0d769164f909daad07ce1bc4d72,362,336,26,Europe,16,2279.24
5071571138344d4d8829258af7a34274,130,111,19,Oceania,15,938.52
50718803e6d34359a915950d20c9ddfb,130,90,40,North America,21,764.17
50739faf4b424f03bcfdc6f9d00f3d84,358,343,15,Europe,23,1843.63
50748f62e2d8413fad355dd8e8e69b52,334,303,31,Europe,23,2878.49
5074cef896cb4c559c945e6366f3eca0,234,183,51,Europe,23,1516.97
5075832b0464499e82256a29934285b2,213,161,52,Oceania,15,1619.63
5076da0fa07b4bd1ae48283e92f07b0d,87,61,26,Europe,16,609.41
5077b4cc4bd34d14a858ec65d320e2ec,343,330,13,Europe,18,2776.54
507805fc5e86424e83062880d35f8449,45,2,43,South America,16,173.91
507942596f3d410fa7caf11afc6ebe2f,280,244,36,Europe,20,2223.32
507a13ee74364e068ae02f461413404d,297,283,14,North America,25,2017.5
507a8aba66c34111b3a7aaceb423376e,278,229,49,North America,14,1306.41
507b608b0a8041879b8969605dcfb05f,61,26,35,North America,22,739.84
507d3321d54c45da85061a11a4737105,350,324,26,Oceania,17,3039.39
507f11633fce4bf3918ca03361bbd6fb,171,131,40,Oceania,23,1055.82
50818c42b6d34594a24d716761abaab5,262,240,22,Oceania,24,2312.87
508592b9f9d947019f578a2b75d8867e,166,121,45,Europe,17,1082.65
5087c34bf95244b794c23e4103edc1e8,365,340,25,Africa,18,1842.87
50884bd8f7784ba293064300cbec2318,365,360,5,Europe,20,1635.06
508957c8c9214b96bc756cdea955acf6,47,17,30,Oceania,23,275.8
5089c62aeeca430ebf9aa3003440c883,364,339,25,South America,19,2494.12
508a1de7e0734469bdd77b71951c501e,190,148,42,Africa,14,1383.59
508a7f9c93ce4c15b28e21d08f297092,362,340,22,Europe,18,2877.62
508bd7a50b8443628188d619d2f14901,67,21,46,South America,11,177.79
508d05dc6fce4c9085401d912b385c56,351,328,23,North America,23,2641.08
508e1573d934451a8d47f09740df3596,41,10,31,Asia,25,185.4
508e24edf0f54658b3fb75ffda100cb7,358,304,54,Oceania,23,2006.65
50919b2512c24ad5aad47591c5a2a462,275,247,28,South America,22,2463.2
50927852f3374a8084b27634737e233e,53,9,44,South America,19,239.5
5092a42258124660b141d4898f2b71c3,165,125,40,South America,24,1456.8
5092b5330c414abba4b91b30bf6148ce,204,176,28,North America,14,1208.57
5092f2d7905f4e288cf230da47e82cfa,233,206,27,Europe,20,1912.26
509343058be543b3a69276d7beaec030,192,144,48,North America,17,837.08
50946f27ab754feeae4c9654e25bc7bc,253,209,44,South America,19,999.37
5095547a4ae04f8d838918efed159613,248,216,32,North America,22,1828.78
50957454f7c44ada824b69e7c5f544d8,305,277,28,North America,22,2505.67
5095b5121d3f45a69004e284b94db65d,267,232,35,North America,25,988.57
5097a0b581134092a91bbc9b86af2479,336,293,43,North America,19,2483.75
509818629a1a48a585c0bb0644f0499f,86,60,26,Asia,19,286.15
50990d4672a94bca86b57d6e9646b62f,328,289,39,North America,16,2284.69
50995e631dee4ca2bb18b9655b95eeb0,107,58,49,North America,21,138.83
509cd59acc104ff8a12b03de2eebcbc2,364,324,40,Asia,19,2443.54
509cebc7eebe43798019e17cdf8c81bc,81,47,34,North America,16,493.73
509d43338caa48eda9fecdfb1b519096,318,284,34,Asia,22,2396.06
509d738fb6564e41975886511b0a141f,125,88,37,Africa,20,430.64
50a0250250a746f692260585ff6e813b,168,137,31,North America,22,1372.23
50a144bf96024e6ca10fc854c4a5d6c8,365,355,10,South America,17,2352.77
50a4624c77044de9a0cfacfdb01fb9c1,364,342,22,South America,22,2086.08
50a8667d8e514bd9bc52ca1c9f9c69b1,215,174,41,Asia,13,1100.75
50a9106ef82d4962b1239af51a026eb3,207,179,28,Africa,22,1688.17
50a9e2a1feba4e36aba3f23e2c11d1ca,206,162,44,Africa,24,900.33
50aa47f9f0bf45108ca1d0b8a7d7b544,57,13,44,North America,20,54.7
50abccf7a7b747b1b3de98008dd40c52,361,361,0,South America,24,1681.8
50ac9bca8815418681cf803c4e3428a3,129,109,20,North America,21,1041.29
50adbeabe80a4b1a992f03d69c1d379f,49,14,35,Africa,22,411.43
50aeeaebff3b45ef94e2d4d60dc00d3e,145,92,53,Africa,21,688.4
50af9bfcce964a29ad0679e0462bf2d4,133,95,38,Africa,20,862.89
50afd7a07a274a78947eb61124f3da3e,82,47,35,Asia,24,472.21
50afe18f64354e819e06f22a51752bf1,41,1,40,Oceania,19,218.1
50b096fc6e0f47cb896e3c2be205a296,193,161,32,North America,17,1263.71
50b23b857dd64e3d8714c4d339215501,224,204,20,Africa,18,1803.18
50b7540bb0dd4705b886e69c03814ad4,140,92,48,South America,15,678.6
50bc57fe75e54b238f0bdad1e5be0f64,154,116,38,South America,18,1383.5
50bdf274048541cb9a7567c536bea0e4,266,240,26,Asia,17,2207.45
50c0c86336ae4af0870d480cf0ed5359,365,356,9,Oceania,21,2912.31
50c1118dac1b46b2913f4b676576a147,110,70,40,Africa,21,898.46
50c16f5d294249cc8d07a0ac096b5ae8,220,170,50,Africa,18,1340.06
50c22f7250b14a1dbf8d79afad1247ab,314,264,50,North America,19,1374.15
50c3fb7fb5274b0ab9bd0a230b025136,354,300,54,Europe,19,2352.05
50c4412e874946e7b30efbd6450f39c7,56,38,18,Africa,23,354.84
50c44e5641bc40e386a33f16b02110de,80,29,51,North America,12,259.86
50c46ba217264bfe8ec78fbe5114db97,226,185,41,Europe,20,1487.39
50c63331eb8243238cb75300d253ee20,299,248,51,Africa,20,1591.16
50c6704b97e34d21a7dfebe735f87fca,364,318,46,Africa,22,1425.18
50c864db95a147b1b659aa63d1cfbbc3,365,335,30,South America,19,2209.44
50c986b7a6434930940f3559d9be69c7,109,55,54,North America,22,619.03
50ca5810a3a145838b0138496049ab14,303,259,44,Oceania,22,1565.18
50cc64da40a04509a60209dc02d63544,364,338,26,Oceania,21,1609.72
50cddf0dd59d4d338829db4affd81c0c,253,206,47,Oceania,22,1698.37
50cf31ddf1544312b91be29ca4587c10,336,295,41,Africa,22,2458.88
50d0c61fc3294b0f9b072681bda03f92,266,214,52,Asia,20,1427.78
50d0f62171d64083bbb0ce3e152c9312,206,173,33,Oceania,23,1032.58
50d2a2e934784eb392e3f836c386417e,365,346,19,Africa,22,1709.88
50d3924b03c84d1c8c3461de54a0e140,361,338,23,Europe,24,3048.32
50d3bac014934b8f9855317cfeb1c2d1,265,226,39,North America,16,1213.95
50d46b9d3df349a7ae8c9329a99e21b5,231,203,28,Africa,13,1949.07
50d488c42f27484085584099def31e93,61,8,53,North America,22,312.61
50d4a5bf0fa547c79bb25b4601305d6a,204,184,20,Africa,17,1368.95
50d5595610534751953537dcc82d9640,365,363,2,Africa,17,2592.21
50d64b4e10f8470ebeccf1427719954e,161,117,44,South America,21,1128.3
50d664c53813421eae66f2b798e8b4ba,364,343,21,South America,18,2010.67
50d868121b6e47f48dc8e32fa9cc2b4e,275,235,40,Europe,21,1995.25
50d8f70579334725b0387c11cd38fa8f,283,241,42,North America,19,2179.09
50d925e8ca784f098d2e396fedd52e3a,230,191,39,Europe,23,1103.81
50da2fcd49f44525b4f81c0f605fb175,127,90,37,Africa,22,682.36
50dad3b941e643e489827564dc267c30,133,107,26,Oceania,22,787.53
50db079dedbe46a99c79a3c4d32e5ca7,76,40,36,Oceania,22,568.29
50de60d47f6740c08a033d380addd17a,351,309,42,Africa,17,2499.96
50e09577b13843688138333fe8664098,275,239,36,South America,24,1709.4
50e1b46838a84c62a1b9970d3e0e5d21,346,323,23,Africa,16,3152.38
50e4a1ee512548fca1b1ac9f8c8591f1,326,290,36,Oceania,23,2077.75
50e72e874b904e39a20db28b39bd8e9e,207,170,37,North America,20,948.6
50e9ef2acc4d42c0832f6daa40baf51b,173,142,31,Oceania,21,1118.9
50ec9ae5baf1447a92cbc8ced0bba0ca,206,161,45,Africa,21,934.02
50ed5841064e4d9e9ec75372a18e9e8a,101,70,31,Africa,24,586.75
50efe5b901464fe08ee1699ca2c06d92,89,58,31,South America,22,487.66
50f3c918553a4c97b74cfc652727db7f,191,171,20,Oceania,20,1160.03
50f3fa51dab54787a22c637f98eea507,170,124,46,Oceania,17,932.75
50f40c77845c4d46b75d8aa136c4f892,169,120,49,Oceania,23,733.72
50f463f4169c4c1eaea087783d9ae684,135,95,40,Africa,22,963.33
50f514d917d540da99c2de579b13976d,260,217,43,Africa,18,1760.86
50f7386545424ad890675191607721c6,189,141,48,Africa,20,1704.47
50f7ce8163744e0c973c7693d8dbd0b5,365,318,47,Africa,17,1838.54
50f872d51f8142ec8ac19248243bc63f,202,168,34,North America,20,725.51
50f8a8d7f01a4094bb01ca56f4c3368d,365,359,6,Oceania,24,2179.03
50fac7b52449481393d90ba760d7e8ed,27,6,21,Asia,20,58.03
50fd80963caa4cdb93ec9e6cd8e8ee8a,364,364,0,South America,21,2089.72
5100a22a3e1b4367bb7de4c87ff36b94,105,72,33,Africa,21,852.89
51036b9d739a40f7b7c597ce331ab282,217,163,54,North America,25,1234.43
5104092863fc40778129248de6912c4b,306,285,21,North America,18,1941.5
5104ef27aecd45bd86ae9dd330c8ec18,146,96,50,Europe,18,856.75
510711dc7b5a4226885c6697dcee2b4e,365,349,16,Europe,12,2011.77
51090e0a5086434d8963825cb7b0b183,363,345,18,Europe,24,1867.25
51091233245a43b18b9716e97ea2dd57,201,169,32,South America,21,1011.48
510b6472be5941a5b109a83391817c2b,170,136,34,North America,19,1032.87
510bee20082943b8acf3fd706e22c717,335,305,30,South America,26,2671.08
510d0f6164b043d585f66dfe4509df0b,57,27,30,Oceania,25,458.54
510dc1b9d4784728aab9de66498da527,156,103,53,Oceania,21,312.11
510fdf921c014059b93d6b7f2bd4d979,268,248,20,Europe,18,1750.97
5113635061a0480bbdf7d2377a9a95fe,364,347,17,Oceania,22,3196.29
51143d840ae14ee085c705a614f178a7,249,203,46,Europe,18,1002.02
51161e3bd8e94fc5896b96082dc92565,168,131,37,Oceania,23,1387.4
5117517d58eb493b95edd7a427bab929,160,133,27,Asia,23,1401.03
5117943b6e2d42a099713dee957f6cb2,286,271,15,Asia,24,2222.86
511835de5a66403280bf2a1166b2bcfe,365,356,9,Europe,15,1642.85
5119d7f2d6484c56b7f57d56c59d6ccf,172,150,22,North America,22,1171.37
511ad3c7732c4a249f4bcc2fce42dce4,216,195,21,Africa,23,1851.16
511b8e15db7f493ca4782af9ebff4b05,129,104,25,Asia,20,1076.78
511dbe20bf9a4c32870cfea4852e40d6,118,82,36,Oceania,15,788.07
511e2351defb478db126e78f02349d9e,317,301,16,Europe,22,2465.46
5120e8e51df648409683a707251fb081,187,153,34,Asia,21,1691.34
51211ceb9f224ffd83f7929b99f53d11,204,169,35,Oceania,22,1719.72
51230ab56acc450ab16e4962e6c63813,93,49,44,South America,23,461.42
51238cbd3ce247eabaa207c1360e122a,213,185,28,Oceania,20,1402.23
51242de66cb04cd9a193e6ea773c3785,196,172,24,Africa,19,1700.78
512492b2af1344faa5520aa35de4866e,341,306,35,Africa,20,2627.88
512528095dbd4def99115ff4b158c7a1,325,279,46,Oceania,19,1184.51
51259480c1b44f9a92fed4f96c0b807b,177,136,41,Asia,23,1387.6
512981c6510141b298d92dc6bbc6a84a,313,274,39,Africa,27,1595.48
5129a65f17f447249b74fd6fbc733808,74,50,24,Asia,22,632.15
512cbf56fde941e8ad4d85653f57b44c,57,20,37,Oceania,18,683.28
512d834a2e2545d99896651833d68b6b,131,103,28,Europe,19,872.77
512fb914fb58456480cb8e90ceea20e2,106,84,22,Africa,25,500.71
5133aecc30bc4e36a86105490aae72c0,123,97,26,Europe,20,840.63
51357711a583480fa26f84009ed41b40,247,227,20,Africa,23,1867.81
51359b4b9d254a00a09868617bb259e5,96,74,22,Africa,19,569.93
513766819a1b458c8cbf0662d8e0b25d,99,51,48,Europe,16,907.44
5138267f5e57450ba8216efc3dc489a4,274,238,36,Europe,27,2494.18
5138f599c0214dbea9ed7fd263686c9c,114,60,54,Africa,21,284.33
513b0b7f1adf4b54826283c412754284,326,289,37,North America,17,2033.53
513bfd0b7de64dc982a77a168196400b,209,168,41,Asia,18,983.72
513d9aadd10b4957b0488b2a3e6af394,365,353,12,South America,21,2869.81
513f436370d24940b9e15f2ce85ce687,80,19,61,Oceania,18,129.1
514003252a9347ffacc2b7d9df41d308,352,306,46,Europe,19,1715.63
5144a0a4540b492582a22a505047cb49,358,332,26,South America,20,3069.89
514632a1facd4abcbe7b90115063a02e,263,230,33,Oceania,14,1645.12
514795852d7e4564a23537151749a63f,169,140,29,Africa,22,1492.68
5149fa3f15684e5182f35264afd3517b,75,18,57,Africa,20,172.99
514b238edd7e44c18b92506be664c874,208,156,52,South America,20,1044.17
514d308703694c6993a0aab683cc5f3e,341,321,20,North America,17,2417.95
5151442526c14e9f9933793e9bbcc142,217,171,46,North America,24,1166.06
5152196971cc43839972da35e4f88796,365,349,16,Asia,20,2397.95
51550b5e15bf4f6fad50ae5d39b36452,300,276,24,Oceania,20,1404.34
51578fea832941bf865f3e02e33b9087,330,307,23,North America,19,2688.03
5159b063793b427fa4c3b7b2ccd7f59a,107,48,59,North America,19,568
515aeac4038f49e481a05d6695d2a9c6,135,86,49,Europe,24,950.48
515c9e80c62747a1ae40175ffe06e1e0,151,113,38,Africa,18,1047.85
515e75804e2641efaa3983a74bc2cb7d,35,14,21,Europe,21,50
515eb6e19bb245f691596b124e95cc50,343,284,59,Oceania,24,2117.94
515f2ce4279c4f71b78947eeae720828,184,144,40,Asia,25,1338.99
51605757653f44f7907570b11eb0e9a4,168,147,21,Europe,23,1499.77
5160a0805490406db3aea7996c4e7e32,287,241,46,Oceania,19,1500.36
5161d5b67cca41bbbe4cd51a89d44877,199,147,52,North America,22,882.59
51625173ff914424938539014d82f8d7,181,147,34,Oceania,15,703.4
5163c0aed63444ebba151a81b920a335,143,90,53,South America,18,645.9
5164e7c42a3b4e07b07be960dd7ffbf2,225,184,41,Europe,18,1328.16
5167bf58d1d1457f97cd1a911623c39f,311,261,50,Oceania,18,1816.48
51693743b998451498094960350b420c,115,67,48,Europe,22,448.33
51694a4071d6443284020c2a0fef96cf,184,135,49,North America,20,772.26
51694aecd3bb4fd59e68b111d64bbb14,145,99,46,Europe,18,567.56
51696f504ef6419f9faea0b77f7649c1,125,87,38,South America,26,670.08
516b69208a45438a85b8400e8e4b17a6,365,343,22,Europe,14,3616.77
516be4b4faef4f669f4d5891b4989b63,316,294,22,Africa,16,2114.8
516c7b380b0c4bba916ad927da921f98,272,231,41,Africa,18,1652.68
516ef31f572243afa35b5baabff5a9c8,138,111,27,South America,25,981.05
5171180c634f4a54a7aa56800ead1b0d,49,10,39,Oceania,21,349.26
51722dfd1abc409582216415e558f602,364,316,48,Europe,19,1548.73
51727bd12c334c2ba929075e7009bb77,122,86,36,South America,15,914.87
517472937e17434793c5c6faf8a30228,60,33,27,Asia,21,425.97
51750a784b0d43fb823c9dfe05860ac5,51,22,29,Asia,17,521.92
51762e1829624ceeab61ec4bd7f862bd,115,98,17,North America,26,577.15
5176490bf2f54284a74a554c20466d62,339,291,48,Oceania,23,2817.68
5177d5a8ded8467dbb18d028bc4ea39d,365,319,46,North America,28,2556.91
5178fe56d119448297399771026b0ba1,213,183,30,Europe,18,965.68
517a185764ee4a71ba33ae2e4b51f5ed,242,211,31,Asia,16,1563.83
517be84948b942ec97f27e01c6a2cec5,58,19,39,Europe,21,101.32
517d79955ef94505a2f4dd5f58922749,365,338,27,South America,20,2876.88
51821571ea0a4bc38c4d0e683bc1c3aa,38,11,27,Asia,16,247.81
518312ffa7cf43c4b0b09a8a7882b43d,210,168,42,Europe,19,1048.25
51837a43eac3460283690da5ffc5d777,55,29,26,Africa,23,402.87
5185ac985d4a49949efa00348b46b645,109,70,39,Europe,24,852.35
5185c95d86aa466bb112489f599c824e,267,238,29,Oceania,18,2072.07
518b80043f46463fa06ff561f45042bf,93,53,40,Africa,27,285.6
518c74970ee64ac3a231866bb4f2fe40,332,283,49,North America,18,1171.82
518dfdd78b404a4091e628721c309484,124,89,35,South America,19,1239.45
51921b1258c04f908f36c31fd6f7611b,116,77,39,Africa,24,899.48
519239be6f4940609d990d61045ebd04,280,250,30,Oceania,24,1914.11
519593d2d06f4b149d5737833fd70d56,196,168,28,Africa,20,1738.51
51975e9065e04ded86fe8c83b407d941,152,102,50,Asia,17,975.69
51976ae794d94b36a9fc24d2b01d02d0,263,198,65,Asia,21,1306.57
5197a0378c1f46dcbf962ca5a0dd434a,299,256,43,North America,17,1991.05
51981d4d9e1d4616be060c413263b2d6,246,198,48,North America,18,1395.05
51989ee247094c5b8fe3c798b67433c9,51,14,37,South America,20,488.94
5198ed89ea064a199d05dbed118791fa,237,203,34,North America,17,1065.11
519a3c15e16c411daacd8e059376e287,150,110,40,Asia,20,865.28
519a94e909f540959cb07f3f3c7a7513,143,116,27,Africa,22,1044.72
519b231350c54bcb9a41a7899dac9bec,365,364,1,Asia,22,2686.89
519dc29a8eb1452b9babb3e42f583f81,312,276,36,Europe,19,2073.21
519fcfea462b42cbaaa4f1096e2537dc,296,248,48,Oceania,21,1719.47
51a02e0901b249589499e0d55c77dd74,253,199,54,North America,19,997.17
51a284f7b8eb4986a0f5d818f59f950b,51,17,34,Asia,18,365.48
51a3c421dfa344d8905caeabf194e1c1,198,168,30,Oceania,18,1499.42
51a643115a974c8fba6ddff60d6b6ecf,227,180,47,Africa,20,1334.67
51a81b591d9c4ae38a7bc3ee32ae5874,323,289,34,Oceania,21,1847.45
51a99d60e1664ec3a5bb991d947e7e9a,27,7,20,North America,18,37.54
51b3ae1ea76a427db2b41ed0acdddf20,107,74,33,Africa,20,748.72
51b44884e29f404a94a9874762acf8e5,318,299,19,Europe,23,2493.99
51b4838d6242430da096375389754ca7,231,206,25,Asia,21,1718.72
51b564eb4ea940ada42595958e00de17,71,44,27,Asia,18,596.83
51b5e159976048b4b2af42acf5673ae6,115,84,31,North America,22,1180.74
51b6cb721b594f42b7397c27d19da521,81,62,19,Africa,27,626.27
51b84011cabc4bb18cb002ecef7d48d7,133,95,38,South America,20,766.06
51b858170e93426bbcce78fb51a648fd,43,14,29,Europe,25,250.93
51ba04b3cd3e4b6e93d8f1dbf33c3d57,158,117,41,Europe,24,1062.82
51bd745043664076a29317e154826623,124,89,35,Europe,24,869.49
51c0e4a7a9284f25b07629aaa6146255,58,19,39,Asia,20,397.26
51c237fb5907420987ff164ac65cc7c8,172,122,50,Africa,22,1008.86
51c2d9d27b38407d93dfd88bb553f27b,364,353,11,Asia,16,2206.59
51c4a2bf81d542a186e0551f22231db3,285,246,39,North America,24,1853.89
51c4b9ea05674bf3967ddfbef3f6a3f9,227,198,29,Asia,22,1325.26
51c53e6d8fff4d16a071b197695de547,114,83,31,Asia,19,709.91
51c74f1160e249ee9efa14f1c47b86a7,365,332,33,Oceania,22,1300.12
51c8eda314e1404d88a39cfde2755008,365,339,26,Europe,19,2687.39
51ca88b6e2bd40d0bc8bf942d53e9223,231,187,44,South America,21,981.34
51cacf52ade947ccb642b4e5f4bb0719,365,333,32,Oceania,21,2596.6
51cb81523c4349c89ada1541dc31cdf1,215,173,42,Europe,17,1205.51
51cf2f915845497683e5bd3a1386bc46,267,235,32,South America,21,2137.7
51cfc6339013409f860e6d007ce04276,102,75,27,Africa,24,1031.72
51d06056d4154e46b4e38ff4879bedf9,94,69,25,Oceania,19,587.93
51d169068de74ad5bb1b98898b1b1572,365,354,11,Africa,18,1983.54
51d1f481f56b4647a4f6c62d0d87ddaa,250,211,39,North America,22,2495.37
51d271a87ddf44f6b1c5596b32295189,261,234,27,Europe,23,2180.95
51d35fcd3c5040ea89de35cb235ec3a6,252,199,53,Europe,17,1081.71
51d456fe4d0a4d3b81dc5b721368b3f3,314,288,26,Asia,21,2697.42
51d4b7fbe95446829f967e7df63a3bc7,365,336,29,Asia,17,2521.89
51d4cb7d9a5b4566bbc1598d7421a07c,340,305,35,Asia,19,2183.56
51d8060b67f442f780b931ec470d155f,245,219,26,Africa,22,1970.69
51d991e8dc2e4278bae2e49f440e5fb7,25,6,19,Oceania,15,281.48
51dd405f968f45409a61e98d5036d855,168,109,59,Asia,16,1005.15
51dedacafc11460f92e9c4f3bea77a9f,174,150,24,Oceania,26,1041.27
51e16968be974b7290da8fa8694be813,140,113,27,Oceania,23,946.22
51e5ed8673fc49a7a446a600b289855d,201,183,18,Asia,25,1384.42
51e6c1de4184402893d77a92e85290e2,76,26,50,Asia,18,450.59
51e76d2e415442c9aa741c6bcf5cce1a,123,89,34,Africa,22,760.73
51ee7c1bcbc448de9a0b9333bbbe483b,61,15,46,Asia,21,291.8
51eec9989f1f4125a0ae33a77c3469c4,97,53,44,South America,27,478.21
51ef8294469d434199e34b4ff51c95fe,117,70,47,Asia,17,728.69
51f01fd3fadf45db81e3a4539d7e8fd4,132,79,53,South America,27,578.11
51f02d06eca247739988394db32a33cd,235,213,22,North America,20,1369.26
51f6addceadc46d89df6a066ed43f0d2,350,318,32,Oceania,18,3513.52
51f6e2395e07469e92ecfde7c02af7fb,295,260,35,Asia,20,2581.19
51f73d2d573f4d05b8c710a1be0a1d64,33,7,26,Oceania,18,339.49
51f7af88f98a49a4a34018870ba8e99e,365,365,0,Asia,21,1496.32
51f7c83e4f464e44bfe0f2328e272f0e,68,30,38,Asia,21,645.51
51f8db88b96445feadbed6ed7764124a,154,118,36,South America,26,1394.47
51fab8f618eb469cb9df61914ae8833d,305,261,44,Asia,18,2912.06
51fb34115a584745b05ed57ede13b699,51,2,49,Asia,20,318.41
51fce855d1c34d4c9ba63f377dbdae01,303,265,38,North America,18,1791.73
51fceba7fd704a0db6fa46ff38cc235c,104,58,46,Europe,20,387.13
51ffc5dfc4694876b35700567befd48c,116,67,49,Oceania,21,635.41
5203c156f3264ab8b7715e916c0cf35c,205,158,47,South America,21,1476.84
52053444098a4818bee6f744b72d55e8,298,264,34,Oceania,29,2451.33
52075b15245647f1828154a7d0d7db17,161,124,37,Oceania,22,903.43
5208953938774e939c538d9c8154d5ce,281,228,53,Europe,13,1543.37
52090c44d62541b9b8330c6f1ef26526,123,101,22,Europe,27,421.75
5209694e04784905b9364821e3100b59,236,182,54,Oceania,21,1306.86
520a08d1c0b44423947037ac2ebf84f3,112,89,23,Oceania,18,934.66
520bd149f57a4bd6a2a4df396f8c8cd0,192,140,52,Asia,21,1342.78
520c3ad302404bf7a730ffa657bc82b8,215,162,53,Oceania,22,1239.43
520e081a553e4499ba896b569472357c,311,262,49,Asia,21,1447.07
5211d4adf08b48038c6d995e6f276a64,359,312,47,Africa,21,2085.44
5213dc3a0eb4442bb5bc7691de4923c5,260,226,34,South America,20,1802.75
52143bed2bbe43a3adb6987448057515,326,289,37,North America,21,2690.18
521b57ca9f7e4e9a9e5de5ed23efd525,112,56,56,North America,17,465.94
521fd46f4e414042a8ad91af18b3b317,294,258,36,Africa,26,1589.36
52240efa12424e0eb2d0501dd5e504ae,316,266,50,Oceania,23,1368.14
522662f962d04f889336bf4b4db2165d,365,343,22,Europe,23,2459.23
5228f8e2f1084525ad9dd96c98bd5797,137,105,32,Europe,17,1484.51
522b1453193d4815a60e092cadda64f5,76,52,24,Africa,19,821.58
522c8096889f4197837900eb97fde2fc,84,46,38,Asia,16,591.41
522d28da148b4ba39eb4500e2694eb9b,237,193,44,Oceania,21,1072.21
522db6f3b7f5464ba5157a7590a2f37a,95,55,40,Europe,18,677.97
52313390759e461c91ef7d205e9ff936,357,317,40,Europe,22,2217.86
5232c38000f94bd29a4d70ab6d5dd904,92,56,36,Europe,21,594.3
5237a426d0814270984a3c816b1ee8da,159,109,50,Europe,23,1389.91
5238be0641f441699b153072d301d218,202,157,45,South America,20,926.51
5238ff4de802496ba791cd7540650e8f,340,301,39,Europe,21,2630.86
523c9abc174a4d769750e27dd8e37307,287,256,31,Europe,23,1997.01
523da4cebf49457094e9756b83e804e9,299,254,45,Europe,18,1574.25
5240e4c57ee845ec88073fd8620e0178,115,56,59,South America,23,700.44
5242a1938140489ea68bb75abf0af94f,347,303,44,Oceania,20,1353.06
5242ae9d7313433bb5908250ca76c346,207,158,49,Africa,24,777.47
52436c4d8a95458c86f16e18c9f897e3,359,329,30,South America,19,2182.77
5244cb9b4fd64d2f8fbb3791be7d47d6,43,7,36,South America,21,175.08
5244e3ae31964e509f59f7cdf2a12ee6,253,227,26,South America,22,1853.91
5247316564cb46998b416deebb42655a,289,254,35,Asia,21,2193.75
5247f1ab4dd24f7bb0a35cb003a2f1c0,43,19,24,Africa,24,357.82
52486d762ff943ccb793506a30ddd4ab,303,267,36,South America,18,1978.38
5248b72cbd8c4273988bf67bc60333b7,113,82,31,North America,19,1195.79
524964111947433cb0207228847be5e5,365,365,0,Europe,18,1183.76
524b728456004f3f9424ecb4fb0833ab,186,157,29,Asia,25,1741.16
524c832967fa4e8c99be5d36044c5803,234,208,26,Oceania,21,2061.07
524f3fcc008647a391d458f4855fe643,144,122,22,South America,20,1195.67
524f4edcc2124c10ad7ee084023bc7b5,96,52,44,Asia,18,463.97
524ff5919b1a4085ba6d38249dc66b31,325,286,39,Africa,21,2165.92
52529aa1233148a2a6ad04181b7d91bf,267,207,60,Europe,20,1993.04
52532177153d421e82630bf79942a3aa,228,194,34,North America,17,1703.97
52547d492b7840b3a256ae3b3b8fe33a,329,278,51,Europe,19,1683.33
5254941aa83a4b0896c67e7547554d26,253,222,31,North America,23,1761.9
52561338e5e64114bfe4c6002081a3ab,183,134,49,North America,20,988.79
52564db3899048afaea18e6eaad722d2,131,84,47,Asia,24,903.68
525731594b04490680b57d2a525b5e19,298,259,39,Oceania,28,2261.73
525c565903e34623906c08aa4235667b,246,199,47,Oceania,22,1133.27
525c6d01cd424771aa1e7d07f38a250f,140,112,28,Oceania,18,787.05
5262246b1dcd478390744abb4fa7dcdd,189,133,56,Oceania,17,883.69
5263c7ac410f471b8f251bf7745e7e7c,364,358,6,South America,17,3531.37
52664beb2941479c8a6a80c9562abb20,155,124,31,North America,16,1267.73
526929d1814f4e6797e7a4d8c189472d,349,321,28,Oceania,20,2036.59
526a25ab8a3f404ebbfb56dac07e5c76,204,160,44,Asia,18,991.99
526abaeac39d4a9a90a686e8e7a8bfad,363,357,6,Oceania,20,2120.49
526c5a1a384b4c7fa18ea18964fec630,66,39,27,Europe,28,484.92
526dcd50b7804ef4b9baf3cdb56ec66d,144,122,22,Africa,21,1316.39
526e0c4501e04850b7f24c64d5e2440c,291,247,44,South America,18,1730.3
526e5542812b4fc1811328d63ea65a69,88,33,55,Asia,22,355.95
527179195fd74616b10f85f2f6742a48,303,255,48,North America,24,1300.36
5272e2f14b1e4acba9d5123d78261f83,122,67,55,South America,20,565.38
52734670374b45d19259630dd920eeed,199,174,25,Asia,24,1431.64
52781fa74b234028a2544d4c392e60a3,41,13,28,Oceania,21,535.43
5278fb1930ea4edfb07eb49e38cd8490,270,233,37,Asia,25,1895.75
5279a847c5bf4a61803503dd5a7d6c21,299,263,36,Oceania,21,1302.25
527a1ef4d229403485f2970547fcf6cb,365,360,5,North America,19,3237.76
527a3b0a919b4dc5a071f836dc583f3f,43,18,25,Europe,21,282.56
527ad088f00247e681a1194561eec13d,333,312,21,Asia,19,2502.29
527ca74409da41a08add0f9913381b23,140,83,57,North America,21,931.55
52807ad12d99487db5c7c869020cc484,264,224,40,North America,25,864.51
52841fb2734d4eef8570f5438e33bd7b,58,33,25,North America,23,334.11
52846b3e381e4cefbc09954451513090,356,321,35,Africa,22,2883.7
52846b6aa7204a109a636520108b9b4d,322,292,30,North America,16,2822.48
528508eb03964381872fda50ed8c5b9d,364,313,51,Asia,22,2003.73
52855a2145f340b6a1b73a82f355bb56,57,10,47,Europe,19,219.05
52858df57037466c8baed3759a6824bf,262,221,41,Africa,25,1595.41
5287548105234098aeb394de4b517217,242,201,41,Oceania,21,1834.07
52886c6b0ce24e9d9fbd4dd56424e988,160,105,55,Asia,20,682.26
52889ce25723495c8577bafc35685b19,202,173,29,Oceania,22,1544.16
52890c762ede4210a6232f61742d52ee,167,118,49,Africa,18,830.43
528add92f8974f0c928b97af5f8d2698,82,56,26,Asia,20,1065.48
528b30a8fd9b46dcb4bcdab82a85d388,219,184,35,Oceania,20,1428.42
5290af7636424fc08db6133c5b48091a,350,324,26,Africa,18,2282.71
52924c443d26487f92d4d3e8c1a08f67,162,129,33,Africa,23,837.19
52934a95c2074e5daba1ecfc108a19b0,90,44,46,North America,22,137.14
5293c3579d854488ad518f434d95542c,365,345,20,North America,20,1760.97
5294cace326e433cb3cb3308270dbd98,79,31,48,Africa,24,215.87
5297b9b5dfa84b599d4371b2f06767c1,165,134,31,Europe,21,1226.57
52982a59e5dd41b7b5533a272dc4f459,161,139,22,South America,21,1346.97
5299d778ca184c24b439099c0de52321,43,2,41,Oceania,17,244.23
529b875c0648487ab23431b1013abef3,365,344,21,Africa,17,2196.81
529cdc896df84e27afea03901344a69c,268,229,39,Oceania,25,1514.63
529d55e0bf994b3bb879795c907d7b38,293,256,37,Europe,20,1755.95
52a01869ec34424c9a120a78a8439630,256,224,32,Asia,19,1893.34
52a10cd633e24768ae20f89c4b0b4ca8,289,263,26,Africa,18,1663.22
52a406154d7348d286b865b01eb16e84,174,121,53,North America,19,880.94
52a656e5f5634c05b9e0ffd01edec116,219,182,37,North America,15,1389.54
52a8204530b64000b103b8ca640744cc,301,237,64,Europe,23,1521.67
52aac094a47246658d3ad5b91c505476,204,172,32,Africa,20,1737.04
52ab499d0a244b9fa038e06d44ddc31e,341,306,35,Africa,15,2349.59
52ab70842bc6446bbca980a0b1dfd0ea,166,121,45,Europe,18,1359.73
52ac81f739704b3ca6857cbd83ac276c,174,146,28,South America,19,1168.15
52b0d3dccb4044e58485f772de28869e,274,248,26,South America,26,1740.54
52b2204f1e344228ba6f3508bbdf5d02,310,273,37,Africa,24,2026.75
52b43ee2dd0e482b951f223f320a9342,213,163,50,North America,22,1824.63
52b5a3328a0641fb8475e94400ba7030,365,340,25,Oceania,21,1977.56
52b68531db4a4210b69e9c9c332f60bc,217,185,32,South America,19,1309.24
52b69514967a4aba8cc790ca03f582c3,215,193,22,North America,23,1284.12
52b7821b4d2b4d868ef1a5f8515d62ea,57,15,42,South America,26,259.75
52b8c83a87d34717859d0eb481ba9ec8,44,7,37,North America,16,333.72
52b906b9fca742698f01dcc9a7622c68,347,324,23,Africa,22,2836
52bcc48bc005498dbb09ec1f2d910698,305,262,43,South America,15,1934.58
52bcd660677549118d575874bdc812e2,225,202,23,Asia,21,1944.97
52bdbd318fd5475b898c548fb533fabe,356,337,19,Africa,23,2777.66
52bfaae7f7b4481caea76715cb219781,230,181,49,Africa,17,1274.78
52bfd556adb540fda31ac8e89475effd,333,290,43,South America,20,2222.05
52c0742deb4a48e484005c1c50861384,365,362,3,North America,14,2875.58
52c0f0d10d284ee7876795f2ec171441,200,174,26,Europe,18,1354.68
52c58d930f2e49bd90d5df4ff45fd2ed,49,20,29,Africa,20,334.25
52c652ee66bf4d06842f8874a378ecf0,158,103,55,Oceania,20,863.62
52c8b62bf0844f278bce99b1e8f6bc05,244,218,26,Oceania,19,2392.93
52c8e79b0eee477e9bad0600390becdc,278,226,52,Europe,16,1736.09
52cc7123a9fb4507b1b8d2164574b8c0,104,80,24,Asia,19,643.09
52cc8eb26be14ea79bcf42354202352f,315,270,45,Oceania,18,1821.45
52ceae2fdbec409cadd1d5923598548f,342,326,16,Europe,20,2523.59
52d052b68a6a4d9182bf85d9cb04f43a,126,93,33,South America,23,874.62
52d266acd41b406585ee53ba34d2f500,68,32,36,South America,21,274.41
52d30b75f7d141719889af217a772cdb,315,280,35,Africa,20,1638.17
52d3c07e54c549a19a3e9982b8deeb53,140,89,51,South America,21,802.93
52d54bcca27240bfa5e6b5d47ed03f62,364,344,20,South America,22,2496.4
52d68debe6254765b5c480939e8468d9,364,323,41,South America,20,1787.84
52decfa6fe60451a964526c94c6c968c,338,295,43,South America,24,2209.54
52e12a5d3b664c5495409634eb21c563,236,189,47,Oceania,22,953.74
52e48a83cb254b41b9c21c7d3d833a9a,364,361,3,Oceania,19,2799.7
52e4a2389c8f4c769ef51bf32a13811a,156,137,19,Europe,20,1615.36
52e5d55cc06e4ccfbf7284bab73f2e59,75,30,45,North America,21,429.3
52e6ff286c41491faea15a48fe3e0253,245,219,26,Asia,21,1678.57
52e7ead62224452490ddf2426cf646dd,317,274,43,Africa,20,1278.97
52e847e162aa46689c7cee599297d591,346,297,49,South America,22,1408.19
52edc9bd7f84452188e569642dd41270,151,122,29,North America,20,1557.65
52ee7ecbca5c4ad297c0a2e1628a2bdb,167,144,23,Oceania,10,1653.93
52f4038211a848a8b6d328361e6f9367,365,350,15,Asia,25,2350.54
52f7077188ef4f4fb1713b40ef9396fa,160,116,44,Africa,23,822.87
52f92fba4c7a49f9951bbaaacb694839,307,278,29,Asia,20,2721.25
52fb69a030164d829040c9b2171f7aa0,60,25,35,North America,22,795.72
52fbb215e9344a429984939515e14ae1,363,337,26,South America,24,2975.76
52fd00cc419f416aa27c05ecbb55bdff,323,304,19,Asia,17,3122.36
52fdea53f7c248799f8062fa66bbdce4,365,356,9,Asia,20,1739.58
52fe3440635e4c859d93bec7135e7d7d,118,71,47,Asia,19,1146.61
52ff848edf244e3c9e9e801860709b27,324,299,25,South America,21,2159.94
53005c2581ef4aa1883c87b3852e888a,363,361,2,North America,22,3093.01
5301458410564196a27e1ba935b92fad,127,75,52,Africa,16,745.29
53021a82d8d347ef809aa386cf97972c,44,4,40,Europe,22,213.21
530348762301421d814842756a84864a,336,298,38,Africa,16,2462.32
5307a82416ad41b794ab7c9a70fde2ed,354,322,32,South America,24,2412.27
530a2552edc343e5a782fee12d6c81a1,97,70,27,Africa,21,705.28
530b15e1716e496c8cfd1f33a789b28a,144,96,48,North America,20,1001.3
530b502a328b4cde932b3ae19693e671,349,311,38,South America,19,2485.43
530c49640a104bde852252813b2f6b80,283,244,39,Africa,20,1544.07
530c6127b9064189825ec69d238ed84a,363,354,9,South America,23,1966.53
530df857b106415a89d08004952cceb9,351,332,19,South America,21,2748.66
530f98be9d72408c9eb8b3ff55f2474c,139,115,24,South America,16,994.43
5314e859d9164bedb2408f7bc33fe9fb,186,154,32,Europe,25,1293.62
53159cd624254e228fec8b115a1937e8,170,131,39,Europe,19,1110.2
5316d3676d384b9c8432dfcecbb983c1,352,307,45,South America,23,1764.48
53177d3b435a4a26b7a6014a7c567264,254,203,51,South America,22,1284
5318fa809a1a437d9b397b7eae1d6b2a,93,38,55,Oceania,21,381.49
531976eac2674b4ba8dad4a112c19c9b,365,338,27,Asia,20,3127.62
531cbcbc747c46019544d593514a8eb1,235,208,27,South America,21,2218.22
531dda94b1124cfd8732c29e260d7a84,207,180,27,South America,20,1479.9
53212c2ca29944a8908261c3e3348579,86,41,45,Africa,21,813.75
5321851ea23046688643b2ccd918f766,109,54,55,Asia,16,349.97
532273cf11a1416397f088c0ff601627,365,315,50,South America,17,1311.78
532321a6d82d4525a8f41c148d1472bb,316,277,39,South America,21,1951.02
53237a4df1434363a68224586f9593a6,308,264,44,Oceania,17,1550.93
532383bfccec45aba880f3a02361a1da,138,118,20,Europe,22,812.01
5323c4bfcc8944248410f3ecd41c0374,223,182,41,Europe,25,726.16
5323dc6c880543e3b7a39764f7df8004,284,245,39,North America,28,1651.83
5324891ea8704434894c84137b804e9d,131,89,42,Europe,17,421.52
5327e6131904475191b758c193ad5e76,103,74,29,South America,19,841.53
5327e8ab42264bcdaa2dded956e34e6c,33,15,18,Africa,16,95.81
532e4029046b48bdaeaff6f2cf2ea37f,229,177,52,Oceania,20,723.48
53300b83fc4c4426a1e360e86798d9ab,318,266,52,Oceania,17,1692.61
5333a04b8acc430fb261ac3ff496dbd3,363,363,0,Oceania,21,2018.21
53349616e9a5469980e5eda157d0b310,283,236,47,North America,21,1528.48
53353551117c466eafb2d34e4f42346e,124,91,33,Asia,22,397.89
5336c8ea55ca427fa0340e53bea025bd,230,202,28,Oceania,21,1555.8
533abd4d99004556bc9f8e55dad2be36,181,148,33,South America,19,1278.84
533b444ae1724eb5a8b2608d706fb61f,53,13,40,North America,17,458.08
533f069cea8940cbbb13fdef19ac8932,260,224,36,Asia,17,2334.96
5341f31c3ee940c1adb2c78e06939c85,155,101,54,Oceania,17,574.97
5343acc61dd34ae093255e3faac64d2c,204,180,24,Africa,29,1622.99
534492fbaab347cb9ea13f8f8e8fb249,260,225,35,Oceania,22,1939.1
5344edbe54b74e799fd6fb4c888f65b1,284,256,28,Oceania,19,2751.16
5346260dfdfd417380983316b6f1db85,81,32,49,North America,20,237.07
5346510226cd41258fcbcca0862267e1,264,233,31,Oceania,18,1314.92
5346cfb00e264b0d97be967073cd6186,279,246,33,Africa,18,2022.33
5359f30b43104703b40990f26c5575ec,97,57,40,Europe,24,626.28
535b00d85945420d984cf4556a785782,223,178,45,Africa,24,831.43
535da5af7b7c4f008330d19d6ae0df8f,309,258,51,Africa,19,1343.1
5360a6cea79a4a0292191da63ac48fdf,139,106,33,North America,16,980.75
5361a1e51cc646658ef60eb7050ef01a,335,292,43,Europe,24,2148.38
536250a59ed1460bbf2a057911d7d4dc,64,16,48,Asia,24,270.05
5366b3342cca433daec85862d44bf533,155,122,33,Asia,25,961.48
5368b5e428fc4853b17aaa3d91b5f274,115,78,37,Asia,17,1010.76
536b2256be384b99a9521efc954cb36e,121,68,53,South America,20,678.37
536d35bc73eb41cdb97f8077b59d9080,155,115,40,South America,21,923.49
536de16b8fd94ad3bf09de3ce322ae92,365,353,12,Europe,24,2032.17
536e4dc0eb3f4c40acbb26b085c88b26,216,167,49,Africa,18,778.63
536e81e26597486f9f50699658f217e6,180,132,48,Oceania,16,1256.88
536ec3d0336c4658a125c83719427440,164,113,51,North America,20,768.08
536fb96ec2054901a69830f9c872350d,231,182,49,North America,20,1676.04
537356dc19e4431686a3f0090242ac83,336,315,21,North America,20,2446.39
53760f9a7e8b469eb9e5d2f97cfd7d7f,33,10,23,South America,18,429.34
5377049372bf421198ed7ef75be84036,315,286,29,Africa,25,2181.07
537850f322da44e5846d6c36ee5f93a3,283,232,51,Oceania,26,1688.36
5378a72568294ec3a2aff1529d983869,177,122,55,Asia,20,640.33
53795f709e5e4c04ba7afb80f4e6230f,274,233,41,South America,22,2123.12
537b5a987fac47658322579cdbd75186,179,157,22,Africa,23,1313.17
537c6abf739842918b67a98c5005a63f,365,327,38,South America,17,1844.25
537d2328fa944b85bf34fc32915b2575,282,228,54,Asia,24,1352.36
5380cb82304a4661bd72af5bf9337d1e,365,343,22,Oceania,16,2244.14
53826ed1c3d044129e5ab20e385357b5,262,226,36,Oceania,23,1960.03
5383ab30a735445ca54532a7f3ce5437,323,294,29,North America,27,2560.55
5384495044a944e09f2aadfc745b69ba,42,2,40,Asia,23,137.99
538459f6ba5d4cf58fc605f4d9df9c11,104,83,21,South America,22,943.66
5384a54961ad4faea5bc224f2343646a,365,358,7,Europe,23,2627.83
5384d92667c54b4984fe0ebf3da29ec8,192,157,35,Africa,24,1667.53
5385ad48e3e542728c9bc395e9a37a38,341,291,50,South America,20,1841.43
5389dd7aa91346e6848b249d6c221774,144,123,21,North America,22,1113.49
538a074b95024d2b87deed203209d139,167,118,49,Oceania,22,632.37
538a28a64d554313a93276dcce445fce,121,79,42,South America,20,1020.59
538a7645ee1d4648beda3c6c7b40f7f2,119,89,30,Oceania,25,747.68
538a79a18960465d8073a5ba4ef5222b,289,247,42,Europe,20,1269.08
538c923f18414facb23e0470b0d266f7,232,165,67,Oceania,15,1077.59
538cad35c38449788cb0d1a9a63dc941,115,76,39,Africa,22,1050.77
538e9130f10f406cb811d71341823c6f,72,48,24,North America,21,528.3
538eadc27e4f4f9fbdca36ef4bb049e5,364,363,1,Asia,19,2070.29
538fe62ddba04e1b9f923cc9a51e7df9,261,210,51,Europe,19,1195.12
5390826eeb7e411a844e38bf3b2eb9e0,363,339,24,Africa,16,2789.24
53922bad3dbc4d65a9f01e07ff8d8b67,251,214,37,Asia,18,1427.06
5392623c6957468db8d0cca9ae2179d0,217,172,45,North America,18,836.85
53952987174a498784436142b5a9962d,233,188,45,Africa,16,1740.84
5398da2e37ad40a8b7cbf2c3648c5d7c,68,38,30,Europe,18,495.64
539b73e00e944b588b3da9844ce1cac7,356,329,27,North America,19,2922.72
539bd68d6d9340ab926ec5a5f747c6cb,80,58,22,North America,23,478.85
539fe7d5b9a246d3b61c9f269818d05d,138,107,31,Africa,21,634.4
53a0c2f800a944aeb7f1c2d901709941,207,178,29,Asia,23,1495.17
53a23f9bb6b34018870460680f7e9377,266,250,16,Europe,19,2048.46
53a71474cf9346f197df54ecece54cf5,78,39,39,South America,26,268.61
53af35b270414d9492b8509e05a4af21,293,250,43,Oceania,19,1142.34
53aff8bc4df742fca5d0622c60296c44,294,238,56,Asia,16,1655.51
53b0efc108454c69a48a08f133e2691b,125,73,52,South America,15,1030.79
53b28f1a6f01475b85a7bcc8b86335f3,360,338,22,Africa,19,3218.68
53b3b870ecc34fe28b3d6609db07e5a9,320,269,51,Europe,18,1961.55
53b5fb003143476ab84f806dce269c41,364,349,15,South America,14,2193.68
53b6aa5d496d4127b8a45d3967341a27,229,183,46,Africa,19,800.02
53b6b61a018a46308849c1e8d8bb8a38,349,311,38,North America,20,2579.1
53b7267cb00a44f38aab8bb8d340cc98,62,13,49,Europe,23,293.07
53b7493a3074496e83208197d12f8ef0,329,297,32,North America,21,2807.31
53bc09f62ffd4b2cbbc779a8fa7c6be1,356,316,40,Europe,21,2242.74
53bc4c096e7b4607a1b7a611a6d29cf0,88,40,48,Asia,19,490.96
53bcda33055b40c798bea6531f4d4bea,245,196,49,Asia,16,1369.33
53bd2e07205a4b78b4080c6c98d8d800,57,27,30,Africa,24,382.35
53befc3359a44ae39ce86d1b327397e2,364,345,19,South America,19,2748.64
53c29781b6a4483bb3ae66ffe851304b,262,223,39,Europe,20,1608.2
53c6d7895c984ef0913da44d868d808b,363,331,32,Africa,23,1857.12
53c6ff624e1040b0b6aa209b75ae9d13,239,217,22,North America,20,1976.88
53c82c78b2904995919264282fcf9164,29,5,24,Oceania,25,107.35
53c87103f72f49e99dd55f3570835811,310,289,21,Europe,15,1936.15
53c94cb5a67f4ff1bb903ad564ae47a2,298,248,50,Asia,17,1943.33
53ca57bfafd7453bbb9a007b7ca0ac6c,78,56,22,Asia,21,534.34
53caa9ba839f4175bf8d27228ba3d106,359,334,25,Asia,24,2186.02
53cbfaaf592348e5b829d825b80519d8,202,180,22,Asia,22,1737.19
53cc24f1c9f140c193acc4f109793445,271,245,26,Africa,23,1939.16
53cef7a010ce44058c12afd2d7d41e54,80,27,53,Africa,20,154.15
53d0ced45d264e86af101ccb05eee25c,222,183,39,South America,18,1094.57
53d20700d0cd4b648e83923cc3b5da0d,244,203,41,Asia,19,1919.45
53d4cae7734b4344af34b2594c0e03da,172,146,26,Oceania,25,748.38
53d52d604f95409bbef11717240c44f2,264,224,40,South America,25,1666.93
53d5da81db5e403e90318254fcd158f4,133,114,19,North America,23,1156.76
53d79736c10042e49b41137172336f71,193,155,38,Oceania,19,1296.22
53d81ac4836e4c7dbc79d3aba5e50fa4,277,227,50,South America,23,1339.11
53d8309665a0413ba59cb8ae53660686,365,315,50,South America,19,2073.03
53da4030155a46178b8aa6d3ef0b11cc,197,156,41,Oceania,21,1218.91
53daf18e3af9431aa81765a7c148aa54,337,283,54,Africa,26,1586.7
53dd77989cce4d95badff71fe5e3268c,255,225,30,Asia,21,2120.66
53ddd43ef86e4cd99375eb3bb44c4be2,89,61,28,Asia,23,885.54
53de791c4d3c4765aff1070e5e5df0c1,365,354,11,North America,22,2915.28
53de9e687f9541dc8ed7488a35acf10c,238,204,34,South America,19,1662.49
53e11b16c72945ddaf217781d91e41ff,360,306,54,Africa,15,1976.69
53e2d74ac98844688a4ee7ade8842c3c,163,105,58,Asia,20,969.51
53e377b11f9e4bbaa692b35b6c3b1900,260,207,53,South America,28,1226.14
53e38f1935e449689a61850260d4d466,166,129,37,Europe,18,1195.48
53e3ff1915814f75a17198419febaecc,177,121,56,Africa,19,710.3
53e4ef7a0cf34818974e6a885e477e58,147,117,30,North America,25,846.88
53ea2dd19b2640588bd411d7ff438f54,193,133,60,Asia,21,1285.78
53ecdf37b45a405186ebf0ac4ae1d20b,197,145,52,North America,23,696.59
53ed100f8c604e12870e89bd04f1c270,92,55,37,Asia,18,896.25
53f114a7fa34495e92f759edda537307,182,148,34,North America,17,889.42
53f116fc51804977a517b22d44fb85c0,219,169,50,Oceania,16,2068.98
53f27eb062c44bf8a191eb0659d9f403,351,310,41,Africa,20,2206.46
53f58066ec294a8493151ac0e9a58ce1,269,218,51,North America,17,1133.67
53f61a32e22240469e15b4b9f4b65236,107,69,38,North America,16,573.8
53f704933a1742298004edc0c396ecc5,113,82,31,Asia,14,988.31
53f8a2af6e514efcb0cbfa844c7db60b,76,28,48,Oceania,15,173.27
53fadeb6c4bd4dc1bd2abd0bf6f1130b,186,151,35,South America,16,1186.25
53fae7ccc66249a1ae95ecf7134fa83c,361,356,5,Asia,21,1696.29
53fb7fc7fed64bb38af2a0ca68284580,285,243,42,North America,16,1118.11
53ff390de6ec426db07cb79ad4261615,39,5,34,Oceania,20,90.63
5400cc9413704a6eb28adb62f603383a,365,340,25,South America,18,1264.98
5402721a328a4ba0a8de6b837939337c,364,323,41,North America,21,1918.92
54036bdf522e4d34b3b7890dfd15523e,82,56,26,Europe,18,388.43
5407cc0d400942fa8760f816cdc4627b,364,359,5,North America,20,3692.14
5408716f004d45efab70251219bb49c1,61,22,39,Oceania,21,549.15
540b6983d9514da68e70ed9b7a882b5e,188,163,25,North America,16,1466.14
540fc4d44ecf48979b16bc61cabd8a82,196,161,35,North America,23,1404.84
541102fba83745bba5e34caa25713bc9,363,337,26,South America,16,2558.84
5412e16d8dbc492d9742b1b7d5ddaaf4,150,96,54,Africa,23,931.91
54134348c9cc40a885e39120c64eda4c,124,78,46,North America,21,395.96
54136ececd4a4cafb24537aa04bfd6e3,188,148,40,North America,21,1020.08
5416f26ff9b543d6b29870e787f28c04,325,299,26,Asia,23,2190.11
54173df40d0f4863aec95225710b7d84,159,137,22,Asia,17,769.09
5417e6c4fcd34c94a1d0ccb7bb7907b8,285,264,21,South America,22,1991.37
5419f4a133ed4a5f95b13ec0b3d37831,70,39,31,North America,19,274.71
541a924de70040dcad01b3dc6d87530f,89,36,53,North America,18,103.99
541b5bc65b834065952f4de860c5828e,295,276,19,Asia,23,2067.29
541c2c3aac8a4fbdbe8affc4243d9756,168,123,45,Oceania,22,1039.55
541dd32ffa7b4405aecce2a3265c4e93,365,365,0,Europe,21,3176.88
541def68acb7404ca58437403e10beae,53,12,41,Africa,22,522.96
541ed68941f249939eec7898c7d97d64,289,262,27,South America,20,2308.07
5420c7aabb9943c48b384bad6cd05b56,244,198,46,North America,14,1175.92
5422b8972c4b465f96d7ed46b9e81fc3,157,128,29,North America,22,1103.44
5423bc8919f14b1d94817ad0efcf20d3,281,235,46,Asia,17,2045.46
542465292e044b0dbc69c6853f53598b,159,111,48,Asia,21,242.85
5425f1db8df54568bbcff62bcef139d9,133,88,45,North America,20,949.57
542839212d314ce5aaa52678a88cf028,362,306,56,Oceania,20,2083.85
5429702fe9504911b2f6170de351554b,348,298,50,South America,19,1426.11
542b26874ebf42e8b958ada2dcc04ab5,365,352,13,South America,19,2121.26
542d5fd9a8194b1fadba474015e7d4eb,298,272,26,Oceania,20,2188.96
542ddf8cb60e432db61363a061033cb7,110,62,48,North America,24,522.46
542ef0fb263a472c8e42deda70c9a497,103,76,27,Europe,22,692.16
542f010eff6243bc91ccda14242d7418,303,255,48,Europe,19,1506.9
5430ef8156be434ab06ea8fad62b625b,320,271,49,Africa,22,1770.36
54354a5cfd13490088b536198a160bf7,354,321,33,Africa,24,2425.57
5435bd27367241b8b114b5c4e6cdae2c,364,336,28,South America,25,2370.23
543a91c44adc43bf8ffecca721789ce0,343,302,41,Europe,22,2110.46
543acd4a5587462184964cf6617c51b0,128,80,48,Oceania,19,656.33
543c45bb929e47bea92e95dfb1a5cf18,365,319,46,Europe,18,1642.11
5442461d90ce40f8b2893c155b4869ff,243,194,49,North America,18,1338.71
54425736a2fa4eee859a453952178d7f,87,58,29,South America,25,636.3
544352e469f44e3f8cd35c04a5add589,352,299,53,North America,24,2072.68
54448c5e81ca49e1a74a3cd67614e30c,131,80,51,Oceania,23,901.6
5445ab5c48a640a4985c6ace0600c1f2,33,12,21,Europe,16,226.27
54483454a2f64d23bc6f418ff8f28ef2,358,334,24,Asia,18,2240.74
5448fa6ecb104eeaab7d820b7a554e93,350,319,31,South America,16,2882.49
544987a3c3cc4dfc804311613657db5b,235,193,42,North America,18,1880.17
544a2bfd879d424eb4f2362466139447,365,347,18,Africa,19,2649.52
544a3ca118cd49879ee41c1c880c6a22,125,72,53,Europe,22,1113.03
544a51a65ed04b6790f760d7a0a95d60,168,139,29,Oceania,25,1115.86
544a8633747c4e6e9a4d927bd4a04eb5,274,247,27,Asia,18,1923.82
544ad8040c4a4792911d6e9d95ec100a,365,345,20,Asia,17,2307.47
544f64283bc04b7897aff72a514b128b,202,161,41,Oceania,18,793.7
5450a27e16804b38b99179ca8830e767,311,290,21,South America,16,1583.89
5451f1f293ed4b8497de69c3d16719d6,177,143,34,Europe,16,1710.6
5456210c6c8442ecb18c6dd4708a90c8,361,323,38,Europe,21,2140.84
545aee34e453431e875e0027c2a754fd,243,207,36,South America,23,1340.23
545b33eb94b84516a765750d3be7d7f9,349,292,57,South America,20,2169.4
545ba269bbb94d40a909b2f3e0a6e15a,147,106,41,North America,17,1281.8
545be016dc274bcb8a7148709f04a0c9,272,236,36,Europe,25,1580.48
545c192583274969aad08074da05d242,365,343,22,Europe,17,1709.69
545d2c385f89499c8ceaee79798afd91,105,55,50,Oceania,23,606.73
545e048a0e554eda937201708d5ff283,265,227,38,Europe,17,1568.05
545e55c20dbf4545bbb74645150a494b,137,115,22,Africa,17,597.57
545fceaa7066459a8c95b0c55de16b3a,259,216,43,Oceania,16,1281.17
5461cf7c4ffd4401b3995c8019340f40,261,208,53,North America,17,1637.98
546226b8d50b44b48a0cedebd1039420,151,111,40,Oceania,15,726.3
5463e25399bf4fc394d814473207a02b,190,145,45,North America,19,1595.43
546442d4b8e743868fac8a372560ba73,243,212,31,Europe,25,2129.52
54656eeca395473390ff31b8977121d4,52,24,28,South America,19,445.7
54674eaf90f444a39daf61f171cecaec,242,189,53,Asia,22,1055.99
546828350fe94c92a3b5ee634e2662c4,136,112,24,Oceania,25,1011.19
546862bcc2484faab8ddbb1c67c147a6,291,240,51,North America,22,1380.15
546d70225960465598661b9d1dfa90f2,364,345,19,South America,22,2934.71
546dd01321e543c1b9ebb5271472d0e8,256,207,49,Oceania,23,2207.64
546e1a1462d747edbf010541e669ef51,362,327,35,South America,18,2556.91
546ed641f6074dfaa4eeb8e6baeeeb4d,166,129,37,South America,19,1199.02
547047fb40974085952951777230e080,133,99,34,Asia,23,940.96
5470744bb09240a0895e5d3758ef9ec2,365,358,7,South America,24,2382.63
5472dd0d22d646c485b02e8c03d02d35,318,298,20,South America,22,2017.45
54731efed1a74b30aa03f86ccf484d5a,365,348,17,Oceania,15,3471.12
5473ced5600e440ca60c9b3497c5fc29,337,316,21,Asia,17,3340.68
547550feafe445ff928dc4c23565121b,157,128,29,Oceania,23,1214.63
547772af489046a4bcf081028bcc3929,112,74,38,Europe,17,709.02
547b40c283904f27b63e536649e1adcc,331,308,23,South America,19,2978.54
547ba3f720764b66aa7a30d08b8b4ecd,200,153,47,South America,16,1234.26
547f24ff2f804bbaa19dc99b4ddd68a0,52,5,47,North America,21,429.29
547fa40ce89b455c8280c01c40f5d5a7,72,51,21,Africa,18,617.78
548483b93a6247f1a14dc3fd77169506,168,125,43,Asia,20,866.91
54850d8b05dc4c319b5b2168fa3fe27f,235,182,53,North America,23,1120.52
5485325f752c42de8964a7bfbd39e396,318,278,40,Africa,19,2207.91
54853c9c0755426db90f575fb00191d7,341,288,53,South America,22,2070.81
5486bf2ed4824804ac7f39931155dfd6,202,151,51,North America,23,1262.24
548b7ffe7a2343feb8b0e22076fddb19,133,117,16,South America,13,819.05
548db9b4e3b44e97a6a9e303e682b5de,350,328,22,Asia,14,2825.35
548f171bb9264db18c3d84ee3ce9d053,97,57,40,Asia,20,487.64
548f1a97ca6246dda9f11742fade98e5,171,128,43,Asia,13,1419.22
549233f3f2e24ce2b679a1ff69d3aac4,285,245,40,Africa,18,1997.21
54993e6f169f4b52b661f1c67f27e8f0,93,62,31,Europe,21,681.56
54998e89aae1461abbbad84549158c01,134,116,18,Europe,20,1255.35
549a30cb177644cdb6f165f928c91a44,365,363,2,North America,21,1869.14
549b72a65f6e4d8ab3459c8e94b8ee10,150,101,49,Asia,18,929.58
549b91c63ff947a89021c674d1294ebf,277,252,25,Europe,23,2227.03
549c55d5ff9a4a498afe44cd2cfa537d,187,162,25,Oceania,20,1085
549d852ecae646249201d1f34339b8fb,119,96,23,North America,22,1160.24
549d9775c7b84b148bf007c10171eada,268,233,35,South America,21,1579.14
549e8bf406f24b85999450850359f00a,364,352,12,South America,22,3078.91
549eac0ea8f640c5ba71833ffdaef08e,365,353,12,South America,21,2487.69
549ee7d2959f4211a8e03028c1671672,355,319,36,South America,15,2942.08
549fa4bdd4cf444da3ef7c6554833284,331,285,46,Africa,24,1542.05
549fd6ef7cdd453aae2714f081040f84,174,131,43,Asia,21,1003.22
549fe1c19dae4faaa3b9d75dddfd9104,364,357,7,Africa,15,2425.35
54a00c672952446f92c6c3190d5041eb,250,217,33,Africa,23,2554.55
54a062806fe74ba0a7c38432a130a5ec,233,210,23,Africa,20,1945.82
54a2e2d62e1545c1a6c41a2010d9fbd1,292,243,49,Africa,19,1669.45
54a351c2848947ea999dea141ef5cc49,150,107,43,Europe,22,605.32
54a6c6ad297c41bb9ce4fc79fbaac9ff,295,274,21,Africa,26,1779.09
54a97df2a1db4b9faba3d10d10ad9c2f,72,37,35,Africa,18,684.29
54aa3f54e8d646468b8f4ff8ba043e8c,365,363,2,Asia,18,1689.94
54ae559a384a473a87527393f9df31af,199,160,39,Oceania,23,1140.68
54b2bc6fde3a4f20bd71b48d568a86d4,90,70,20,Asia,22,982.89
54b41351f2944e15ac1aaac9e77d9057,305,274,31,South America,20,2474.82
54b66241186b4eac8b6adbb6a0bb09e1,365,328,37,Oceania,25,3173.5
54b805b51c844d21b64b054a84a64e90,73,36,37,South America,21,387.77
54bb27b2ed744e0582c526be733118d7,204,180,24,South America,21,1352.25
54bc8b6654234d9786e9b128a2fa4a54,115,76,39,Asia,25,516.93
54bd73d0a95242aaa061eb942156352c,50,2,48,Oceania,20,192.91
54bed522b70e40b0ab2485c314999d58,146,116,30,Europe,18,953.96
54bf61a5b6ee4dc7a9b6ae7031e1e263,364,358,6,Oceania,20,1394.24
54c09ecc48e34a3a927a67a98cc8a837,55,23,32,Africa,17,406.55
54c2bf2480094b4e83636ea035dc0630,131,75,56,Europe,19,708.5
54c52da43c4244c59de4be0ae9277d4d,238,219,19,Asia,15,1873.92
54c58e528d354923addb02412965940e,305,281,24,Africa,24,2242.5
54c8b7540cd04d2b81a2a584ffa0aaf1,286,256,30,Europe,21,2409.7
54c8c27b14b04fbb9dad67f9b2e45785,363,342,21,Asia,19,1341.51
54c8cbb212ed4e54907c51f2034a770c,86,36,50,North America,17,563.61
54c9618dec5145e78ea102d16137e2b8,157,136,21,Asia,21,1016.53
54cc656c02b84896bf94dde546e9ac71,326,273,53,Oceania,22,1290.79
54d3909bc12a48afbcf23b0ca0e28183,287,260,27,Europe,25,2519.38
54d65771fef14c2b94617c27d8e3636c,365,334,31,Europe,17,2112.89
54d6ff49bfdf4c269c6fa07d1ea9e411,142,108,34,Africa,20,746.02
54d7d226cbec4e319f754eb9e10a89a1,176,134,42,Asia,24,1147.27
54d96c4746694e83ae5799f0a73c175e,219,192,27,Africa,21,1934.27
54d9b69cdd3c40f8b87dc33a0d73678d,146,119,27,Asia,19,632.3
54da0f9eeb4947688ada5a1d13b07410,340,293,47,Africa,20,1264.36
54dab723f835499c8a9823bd1b8360b1,291,244,47,Asia,17,2019.63
54de1dd3448a448f9a46842d351b4b80,62,25,37,North America,22,468.43
54e268a4544c49ce9c2547e5899b5612,170,129,41,South America,20,757.01
54e2e5bc0ba148c381f0234cb4805629,352,324,28,North America,20,3550.47
54e4358b0a6f4138aa3d0d57d2d28450,157,123,34,Oceania,22,773.23
54e49535bb8c4b42ba16a41f5c2db41c,137,91,46,North America,22,1107.97
54e5965c062245bbbae11ae8eb68533e,309,285,24,South America,22,2807.81
54e767f941454567a4b449270f041b42,145,104,41,Asia,21,990.18
54e8b590a339477ab0160df15ec54af0,136,91,45,Africa,18,911.24
54e8c4f992984d1186208db0461e36a4,164,138,26,Africa,20,1519.92
54eaefc3d51e486a9bbcaeca78f6e62f,339,308,31,Africa,18,1911.22
54eb3a162186478294f778c5de791466,102,54,48,Africa,22,722.56
54ee2de3cf8741988110d447ee2f9b74,275,252,23,Oceania,23,2388.22
54eebb538ecd42eb97b9d9592f0cc6e0,305,299,6,Europe,20,2596.58
54f3e62acb164f9099d779b1f14462f2,337,305,32,Africa,20,2741.97
54f458d523504722a8c52fda0f1f2e79,365,343,22,North America,19,2096.5
54f5d22c561744d485014a443b0b4ae8,365,364,1,North America,22,2507.17
54f9df5a248b4e4083fb02b08c763d63,214,191,23,South America,23,1499.54
54fa420bbd1d4b63883f8a32c1ebeebc,327,295,32,Asia,19,2395.36
54faa4fe639d4ccf8eaf823f7d1c3f6f,181,160,21,Africa,17,972.8
54fc5649656e41808075613856de3677,317,286,31,Asia,19,2320.72
54fc8a82de5b4c0a8bd83d5f15c0c0ab,206,172,34,Asia,18,1522.12
54fd56aa37f94fea8e57e74445bbf86b,249,195,54,North America,13,1077.47
54fea850a167416da8915c2da3465df0,153,97,56,South America,24,740.53
5500d404ed7c4be8866073227e66777a,333,292,41,Europe,18,2258.73
55021c22bb5d4b92888d0a0a82899f56,342,301,41,Asia,18,1820.91
550987a7a53c4ec8b455b9b959067bee,299,273,26,Asia,23,2377.04
550b1f50ccc646918ecbf0226de50104,363,345,18,Oceania,20,2328.34
550c6ad35b6f42459cc68034a9ab3e8e,36,12,24,Africa,16,192.64
5510c62628c0456c87360909504af8cb,362,360,2,Asia,20,1924.67
55113f162cd04d699afa399c69370f17,39,18,21,South America,21,356.64
5515869544034dc3b6439268972ce44d,189,162,27,Oceania,22,1911.37
5517a3399735459ba9d7451f2c6a7a15,53,23,30,Asia,13,181.8
5519463d27b84f5e8b37ee477052f0ee,303,252,51,Asia,18,1661.47
5519546c4a9c476a8192f90e4b72f188,44,6,38,South America,16,290.79
5519b0234a8d4de9917ae0e7f4036750,231,192,39,Asia,21,1623.14
551a757fa4824761928dbad142f4da70,364,359,5,Oceania,24,2119.04
551f9d2f859043b2a291cebe8597a91c,224,184,40,Europe,22,2055.22
5526df2e9bef4885af1fd4b07bb8d691,166,136,30,Africa,15,1047.53
5527d8c6eea14f098686c7634f3d6f45,299,249,50,North America,21,976.38
552931ce1d664b06bd88dd7e82710f94,347,323,24,Europe,12,2312.99
552934edc49c4b3b951893374c8c50ca,239,212,27,Asia,20,2335.61
552c0886d82d46b8ad46621ac708c31a,106,74,32,South America,22,632.99
552cb82c2f254a179179f83ce7732a35,103,74,29,South America,23,730.33
552f1165499c451cba6790516c429288,141,109,32,Oceania,22,896.7
552fbbf3ec214ae39dad79eaed15a472,183,138,45,Africa,25,907.97
5534d3cfe7b44173a32a157ab4855500,203,168,35,South America,15,949.07
55358e080c624fb09e0c6f39814b2e1e,362,358,4,Europe,23,2035.64
55390b710a804399a0d7925c51a67127,319,267,52,North America,21,1941.83
55393598329b4f8caed8dcf1edb03023,303,264,39,North America,22,2686.33
553c863230264c8b88e021149f129e59,74,31,43,Oceania,18,35.02
553f41cab8cf4f268d44ad95a84e2779,335,298,37,Oceania,19,2142.88
5541531a54264905bfc483c96e6d4e90,29,12,17,Asia,22,318.26
554300bcbfb64de8beb00b1ccbcfd09d,256,224,32,North America,21,1624.66
55435889260148f1a878a77e64d6cbf8,362,317,45,Europe,23,1434.22
5547df5fe88c4a858967f3a22e66c5f7,198,162,36,Africa,18,1468.9
5548273185924947af5368ab1fc8e1d6,304,272,32,Africa,20,1697.8
5549c7e499d444878097c85eaf6336fb,365,346,19,South America,16,1599.88
554b38b2db80484cb0fdbfecbb3bdcc0,262,215,47,South America,19,1298.44
55506e6f0809466ab8148aee80cd7836,198,153,45,Africa,24,1277.94
555106a03a4c48d28d4d608a4f5859ee,228,200,28,Africa,21,1158.68
5553e635f9664e628bb9b2d534b28fb3,125,70,55,Europe,23,556.39
555414c22b5b40cdbd04a8c718572791,365,363,2,Africa,18,1735.77
55542818607c44bc96b4bbbe4bb5dbc3,152,123,29,Asia,22,1112.89
555612f3af074bcbbaf0f0b024c20cfa,229,207,22,Asia,15,2009.99
5559a12c3ba74ead9e5c95129da83af0,165,141,24,Asia,16,1181.71
555dc0a802c7462da63af0cdf7fc534f,231,196,35,Europe,20,2011.73
555fdfd909d34674abc81d5eba7e6081,351,308,43,Africa,21,2641.56
5561d04ef00440cfa157b69f2cfa1c47,323,273,50,North America,14,1424.24
5565287e89444012a3c8d72e8d575f47,65,45,20,Africa,21,699.79
556a6112778f4a1ca9f63f808f951644,280,244,36,Asia,21,1951.2
556bd9a9c6784743b532f0d3bf970b3a,235,214,21,Africa,22,2116.73
556d618b4c1049e1a2008a3acdfb46d1,136,110,26,Oceania,16,945.83
556fdef2efde49b4822a8e1932b0ec5f,192,165,27,Africa,20,1179.12
5571836249b54d9085b678f46cd069d9,363,332,31,Africa,25,2611.21
55730bd5f5df44d9920558c685352e72,299,261,38,Europe,20,1942.94
55732d7f94c24ff697581cddeff6501c,76,40,36,South America,22,727.04
5573c009f7474aefa1e857dd5b8d1a6c,242,191,51,Asia,18,1287.77
55749331eae84e849077b09e368a4595,365,353,12,Oceania,24,2541.37
55757ea4c5d04c8f9712923c637240e4,332,290,42,Asia,24,1380.09
55789dcb221b40489aaf284da7907c3c,76,33,43,Europe,19,734.41
557a40f766ba4dae9db9ca6d84ecb8a6,124,88,36,North America,19,747.62
557ccb4bb2204cf99bbf0e6c51f3cf00,322,269,53,Africa,24,1927.87
557d6af7bc8e4608b273c640fd2d6c61,264,226,38,Asia,23,1525.3
557ddee69d4446d1a64f02111df1ed06,250,198,52,Europe,17,1185.79
557e9f58b72d4230a14c711ba5d83559,295,263,32,Oceania,17,2152.3
557ee93e0bf847399838e14fe95f2463,95,64,31,North America,20,1011.58
557fbc1a7cd4432aa88a74cceb24306c,131,80,51,Asia,22,721.27
5580b015d6404e6b99bc64ab1f70d3d7,53,29,24,South America,18,395.85
558217b9680d4869a124fdb339094a4c,295,242,53,Europe,24,1815.77
5582b34f354e4d94ab6d48841ceb8902,241,196,45,North America,17,1365.03
5584e500285148d5be462930431f1679,196,144,52,Asia,17,805.03
5585ad53a1df46459ae0bdb495493664,276,231,45,Asia,20,1959.95
5585d745099748ad8734afb3afd172c3,134,91,43,South America,22,864.06
5588fcf3c7f84245bf63276cb46683eb,225,182,43,North America,15,1013.25
558c6af8e6694865a34518f9e13b786a,230,189,41,Oceania,24,1341.99
558c8986cba14cbd866d7ef75b60b2d3,119,87,32,Oceania,17,1108.59
559046b10e2b48e88daa34ae5aac0a7f,227,182,45,Asia,20,1321.55
5596db8f826448658e31e554097d816a,93,65,28,Europe,23,793.44
55979b8916c74e6d9d96b7671b492d6f,160,137,23,South America,20,1120.52
559c3406ca464cc58e9e98e85b773702,65,33,32,North America,18,982.03
559de8b819f546f3a5efb47028965b06,328,303,25,South America,22,2539.15
559fb5913bf14c5595777ef7cdc793c2,117,86,31,South America,24,825.53
55a1d55aba8c47f5b727dbfc96d3bb19,300,245,55,Asia,20,1211.8
55a2f467928b4a72bdd992fa2e443a57,355,310,45,North America,27,1462.72
55a71aa1d0424c939279a0cfe30e07a1,86,55,31,North America,21,927.49
55a98bcb3a174a648d9567c74c3b11d4,237,185,52,South America,18,1693.41
55a9af545e8142ce81cc27bc3686093f,103,73,30,Asia,19,870.84
55ad89639d444cf8a4b29fbcc54d259f,173,141,32,Europe,22,968.83
55ad9587592347369ecd269287e8fc9e,362,343,19,Asia,23,2705.75
55ade7c221e0404a9690020c828581a3,172,147,25,North America,19,1213.53
55aefed968494781b44a0c53d42d7a65,323,281,42,Europe,24,2038.34
55b15482b134418db9c2faf256440457,77,33,44,South America,18,575.12
55b3807101de4c8c8db07fbce2b3dbe0,363,348,15,Africa,20,2598.6
55b644136dff4b848413fea5e19fa3a8,63,42,21,Africa,15,521.97
55b6654a029d4b4bb7ae870db2f68723,148,109,39,Oceania,27,912.27
55b96a5b2212473a8af2f42ffed29704,354,331,23,Oceania,19,3749.2
55bc5fb93689437081007a64905dc66b,173,124,49,North America,20,1286.97
55c0d150014a47dc882115a00762c613,63,23,40,Europe,18,497.08
55c180ea91cc459894a9520212f403f0,310,292,18,South America,18,2195.3
55c2106bfa3e4b209b310b593051de29,110,72,38,Europe,23,510.97
55c2b4265d3d44fb90fa8e3088d8ef4e,57,22,35,Europe,21,370.32
55c382c4fd494b2fa4be580eafefc74e,300,241,59,Asia,20,1577.35
55c3c5a994bf4eff8bea218bf31c4def,280,241,39,Asia,18,1775.85
55c56dd3abc4410986a3ae6e72e2263c,83,38,45,Oceania,23,510.92
55c80da8cde843a58aaa0eb8487f1163,171,120,51,Asia,16,964.19
55c87719c33440a880e323879fe92020,110,83,27,Asia,19,368.63
55c96da165bc40859ce2094dd043ff72,299,243,56,Africa,20,1018.99
55c97222c90a4ec0aad1eea346c34d05,334,295,39,North America,23,2995.95
55cbfba14cb34a669cba26b7eae42c41,248,211,37,Africa,17,1342.96
55cd288e7d4145519a213f5f4b4f6f7d,365,364,1,Oceania,21,2619.27
55ce42033d3843aba91b1b9518a1b082,226,190,36,Asia,17,1960.68
55d201b0ccb54f6ca2f8a498ad66d4a0,234,198,36,North America,20,2185.27
55d2519461a94e5f8183303094c5c873,216,176,40,Asia,24,1966.59
55d2b747054e45f984d3dafdc977f1cd,318,276,42,North America,15,2029.95
55d5102e3f894762ab5127ee3cd1db0a,93,47,46,South America,17,426.47
55d5fb72e1b442e8aba8e340d55da5f0,227,201,26,North America,20,1637.94
55d7edc2c960489e914677646409516c,365,365,0,Oceania,17,1428.45
55d9878df2dc4c8a92f48d1ce53ccb16,158,134,24,Africa,27,1514.87
55d99ea3c3cc443697280c5cee0976da,288,239,49,Africa,23,1524.31
55d9b23e340645d0b9ac6a040c90767d,86,38,48,Europe,20,600.47
55da9e2a102242a9a823c5635944c924,333,286,47,South America,26,1764.55
55db8a4d5a6d477fb8bcfd61ce6ce433,365,338,27,South America,18,2455.89
55dcff3e1bd24a7399b51f05f2e6eda2,226,182,44,Oceania,13,1498.99
55df7f4e957e4028b3bbf36f50d3ca2f,212,155,57,Oceania,26,723.58
55e049503d3e4c9180cdc276c671a16d,362,328,34,North America,22,2135.97
55e2b11549b44ffca8b6bfed5b2ef942,129,74,55,Africa,20,550.82
55e2bbf808e14e9787f50e25634ac40d,56,21,35,North America,20,191.55
55e5eeac8e514d2b9374f76db6b858da,165,137,28,Asia,18,1577.8
55e744ad117c4b4d8b0ab6140146eb95,158,138,20,Africa,21,942.08
55e76108ef1148bf8fd2673b784e0c33,244,212,32,Asia,18,1898.23
55e8df92917b4b63968a27c3480bd67a,363,341,22,South America,20,2188.07
55e942cbe5ad4dd394948a0aee073334,58,12,46,Oceania,19,301.24
55e95db59df44150b7ccf4f0a9c40035,90,49,41,Asia,29,289.98
55eae58943794660804b1bb32cdd4fb8,54,17,37,Africa,14,556
55ef8daee50d4befa6178dd57dff3526,121,101,20,North America,19,743.23
55f00ba604944f8aaae8082553a9b730,361,312,49,North America,22,2087.72
55f13fa8412c421885cd083efd373bb5,288,268,20,Asia,16,1798.89
55f19e1756834051b8522b81f897bb4a,360,323,37,South America,20,1871.74
55f44914ce4241b4994a474b384a4110,137,89,48,North America,18,919.28
55f6b12d61084bc789ee3dc6a52f06fc,303,253,50,Africa,22,1051.98
55fc5f7e6780440494f15e6734162c75,355,300,55,Europe,16,1492.45
55fc86bd0823481981cc6e748b5e240c,176,151,25,Europe,13,623.3
55fe472dd56a4c6d9dde42a718712da0,365,349,16,Africa,21,2368.96
560568eee83142bb817571ff4be2bbc5,174,146,28,Africa,20,1193.4
560a344efc1b4e928972b26025b10954,240,199,41,Africa,20,1782.19
560a94c5ebc841dbba4b7b3445b89edb,90,52,38,South America,17,601.06
560abbdbc6c1466fa7fa4dda181336d8,288,268,20,South America,15,1850.14
560b24e6583d467aba54ab57878a0da5,150,114,36,Asia,18,1099.14
560f4d0745564d34b47e6aabd7ef1f63,201,183,18,Africa,21,1870.89
56101400d0544549b981805327e9bae0,89,42,47,Oceania,17,154.44
56119cc3167a488eab5003899b854d27,89,48,41,Africa,18,951.37
561258cd6a4d4f63898a46422f75c707,365,344,21,Africa,20,3058.85
5613114f558b43e1bf36200e3b8d6b99,306,284,22,Europe,17,2071.28
5614442366654d589989aa9f6d010869,316,304,12,Oceania,16,2010.59
5616b901c1bd4092a2d6d626ea09684a,86,48,38,Europe,22,640.59
5617758df6284a9089c93c12a1e02d73,365,337,28,Africa,17,2582.97
5617e2595b7240d8ae7fb301935c7899,64,20,44,Oceania,23,675.14
5619b5dfb20a4a1693e2126f167ae644,229,194,35,North America,18,1052.78
561e6ea63ec84e148e4b605f87241eed,172,123,49,Asia,17,974.6
561f07b5e9ba4214aa7fd924ef1bf031,112,75,37,Oceania,17,1039.81
5620a658750844128d7f3615f8fedafe,241,185,56,Oceania,22,1517.07
562138d993844ed3ba0168037005d189,140,105,35,Europe,17,691.38
5622061f7d77493782441642f87ea158,274,227,47,Asia,23,1666.21
56228a09e3444365ab06773c470de9e8,49,16,33,Asia,21,188.5
562387134c2f467f8d9a45955f7a1c1c,348,299,49,North America,16,2345.43
5624874981194206b4f71ba3339f92b0,297,276,21,Oceania,26,2329.83
5627e3ff007546ceac7159b35fa29d22,260,218,42,Africa,17,2062.61
56284ae6c8fc4c2b82ea91f0b81691d5,225,183,42,South America,17,773.39
5628f03f02e44755b4800c39b3045b33,62,22,40,Asia,21,524.12
56292aeb314c454783e38fbb120c08c0,203,185,18,South America,18,1299.42
562bb455f7884090a205109f6bb70827,76,45,31,Asia,22,971.98
562c37ba98584ec7a640d17b6bc0eb20,364,359,5,South America,25,2875.08
562f63be2ce149b68084c45cb59c1e06,300,254,46,North America,21,1242.37
56323ba36a41489e998faf227d4336a3,189,152,37,Asia,21,1284.38
5633b78be8804762b98d18f5ed6630bb,157,99,58,Europe,21,594.41
5635a3b2da324553a24b048ea4e8769a,258,230,28,Africa,26,1386.1
56374d52d9774cd0a08e55edfe261868,49,16,33,Africa,21,165.87
5637df0e5388485e84e52c58acc17f99,123,88,35,North America,18,1173.25
5639ae3d44594560b1643ac4cd55387e,298,278,20,Africa,14,2540.93
5639c43001a94a59ae4d8d92a3b9398d,142,105,37,Oceania,20,1193.74
563ae1e7b5034dafb1e9d7eee9b605ae,365,359,6,Africa,17,2161.67
563b298463c248198d2f591b64246707,365,330,35,Oceania,21,2509.15
563c947979474faeac54183eb3728bf4,358,325,33,North America,20,1494.92
563cadf7a11b419599df95f30fc394a8,317,285,32,Asia,21,2088.26
563cfc0d45a8449ea09b111f7f304a42,165,127,38,Africa,21,977.36
563e5b0c8c894cb88fcafb5fc35d72c3,60,21,39,Africa,18,367.18
56419585ac25407b8efa6be1af2d0538,223,198,25,Europe,21,1465.61
564198618b794b0ca32f65bfb14af5e4,75,29,46,Europe,20,435.42
5645c41c6068451cb13b84d3ae186b59,283,257,26,Oceania,24,2464.46
5647cbf334974ea4905de9dcee01a370,364,363,1,South America,18,2363.47
5649ab32f1624697b97a5799b871a39a,163,129,34,South America,20,1104.19
564f1c567786456bbd3f3d2fe38e9d0d,260,230,30,Oceania,18,2094.18
56507095b60c4a65839f680e07fecb39,354,315,39,South America,23,3126.7
56510e8a6e2d4d9e853f1cb78927c86a,135,86,49,Oceania,22,894.34
5651b15c764a4ed4900bd9414c67c57f,124,73,51,Africa,18,885.22
56521fde44bb42c2a17a31d77cc1d1f8,85,30,55,North America,24,372.33
5653ccd49e154ddda14bd75abf6e1880,57,21,36,South America,24,274.5
56556fc050684c67a3271441cb8efdd9,224,199,25,North America,22,2183.71
5655b922e4334cb7a83a5069227f4ddb,225,177,48,Oceania,17,1503.61
5655ead3cf29481e830f5b6b4c53d8be,341,321,20,North America,21,3133.7
56567faf3f484d0c8d950e54ca16ff65,144,89,55,Asia,19,888.7
565680b451af414c8e8ff9e1365308a2,242,216,26,Europe,20,1932.31
565799ae143a443ba3110e26499a01e6,194,150,44,Asia,19,772.42
565874ed20b5445e84c89b475a76a449,104,76,28,Europe,14,970.59
5659893af6b04966a023bfe5a7f0bd1d,365,328,37,Europe,13,1337.1
565b4e88a23d483da30426d666f38810,174,145,29,North America,14,842.46
565f1d463e4d4655a1a2ddacfe882a83,128,89,39,Asia,18,970.25
566124628c794d3f8c3b118bf7750e94,249,216,33,Asia,21,1789.81
56613c1e9b704525958468bad43eb895,169,123,46,South America,20,736.86
56633617ab004cd8ae5fe53792060c9f,280,251,29,South America,21,2156.22
566418f35d4e4473a36a0122fdd7baff,57,29,28,North America,21,436.63
5664fe5a8be142ce81b1709f25f05028,291,252,39,Asia,20,2391.1
56669aa494d94a26890d1b34234c94e3,285,248,37,South America,17,1790.64
566838cd93d1494699e89eff9154f134,282,248,34,South America,20,2058.91
5669a600362149c6a0201725f14d89db,292,240,52,North America,20,1477.24
566d2b24ae85486bbbcb02aea178c3fc,273,229,44,Asia,20,2234.61
566e04a2d32944a5895e6e8c4fda3170,100,67,33,North America,22,580.29
566e48275d7b42bcb03c8bbe93532800,248,241,7,Africa,27,1630.17
566e5683c9ab4536b30cb2fd6798c6c0,365,345,20,North America,20,2189.84
567043a054d34acb80bbfa919a5f8534,297,252,45,Asia,22,1735.66
567087d139ba435abc821e34ffe2dec4,156,117,39,North America,17,1393.27
56768b5b3c114afea93f040d07516806,363,328,35,Oceania,22,2112.71
567831c0d7a345e0bac42f9d0b026bdc,46,7,39,Europe,25,615.42
567949b82a074e1193f32d4377b581e7,156,116,40,North America,22,823.58
56794b81a01d4b61abc36f3376425e81,211,151,60,North America,16,1104.66
567c645dd5dd499d96c4a6351e669fbf,42,23,19,South America,27,298.92
567e4e3ff74947acbabefd8ceb917388,179,130,49,North America,20,944.03
567ef9746bac45cf8a3440c2daec67eb,338,308,30,South America,23,2586.66
5682b13d1b394a218c85d11946e285c3,89,41,48,Asia,18,401.64
5688071d6a65461f8e8129bbb54c9327,204,164,40,Africa,16,1013.62
5689bae9aecf4526b0e37569c4339646,57,3,54,Oceania,22,283.94
568b894a0af0432db693516d3498b943,290,241,49,North America,23,1638.52
568bf433f818446d8abb911a55499b68,308,269,39,Europe,22,2574.4
568c775a0bec46e5bb6f93cdd802be85,365,331,34,Oceania,23,2866.45
568d807aa1f04429be37ea9f7bad38df,352,327,25,Europe,15,3527.47
568f381c3bad422680a839273ec0265c,218,189,29,Africa,21,958.62
5690052165df447bb9480dc0f4e38c91,363,352,11,Africa,21,1751.64
5690c0af951545f6aa9f5fac80c9cf0c,365,339,26,Africa,21,2720.76
5690e462c4b04d209bc0a807cca61c58,291,269,22,North America,19,1902.14
569562291b584404a882a0309eb0e6c1,132,84,48,Asia,20,595.96
5695febdf02c4175a0084317379bee79,160,137,23,Africa,20,1014.46
5696e786d5ff4943b37079b9b282f0b3,345,314,31,Asia,20,2079
56974f1d320349178d58061442d4f1fc,365,351,14,Africa,15,1446.01
5697664886a04b5bba6ba8d9d154a53b,361,334,27,Africa,23,3087.81
5698af01cadb4801886e14aba49f3354,79,47,32,Africa,24,368.05
5698bf659dd74675a10360956dd3e70e,77,25,52,South America,22,623.32
5699326a607a46d8ab624f05f83a3093,346,313,33,South America,22,2915.3
56999418750d446f8d8eb251bb9228ba,272,258,14,Asia,17,2106.04
5699d29a5ce14af3883583e48d32af15,103,67,36,Oceania,24,895.99
569af764221a46ceb999ec481d6243c6,123,95,28,Oceania,22,833.85
569bc0f27d294ada94b59fa7e8b1adf3,196,162,34,Europe,24,1527.52
569be205bc9d4e488ebee1f944b21646,153,126,27,South America,21,1112.19
569cd9d45e534d45a6b92d81446c6155,61,37,24,South America,19,362.39
569da1858fd9492384b0f035426baa4c,364,330,34,Africa,16,1954.51
569e17e12ca54562acbfaeac210c9990,300,250,50,Asia,19,1207.6
56a05443a73747cc8e5139e645774bf2,88,44,44,Oceania,25,435.81
56a13cdb72564a15ae65ff4bb7a2f437,258,224,34,Asia,23,1910.8
56a356befd3f49caa9987382f58789aa,120,95,25,Asia,19,404.76
56a3d1f2fd004378b4146a5b8f457025,116,69,47,North America,21,415.82
56a43aa2d8574644a1cefa3752b8c5e6,152,119,33,Europe,18,904.44
56a68c5111114e739b057dbfe3dc7c80,121,99,22,Oceania,22,1071.48
56a6a6d04613473eb1fe4532845eaf8b,74,22,52,Oceania,21,349.91
56a711848c9f4c7ba2918193e1e0cfe1,23,3,20,Asia,25,191.44
56a8e024e69246d2acac1fed19db75fa,113,61,52,Europe,18,421.21
56ab6f359cc1418eb14a1210eeee123b,117,82,35,Asia,21,771.52
56ad4a7c1476451e9b6b74d4478dcdda,117,75,42,Asia,21,717.13
56ad7d3c49cd400f8a8347fae7e11133,348,296,52,Oceania,21,1360.61
56ae85e006f4444991a815a4050bdc88,220,169,51,Asia,19,1840.39
56afd6aa25054aaaa30b45b765e079bd,49,21,28,Asia,16,317.72
56b1430057694fa492f93811e56c64e4,56,16,40,Oceania,16,582
56b28efd55054546b07863b7225898ef,62,17,45,Asia,22,391.37
56b5fa05853d4fdeac7694161213c33c,365,336,29,South America,16,1796.71
56b84e2b403f430382e9832993f66653,226,197,29,Africa,20,1580.9
56b8c153436a4871aa1bfb0a0299d7b4,156,133,23,Europe,20,1603.2
56b922ba03c84512a7042ed46e42f01f,357,315,42,Europe,21,2394.56
56b94575ee95404e86afbf1c062a6563,55,24,31,Africa,20,537.97
56b9815d2c79496195445d04e311d0ba,195,150,45,Asia,19,600.1
56bb9ff81b9c44d5998ff1b5219119c3,89,53,36,Africa,20,536.89
56be8b97144b49bcaf8933c2ed55a345,283,261,22,Asia,22,2468.08
56bf04f0b0064966a948cd275b941ad3,179,145,34,Oceania,22,1489.69
56c0b10b61564ab58c4c9640befb3d89,169,149,20,Europe,19,1966.82
56c0cc544ce945b59efd1ba86b3d7de9,88,52,36,Asia,24,516.21
56c0dfa233ce4e989ffbfd4200f9887d,353,326,27,Oceania,22,2407.55
56c186421cd040fea86c41375adc1412,144,84,60,Africa,20,724.38
56c25c62517d489c8cce8bb15698ede2,46,1,45,Africa,22,217.08
56c409ead81244799c87a07c73d8562d,314,274,40,Asia,17,1610.65
56c4cfe9c87d481c9403a988e6bc2cdb,365,343,22,Europe,24,2422.93
56c584935ffa4e54ad3c0eca2d5b7e23,327,305,22,North America,26,2164.51
56c5b1a6574043048ea278bc51543e5c,126,84,42,Oceania,24,548.69
56c7f81f3f8741849e4fa900eb3723e3,133,76,57,Asia,25,441.16
56ca5802139a4603973a28833492dc1a,364,347,17,South America,17,2026.08
56cabadb95914abc9bf7d435688d476f,346,310,36,North America,18,2289.52
56cad0664f204c5e9cff4ec70a08f99d,328,283,45,North America,19,2382.06
56caee63c3df40c9bbcd2fa60ac7d11d,80,31,49,Europe,21,276.93
56cd3fa67355470fb067a2d1639aca30,353,305,48,Europe,24,2181.17
56cde7330f294e39a9e2bc3a36008263,219,194,25,Asia,18,2113.23
56ce1ecd4d8d440fa09de51793574785,203,155,48,Oceania,24,806.42
56ceb39a066c4639acd543bb92e59aaf,328,300,28,South America,25,2316.25
56d04d3447a74d9c96fc56c517f5a884,43,16,27,North America,17,51.08
56d094782036458aadee05b22449b260,267,244,23,Africa,14,2289.12
56d29bef66f34d81aaad94c8e3345223,48,4,44,North America,16,238.15
56d4f52d983544898f06249e0279a6d4,159,107,52,Africa,23,925.3
56d6a5cef4fb48eb963566e0e438193d,241,194,47,Europe,22,1393.1
56d7097445214042a074f638de9015e1,104,71,33,Africa,15,1021.92
56d743553dd441ef9df0004be885e218,267,237,30,North America,20,1829.03
56d90d0adad8429097878586e7901228,326,280,46,Oceania,18,1333.93
56d933d48970440f9aef59050870f5f3,286,234,52,Asia,19,1844.51
56db927025c7467c9447585062499e23,230,187,43,Europe,13,1883.98
56e13213119c4b31982c0bdee9fe8b6e,232,211,21,South America,22,1806.17
56e1e7c859aa4d1096c103c76bffac68,206,162,44,Africa,21,1536.24
56e2ce4b60874213a3bb1d38d7fc0574,125,110,15,Europe,20,902.2
56e9cc8c795d452da4a618f0811b4732,365,341,24,South America,20,3458.1
56ec13b800c54e6eb4663d6b73833947,365,337,28,South America,23,2023.54
56edd1e56e11473e80e134dc6a25efb3,90,64,26,Africa,18,867.5
56ee77183c624c9780239bea86786224,102,53,49,North America,25,524.69
56eeaac4d67f4cb7abb4a9e5342cf81d,157,111,46,North America,20,635.51
56eede54a4bb4418908bac8537cd821b,365,353,12,Europe,19,2079.67
56eee667f7b84540811aa874346311ee,307,259,48,North America,24,1351.61
56f07904aa694daeae1964c37c07f49a,136,82,54,North America,20,842.51
56f58b290a8c43a68ec45e151f2694bb,257,220,37,South America,17,1283.29
56f763fd96a84837ae6d253be85cebb6,58,23,35,Africa,24,535.68
56f81390fed34c678c59d19345d66f45,121,89,32,Asia,24,873.32
56f9181733f14735a4d8e54376f1ffca,333,284,49,Africa,18,1129.89
56fac9e5b77d4c0c93cd4cb34561d795,362,348,14,Africa,21,2495.79
56fb485f30cb461890a6484bc9500f58,365,319,46,Asia,24,1960.46
56fb6e7596d348a580193f944e6e6d6c,214,189,25,Europe,18,1913.42
56fc28716f5c49479fe02dc72231cd67,92,48,44,Asia,15,518.77
56fda02dda4e4c6480992b4e6b5ff694,329,291,38,Asia,20,2571.63
56fdee39147541629ec7f97a38a6cde0,341,298,43,Asia,20,2105.92
56fe53763e6c46f4b8e476d58eb3e5f1,324,292,32,Asia,18,2533.61
56feb13fc7ad43929c0e7b3174376b39,315,272,43,Asia,15,1957.66
56fec963cf2d48aaadb113a5d121875a,322,291,31,North America,18,2516.14
5701bf2db83843dfaf78a5af3da1e733,158,132,26,Europe,22,1287.31
5702d1d9ec334e57919fd077e2fc9060,206,188,18,North America,21,1506.27
57041c4c2f3c4e16b82fbd4b4c7624c1,272,250,22,Asia,23,2318.66
5704c71533ee44b7aec425f25358cb1d,131,108,23,North America,20,1359.55
5705005fcc7e4178b5e36950c101afd8,70,21,49,Asia,21,428.38
57080082179b436cb2d2e34b91f3ccec,65,18,47,Asia,16,129.75
570a533b70a445c7af3a993c52f7eea9,122,105,17,Europe,15,837.89
570abbc5a049469dbcd8b85d4e764d63,73,45,28,Asia,22,613.84
570b1f3548b74dc8bc2300aa86432570,89,60,29,South America,19,836.81
570b5a58d9cc4202be6ece9e65ce597d,283,237,46,Europe,22,1683.8
570c35ae20264e538f9677412f93a821,358,312,46,North America,22,2094.09
570c5ec7ca434293ad49ba683b578c51,103,58,45,South America,19,436.98
570f2d53ca484104ace15a8f7c386d1f,211,157,54,South America,22,1307.7
5712eea77c7545d7b1711ea6955b8c38,279,258,21,North America,24,2446.57
571407f7aa7040ad84e5cb6d7fc4af7c,316,276,40,Oceania,21,2266.24
5714221037cb4b7e9d3cc8a5e8d4fd95,363,350,13,Europe,21,1688.2
5714c249928245fcad4fdac0536c4e2d,205,168,37,North America,21,1298.86
57166841764c4feaac8ce72680ba000f,328,291,37,North America,16,2795.74
5716b4b83bbd4fef84fd0fd7c234bef1,321,304,17,Europe,17,3095.66
57188311a5fd4616a4b0372b05d82b5e,261,235,26,Europe,26,1605.28
571a0437a73f4f77a07d00c1b2e75705,345,300,45,Africa,20,2366.68
571aada413094a2f859d8348beb46af5,121,86,35,Africa,21,447.74
571be6ae92474044a557467eddbc7965,354,317,37,Oceania,24,2051.48
571c3ed075a444e1b57d26f967a652e2,363,362,1,Europe,19,2062.33
571da465282343b6b432164aa886155c,364,358,6,Europe,21,2037.87
572014ee74cf43ce860179af210bd964,363,348,15,South America,19,2746.22
572046eeb68941899791e754c02f3bdb,137,107,30,Europe,18,1122.58
57231e8a637b407a9165158c7e4aa704,169,122,47,North America,16,642.88
57250a9867f24d6eab3779952e822ef3,243,188,55,Europe,19,996.66
5725d1a4594247bda9aa2d1f240a2a45,309,273,36,Asia,24,2322.08
57275f05f0544c6db9155af4e8c59bfd,316,286,30,Asia,25,2379.7
572848f0bcf540ee8a4fa67cf43565d5,94,52,42,North America,21,440.01
5728e3a874e34acea0e5ee56bc878a7b,96,53,43,Oceania,18,357.44
572a04e88ae947c488e6b70c9c41f059,306,276,30,Asia,23,2857.08
572b0bca8fd44e749dd59bfd0f1d0eb8,189,158,31,Oceania,22,1689.49
572b5cc3d0674936bb2f17dc7cf5f540,365,352,13,Europe,20,2396.29
572c261a30674c77a03f0f471ca1a3da,362,321,41,Europe,17,2628.55
572e0973c1f04ca2b6ca65dbe04c5c09,139,108,31,Africa,26,1075.05
572eaa892ad7448c9c4f12b28b5ba157,136,104,32,Oceania,19,824.07
572f954237ab40e3bf60f3b4987efbfe,41,3,38,Asia,22,448.43
5730b5fe352643b185ee9d7f74f1d0a8,179,139,40,Oceania,22,798.31
57310815e4674437ad885df96938f576,39,4,35,Africa,21,437.09
5733f505c3744fa8a011c622d620149c,298,274,24,Europe,19,1649.09
573863115729478a9772b074a118e935,75,25,50,Asia,21,720.77
573882f311df4c0484ea053af3a9a68c,365,321,44,Oceania,21,2037.84
5738a8cc04fd42ef90d6d30e873cba7a,358,324,34,Asia,17,2023.9
5739c9030d884ce9a8309b9b0b7b34cb,365,316,49,Africa,22,1606.5
573c2d8314284a9abfaf0883c6c646d0,92,69,23,North America,20,708.74
573d4ed0c7ab49be9438bfab218d890e,300,253,47,South America,19,2190.34
573d78f3c0284d42a1cf693eeeb907c6,80,53,27,Asia,25,1020.04
5740dcbcf982400d8efde31034cc9d18,330,295,35,South America,14,1701.34
5741eb5dbf1c4713afa4ffa91e5cb053,86,44,42,Africa,22,719.61
5742e21ffe4d42bda68c321931a68ede,288,261,27,Asia,20,2356.53
57437939ee9d49b8bbe916fa23468907,279,243,36,Asia,23,1694.24
574611919d9b46a699a5085bfe18b6f8,284,261,23,Oceania,23,2536.71
574838db4379443d8b7ecd6f01d1c16a,130,81,49,Oceania,21,428.2
5749330ee5f34fbbac26a480fb320e38,207,155,52,South America,21,851.04
5749a993d465465e9fd425f9464d1217,224,177,47,Asia,18,1341.54
574aa9f6a9a544e48535ad2334921409,364,345,19,North America,16,2601.9
574ac29444be4fa1be1fee3a4f092994,181,137,44,North America,25,904.14
574f7559b7ce4fb08768083a72242be1,148,108,40,South America,16,893.97
5752086c030749558ff36084e9a80382,239,210,29,Oceania,21,1889.05
57526557266a41eaaca67622c60850bc,364,357,7,Africa,18,2345.93
5753f0df0b28443b8d4550a715cb5e9a,239,226,13,Africa,23,1747.61
5755d130c69f45ce97d12b42240bba17,149,103,46,South America,16,557.65
57565fda1a85405cb01e8cfc6e0f2e90,56,20,36,South America,19,503.68
5756bdfa43334ee48cbaf3e226f5daa9,44,20,24,Europe,19,368.43
57571bd34a414a5e97811c27fa995086,132,113,19,Europe,22,507.49
57579a5fdc194e8f9c08a7bce21a9f90,66,25,41,North America,15,474.64
5758275ee3fb4c7194ccf4afec59d1c8,269,217,52,Africa,17,1387.42
575aa4ef77a44380825e576153a0f840,365,359,6,Asia,20,2621.07
575b12dfd8da467a9cff8cbdd44dc52b,198,157,41,Africa,20,1080.24
575b469673fb45f282e81a86d7afecde,88,68,20,North America,15,609.37
575cc542593e4a42bffc756bcc1a2fdb,28,7,21,Europe,20,115.97
575e1290bafa44f2a11ac49b6de3b110,239,190,49,Oceania,21,803.58
575e1a3a2a0c4a54ae0f31ad29ecdf9d,208,165,43,Oceania,25,1430.16
575e3fde6ec6443f88ff87b38de4fa82,365,365,0,Africa,18,2057.92
575e490828ca4c02bf4967085e20cab6,308,270,38,North America,21,2226.57
575f8373babb4385ac2b78f09ff37e4d,206,171,35,Asia,24,1167.05
575fca3254e74d098990220e716b31bf,161,110,51,Asia,19,704.02
5760feb6438f4e8c96dd3f213d7682e6,134,111,23,Europe,16,938.82
5761d414d2724be4b048dbbe2af17b2b,75,33,42,Europe,23,327.28
5762a026c2b14f03af6a033841259243,262,222,40,Africa,19,1446.86
5765431572e040a09713b51b409eb032,55,5,50,South America,21,49.22
576696b8167e47eb86abb4d34139cc29,220,193,27,Europe,17,1453.08
57674fb2363c4f20bff5cf5be342c909,108,67,41,Asia,17,474.78
5769c98bed2a49a4a1ec077d50a9b7ef,152,108,44,Asia,20,1259.79
5769da527ff24659a8c3cd3fbc6bb66c,191,146,45,South America,17,876.57
576b2827657a42a0964ea184d058ac43,182,161,21,Oceania,18,1521.67
576b42884fea4b9490aea52065bfac48,100,59,41,Europe,21,646.24
576c4cadb3d44c3483e8426d0802de33,58,39,19,Asia,21,568.89
576d971e20414a1198ce10965c52cfbc,233,208,25,South America,25,1722.31
576f517a4ac34a70950cb74b572c426c,237,203,34,Africa,22,1535.37
57726d8c7a7e48ea8059ca63f2cd5d9c,298,252,46,Asia,18,870.01
5774095db7e8454190c70c35ccfcef2f,179,125,54,South America,21,755.3
57747063c4174d75ad1f166924e9c159,209,153,56,Europe,22,1098.63
57761d9a759e4b0fb384bb79f9f97140,116,97,19,Africa,17,833.61
5776d3bd723a4c7b8725f6c4ad149887,141,81,60,North America,20,1090.83
577973e3473e4926ba04980c15213cde,365,363,2,Europe,23,2367.26
5779dbeaa48845149ef25a0ac926964c,139,88,51,Europe,21,975.87
577a0677091e4c2bb804476a4b36abf5,362,331,31,Oceania,20,2445.42
577fe87a0d57409a9ec9913d638c7a2f,339,309,30,Africa,21,2426.42
57819e060c0f4ecd8d06e06a3c07c3c4,39,1,38,South America,24,424.26
57822d43ccf74510a3306cbfe4a5e261,362,353,9,South America,23,1754.58
5782827865ca47e6a99ea3dafb10642b,62,11,51,North America,18,591.79
5782bd9d1f0042b8b5586543f74718a1,363,357,6,Europe,18,1621.55
5782f510d12147debbe13926118a44ec,170,151,19,North America,25,1732.56
57832a70ca114307b35f31d133373564,66,11,55,Europe,21,315.61
5783e6609111469e9a12152a169a21e8,323,273,50,Africa,24,1739.07
5785b34f61ad4264bc684e8b9e994454,323,274,49,Africa,15,1645.17
5785ea3cde9949cab1b5e85ed29c5424,104,82,22,Oceania,18,789.05
5788431adf12451899b302100f09b004,222,185,37,Oceania,22,1053.19
578a0267379b40bea54f164003dd3b00,181,159,22,Europe,17,1619.3
578a84cff0e349cd851e08fba6f77d87,184,152,32,North America,21,1357.82
578beea501574142a592e11b2722bb4e,212,158,54,Oceania,23,1408.38
578e6a8966334ca9a8e8974cca963551,252,220,32,Europe,19,1572.15
578ec99d709349839ae33d3a3d3fab31,300,267,33,Asia,13,1818.95
578ee1148e294461b6bf1249c6a4a3c8,223,173,50,North America,24,1218.57
578f24a44ec544ebaab47ed2b2ece15e,255,206,49,Europe,19,1470.13
57915024a542488b8acc5e57e00ab579,365,362,3,Africa,22,2613.05
5793b66c629541d5a88e7baac33329cb,264,245,19,Oceania,23,2033.22
5794f19347574f0d92de4f1ebb959ad3,145,92,53,Asia,16,1047.52
579970ca22dc40659a6cbaebeb94a8e5,243,212,31,South America,18,1401.94
5799cd02f01f47569f68c0ff4c152f2f,117,80,37,South America,16,722.81
579abe4a1b2d4ed998c6950f058d3022,253,196,57,Africa,23,1350.91
579f48299e7e4ad398a359ad667b2f84,336,310,26,Africa,18,2913.44
579f741d74184e5a8840ecb475373867,289,268,21,Oceania,22,2184.3
57a131c4da1f49608d87a840c1ee7de3,364,345,19,Oceania,16,1973.24
57a1b954bb894b338c17d139973449cd,346,307,39,Europe,20,2738.19
57a24bc2cd8a40dd946c8875c5756414,65,15,50,Asia,16,351.07
57a2fc70e2134e379441247241970d29,205,171,34,Asia,15,1988.84
57a517f58c7c4af6a7ae3c355a72aad1,365,319,46,Oceania,19,1159.1
57a5d2bc8a714896948d8584de5e88b4,276,252,24,Africa,14,2235.78
57a5da81a93842cf95e1959fc45c78aa,291,259,32,South America,19,1840.8
57a652af20a54f9faa3388cab0b7e972,184,153,31,North America,22,1188.9
57a9894228864a868efe8a894dce68b0,154,123,31,Oceania,16,1721.64
57ac8ae5a4244fe1a8da5d34475e8412,365,353,12,Asia,17,1916.87
57ad8d93940d4001b397d7236f63afa3,244,216,28,Europe,24,1929.51
57aec84a647f4efc8dba9fb8edfa9706,171,149,22,Africa,15,1720.76
57b0a2faa86f4335b91017dd7565758c,333,283,50,Africa,15,1884
57b14e7facaf41f1a3d9d402be348f9b,309,292,17,South America,18,2437.89
57b1caf1f68e45168abb29686e92493f,60,8,52,Africa,21,406.7
57b1e4b045064f27a34eb55b2768eeb5,66,23,43,North America,16,373.6
57b27c80479d4c9f8854f15a6ab72b5a,278,257,21,South America,22,1990.15
57b418406a65466da6afdbcf49bf0142,64,30,34,South America,19,532.75
57b4a5a660444082a4df394cf389cc47,233,192,41,Africa,23,1759.58
57b6a5cc007f4c03800cce9e07e1b54e,312,277,35,Oceania,17,2415.62
57b7d42635ff40bba21fc51792779711,314,282,32,Africa,20,3051.47
57b918d5e8dd40e796ef98db85fd90f7,118,81,37,North America,20,641.33
57bae1df77d14f85b548a3a7ae13acd0,78,32,46,South America,22,352.42
57bc04cc4bdd4adeb26c93dc6c4bd4e0,215,186,29,Europe,16,1251.62
57bea209f2064c3fb8af4b9510686088,252,223,29,South America,18,1555.48
57c32aa3842a4c6da0da7db59ce911a8,272,206,66,Oceania,21,1337.75
57c59c30e6494c9395fc4706829b2017,188,149,39,South America,18,1181.87
57c8ce62aac54209b96aa0b1fee08bd1,361,360,1,Africa,18,2202.95
57ca191960124931a1b8b0ea78f74829,244,205,39,Europe,20,1446.36
57ca298e45c145f4a9ac1ef0c8bae9d7,327,279,48,Oceania,23,2029.19
57ca795af2b84bbeb6ac8d15e37de583,292,236,56,Oceania,17,1144.59
57cc1f979ba34f30a708b80392e7a0a2,287,267,20,North America,23,2066.12
57ce1de57d2244539aef5ee7621282d6,152,126,26,North America,22,1888.15
57ce81bfd0324c65a0429a5cf0cb669a,360,326,34,Oceania,21,2729.25
57d0909db8914317812208d91950f175,282,256,26,Asia,17,2141.23
57d0b3217a8344ebb367cfbf255f7341,51,25,26,North America,19,393.7
57d0e5828f6347fb89b4f87bd9d4436a,133,78,55,Africa,20,488.26
57d1eaebd77e4dbcbd53c39cba45c784,271,232,39,North America,20,2056.41
57d291e9a9454627b7b1f196f71084a3,258,238,20,Oceania,18,2307.5
57d4fbc4befd4f08a2c5683e9c3ecd89,138,103,35,South America,17,981.79
57d545f4c5254f19bd16739f9eba6048,364,364,0,Oceania,19,1141.54
57d5d9bd108845f6b549cae394b96216,350,300,50,Oceania,19,1424.46
57d7f93f2dbb4dbfa8c052fef1d6b118,194,150,44,Africa,17,1278.32
57d9a2839a634d1b9c3ed4fa956bf45e,114,94,20,Europe,19,866.69
57da59c5169f4bc78fd12586cd58daa8,365,334,31,Asia,24,2749.21
57daa0f726c3431897116f3a9bc16fdf,365,352,13,Asia,20,1386.13
57ddcc0d079540e2ab71ac3b06eacf81,292,246,46,Oceania,16,1384.2
57de109e1a6f483f812cebdc7984db32,355,304,51,Africa,22,2075.82
57decfe9ddca43d98a8763bb24c6052e,242,187,55,Africa,20,1609.37
57df44188d7d43e9aca9d3696d24c679,94,65,29,Asia,20,958.99
57e0edd197d24e7d918c9e3cd437e579,49,29,20,Europe,27,497.84
57e17af0d5584011946391ff59d8a965,100,68,32,Oceania,13,612.8
57e1f365924c4115a800857872d56c39,83,31,52,Africa,20,631.74
57e3bbd7771e4d618c036e45565c87a5,74,28,46,Africa,19,746.23
57e7e339d90f4d3bb9bcfd145916d74a,353,313,40,Africa,24,2292.05
57e997d520784d46b4191fc883a044af,125,73,52,South America,23,430.32
57ea18493a6f451091cd5e6dcfcc56c4,138,99,39,North America,27,917.09
57ef7beb203d41e7b9003cb4288c371f,333,282,51,South America,19,1985.74
57f26cad07d6410ea669bcdfd610bcbb,318,267,51,Europe,21,1544.66
57f2799bae774c2bab04affc6fe0b02a,90,47,43,Europe,14,363.13
57f346af5292401793dc5bcacf3c4cdd,149,111,38,Europe,20,1003.76
57f4257d70b641d889622375e6a69514,365,348,17,Europe,20,2619.89
57f49d454140460aac5fe43e89be9b52,107,54,53,Europe,31,437.34
57f4bf6795ab42eb9ea395439abb65a3,60,10,50,South America,24,197.02
57f5fa7e44ee43d9a3e4d3db3bc36f43,342,289,53,South America,22,2063.81
57f8e368f291429983fe655f033f5a6a,100,79,21,South America,20,660.53
57f9397b90d84f399823734c3992c734,362,344,18,North America,21,1660.15
57f95f44d611476eaa1e4041dd003af0,222,177,45,North America,26,1745.85
57fb733623cc44e19ed2568e694d0184,251,229,22,Asia,20,2113.01
57fc07eb464d48d6b80be58d1e43873e,323,263,60,Oceania,18,1586.92
57fd8881c7fa4d208fb36d99cc1cab38,200,166,34,Africa,22,1299.12
57ffb0f55c594940931cd0594236033e,171,137,34,South America,21,1088.73
5802503fd682433eab85e6f64361fc1a,281,242,39,South America,15,1556.35
58034fb8c3114a9c927e9f91a350a8d8,74,38,36,Africa,20,283.03
58040f21d0e3432b85629caeea23807d,243,201,42,Africa,17,1152.61
5804f30937b946d2a2a2826140f3f32c,216,159,57,Asia,18,740.17
58055a4ab6704c92872367ea75864374,365,335,30,North America,22,2365.04
5807d5a984c6485f989b50d3cac74f3f,350,309,41,Europe,24,1920.19
5807feeb1f984c7592e7279edfb0603a,101,61,40,South America,18,256.44
580acbb2429e4aeaa51ade11d270c6c4,304,261,43,Africa,21,1941.04
580eff9c7f4a40eaa80ffd1c703834bd,153,116,37,Oceania,18,1191.84
5810227857a4444aa3ece4c9d06d30c6,332,307,25,North America,20,2294.06
58111304f43843b2bd6ae7ca41a74172,92,68,24,Europe,23,612.66
5811df7a1d374056a03f7fa176daf59c,53,7,46,Europe,20,492.19
5811fe4ec3eb4c448cad5874fcc0584f,158,119,39,North America,22,1178.01
5812a5992cb54f90ae5c9210beb987d9,365,357,8,Oceania,23,2928.39
5812aed67a05458ead3bc60718d9a447,188,143,45,Oceania,20,1067.58
58131a011595435599e8ee39e95e4f4c,45,9,36,Europe,23,158.65
5814e99ca20e454fb6f62e0ad817a847,346,319,27,Asia,15,2346.93
58171b3b110044a187665d6b0c9039bc,355,311,44,Oceania,22,2357.92
5817938832344ad8a93adcaaa19818bb,259,221,38,Africa,23,1679.68
581c4be2cc9b40f18d68348e7eb8ec08,311,281,30,Asia,20,1768.38
581dbfb114ca4015ba496f0ec1e6ca09,223,174,49,Oceania,22,1105.48
581e9a00aa6446f697bf56f09f4975bc,363,355,8,Africa,19,2477.78
581f484872e64a13b4c98fe1c9e39223,96,70,26,Africa,22,730.95
582091855d6f42068fc1320b3f411e80,226,184,42,Asia,23,937.97
5825676d76104fd5b6ce78e06ec1d259,252,218,34,South America,17,1821.43
58279b3b72f945c499d178899acac5d0,363,359,4,South America,21,3120.12
5827ae73955a4a3f99077ff250cb6dec,95,61,34,Asia,18,1077.35
5827bad20b934763abde0ec8bac31d23,327,290,37,Asia,23,2415.38
582973d88edb4c54960a91ad0f96a432,223,182,41,Asia,16,1484.75
5829e9dedea34031867d6155de313f5e,313,274,39,South America,22,1580.63
582c02f254f14b9e90e71b1d80f3ceb2,210,156,54,Oceania,17,1827.6
582c5b58c68347399d5154e549a75c30,354,308,46,Asia,23,1646.41
582cbfef47c2495f89b5e63fb460d800,289,257,32,Africa,24,1777.06
582ddf97ce1346b4b57513f53776f3f3,144,109,35,North America,21,1361.7
582dfd9476824b0a8f90c87b71e29842,221,177,44,South America,21,804.24
5830f31a7e5a43a5b94d5421313d5559,103,60,43,Asia,20,436.62
583125c5f74446f2b8cb7eddd763eac6,110,83,27,South America,26,571.68
58314ae25f994c78a2435467c17cad83,45,17,28,Oceania,15,344.84
5832743164ee449a88329df6376a3254,211,179,32,South America,16,1761.37
58359f01382a4d18a2a2c09fbeab9a4d,85,26,59,Oceania,15,197.7
58387616c5a44e109ee2b83f72aa3bec,194,177,17,North America,22,1291.72
5838d5ea85cb4aaab8dfd8eba50a3544,129,105,24,Asia,21,857.9
5838e5ed7fff4ce9a2575497a05145d4,282,226,56,Africa,17,965.28
5839c44cac0f49f4b6f916c915d8ffa7,346,316,30,Asia,21,2803.12
583a3df11fa94f23991bab5150d0b4f7,302,274,28,Oceania,18,2860.18
583adcce767e4831b1980615925a2c61,63,36,27,Europe,20,660.38
583b783f4f954ab5a83da24db88eacef,111,95,16,North America,23,725.61
583be210749544b79ab91e52265eb6d7,240,212,28,Oceania,21,1590.99
583ca906b7194e9184f17d426068c181,343,316,27,South America,17,2296.02
583dd04a58064136ae647496d595f3e3,260,209,51,Africa,22,1664.76
5841a43aa553418fa599a5ffd377fbbb,56,11,45,Asia,18,374.92
58427fbb1f6845ceae2cd02e290ec825,59,27,32,Africa,24,427.8
584400a48461489099a6437257c9ea16,138,94,44,Oceania,22,539.86
5846e9c642e944a39c08e7aa3e6f921c,178,150,28,Africa,17,923.69
58487c866f2b4884a3596646eb0ecfae,365,338,27,Asia,15,1834.74
584cb65150854e41a7f2006e937d093a,353,313,40,North America,21,2141.54
584ceb30f6f34c67aef97ea7084baf71,136,90,46,Europe,16,709.68
584d63e81e72467689574ce79d4ae09e,329,276,53,North America,23,1704.11
584e075fd92f49f29613bf07ff0b69cf,361,345,16,Europe,20,2237.36
58535d39ddbd4d87a060565d717a34b0,363,343,20,Europe,20,3367.33
5853bab51b6a4bc99dffbd25048ebea2,173,131,42,Africa,22,1506.84
58550f56ff8e4dc988c923f1bd6034fd,302,248,54,South America,22,1478.53
5856b2f6e5384324b7504029c96269c0,320,296,24,Europe,23,3132.94
585854b4938a4f63ac9b30b91db9e15d,365,359,6,Asia,18,2375.78
58598dcd46634fb99813574ffb018bbf,157,129,28,Oceania,25,1357.79
5859c364c96d44789b049384b1cb44c0,333,305,28,South America,22,2534.6
585d3011bf5b40dcb9da754bce9642fe,151,98,53,Oceania,17,823.63
585e9c0a32e543c18d68ce74e0e66265,224,180,44,North America,23,1134.95
58625c69d155485db5c5f0053c06f173,365,342,23,Asia,17,2343.67
586275dc0e86452baabb07aa4d27dfdd,148,102,46,North America,25,592.68
586348971ed44cd9a2920eb8c6147d81,95,53,42,South America,22,207.68
586367d0adf2407d98763ccc71486591,310,274,36,Europe,21,1996.67
58637632345c43a9ace9569417b0b8aa,171,143,28,Africa,18,1639.54
5865c878d17248488d46bb44ea42d5cc,159,123,36,Asia,16,1082.03
58666bfe9a4542ef8d2b717a723c16ef,169,130,39,Africa,20,984.08
5866f83d13d144f6b2c7329558e3737c,345,302,43,Africa,15,1879.08
58677d3229d1479484def5dac299333f,356,307,49,Europe,19,1980.08
5869fd7f3a444673bde6db66c6ee247a,341,315,26,Oceania,19,2480.41
586b2f5e51394cfe8c8ac8c0d04e499d,247,222,25,Europe,16,1645.2
586c0eead94d4db89f7c8491c443a068,88,45,43,South America,20,619.62
586c409010584e8096d9015e863c9ce3,324,307,17,South America,21,2571.88
586dac7191d74c4889326db15b95b6e0,126,97,29,Europe,19,963.86
586e1168f3664a1a8e69b6fb97b238be,127,83,44,Oceania,23,420.99
586fd6a592e94fbab9cf8ee7806b2f8f,310,283,27,Europe,22,2469.15
587276ada2224dfa8bb8ca3ce98a5834,192,136,56,North America,22,973.63
58776dcb0156481793085a0726333304,60,35,25,Africa,18,534.3
5877e6c695b7444a9bf04635c72b290b,168,133,35,Africa,19,1359.94
587a12188c9b41a083edc4de8b6e6771,50,12,38,Africa,23,492.78
587e6fae0b434cd596b9d0e53f8b864f,119,91,28,Oceania,18,1099.8
587ed778a4a94421974be73bee9edf1e,357,319,38,Asia,20,2423.75
58801b6e69b14edaa6f8e9354c885b05,127,76,51,Oceania,19,480.57
588824cfe4e14b9c84184fa1e65eae9a,87,65,22,South America,17,693.98
588a9820788a409fad31ac743692ecd7,292,260,32,Asia,21,1715.39
5890548dc48248abba055da59e15f614,365,342,23,South America,23,2213.95
5890dead7e884eefae8210d3896b0c2d,281,252,29,Asia,21,2034.13
58937df290864e3390e1b4c70d9ebe2e,364,344,20,Oceania,22,2545.42
5893bf23c03e4e2b83dc4671ae3c770f,188,154,34,Europe,20,1597.93
5893d4d2fcb24c18a084180b1d0fa189,228,195,33,Oceania,24,1405.36
589412911cbc42b9998b3a2a76c5dc17,287,257,30,Asia,23,1715.4
5894c7abd46145f890022f5c80b3ee3d,251,198,53,Europe,22,1250.59
58993a4409474a2c9c23622506615002,361,353,8,Africa,14,2685.11
589bcf516f954463a2c4153dae3c8d04,77,45,32,Asia,21,780.93
58a07ebe17e94ab88835854fd41d6306,79,26,53,Oceania,19,241.09
58a1a3c20f0045aaa10c20c4c94126a3,215,171,44,Asia,15,1390.12
58a2425803a24f1ca9ec52214b29b826,364,361,3,North America,15,1857.17
58a243cbc28848208541fe6ea8a0984a,327,290,37,South America,20,2562.38
58a354916b9c4fcdb7af9dd28e709e7a,163,124,39,Africa,16,899.14
58a3739f16624ffd9c1fe6729287ef35,187,148,39,South America,24,903.43
58a42432de3942c390aabb6dbd541c8a,187,133,54,Oceania,20,1253.74
58a6beb6a50f42f8a6bb99ae8329a9b7,86,50,36,Asia,21,593.52
58a9bdb185234c32999a303c3f409c3e,280,231,49,Oceania,16,1229.52
58aa1de01108466ca38edfab8ad5286a,283,270,13,Africa,20,1986.43
58aa6257777b4054851b5216b6efe623,210,185,25,Europe,17,1997.46
58aab97c88f54ba680d5ce483ca62526,146,109,37,South America,17,838.06
58aacc5f49b0468abe8381d7d88a05ce,209,154,55,Europe,22,1249.23
58ae54d961474b93ab57f4a2e3027205,232,202,30,Europe,22,1587.23
58af542dc6b5466f9f9a6b378f06a8c6,365,355,10,Asia,16,2457
58b4b1a5a8ac4c0cacbd02eb910c54a9,239,206,33,Africa,18,1159.23
58b66204f2754568aa084d4d907fba92,363,348,15,Africa,19,2190.01
58b8432208e944068c146f71ec45746d,299,284,15,Europe,23,2652.57
58bc930878e74db99d15a449389bb9aa,81,50,31,North America,19,349.06
58bed1b6910e4c289871d7380d756ed3,265,250,15,South America,14,1718.82
58c0d7d0fa0a4ec6bb26da20bc68f02a,173,121,52,Oceania,17,1126.53
58c19fd696c14fa08eebabce6346ec59,96,71,25,Asia,15,899.65
58c3825d54334feeb3de9d65f703212d,205,181,24,North America,16,1153.48
58c6214a8a3b446eb5d993887e8bd776,350,329,21,North America,20,3268.15
58c657d5bb504758bc6a70b69a1ad0a1,363,340,23,Oceania,21,2053.36
58c7592d640148c0abec5e12c29e68fe,351,316,35,Oceania,25,2693.76
58c7831b02984115aebbcf69216c5b22,240,228,12,Asia,16,1537.49
58c82aba797b4fc4ab20bba888e7e1f2,249,219,30,South America,17,2204.28
58c8d2d87a6848cfb1ccf548dfa4372b,95,70,25,South America,21,671.18
58ca89615b724f88907cdad03c571172,364,361,3,South America,17,1950.84
58cb6d69a70e4bec9edf067c57d5f27a,90,46,44,Africa,19,696.4
58ccbc006b694a3aac1539ba4ef9f3b1,259,206,53,Europe,15,1566.93
58ceb21e80e64addbf0b41d913f11529,24,8,16,Europe,20,74.68
58d058abd10e4ddf92da96ef65944368,72,33,39,North America,23,515.79
58d091daba7447598abac024cdf37265,361,330,31,North America,15,3390.18
58d19383fde84b52b69061f3a0b06588,220,208,12,Oceania,18,1279.28
58d4087d8b114f74980893cab587998e,275,224,51,Europe,22,1544.34
58d533b324024630bc0009df1b5f3a56,253,213,40,Asia,21,1332.37
58d56efbf1ef4915a465e45bd026a76f,191,167,24,Africa,22,1356.03
58d5a7aad9604711a080852ce0672c75,172,139,33,North America,14,1151.34
58d6f54a1147460c88658a2adc0b5a90,168,115,53,Europe,24,589.03
58db8c02a2724a498e09914aa3fea356,78,32,46,Oceania,16,436.19
58dca924d2cb499486797b2c941022ff,180,138,42,Europe,17,1237.69
58df672971ea4dec91d3b5dc7e6752c0,222,183,39,Asia,20,1780.96
58df8df2eaaf4bacb457627eabd02948,364,345,19,Europe,20,2721.52
58e0dfbed89540e6a2f39be26e7bd3c1,358,318,40,Europe,23,2048.26
58e13613fce54a8787903eac0fc8b641,325,291,34,Africa,17,2392.34
58e19bcbed2b40c28deb677648841390,284,262,22,South America,21,1871.09
58e24d8288b2424f974c5685d7038b0a,135,89,46,Asia,20,1000.92
58e2d4c309a94beea39c90dba21ac4da,205,166,39,South America,21,1723.29
58e34370f287484ea7d6d1ae3e967039,313,253,60,North America,17,1928.4
58e3d98e627b4262bdd2d8f682271a0d,181,155,26,Europe,19,1359.58
58e735eb032441dd81816ed405e80422,99,50,49,Oceania,17,820.05
58e7e169027545e1b4d2401368fcb696,335,316,19,Oceania,27,2923.98
58e9a074f1cc47638d2f2801cc667928,247,197,50,Africa,20,1490.79
58eb399eb7c649f6a582fbc4b90e8c61,178,114,64,Oceania,23,1017.92
58ebd4ba67f94d2cb8a30475ba8c1fa3,173,124,49,North America,18,775.34
58ee1b09f6504a8eaa1f63ecaad9921b,254,227,27,South America,18,1339.88
58eec24d91af4f25a917cc9fa57169bd,348,314,34,Africa,18,2112.74
58f09da7532946d8a9243c943b2bef99,365,365,0,Europe,20,1825.48
58f113c0245b4fb38df1fece6d54fe79,359,355,4,Europe,21,1410.27
58f13db1365348c083a9104c3dd25a9d,288,249,39,Oceania,18,2442.85
58f13e36b46a4fed808a742f99f5a130,229,194,35,Oceania,23,1937.63
58f4831a484a4e0fa4c84c3b3bd9c357,96,62,34,Africa,21,985.83
58f6498a0e7849209fe349f16ebef3ca,205,169,36,North America,18,1742.6
58f69235db95460c9826ab5011a6951d,363,340,23,Europe,16,2961.59
58fb9923f01f460b908e470e74e889f3,116,91,25,Oceania,21,726.21
58fc4f3bc6c9433aadbbe61a8f387f0d,52,19,33,North America,23,363
58fe4a705ce04712beace712b8cebbe9,45,2,43,Oceania,19,277.3
59009e44e2d1471795f3a6810ca9f12f,293,246,47,Africa,22,1958.42
5900c538343445d9bd685c7ee9c44b9d,166,143,23,North America,24,1046.56
590248b4510d4870bd36793f9d3ee92f,309,280,29,Oceania,16,2470.69
5906d0e4beed422c98ee97724b29203d,260,235,25,South America,20,1362.07
590a43b616ea410c92b2b1127fb007e9,135,79,56,Asia,24,883.49
590a5fc477d6405eb868c9746939d805,269,238,31,North America,19,2252.93
590adc131c804eb39b637546fbfb5882,344,319,25,South America,26,2884.92
590c7fbc22124d79b868be8dd92fb152,78,46,32,Africa,17,638.76
590d775466f947378aefea52f036fa36,300,273,27,Asia,20,2105.16
591052450ded4320922417dddcd65f97,304,261,43,North America,21,2046.37
59127991619f480f9d8c5c52e1aa303a,338,312,26,Africa,20,2670.97
59158f94fb0e44bdbb5709c6ff4c2cae,170,122,48,Asia,18,977.22
5916cb379dad47f6b1e36f4d8c0c81b1,246,205,41,Africa,23,1763.27
5917bce926364bbf87f6fce873204879,314,278,36,Oceania,21,2195.16
5918ce69508d457ba471ce01b98d97a4,327,307,20,Asia,20,2058.19
59198cab5bac4db7b021ddf4f041fdf1,160,129,31,South America,16,956.03
591b5e3e84ca48cd8985f46d0f7b976d,62,26,36,Europe,16,341.8
591d18fa4d5843998f2ab70c7ed708ff,349,315,34,Asia,25,2265.87
591d5e69530d4ebaa90cde5bebd6a83b,224,182,42,Europe,18,864.83
591dc10bf71e41b7993dbe36c2509901,111,62,49,Asia,21,333.7
591e0f2625c544949753ac28fee832ec,128,108,20,Asia,14,1158.56
591e155f78554c37bfdd870276a3ca43,233,202,31,North America,21,1599.59
59205e175ddd47e7943a243b90658457,146,109,37,Europe,18,609.61
5920716e423e4560a0f8a8308fca099b,250,199,51,Oceania,18,1318.04
592197600b344809bcae18c2a63969b4,78,51,27,North America,20,565.94
5924347f72994d97a0fe9bd73a2eaf5c,182,147,35,Europe,20,1560.13
59246069d46c402090d479d6013671fb,272,243,29,Oceania,20,1875.09
5924b6dd247f4743ae2f6e5b7fdf87f2,183,152,31,Europe,20,1674.09
5928828ce40149efb2be4188225be46f,364,321,43,Oceania,24,2271.5
592bb69ba96b4a6190877bde358dda92,365,326,39,Africa,20,1886.06
592ccc6aee9549be82497d8b70dac290,163,108,55,Europe,22,1549.28
59304c2f4a764f618aebb917b86a2665,221,194,27,Asia,23,2449.7
593155eda6874be8a87cee9a16d6fb81,134,105,29,Oceania,18,1011.72
5931c72f4b3546e78a55c08f163ce446,184,134,50,Africa,20,991.16
59332290a3ee44b58dfcd82a7319b8d3,81,54,27,North America,20,529.41
593673ce236249309a83a467b2d0f805,137,103,34,South America,22,746.59
5936fc99586f4485b5fe59ecf74a6978,298,265,33,Europe,21,2965.46
59374c1626a640459df516d6e0475a10,105,70,35,Asia,20,732.3
593b001c25f74146b65494e1e07afc48,110,68,42,Europe,22,539.33
593d798e39c44770a43d5dde1ebdbce1,189,174,15,North America,20,1903.9
5940f6f377b34d7594471c6bf789f706,54,14,40,Europe,21,243.83
5941109fb6e741388847e54f6933b2c6,80,53,27,South America,19,695.77
594128d17ed7483c8fa55f1da4b26e8b,147,126,21,Oceania,20,1110.64
59415c8d99d8442f92839574617fe634,364,354,10,Oceania,23,2446.91
5941e13694ef4727a4447bc654f572d1,257,223,34,Africa,22,1582.38
594255b6765c45b88a328c7f5f3b738f,172,116,56,North America,20,777.59
594460afb1bd49e581618f5b7f677f77,133,84,49,Oceania,23,836.44
59477e05f5b14ef78c11bab6abf2c2e1,363,322,41,Africa,21,1588.59
5949788c037a45298f3f52b057730c9d,254,212,42,North America,17,1433.8
594a3342be244e8baf5f26ee6d48b9cd,85,59,26,Oceania,19,614.86
594b4295c13d4b6ba300176bf2c505b9,245,217,28,North America,21,1721.95
594d05f00eaa47d4b680178efd86b39b,298,264,34,Africa,22,1616.29
594dbd5d59ba4f8e86dacd8b6a7809cd,55,7,48,Europe,24,437.14
594dd4cd868e444181ee446b11695c2f,160,131,29,Oceania,16,1023.15
594def9995b54fef959343483f480420,305,264,41,Oceania,22,2126.15
5953a3d3ccb2469aba768c0ae45810ab,64,32,32,North America,21,680.83
5953c16ea67e4fcf84699caea321a582,285,262,23,Africa,22,2805.44
59541db526df49b89db542d41c06c0f4,317,288,29,Europe,24,2838.07
5955a0717581420689fd1c55d1897bf2,205,169,36,North America,22,1136.11
5957625901814d3d8d2f22e281bf8822,57,16,41,Europe,19,163.6
5959e993e03746559614c4aa347e1b2f,112,72,40,North America,21,894.34
595ac8999424426ab084ed9bd242f3ce,306,255,51,Oceania,22,1263.41
595e02a63c8f47c3a6747f5b22c6306d,89,46,43,Asia,20,618.84
595ff98c3f89462ea4504cbe840b89d2,209,153,56,North America,16,1154.97
5960057cff4f4d7086c92b66aa1f10a5,229,211,18,Europe,23,1243.9
5960d463fe434a9998e291d474836e87,241,208,33,Asia,18,1688.49
596122a61d8e4d738aeccd9a7899c158,218,190,28,Africa,21,1533.78
5961b9fe130b41c8a6a91e0ff1073db7,55,33,22,Africa,22,319.46
5961e85ced014d0f9443bbceec14d5a4,364,346,18,Asia,16,2497.84
596a814fdfa74363b3fc715d32612c4d,295,275,20,Oceania,24,1474.44
596b05b31f014e6a97d89af98dd9e420,66,23,43,Oceania,20,319.69
596cd704009c409b8832cf6ceaf684d9,322,303,19,South America,25,2426.19
596dd67b7054471ab88fa04a4f556dba,228,187,41,Europe,22,949.07
59710ef7884d4414a3d09209719834bf,121,81,40,Africa,19,1003.91
59724b661a8e43e1b1c4003c8ce5457f,263,218,45,North America,29,1513.97
5975513d33b145bba85089c95200d6bc,275,217,58,Oceania,20,1055.09
5976d60c79a543fba74bf2d0669f5c95,207,183,24,Asia,23,1903.39
5978112d9d5b4f9c969679ec0a1a2b9f,267,218,49,Europe,19,1786.07
59788b9af9654f1e99f217a04eb58669,271,252,19,Europe,16,2225.17
597a5d9ba375483cbef217077085bfb6,365,340,25,Europe,20,1459.25
597ce7fa041b405eac7efed9d66cbbb1,245,197,48,Oceania,24,1213.38
59804fd85e864e4191cd97c5df8eb683,229,205,24,Oceania,21,1515.86
598499bbbaf24ae3af5948a30d8b13e1,365,321,44,Asia,19,1530.06
5988be700fe24014875314baabb6bcb3,99,82,17,South America,19,693.54
59904c02101b4d3c8a610728fb5a97dc,365,360,5,Asia,21,2338.98
59906f7e52a9417fbd0c3343a553518d,216,178,38,Asia,28,1210.88
59978b8fd8c04e879e704f9cc29e78b0,365,325,40,Africa,23,1277.14
5999c8f41f0f4cbfaace9ba78213cd13,199,138,61,Asia,18,1169.01
599ba00c8f6e46d5a6feb6dd8ea05b1a,137,111,26,Europe,18,910.78
599e658950b54cefa4d43f639e67785f,341,285,56,Oceania,18,1875.29
599f091d7eb74d16b1e3f52d8aee068d,364,361,3,Europe,22,2059.86
599f4dad189644b78363ecbe298125c5,219,193,26,North America,26,2245.49
59a001a716d1448c8b48280f166c249f,189,134,55,Africa,20,793.88
59a14958a3c547eeb416b09df75c41ca,109,55,54,Asia,24,585.25
59a37d25faf4475ea8a0d9f53c9c8226,297,268,29,North America,23,2426.73
59a4ea575b7648dd93378b3249d9bf93,62,20,42,Europe,18,451.29
59a57a2b5aeb4b4ca8939f73ff7da6ea,361,327,34,Europe,23,2784.51
59a6287371104b288553ca670c0cc618,88,55,33,Africa,20,635.54
59a670adbce746a88366e262c64b9732,189,138,51,Europe,20,1265.07
59a6a77836614b8b8acdf255ee9839e4,210,174,36,South America,21,1549.92
59a6e4910c2a4844bdec33f1ad205bd2,308,263,45,Asia,21,1481.9
59a70ce57bd94bfc9b1c40cc303cf9b3,331,307,24,Asia,18,2158.54
59a76f48f6c74f23afad84519b95395e,242,189,53,Europe,19,1281.6
59a7e350100942e5a206c529c958f71d,69,24,45,South America,21,242.27
59a8146a24c641b29c456f03aa919ff0,155,137,18,Africa,21,1246.62
59a96fc35afb4376b3e4c51e6334a759,47,24,23,Oceania,23,330.18
59a9ac85998e4eceab973f081d9d9cac,153,106,47,South America,20,950.24
59aa43368c8e48dda5d7df71c044c1ce,362,331,31,North America,21,2846.66
59add79fa4aa4227a7f3c771ee095a8a,137,111,26,Asia,22,1304.9
59b1756a71834704b2df4b955c79ba3a,365,335,30,North America,21,2317.1
59b1fd3736c146118564b672462b0b57,259,213,46,North America,18,2053.26
59b242dd40cc44968b1ac83f8430fee6,182,130,52,Europe,21,982.96
59b31b5d82004b42b70674446055343b,193,160,33,Asia,24,1175.32
59b3fa1c213d4f34bfcf851851ae5ba0,125,87,38,North America,21,1048.27
59b4c858ad9d491296e387e025a999d7,227,173,54,South America,20,842.03
59b89805fdf04fceb23b8ae466d93619,66,23,43,Europe,18,263.12
59b910d6f759416ea8b5d235240faf0a,40,13,27,North America,14,141.13
59ba421955d24698b324498db5042356,43,16,27,Asia,23,237.63
59ba76a898f141438a5557d63a2e0cec,115,91,24,Europe,18,1033.43
59ba9c97a859412a83531198f8db190c,312,278,34,Asia,16,2662.08
59bb3e885ebf4be8914233238c58ad95,99,73,26,North America,20,517.54
59bb76953e874ca89a32f199e4e0c8ee,264,244,20,Africa,25,2600.81
59bc140516e6430e8d5ce9798186fe00,134,105,29,Oceania,21,915.31
59bc8be2da62470e96ea00aaa3bf9b60,297,257,40,Europe,24,1934.73
59bf93af585847b2968bfa20e5cd73f0,182,146,36,Europe,10,1401.01
59bfb4d2129643cfb09b13043a1001d0,294,269,25,Europe,17,2631.09
59c0e03300344d4b91f73a265e6d9e46,285,256,29,South America,18,2644.83
59c187a3a1864b7494f066be7aeb764e,309,263,46,South America,21,1226.9
59c2709323ba46dca6922947d0124add,261,225,36,Africa,19,1886.17
59c2df90e4354384929ed4415bf3ed7f,363,335,28,Europe,21,3160.29
59c4055dcad44edb92636ea648dc8fd6,50,18,32,Oceania,21,434.44
59c5239d512244d29d6dea12a174c97f,211,170,41,South America,21,777.87
59c567991beb4b1fbcaefd4ed64d3ed8,224,172,52,North America,19,1513.1
59c96d7dc2b3497c8bbde92ab0c15744,221,152,69,North America,25,556.44
59c98fe270d9458eb908fc8bff693a00,355,314,41,South America,18,2772.72
59ca14efe4a342668aaaab424498a605,365,365,0,Asia,18,1841.96
59cb186fd2c34f769787cd789754eb58,97,53,44,Europe,19,830.1
59cbb6a1b6524e27a52836aedac11e18,80,49,31,North America,23,651.7
59ccb066aaf74b108138aeb0b9825aaa,172,132,40,Africa,14,1528.58
59ccebfbb69846e4ba202ccc5b4075b8,150,107,43,South America,24,1110.27
59cd17d6bf8a459385e2e1ef6816049b,164,125,39,Europe,23,1227.61
59ce9c69c20749f9b525ad49daf9c9e1,116,67,49,Africa,20,251.2
59d0144f34fe4e9bbf213da6ff019e29,323,278,45,Oceania,22,1959.54
59d071dc829a41a480f8835dff597ba2,267,214,53,Asia,22,1061.47
59d33bfc5b604a0186c45ffccc5eaba1,280,265,15,Oceania,18,2819.54
59d42cacdb164adc845a33d5fb8094e3,281,244,37,South America,21,1823.07
59d64da8e11e4b2f9683525bfeb919c9,360,329,31,Oceania,23,2141.28
59d6b87fc9634759b41449fde18671cb,229,185,44,Oceania,18,2079.84
59d9375c83c1427695cce4898b437f2b,129,78,51,North America,25,441.46
59d9f2dea1654a03a9fa3e01b86b9aaf,212,181,31,Oceania,24,1110.09
59dda896861c4e4e90701885b15c9789,232,216,16,South America,17,1650.72
59de423ffe06475582ae7eaed0a057bd,283,253,30,Oceania,22,1601.75
59dece531e274b29866e12f3f26c195c,271,222,49,Africa,20,1736.84
59e67f84229f49e38a5a552bf363b68b,316,279,37,North America,22,1504.19
59e815404c944d8daab72d44e244859b,270,222,48,Europe,15,1232.74
59eb7c07a59143ccb5207a4dcbabca3a,217,193,24,Asia,21,1591.12
59ebdb0128594bfeb41ce1d43361dc92,72,37,35,Europe,20,678.7
59ece5a0f8ca47df8804269018d88ac8,201,160,41,Europe,22,1652.97
59f1ac8708f1435b9861f3d4c6787915,251,213,38,South America,17,1765.92
59f3d128bc4f40859a31d4b9647a2eed,235,192,43,Europe,21,567.11
59f5a724ee594e4eb0d78467b5704515,201,163,38,Oceania,21,1367.56
59f60627ce6f4516b27491d665ddef9c,62,21,41,Asia,26,333.87
59f7674bfc6148a199c740605336ba21,105,58,47,Africa,20,431.63
59f9f8d4809c43c4b00545bf3d3b7201,297,277,20,Europe,21,2616.08
59fc15c597fb4fbbb2f919d76ce9486b,179,162,17,Oceania,17,1603.89
59fe32b324bb44b69e9d13c295be1074,184,167,17,Africa,21,1658.68
59fe64b89ee4471099930aa34461ca2e,176,139,37,South America,20,1470.89
59fec4293fb54324a954b25e0a718969,364,362,2,North America,17,1286.67
5a00f29da32341159c50e842735b2029,226,163,63,Europe,18,1069.28
5a015d4739234e64b6a155a72b8af35d,236,213,23,Europe,17,1861.23
5a025932c06a40a4b8aaf95749fefb46,107,80,27,Europe,19,558.01
5a052178c90a4471bc10d187e5c94a5c,323,291,32,South America,20,2058.66
5a078231a28549a2b5faad3ecbe12547,113,85,28,Asia,19,912.81
5a0976a22ad3441abd6da41d28d89d78,365,348,17,South America,20,2476.19
5a0a27e199b34a5d863d0e018359a4d9,183,162,21,Asia,24,1303.62
5a0ad9e7105e46e393dc0a48b022cdfc,226,196,30,Asia,22,1514.17
5a0b3d97124343c9852979f1a3c8d075,245,195,50,Asia,16,1040.2
5a0c7df021de448d9f8031c96f9d7d53,346,314,32,Oceania,21,1843.72
5a10258d362443ac9c4adc87b412dd41,340,317,23,Asia,17,2345.68
5a1386b501bc4194a264e96407026f98,178,125,53,Africa,21,704.24
5a138b8d5d6c4f05a2d0819f0363a41f,181,132,49,Oceania,17,1196.3
5a13b1851e884701a59234e5c43de872,107,82,25,Europe,19,899.96
5a151362bd034577910ed1937aa50490,210,171,39,Oceania,19,2167.51
5a1676d85d8f455c8587fb29c6f4cb18,50,2,48,Africa,20,141.56
5a189b8ecf9a44be93380416833ba580,312,272,40,Europe,30,1967.79
5a196f857f6d4ab4b509237be819ca3d,172,146,26,Europe,20,1586.56
5a1f0d9cf3b6425dba05c9468df66976,172,138,34,Oceania,18,967
5a2209894e5a4688ad244dea988228c5,69,27,42,Africa,17,375.81
5a221a6f8c884c47bb5dba912aadc730,294,270,24,Africa,21,2574.66
5a235d242db6496c83c20b6562296beb,363,354,9,Asia,23,3960.36
5a24a9c678374109a1e29c4e4c797110,296,248,48,North America,25,2204.76
5a2943edcd2e44fbabad20ee933a575a,313,288,25,Africa,18,2158.76
5a2adfe23b264857a7595fa55b6491fa,361,357,4,Oceania,23,2509.96
5a2d58828f9641c2a8058f14bc0e0bc1,270,217,53,Africa,26,1132.66
5a2d9c6ea47f4cfcb98be2bc8e093821,365,336,29,Oceania,23,1977.05
5a2e1bb727b04f4c9ea2e34625abe068,40,15,25,South America,20,250.11
5a30acafa4b24e1887c60977fd907f7a,102,76,26,South America,23,606.53
5a3447469a2d4b6f8e6f0cb2fbddb137,64,38,26,North America,14,349.06
5a34d381254944889ba610e386415cd5,363,336,27,North America,14,1632.23
5a34ef0e73cd4c91be709bf7d3e41b14,361,354,7,Africa,19,3138.07
5a382673ef354f9bbcf97dfa095fb1ee,365,311,54,Africa,20,1879.28
5a3a28cf79f348fb9b1a55fc21a7889e,233,194,39,Africa,12,2044.42
5a3b3b524bb548a6a2c3b0aef4049300,300,266,34,Africa,18,2509.87
5a3e3644e9b64849b85d5a4687c36835,110,87,23,Asia,25,866.38
5a3e46c58d044a018770a11efc1a1655,96,67,29,Asia,21,431.95
5a40605cba714853adf2746ab4e9ae97,196,174,22,Oceania,18,1305.36
5a42b987af4646dcb7befb2e61ff5a5c,356,313,43,Asia,20,2241.23
5a42e12775af4a87a07224c9e1c47809,57,9,48,Africa,22,588.77
5a43879290ce4bf0ae7963c26bc6219a,130,69,61,Oceania,17,756.35
5a439395f7f94c7f9903495098a75aeb,261,203,58,North America,19,1980.98
5a448db4c55748898b0508e419699308,265,225,40,Oceania,24,2264.05
5a459e37f8bb4e76b153f6d3225a2781,286,268,18,North America,19,1486.17
5a497be8d82e4859addc25b19818b46a,272,220,52,South America,22,1298.21
5a4a5d35b76f4553aa1dfcc4a25b3496,294,257,37,Asia,19,1897.61
5a4b1c8ee99140189f78e14bda4bad7a,177,149,28,Asia,20,1696.83
5a4d667315a84309948e6f771eba9bbb,127,104,23,Europe,19,554.78
5a4e9552cf7a41f5b2958555a08753f8,63,12,51,Europe,21,144.46
5a4f848ff1ed4a9fa6ea9110ba50dcbe,118,67,51,Asia,23,638.35
5a5198ce987043849ffea4e8e350429d,68,31,37,North America,17,458.27
5a5468b6c5504ec7aa2ef49687095f90,153,100,53,North America,25,893.36
5a5541d5a0164d35a2a3988e0fa61a26,174,150,24,North America,20,1253.05
5a5603668b65484e9a14fac643b3a0bc,176,129,47,North America,17,1398.25
5a5847c026e744a8a9e0f355d30aba53,290,257,33,North America,22,2196.76
5a5a26d1dac5457caac635f165c5e205,216,194,22,North America,17,2178.4
5a5a83bb825946da8456e9cb2fde23b7,333,294,39,Oceania,20,1601.17
5a5abce772164a26a1814157c23522c7,191,157,34,Oceania,13,1272.12
5a5c79ae535b4f3789422cf9fcc7cad0,128,78,50,South America,22,813.86
5a5d0f5fb8e947f294984ffaf3cf3097,218,188,30,North America,19,2394.1
5a641c732c5542c193641104bdd1463b,220,176,44,Africa,16,1506.01
5a6558803a014128b34d0d4019508b6d,204,154,50,Asia,16,1013.33
5a666dd172dc45328b9fec2ea8184178,127,73,54,Asia,23,593.65
5a688d9b53b3456fadf0a74f9a4c6fb6,101,87,14,Asia,23,599.67
5a68bff47d5b4689a6ca6b84e5af271c,209,168,41,North America,21,928.96
5a68e0b68ade4fa9bbf52ad5d539db2f,137,90,47,Europe,19,1096.96
5a68f2c152de4176bd83ab2aec5eb2dc,200,173,27,Oceania,16,1298.23
5a69788a9e0a4c43b8f693cbd8948a54,297,240,57,North America,19,1001.22
5a6a1d11fe9c40b7b92f7cdd72e66852,332,295,37,Africa,20,1795.17
5a6a2dd6f700439d898268fe33b17b7d,326,300,26,South America,20,2925.24
5a6b59137cb1416d8aa66e41e764a41b,322,279,43,Europe,20,1635.39
5a6eec9978224670bd9e487804de02e6,276,231,45,Africa,19,1575.05
5a6fce12421e4d35bc07d2adbb10d06a,146,128,18,Europe,24,1256.01
5a70197a65fd41c493f49ebded50756f,115,92,23,Europe,23,502.55
5a70a5064a8544feab7c32613f44c306,341,297,44,Asia,21,1571.42
5a759587caae4762b816669c2115a94b,157,123,34,South America,19,987.33
5a76b50ff91340cf9beebef6c07bb911,127,73,54,North America,23,427.74
5a772aacec1848c1a9f9dbb56edb3faa,348,332,16,North America,20,1946.19
5a789b5c396349dc97e953a00f6a5cbb,288,257,31,Oceania,18,2297.69
5a7a6ffa4c6348da8b5dfb9ae481a8cd,222,169,53,South America,22,691.08
5a7adabd39a54e1597490057e2d851c7,133,102,31,Europe,19,1543.9
5a7bb1ea60bc4019938f274f3fec4a8e,365,340,25,Africa,23,3003.5
5a7c043b99f841b29f417a3adb3151cc,207,154,53,Oceania,23,1270.57
5a7c7ea6491340f083aaab6af3c8eaa9,130,89,41,Oceania,19,746.95
5a8071c0b9a44fc8862d4a9e6ad71464,290,270,20,Asia,20,2123.71
5a818932711c488d8eb733ddad1a3fb1,315,274,41,Europe,20,2345.07
5a81900a37a041f2a4abdc0bb4701489,109,60,49,South America,15,804.17
5a860a134372473f87ad48c2fb0f26a4,142,94,48,North America,24,635.25
5a8627bce02b4f7289e3d6f4fc41877a,57,16,41,Asia,14,146.83
5a88aebf97624b308d1897d37769d409,260,228,32,Africa,18,2026.3
5a8bce9e5cfc45aaa39704efbd61b191,82,50,32,South America,22,479.26
5a8d16091ba544e4986c052a5c79ada4,364,340,24,Oceania,23,1704.54
5a8e57e63abb4e6badbc6acc011e6fc1,365,338,27,Africa,6,2587.69
5a8e722466b1496f9c303c2cfe51d311,180,144,36,Europe,19,882.49
5a9124ed551c4630a3d1d13a28345f14,144,99,45,Africa,22,1232.33
5a947933ad8842a5a9094e96e22a4609,175,122,53,Asia,19,1027.13
5a9522d759f5401aac2c852e25ca76e6,308,288,20,South America,23,1831.92
5a96f92072d94c24be401b58c6eeb391,70,46,24,Africa,23,529.18
5a9ab8ba4c3e4295afc1f50dfe24ed04,281,256,25,Oceania,19,2733.56
5a9c2c31b3544460b10cd0d2d753656d,183,160,23,Oceania,18,1572.75
5a9d3c24eeb84b5aa0475aa6b4cdce62,277,234,43,North America,20,1783.98
5a9f314e014c4d33b96454bb89588247,68,29,39,South America,16,500.06
5aa13d4dd0204ccbb99a4b6c056548d5,307,283,24,South America,21,3042.34
5aa20357d59f43df903783ec7955889b,323,286,37,Africa,15,1865.77
5aa4b8e7b723415ca98f269e629ff5dc,308,259,49,North America,16,1213.67
5aa5414620cf4037bad32d216b1c1179,215,186,29,Asia,21,1524.26
5aac6dc421024caaa7bbb4bfa109d017,198,155,43,Asia,21,1106.55
5aae69aaffd64bf0a22649de833fa09c,348,309,39,Africa,22,2623.83
5aae7b2f0c1e4cf0bf206a6e470a54a1,315,282,33,Oceania,22,2900.57
5ab2b56383ba4eb6b4e746c26d912db7,227,202,25,Africa,21,1408.63
5ab4843932bc40229699b4e9492808a8,252,218,34,North America,20,1632.95
5ab4db1ef87c4e58963b5c78de01cda7,336,317,19,Africa,21,2539.35
5ab5213462924f3db80ab4920a71b26d,332,300,32,Oceania,22,2053.09
5ab59845f6e940f39f2d38dcb0b1934b,365,360,5,North America,20,1246.29
5ab714dc95f049c0bb9a5294c476763e,244,192,52,South America,21,570.09
5ab7234d91d14888830c0b2c0e6fff09,75,22,53,Oceania,22,302.44
5abc0bca0225472ebc87e4c0e786d473,130,96,34,Asia,25,825.89
5abfb0ebc4f64f3e9757b96f77416e3e,364,338,26,Asia,23,1514.77
5ac03e38735c4b5ea10a82e64fecec16,327,287,40,Africa,20,2094.01
5ac05326c3b648b2a3a09830caeec49f,235,209,26,Europe,22,1963.1
5ac1119952284e268892faccabbdd65f,357,328,29,Oceania,19,2181.19
5ac166fc83b248fea6187803225561bf,261,237,24,North America,18,1988.99
5ac1934f94f747a38490dfd6411681ce,193,180,13,Oceania,25,1515.39
5ac635241f7e43d28283c203e1c9a5c3,239,213,26,Europe,20,1606.65
5ac749f5e6204eb7902b83e4feda5f33,316,295,21,Oceania,23,3025.93
5aca39700cec4f068c93e465987697fc,365,341,24,Oceania,21,3109.3
5acb0023e79e4b4b8aaf46136699941a,58,15,43,Asia,15,473.42
5ad0adda58514428b4a9fa357ad6aff5,208,168,40,Asia,20,1265.26
5ad649a1b7f24c5a9e7153fd5d4bd78d,353,301,52,Asia,17,2025.25
5ad9f14e79ef4b3db4435072a50772af,96,70,26,Europe,19,751.15
5ada4a23fae54cb3ae393d52656128e4,128,88,40,South America,18,664.72
5adcf64434f1464daf7db9fd57aef483,125,94,31,South America,24,1051.01
5ade4678c9044285b582cb415181774a,67,45,22,Europe,20,562.65
5ae044636acb48599045b8de3caada49,249,191,58,Africa,19,1153.84
5ae07e4858694cb49fc593bb81b6af01,231,180,51,Asia,19,1135.64
5ae1b166b23141229480322e09e1d14f,219,171,48,Asia,16,604.04
5ae446317cbe4333b77240758a9c2184,264,212,52,Europe,25,1693.03
5ae4ab25b42b4e3a94a57dca70915f8c,151,102,49,Africa,18,902.37
5ae71f0f187a408facb276e37fc18e45,91,62,29,Africa,26,550.2
5ae91c5361944679860ac9d0c344654f,57,6,51,Oceania,19,96.44
5aecdbcbae974b99bae9d636f16b29b8,324,279,45,South America,19,2572.48
5af03fad0e464673a6652125329bb085,63,23,40,South America,20,421.28
5af5722da1a5475d850db8842092363a,136,78,58,Oceania,17,711.9
5af59623c17b433d9a028ab692a21d5f,243,213,30,Europe,20,1324.29
5af7cf2c2ece44ef8a17d218f1b1fb97,37,12,25,Africa,21,147.58
5afa3aad56ab4901a6e72b1142741a7e,322,289,33,South America,21,2482.71
5afc5916e3ad4dcb928e15a95bea3129,161,134,27,South America,24,1509.52
5afe62eb3fac4b77bd1de7d5729731e2,201,179,22,North America,20,1707.92
5afe8cffcd9c44b98a12cc6a47c3bffa,216,167,49,Europe,17,1068.8
5b00c94291b6446ebe963096ac25976e,363,357,6,North America,24,1688.32
5b0253056d454719ae19ea6438a7ec1d,362,345,17,Oceania,18,2016.05
5b03155bab584976840b0fd708b4ff64,134,116,18,Oceania,22,849.69
5b04bff131ae4915a1afad600cbb9301,216,191,25,Oceania,22,1276.16
5b057966ceb04a6fbe1386f940e34aa4,357,316,41,North America,24,1899.28
5b0759c79ebf45d08079180bc079dc58,364,361,3,South America,16,2545.05
5b0a4ab228e94988baeadc5e01d16cf6,174,135,39,Oceania,22,1262.69
5b0e5040cb2e4f6b8b45393b58a9c97b,43,19,24,South America,23,349.2
5b0e7bf05fda492cb922ecaf9cdf5af4,183,133,50,North America,15,503.18
5b1080327cba4439894b77ec405e84c3,365,347,18,Asia,18,1939.38
5b140dd5ae104f04812b8f911d9542ec,177,130,47,Asia,21,1442.27
5b141cfd9b6847e88cd83c1d4ddc70f6,174,123,51,Oceania,21,1063.87
5b164e9c4fbe4b048f56074bd2ff8524,336,285,51,Oceania,19,1622.43
5b17609da0d24039b6f6d9a3808510a3,134,101,33,Europe,16,1598.11
5b184a29eee64328be330acd8ba9134f,167,131,36,Asia,25,1215.04
5b18e4f84b824912af94eb420509c626,127,105,22,Oceania,19,988.33
5b19398e3d274eeda648194f0e189367,361,356,5,North America,26,2183.42
5b1ea81f28de410fae83c72c9caffa9b,316,286,30,North America,24,2972.91
5b1ee0f0a33f405688d01eef6eaab438,213,170,43,Asia,16,652.3
5b1ef6fd993f45c4a2c710cb6bb1e5d1,163,119,44,Asia,20,1145.9
5b2090505ffb464d8614b3abd39b0b43,114,71,43,Asia,22,623.56
5b2094c35d1e406d9c40128d04fbaf16,140,113,27,Europe,21,1222.47
5b23565f7cbf45b895aeee09f77b97b9,294,242,52,Europe,22,1697.18
5b239ffad55c4a688f42d2df164337ff,113,83,30,Africa,16,781.29
5b244cd4501c44e29f03a04a22244553,101,53,48,Africa,26,785.35
5b24c80b922e41589f8fb0054b51f966,242,206,36,South America,14,1939.59
5b2a017e98a849a9b2c2d8ac4877bdcc,273,240,33,North America,15,2344.16
5b2a71c7591548b39055f1e89812f0fe,62,38,24,South America,17,251.58
5b2b4ed88840453085204713098caf7b,158,115,43,North America,25,898.26
5b2bd4554c234bab94173ed37faf9b8e,57,38,19,Asia,21,617.92
5b2d5ed5c80d4c9b92c97ab3b6a61843,240,198,42,Africa,19,1639.92
5b2e8a9eff9d49ba954d22393f182c96,338,286,52,Europe,19,1557.68
5b303bdd61e84ddfaf04265cf613d978,75,24,51,North America,20,410.08
5b30dbd9d23f49bcb0af989e414f75b3,177,145,32,Africa,17,1668.71
5b3173b7d31f4739ac9fe286cccdc822,197,157,40,Africa,23,1327.64
5b33047cd7554aff9c97fa72a14b28e9,146,112,34,South America,21,1119.18
5b33aefb7e6041de8c8995e4b0b80956,365,344,21,Africa,20,2354.93
5b34b3e935da49d58647c73f97e19366,192,146,46,North America,21,1801.84
5b367c37b5a94106b6d3e7260a84d9ac,42,5,37,Oceania,18,179.6
5b36b09720ed49b990976152e7a8851b,105,61,44,North America,21,579.31
5b3a2fae3c774a15a99b09cab97ecc6c,365,345,20,South America,17,2838.81
5b3a57183802470fb74087a52935ca75,354,307,47,Europe,24,2005.45
5b3b3de9141e4dfc82bff962c44d81d9,272,218,54,Asia,18,956.69
5b3bcb46ee474218bbf958a452fddb16,359,319,40,Asia,18,2347.05
5b3bcf8a734343d3ac2b93cecdff888c,361,335,26,South America,20,2239.43
5b3ef19fe41845948f385af1dfee1931,123,75,48,Africa,20,773.11
5b41979f9f78453ba459c75766c098b4,314,262,52,Africa,24,1785.37
5b42b67f35a745039ceca9c43e76ac62,257,201,56,Europe,17,1013.49
5b42c621ef044e3e883d9e4261ea3fcd,364,340,24,North America,23,2660.33
5b45cf464911406f88c13d821ee1efcc,118,94,24,Africa,21,1011.6
5b48b494337644baa2baa14e40d81439,82,64,18,Asia,22,499.75
5b49fa361ebb4a28b39ef55b2c2def8f,154,101,53,Africa,23,873.98
5b4b466762fd4da3b0ad8ee54c90805d,61,11,50,Oceania,15,182.6
5b4e897dbbc04cc49b2f085e6eeeb116,365,345,20,Asia,19,1949.12
5b5003d9e96e40c29e892005aa7ca10d,80,44,36,Europe,22,718.12
5b50a96a09f344fcaee574f1a7236ef9,251,199,52,North America,23,719.31
5b51d064450448bbaf2c2edbfa28319d,213,186,27,Asia,19,2112.09
5b55056815d0409291d492a2c5680fd1,364,343,21,Asia,24,2072.46
5b551142c8974c02ba5857a6a31d62d8,48,22,26,North America,18,273.25
5b55253ce2814064b2f5ca44f9916284,359,313,46,Oceania,18,2442.38
5b57328810b342f0ae12470460fdbf6a,66,21,45,Africa,14,302.7
5b58149810c0458ea04b664b630ffbb9,113,79,34,North America,22,750.06
5b59a9e5f3e4432296a0191e7b189126,127,89,38,North America,15,905.4
5b59ae814f7e40bb85c175743733be40,114,57,57,North America,17,509.59
5b5da597487949eca9d5d3497dddeae2,364,355,9,Asia,19,3378.38
5b604b20317a4fbfb745858325b1e02b,197,180,17,Asia,23,1354.4
5b6123cc353b4fb7be224802b896170f,365,330,35,Oceania,20,2034.87
5b61ddbf81584ff19340d4fc83e31bf7,216,186,30,South America,21,1065.68
5b64fb7e84754d789ade565f33a7733a,202,165,37,North America,20,1111.52
5b664c6f9576486f98861dae45d9ab32,156,104,52,Asia,24,647.02
5b66864e67a44736a73259783c1f1c4e,336,280,56,Asia,18,1519.43
5b6a51e4dabc40cfa51ee482b8ee0ae8,219,192,27,Oceania,18,1802.79
5b6aa25c5d604c4b89c339466309173f,284,263,21,North America,20,2366.35
5b6ac60f7ffc4254a80a73fe318e962e,175,137,38,Europe,24,1508.2
5b6acb6e97e14f9cbcca3d4da9bab23c,176,147,29,Africa,20,1272.17
5b6b49621689467798255c9937f22800,199,163,36,North America,25,1116.48
5b6d7daf0117437fab09a6ce0062f194,60,34,26,Asia,17,362.7
5b6e5487d3b74437a04f2673672d584c,154,112,42,South America,18,1233.92
5b71379916734b67ad8c5f05beb71526,262,212,50,North America,25,959.61
5b78f603181a4433b8d175abb6d29630,217,178,39,Asia,18,1174.67
5b792353a61e44adbe1b279c581f4e2b,132,88,44,Asia,22,1025.69
5b79629673934fc19771d39f486349bc,160,112,48,Europe,20,1474.52
5b7b5d8d36f54cca835facd738459687,145,105,40,South America,21,1119.35
5b7b6d8cc3744e9c86bc35bd17af2d0b,365,349,16,Europe,25,2181.71
5b7b875da8f64ae4834363adebc58b6a,130,105,25,Europe,20,1040.04
5b7f1873c57e4a598b9e6e25c692cd04,69,28,41,South America,17,610.3
5b7f9449a921453788e53738f6513a08,345,303,42,Asia,26,2138.92
5b8144089a544cea97988ebe921b97e6,310,285,25,Europe,21,2174.05
5b8561eb75d246b7bebc307d97eda19c,313,262,51,Africa,22,1270.69
5b86b30c717b4b96bbff8ef311a80475,188,171,17,Africa,20,1406.35
5b88e34da9b04791af60c0cbd8fbf05f,104,46,58,Africa,18,416.14
5b8927f3c3234edd9c3daaaa0fa9ec58,58,37,21,Oceania,17,585.81
5b8a31469bfb42a9968f464810fdaefd,308,256,52,Africa,24,1738.1
5b907f12e28f4088843d4002273fa516,78,38,40,Asia,21,861.18
5b920dbe820a4bbeaffd6cd6ad796ace,240,182,58,Africa,21,913.21
5b935f38af984a3abbad02a484a87af0,166,134,32,Oceania,18,753.49
5b95dc76126145ddb8fe068aea1227bb,176,135,41,South America,20,1455.33
5b97856c48904295914732ab901fcfef,88,56,32,North America,22,761.39
5b99ad43a3224829bfff4997cff45848,210,188,22,North America,25,1720.45
5b9af127732b4f9cae7a3ab8a54169f1,128,96,32,Oceania,20,988.75
5b9c470a7c504e7ca63f1b6c4727dfad,365,357,8,Europe,22,2426.87
5b9dd0caff844d2cb0ac75b37a8bbe3b,45,3,42,Asia,22,253.97
5b9f78e507034447bda7e4fdddcf14bb,106,52,54,Europe,18,526.28
5ba044a8323f4f1aa07e77aed73e6200,326,303,23,North America,24,3132.58
5ba3783319fc41a8ae60db5aed4ecadf,233,188,45,South America,17,998.85
5ba52f65132e4062b0279c3a8dc1f7f9,262,217,45,North America,23,1677.59
5ba538e750b64665961d51172af5e2e2,247,205,42,Africa,21,1670.37
5baa5a46a09e465988fe8600af67f4d6,218,198,20,Asia,20,1657.35
5bab03cff2184ffcb30ec52c69ce36d2,77,28,49,Oceania,17,141.94
5bab1970f99d42c7a1291688131f991e,300,273,27,Europe,14,2268.69
5bab222d725c40eb8d1be876107a0fa4,277,250,27,Oceania,21,2353.09
5babb156829041dd8cc0fd358e5ea018,86,51,35,Asia,20,470.86
5bad5d9f5ecb41c3bc6b2df0ef503175,303,275,28,Africa,24,2308.42
5baddaa8ae714750b5cfba0630bf73b6,238,204,34,North America,25,2285.92
5bae1885f95242e9ae241f6b1e6e0249,203,163,40,North America,21,1421.36
5bafc112d8564424a97100f09e34067d,174,139,35,Asia,20,1285.1
5bb2193bf1c1468bb1cf5d24f433c0e4,66,45,21,Africa,18,862.75
5bb24a51d41b44dbbafa4b2f54cf3e32,326,285,41,Asia,17,2057.92
5bb3c6d6a0d946269a0291ac40d1434d,231,198,33,North America,17,1392.69
5bb603c621ae48cd801c24511409b5e2,136,94,42,Europe,25,907.66
5bb8887994054989af2e6b814ad2ef7d,96,42,54,Europe,24,468.44
5bb8e81c5273424ebe26057dc8d561a5,241,198,43,South America,17,2123.14
5bb9cca254ab4b0fbb082f4f9ae9514e,58,16,42,Africa,22,306.68
5bbd773a43b2439c923f1ee22e9d521c,364,359,5,South America,17,2055.74
5bbe50b84f89451aa0007ca66774d169,174,131,43,South America,22,1225.7
5bbe81e917e54aaa905bcad0ff37504c,365,339,26,Africa,21,2563.75
5bc170d2184e44768b38aff9395bf1a0,266,243,23,Europe,20,2248.66
5bc1f0455e3f42a69c98e9f83ace385e,261,203,58,Asia,17,1247.22
5bc2a2a289d346abb7b503418152d183,91,54,37,Africa,13,553.62
5bc820a632d1493991e4e1a87f25d771,94,67,27,Africa,18,997.27
5bc872759ce04388a95f6f9a3628544d,91,69,22,Africa,20,715.07
5bcbba9671034068be4c682f983518dd,355,322,33,Africa,20,2428.51
5bcdb9a238884feebd695539b07bba82,322,278,44,Africa,15,1251.55
5bcee26df0014a12847ab2a88d13e1d3,363,338,25,Asia,25,1509.64
5bd219fbe9bb4eaa9a1c441d65951f67,95,69,26,North America,21,582.23
5bd3268eac23468dac29f5228343dada,174,152,22,South America,22,816.9
5bd351b5fd564873ac8e08c35c850545,75,46,29,North America,18,838.85
5bd3d0b9ce21480fb3f50c786b697010,218,189,29,North America,15,1800.33
5bd4f92bb7c74e048fba4a86a4ac6fdc,300,248,52,Europe,22,1335.63
5bdc8a9f96564731b8b212d7afe27fc9,52,30,22,Europe,17,300.21
5be7361f0e964b6c886c68703750df6c,329,299,30,North America,20,2489.69
5be79a31ef65426cab0762472204d5fe,273,251,22,Oceania,22,1876.83
5beac838da134428b4cf2ffaaf93ab5d,270,234,36,Asia,16,1039.22
5beb163f6090442d8ccfdaefb187e32b,365,351,14,South America,26,1675.31
5bec346111d045208e495f7d6b006548,228,212,16,Oceania,20,1674.86
5beda96c7d5e4f9284fdd85eb2b6c97e,281,253,28,Europe,22,1705.93
5beedc7ae28943c7a8265a9b7eb06254,188,143,45,Asia,21,774.92
5bef170f844f42df941760f8f647eb74,115,82,33,South America,20,790.84
5befeeba09c64555b9e7506a603032cc,28,7,21,Africa,18,296.39
5bf06831c9534de580a4bf5d5035fa29,356,324,32,North America,21,2602.74
5bf0f0eca98246dc8322204207a0a361,364,362,2,Oceania,21,1868.4
5bf1d768b01d423d9770f443a3921d33,364,336,28,North America,20,2602.71
5bf26b18d2624c54a9efece9bb84f3e8,166,140,26,North America,19,1119.45
5bf516c92ea440f2b90c022631b2e38c,365,349,16,South America,16,2143.78
5bf66787ac6b4738aa2cd4d569e843d8,78,35,43,Europe,17,449.59
5bf75c0f222c4f0693590ca62f117310,95,46,49,Oceania,24,686.4
5bf7d263d9ae4af4a027dab1a4d73387,40,20,20,North America,20,329.45
5bf8d2cfe3024d05a001bdf318f08657,245,184,61,Africa,23,1363.16
5bfa7f284b564b89ad0a559ba184af21,95,58,37,Asia,21,640.73
5bfae8b37acc47269b3b1addab00aa10,252,200,52,Africa,17,1357.31
5bfb0b4c13e54527b105f8d3a3f3b750,67,33,34,Oceania,21,459.69
5bfbf820afa94b30b66f0657e406b93e,227,215,12,North America,26,1938.83
5bfc16f644824093993e6b748af7b79a,102,89,13,South America,21,512.09
5bfcbd74fc4042dbb0b2a24e1f7ef528,146,91,55,North America,21,1255.54
5bfd84d9264f4fb0872ed762d691df15,288,260,28,Oceania,20,2020.86
5bfe1f1bf423432d8bc13bb04d2e7894,289,251,38,Asia,18,1504.65
5bfe347412da4f3884f65c373084be2d,342,298,44,South America,17,1830.56
5bfe88a553ca4cfc8e724f139dcace58,268,231,37,North America,21,1491.86
5bffbc40049a4108aa1dcda882c190c1,184,137,47,North America,20,642.39
5c0007cd53ff4dd895f29dc269185d60,343,306,37,South America,18,2435.22
5c00fafe95954d3fab52eb571ef50bf3,287,238,49,South America,31,1530.6
5c04c702b5334035bf0ff93cc07e6f47,325,299,26,South America,23,1683.44
5c0669378db944d9a62e0d0e4531857d,170,115,55,South America,18,610.77
5c0ba034487341cda289fbc667c2579b,206,168,38,Africa,21,1816.36
5c0c8b2e037b4235b41f80a3e1439439,365,323,42,North America,18,1711.45
5c0d04646bc44011921f30473d1ab7af,35,16,19,South America,18,160.67
5c0e07049eea4d71ba65e37e3fe9922d,153,117,36,Africa,20,1214.68
5c12efc74f664a809332b839ee3699da,101,60,41,Oceania,23,606.83
5c12f05c9d2a4ddda27bebf51d80ea8a,280,231,49,Europe,20,1558.85
5c1300976a7d4ef8aafec4cef6e3331f,365,326,39,Oceania,16,2274.83
5c13118e175c4341aa75aff73e05bbaf,364,346,18,Africa,15,1629.93
5c13714101f14d549e89ca520ca63a7b,51,21,30,North America,15,392.97
5c139c16228045ecbd50995e55cd71cd,292,267,25,South America,23,2400.17
5c14315f439e4ed598c71e96734fdc82,154,116,38,Europe,25,805.56
5c151fc953604f888c27209e35e33940,147,113,34,North America,19,603.46
5c168742008b4fd68847551e81716697,142,118,24,Africa,15,369.86
5c16a5fd44344bec9d49683ecb6bcc73,365,354,11,Europe,15,2386.54
5c16b1ed39e24dec9a47a619ee4e5b64,290,270,20,Africa,21,1988.99
5c17c94d95da4156a675148d2169e311,297,245,52,Africa,22,1726.97
5c17ca193b004b10b1053edb7433ca50,153,113,40,Europe,22,1042.97
5c18f040bd1941cd8373899cc5ee3809,193,156,37,Asia,19,999.83
5c1bf21da3f2411cafb77184dccfaa29,153,117,36,Oceania,20,919.49
5c1c790903c1481ea743a14dc41e333f,188,140,48,Europe,20,938.59
5c1da15e6f784520a3ac6a92d0134b15,365,365,0,North America,21,1630.43
5c1f7bcdc7174615af080e880cee9127,365,350,15,Africa,24,2056.39
5c20746ff6bf4e6d84e8e3444829d5e9,210,164,46,Oceania,17,1189.78
5c22761699de4d14b2c4c50d39c2f0c3,76,57,19,Asia,23,1221.05
5c25103fbace467d8cda0f437dc69bd0,280,225,55,Asia,20,1147.99
5c258c0a62364980ba5fcf354ba522cf,331,313,18,South America,19,2876.68
5c2a23d88c96462090d07863fda34fe2,63,14,49,South America,25,523.07
5c2c0b8a0f1d4870927fd01cafecd25a,133,91,42,North America,20,1028.72
5c2ca2b7403a43618a070b2185122346,236,207,29,Oceania,21,1558.56
5c3054967ded49b08533199753d945a7,245,191,54,South America,17,991.28
5c325e821fd84fe3b1109978bae30f27,246,202,44,South America,19,1209.4
5c33ae43b6ac454795f262d5f8aec209,74,24,50,South America,26,180.95
5c34cbd7ec004d2695037a917596daa6,48,6,42,Europe,21,207.92
5c3507594523404599320606212eb454,215,179,36,Asia,22,1266.17
5c35bcb643ba4e93b4c66831552672f0,97,59,38,Europe,21,1165.21
5c35d1aa6a0b47079db6a30590f9e433,277,261,16,Oceania,17,1700.56
5c37970f6dc84ab8b7605313ab6114a1,48,6,42,South America,24,268.68
5c3dc2318c3d444ab9a24485dabea422,237,188,49,Oceania,21,933.19
5c3e7dcb0d394a66b3a11a0eacb8b609,289,253,36,Oceania,20,2385.6
5c3efee01ba64235b7b0c4628c9db59c,36,6,30,Asia,18,20.08
5c400f4d3767455ea8207265d44aabe5,293,270,23,Africa,20,2885.55
5c40f958ba5e461182efe4b8d355a9de,304,255,49,North America,19,923.79
5c41d7a944e44243b9f3ae39e9c8cbe5,225,183,42,South America,12,1118.91
5c421d72a43c4932b6723d44a4ba2dde,187,136,51,Africa,16,1425.63
5c4587d81bbd42309b7af4273237ec24,82,53,29,Oceania,19,985.1
5c47d7a8868c458296a9550e6320ce58,131,70,61,Asia,24,605.51
5c4919c7568e46adab6d0bfb75aaeea8,240,216,24,Asia,23,1943.03
5c4ca3f416d844389601f9295e5881fe,151,106,45,Asia,19,1014.39
5c4cde0705c7457592d4b80d8fc362ba,180,145,35,Africa,19,1492.4
5c4fbf17326d44b5bb167a0b2c6a4f90,45,6,39,North America,18,216.83
5c502e5ba50a4c24b37f97c3b7251f95,298,247,51,Africa,23,1111.91
5c52828581b44b728b30df1d027d5d0f,176,138,38,Oceania,17,1093.34
5c5312f515704313965808acb402c73c,335,310,25,South America,26,2652.01
5c555cf37bb148ff8a2ffe6abb753d04,349,308,41,South America,21,1694.29
5c58322691674c35a4905e2d39dfa732,106,68,38,South America,20,580.45
5c5a7f75b4a843dba717ac441ba39807,289,245,44,Africa,24,1062.09
5c5c417c83974a03b792701d2a54bd4f,194,147,47,Africa,16,1028.8
5c5d1f7ef6e641a395f395c96909a2f7,334,288,46,South America,12,1849.32
5c5dd5b2007b489e9e97fccf5d295a90,335,300,35,North America,22,2298.86
5c61a14369234135b0036a1a0db969b7,75,43,32,North America,17,679.81
5c635fe363944f86a3d9b37504553926,354,321,33,Europe,19,2996.14
5c63f720b3cc40d49e2e33f824b7492b,365,339,26,Europe,21,1957.88
5c662e77ebae409d87a26669beda3a5d,365,352,13,Africa,22,2943.85
5c6a4219358b4bc29b805c83b647c496,132,109,23,Africa,22,418.19
5c6e0df26c6f49ef8a755bacb2f74e12,52,26,26,South America,22,269.03
5c7002304a3a4fe69a7755a10c3a6c5c,336,286,50,Oceania,20,1763.26
5c7142838ae6459da888a447b3c658b1,364,315,49,Europe,20,2123.25
5c73ea2e1558430eb4eb1f5b7c86a68a,86,45,41,Africa,17,527.36
5c7406b3143c471da45826fba7dc725a,194,159,35,Europe,17,822.74
5c753142ffdd4470836836c9a7dc58ac,242,215,27,Africa,18,2067.34
5c77d3c5dafc407f9efe94dd93c9d376,137,107,30,Oceania,22,749.8
5c77e74543b84b8fbd0133836cd836d7,179,153,26,Oceania,20,1291.07
5c78242969464d4c91bbca73a82aec80,287,247,40,Europe,22,2440.56
5c78915554d2456596c08b629549c422,291,261,30,Asia,20,1840.46
5c7aedf6f6bf421c84cdf8d27a857e67,271,219,52,Europe,15,1749.19
5c7b9ec40a1f4ee28a9f1f07e5dba8cc,363,343,20,Africa,24,1653.74
5c7da0bd90224309b7f56039f0daf54e,210,183,27,South America,16,1186.5
5c7e36a73e2b459f9ea8855cba476cce,321,278,43,South America,19,1908.02
5c8042bd312b4ede9e46eb06f6f9ebea,364,327,37,South America,22,1387.69
5c804cca57574d2097ba8c43a38a831f,356,304,52,South America,19,1801.78
5c8095cc51364f5a88a70ad7d09c606e,67,17,50,Europe,23,457.33
5c815580696d43b5a2b2b691908e4802,309,267,42,North America,16,2519.21
5c81ee900eed4e7f865703837a3a9988,76,48,28,South America,23,601.78
5c8278ca637949358ae6e9d79f619643,84,35,49,Africa,19,306.68
5c8313da1ebd49e083f4cf0ecbfba952,153,101,52,Europe,20,415.05
5c846e0617444ae6abbee8bb601ed0a2,244,203,41,Europe,20,1261.33
5c84c8c1858a4d138fdfa02c6d0d3af6,230,182,48,South America,21,1118.61
5c8643a30a6545f2b33300b6c9612ba5,363,315,48,South America,17,1759.13
5c86bfc2247a4b07be156e9adaa523b2,58,24,34,South America,21,123.47
5c87e5c9c1714106a4394be08f915952,137,96,41,Oceania,18,928.24
5c8b5fe700194baa8a4119c8cafd7809,181,133,48,North America,17,496.77
5c8b83e4c1664bc5a2b08991173da774,189,146,43,Europe,22,1046.07
5c8f4c79c686426e808a2c9aaadc8bba,132,82,50,North America,17,722.12
5c8f7e34ad00400aa0fd4f4e1f2615e7,110,84,26,South America,20,551.03
5c915c7d8ea9488c9faaf9dcda4c7d43,200,161,39,Asia,22,1634.67
5c91a916406f4484abe29a31e15043df,365,347,18,Africa,20,2445.79
5c92814b151e4b2fa453d59b642f6579,165,134,31,Africa,19,1384.76
5c93215c0a874b52bbabbc0fc731bbbf,72,23,49,South America,21,579.06
5c93fe9c20634cc29d29ae8c8d52fb6f,164,137,27,South America,19,1326.12
5c9450b877fb4518b9530b487e5182a0,226,176,50,South America,18,1251.14
5c96597ac7e3496c8da6a5b389294777,311,257,54,Europe,16,1704.23
5c96dc7d8f7c4fb4916a8c68f317093a,142,100,42,Africa,19,253.59
5c96e78055f8404e8ee0c0a0867edf06,308,257,51,South America,21,1337.58
5c96fd5680054ac387e973be2a7b0f8b,107,74,33,South America,17,544.82
5c9721f187494fa89309ac746781dd96,365,359,6,Asia,19,2176.47
5c98f69138be494b86414f531d21333c,365,364,1,Africa,18,2557.89
5c99b3d5568f47f28f23c95b4c6fd60a,364,330,34,Asia,19,1407.16
5c9a5401815d400b81130fe81fb67ad7,365,348,17,Africa,22,2809.55
5c9a5c269a3f44aa9dd944f960ba3987,194,156,38,Africa,19,944.73
5c9c500e6e214f7898c1cb618fee49dd,223,183,40,Africa,14,1543.54
5c9fac88d30e48d397b0933737ccd839,365,327,38,North America,22,1568.88
5ca078167a92441d8342611420cabfc6,58,11,47,Asia,22,314.31
5ca3a971ae19452c9f9ff0735220ea3b,365,341,24,North America,18,2397.96
5ca46d39735345c78d015f95cc5729ac,110,80,30,North America,14,924.88
5ca5d4fe4c444357945e2e72ea5dc67c,241,203,38,Africa,19,1800.84
5ca6955ad3a5468696ca59ebc58fd1a2,316,295,21,Oceania,26,2067.3
5cab840baf444c91a685ab585d08265d,264,212,52,South America,21,1794.08
5cad3458379b4861986b2204e6a4a7fa,270,249,21,Africa,21,2179.33
5cadafa43177400284735c832df33a02,280,233,47,South America,20,1220.23
5caf076a6b5d4aa8b2eaf8e66c8ba7a0,204,152,52,Europe,19,1244.14
5cb206cb4adb42d69ffec476c00fc403,171,118,53,South America,24,824.63
5cb5aaf4890249b7b50d2c087872f41a,302,256,46,Asia,25,1351.92
5cb76ce550ae46b18a20fba3fb4e9ace,126,94,32,Oceania,18,999.64
5cb9034ec6cd4d61af09de1bb46a95cc,290,270,20,Oceania,17,1749.94
5cb98c8e11934343b06fd46a1cd20f94,204,157,47,North America,22,724.6
5cba3ff5fbcc440280b4be1df394e220,190,151,39,Africa,19,1463.25
5cbb4084a6bc434183abe266b0ad5ec6,276,234,42,South America,19,1593.53
5cbdca08bcca40b794637e3894a91046,129,90,39,Asia,18,1218.19
5cbf66e984e040e983e15de3e7f046b5,42,19,23,Oceania,18,421.96
5cc02888f8024460a5ff867ebf29299a,53,1,52,Africa,25,227.89
5cc7d03f100842f8b24f80b1cf11ab27,183,148,35,Africa,25,958.51
5ccbd6d9d3c7405fb67029d264757902,325,309,16,North America,15,2895.12
5ccc8c34969143438816fbedeee36e5d,365,345,20,Europe,22,1183.33
5cd1cf45c4f645bb9380c54831e971a5,181,151,30,South America,21,1837.47
5cd1ea1ce4874a51a28e923544c5143b,144,111,33,North America,19,820.87
5cd2c93f1ef14c7689f0efe3f6d41c63,95,43,52,Oceania,22,172.78
5cd46afaeba442039599a20aed58303f,132,108,24,Europe,23,1231.1
5cd5514dba7748fc948a40fbb857a339,94,79,15,Africa,19,700.32
5cd5bb6e5253456fb4cf053cf743ff20,229,188,41,South America,27,1771.99
5cd6b7da08c642c891da1ad823ba0f53,87,48,39,South America,18,565.87
5cd938c131ce47f5ab40d0c7321f046d,62,6,56,North America,17,591.6
5ce104832cf647a185075487711d20b8,350,312,38,North America,18,2337.37
5ce1cf2d7b524972b058fff11f06e5db,159,133,26,South America,18,1404.73
5ce35803b21440afa94ffa395903ff0f,295,245,50,South America,20,1798.4
5ce402fe888d4befbfb204e04ff4428c,292,270,22,South America,18,1966.82
5ce58dfd4aaa47e8852fc549245db536,40,8,32,Asia,16,295
5cf289476394473cbb7514781559c7e3,156,113,43,South America,16,1093.21
5cf4470377614435baf4321a2497b33a,193,163,30,Africa,20,818.44
5cfa93f2ca3240749be4832dc119a73b,365,347,18,Oceania,18,1913.55
5cfba32557a3445dbd2b30832284889b,97,71,26,North America,22,703.16
5cfc51dcc9034b9b9294516d48a0fb00,364,335,29,Europe,23,1397.1
5cfd8ee564e346e99a4b4750264419e1,235,194,41,Europe,21,1517.67
5cfddfaccefe4484afff453e0e5ad247,83,34,49,North America,18,255.6
5d03ded5b3db476ab397672b113ab6e6,356,295,61,Asia,19,2045.87
5d041b8d73f147399cf0a57f3b5e3aac,158,109,49,South America,22,725.4
5d0448b220e5486aad913e39a48e0ca0,310,259,51,Asia,22,2180.76
5d06013663e64d3bb092c3ba535351ec,109,62,47,Oceania,23,857.61
5d07b3313f1e4d329d31b774c3738293,151,103,48,Asia,16,821.14
5d0a35ebecc24a8086e42628384394ff,321,277,44,Europe,25,1408.71
5d0af7ac107e479893e17a0b4b9ed8c1,204,178,26,Asia,21,1422.33
5d0d13758f104dbeb5d8782f989b292a,361,345,16,South America,22,2113.73
5d0e8bb71f5940fa9361cf52f40d2f03,364,339,25,Oceania,17,2234.65
5d0eef8eaa4542fca4341385153eb791,223,196,27,Oceania,17,2266.73
5d0f3431ac29482385657775e4efd190,120,82,38,South America,18,365.33
5d0f5d427bc5417ebe199c6145973b19,360,308,52,Oceania,20,2308.04
5d10871dbe3a49e48f85881f4aeff8a9,245,188,57,South America,21,1051.94
5d18c6a9233241669740ec71630f02f4,50,24,26,Europe,19,150.65
5d1a4fb108354ccdb7610124faa338bc,353,316,37,Oceania,25,2323.38
5d1da4c671a3459495fba012933ea3ef,188,155,33,Europe,23,1617.95
5d1e53c4c023420ebc5b4485118c36e2,138,85,53,Africa,17,272.78
5d1f8f231962432c9c387f2faa72fed0,351,325,26,Asia,19,2671.61
5d1faefa1756487c82f081a20edfd2e1,183,156,27,South America,14,1219.67
5d20e60d0d4d4b59a970383bc6901bf5,247,202,45,Africa,20,1985.62
5d216f64886940e08d02651ac97b9873,303,271,32,Oceania,20,2520.4
5d21785dec2242ff8d10cd37fc15727b,172,148,24,Asia,17,1308.95
5d2312f9a545433385238826b0b23ad2,181,145,36,Oceania,19,1367.58
5d2445ecb0ad416f97005740aea8c158,91,48,43,Asia,27,278.77
5d255d63824941a2b854d9393c1e8553,331,294,37,Africa,23,1759.65
5d28f0f76e8e4a529b7906b17b5a57f8,363,318,45,Asia,15,1821.76
5d294202d71b42158acce31232796b72,59,3,56,Europe,21,277.27
5d2bba22259b4d16b76bfedbb21b0d4d,313,272,41,Europe,18,1936.31
5d2d55fc5f0e49d0be6d37ea6c9ea833,181,163,18,Oceania,21,1281.73
5d2e99022dc845c1be4bffde0be9cef1,117,73,44,Asia,25,479.57
5d2f6ae2c4dd43cc9006f811a2033958,210,177,33,Oceania,25,1300.02
5d2fe194a61a4d54afcda6a97589eb1f,327,298,29,Africa,22,2290.16
5d303da0d8ad47e58240458d259c6b2b,215,162,53,North America,14,966.85
5d3216aee5554a1da7e9031b5b9d0cae,60,12,48,Europe,22,401.2
5d33da6c418d471caadf5db87144fe0d,181,163,18,North America,20,946.93
5d3621bc80ff42b39b67d316b86437bb,53,5,48,Oceania,18,344.51
5d36e780e4944d0ea4445cfcef1a99c4,241,218,23,Europe,21,2333.9
5d3cdc44c328472488e64774e3264700,236,201,35,Europe,20,1372.11
5d3e2a6a1b994f8e8173f7d00bdfad3e,59,15,44,North America,17,108.27
5d3eede181d6408f838ebf3a1fce382b,74,19,55,Europe,23,203.82
5d40c5caa75140c0bf6add3493678791,93,74,19,Europe,25,920.18
5d435d020f0f4c0aace042cb1d7cbb71,349,295,54,North America,22,1995.26
5d4444efe8e1452ab265ddb4578c7594,291,244,47,Oceania,23,1473.32
5d4575a6a2964d94bfd96cd765ddf5e7,323,272,51,North America,19,1368.75
5d4686c52d6c4684b2880c14342975c8,275,215,60,Oceania,22,1449.45
5d471783c1cd4d4999f84d94d1701997,222,179,43,North America,17,1155.08
5d473703a65f4a999516faa08cf24e7c,261,210,51,North America,17,999.12
5d4a70b327ac476b9ca4ed1dd1f7355d,100,83,17,South America,17,639.49
5d4a75c16d5a4471a559067a99733a21,85,41,44,Africa,18,359.12
5d4f0e43693c44c09465864ff962d83d,294,268,26,Europe,20,2057.81
5d508347277d4ec98ad9cf07dc929354,242,199,43,Africa,20,1724.13
5d521ff709774924a38ea5d9a0c29ad9,364,354,10,North America,25,2167.41
5d52455cf01a467383da687a2b9829be,363,303,60,Oceania,20,1483.63
5d55d1c89e3b46e7be74d5e871adaf28,100,49,51,North America,17,589.11
5d573c3269ec4f6889d1adabaf1a223e,216,190,26,South America,22,1945.4
5d59b90c75704a6eb9a0e1dedcb50042,123,83,40,Africa,24,569.34
5d5a29a8ffd54d038b1f8c6db2dc5471,289,252,37,Europe,23,2316.34
5d5ad4879c894025a7464b1c6187e36e,302,256,46,Europe,20,1837.37
5d5bf62da4ad436994c37af91f6da11d,365,354,11,Europe,17,2108.84
5d5c197087424423836959f810837e94,290,263,27,Europe,22,1662.07
5d5d2fdae0294e02a82421a64c777cdf,312,271,41,Europe,21,2524.77
5d5f055b3df94d309080fc011ef89097,244,205,39,Oceania,21,2005.99
5d6113cd38a74ca09205c4349a5eb131,103,74,29,Asia,20,661.45
5d61290a9b5c4b8d807b0e2a13dd7172,78,25,53,South America,22,190.03
5d620fc2e99b4c649bfe8c84c8115466,128,83,45,Asia,21,309.76
5d6677f0fb7b4971b97a5c4eaeba5f46,364,358,6,Asia,23,2610
5d66a6fdb11a4dfe96d5fbfa0c96ee5c,309,281,28,North America,18,2603.07
5d68180fb9754325a5ffe94b089934a8,182,144,38,Africa,22,946.48
5d69062ca9c44e60a0810b5ead333f60,175,159,16,Asia,24,1271.52
5d6aa304cf1445fbb8d32f0fe2b612b6,62,29,33,Africa,21,244.31
5d6b2fc4b72843c88755299618c6c22e,345,328,17,Europe,21,2278.95
5d6dfaf478424172b149f439e017b269,88,52,36,North America,17,777.31
5d6e978e1ec64a8fbc95dca3ec8ff7d1,156,112,44,Europe,15,417.08
5d71e22353ec44739dd335f6ae1e7eba,230,206,24,Europe,24,1563.25
5d737f408ca14d829a6771074841aa78,111,66,45,Asia,15,646.6
5d74a17263b946d3b58375bc7ecdc3e0,229,201,28,Oceania,17,1971.06
5d7598f44ea94796925819bbe5cc1c2f,299,268,31,Europe,22,1723.12
5d772cef247a44b68710b5b0b9020136,92,50,42,Asia,17,516.54
5d77fa53cee641bc960340532c9c7908,232,208,24,Asia,17,1871.44
5d7b44700bd14eb8a3ae79166fb78146,33,5,28,Africa,19,106.47
5d7ca6619a4548779722785198432b54,283,244,39,Africa,18,1627.04
5d7cc1d316e24e5683707b1159679030,231,194,37,Europe,20,1245.82
5d7e44a225a242d1832c60a962834329,275,233,42,North America,24,1037.23
5d80a282a7054cca9f0de854086737a4,92,33,59,Africa,20,537.67
5d821c3be7b84f98a4eefa5ba193a366,125,94,31,South America,19,674.72
5d8244cf24c24f1cbd62ec0e5782ef02,198,156,42,Africa,21,1657.44
5d85624be180478e99afe54d79f39cb5,76,30,46,Africa,20,205.51
5d87664e949c4fd18ad8881ce5cac245,201,152,49,Africa,18,1038.75
5d8a4677101b4263a283929ec139ee6e,298,272,26,Europe,19,2089.01
5d8a538d2b5647758e1fa98d5ce95ccb,332,283,49,Europe,26,1309.08
5d8b4fd9e00b44188d1492670f254b3c,365,331,34,North America,19,1857.92
5d8bae83ce3f4f4988e98bc511322c67,117,77,40,Europe,21,954.68
5d8d613d3d2b4aa4bd5cd263c416c809,181,159,22,South America,16,1064.62
5d8e32e12cc9417898d6824b6b8c2e3b,278,240,38,North America,15,1883.7
5d941a7dda6d42a6be45f324bfcd943b,285,257,28,Africa,20,2564.22
5d9b3cbfcaf64841aa0672ee6f8633de,351,328,23,Europe,21,2964.24
5d9d269c380a4eb492fd94df58716125,294,267,27,Europe,21,2600.01
5da007a0f39a4d0592dead358381f221,128,96,32,Oceania,20,767.39
5da05302f8a34117bbda0856b884dd7f,357,318,39,South America,19,2343.35
5da0d944b8d546bc97168161d04d5e42,331,271,60,Africa,21,1435.16
5da1c40ffa8b4d7b9fbfb010615135aa,134,90,44,North America,25,994.73
5da1ec18235d4225905eb1ac44ecf9a7,365,337,28,North America,24,2954.59
5da2836bd6e445b4b61934e8ab72f8ca,364,353,11,Africa,24,2138.8
5da44e2f51a64527a88f776674a6516c,281,235,46,South America,26,1698.26
5da6a8fa26ad4178ac4385114c831cea,363,359,4,Africa,17,2016.34
5da82f0e68b34f8692031c75636bc18d,168,128,40,Asia,17,1274.86
5da8b148f3bf4b4483310034e296abea,23,6,17,Oceania,22,140.17
5da8fbf7d4ab4e9fb47b5a8adff0e01e,49,23,26,Asia,18,620
5da9d8561f974c2d9efdb2783018f5bb,145,113,32,South America,20,736.18
5dab194bb07c408e900f220aed9e34de,364,351,13,South America,19,2955.22
5dac44c4bbab47a29ee4d666b4e4760c,332,302,30,North America,15,2743.63
5dadf63bff7f479f959ae49bf7c40a1e,365,349,16,South America,22,2228.47
5db09cf5a4514397bff5cf78c16f391f,277,235,42,Oceania,12,1732.05
5db0b729126046bcbd5616887d8424ae,365,341,24,Oceania,19,1815.68
5db170efb7074f308cecadb4177a2091,146,115,31,Europe,16,767.17
5db220a944d348d5b89eaa3504f6e92c,286,245,41,Oceania,19,1858.65
5dba6ead63a543bcaca59e1e48c5e5a8,215,190,25,Asia,22,1373.26
5dbaa50b8dbf4400ae04290d3dc141cf,298,262,36,Oceania,16,2015.01
5dbf2ee510e24b4c9b94e350e6181038,245,208,37,North America,18,1772.57
5dbf95959cb6420da35e67a98cb2d596,150,125,25,North America,22,1676.24
5dc07b6b86b847fa89bd765d56447fa6,181,153,28,Africa,18,1413.29
5dc08b0c9f9f44af9f95bedc26a6bf7d,179,141,38,Europe,21,1083.92
5dc5f9096bb84b438344c093a9ad8a57,296,256,40,Asia,18,1986.6
5dc742ee0cf74cb9ba018b7e9afbd56f,150,121,29,North America,19,1549.45
5dc761a177394337b809bcc073cc90c7,130,106,24,Africa,16,1297.62
5dcac0d45f6c4db8bc3584b126b784a6,230,194,36,Europe,20,995.28
5dcc1efdd8b941a5a12c19cacf0c08c7,93,61,32,South America,19,581.75
5dcf0da39a8c400180f38732c4691714,319,273,46,South America,23,971.48
5dcf6061d4b042e396731677ec9d35bc,93,64,29,Asia,17,585.22
5dd04b0e5f5f419f820bc47ae82417ee,309,261,48,Oceania,23,1215.18
5dd1afb2fe8d4ffcb3e9d1986a5b9bf5,240,208,32,Oceania,21,1729.69
5dd213c82e3841ce927ce69b706a5513,333,284,49,South America,19,1739.51
5dd5e5c0467c41328dce2645821115a7,364,337,27,North America,17,3106.04
5dd6be6b4dfd4b48b8c8857b5b634a6a,56,30,26,Africa,18,491.43
5dd6fb75b7064935904293d4cb697b72,181,153,28,South America,21,1050.55
5dd811f1f5ca45da983d64c129618d29,344,291,53,Africa,21,1651.27
5dda936e8a3e4271a7151c5514cfe7bb,187,149,38,North America,20,1139.23
5ddac1bd450149a3aa471970d729dab0,137,108,29,Oceania,25,988.76
5ddb5fefa3f54bb6b2c2baddc3883d0c,118,94,24,Europe,19,1236.6
5dddaf527b5f41df8bfa6bff1b2fd4e2,233,194,39,Europe,21,861.41
5ddf7bca442348649038134fde15e912,276,241,35,Asia,16,2051.54
5de01f05161e4cd5a5e2055403d6a141,122,76,46,South America,20,513.91
5de09401045c4924a2521e4994ea367f,45,14,31,Europe,18,79.97
5de1d8aba86e46a3a76fc1be44b2c295,362,341,21,North America,18,2347.71
5de41225e9fe458b8795830c7f0512f3,233,212,21,Oceania,17,2145.49
5de4da8fa4a54b1c891db5c0b33b2a26,98,70,28,North America,22,980.49
5de52cb0bcf84e839c884511aa3b6400,227,181,46,North America,22,1255.11
5de7a004061b4988bc2cbf07560d6904,118,76,42,South America,22,734
5de7e6ddd2ad4c62871a2f63eef2fe65,106,57,49,Africa,25,563.87
5de9772999fe48f38a8c84f1d8de1caa,352,319,33,South America,21,2798.77
5de9a4cedf26451484d752caeedaded2,278,253,25,Oceania,20,2378.95
5dea59525a6a41c0a8c0a904f19ac96b,97,71,26,Oceania,18,460.48
5dea91b39c83487b9fe06311be09ebc0,341,332,9,South America,21,1918.92
5dea9a0c0dec46709da35912fd529789,206,157,49,Oceania,22,1324.2
5deca874a71745df8dd1ba6c7e544864,292,245,47,Oceania,25,2307.93
5ded3162dbe244838886faa0df783148,262,216,46,Africa,18,1855.64
5dee59ef0a2a422ab929b0ed134f139d,64,26,38,Asia,18,641.12
5def7af0b97843229764d7bbb35a756b,101,73,28,Europe,18,815.35
5df0f241dc2d4f81910b80e37473fd15,240,185,55,Europe,15,1559.5
5df1dd0bec44447688160c9325aeebe2,170,112,58,South America,22,1168.15
5df21b9d09a34fb391ad8da23122f373,211,182,29,South America,23,1375.25
5df50c5f0c77495384d582d7484b9cad,355,319,36,Oceania,27,1744.84
5df6d71a693247c498e9cca6239a5ad4,301,272,29,North America,20,2091.24
5df77c2a5b9d45d9b501a0e8e3d39f5c,67,7,60,Europe,19,149.89
5df9d4b917564976ac7517e42c4f4c8d,364,344,20,Asia,19,2312.07
5dfb3193308949c6bcb94021ba5198b6,342,318,24,Europe,22,2298.1
5dfbb26373d046d395f8bf24daae2c81,356,315,41,Africa,18,2454.17
5dfcc99b27144fc1a104a4ce1ff8a7db,84,32,52,South America,18,459.64
5dfd9bef8f4c427a9baea5fb5c63f4a5,360,331,29,Oceania,18,2020.27
5dff11d7bea24182bba24e25a2d259d9,95,39,56,Africa,27,564.42
5dff266e649649ed84752cb4e6591c3b,362,335,27,Oceania,22,2386.66
5e00d0f4d5d7454996a8fb7503884df6,317,275,42,Europe,16,2282.37
5e082f9c9e9a4cb8b41231cd09e82e67,265,242,23,Africa,21,2172.61
5e0de2a257b54cd297820c3e7db43372,121,98,23,North America,25,1461.93
5e0f270e62c74105baea3483847e32f6,308,251,57,South America,13,1820.49
5e0f2cf68d43488eb8e32f73fbc6d6fc,364,363,1,North America,19,2279.89
5e0f8754438f4d75b0821841b144a273,331,274,57,Europe,18,1697.25
5e10e959147b43f4b913b175fc33f406,153,125,28,North America,13,1253.98
5e122f19188541419616dbe2eabf2c62,202,169,33,North America,17,1708.32
5e12cf80cc11479cb52a4d7c299c971b,365,351,14,Oceania,20,2417.66
5e153a2cad844fc99ae79dd808449391,46,22,24,Oceania,19,646.39
5e1729160bb9491abdf6224afbb7ca71,149,96,53,Europe,20,555.39
5e192cb0594a4160b32cf7baaa36f710,110,91,19,Asia,21,709.16
5e194318a3c0480cab062eb785902c1c,348,324,24,Africa,18,2377.56
5e19efccc413402ea596195a4b9bd40b,92,74,18,North America,21,688.7
5e1c04073ee94e8ab60419f37fc3b301,256,225,31,Asia,19,1968.81
5e20fa61a38b4d0aaea7e5169967aaef,205,171,34,Europe,19,1161.64
5e25d8c1311849c68c0ab7ecf68c9b30,224,167,57,Oceania,24,1072.52
5e26efe515fb4f628385785112040c89,277,239,38,Europe,21,1629.83
5e27b4af89bd47deaaef8b900b30227a,91,71,20,Europe,22,418.72
5e297b3fd454400d9a2dea7f73d51f2f,361,341,20,Oceania,20,3003.17
5e29a32087894cb89a84a1495b30890e,126,101,25,North America,18,1230.34
5e2a64023c8e4654be8d642c2c74467c,343,290,53,South America,18,1917.99
5e2a9c8f6405401cb2504e5e3b1cda53,103,47,56,Africa,22,313.47
5e2af1a2cce94cbda500f2799ae1a2ae,206,165,41,Asia,23,1325.53
5e2e27c3163e4f10a7f2c833c115e748,330,312,18,Asia,26,2699.28
5e2fdb1c7bce4dafbdfbd43bce75d206,328,320,8,South America,14,2384.75
5e30c194c8dc462bad602eb37485a3da,364,337,27,Europe,20,2882.54
5e31174291754f60b9cf208b6f0cf974,92,53,39,North America,17,566.07
5e339a510d0149ca9800a571f9732c0f,236,206,30,North America,21,1485.81
5e35ce10a3394b009e31d78a833370b1,322,272,50,Asia,17,974.09
5e371bb21d5047eb865f5e1d25cbf17c,285,229,56,Oceania,24,1520.27
5e38fc5b98214840afece4162d7dd9a3,351,324,27,North America,14,3632.45
5e3ba97aa9184222918acbd1cf11ec28,284,268,16,Africa,20,1858.21
5e3bdf403d794a90beef535395881ec7,301,272,29,Asia,19,2325.57
5e3ca599f8f34aedad98163ac3b3fa38,249,211,38,South America,18,1695.41
5e3dc5aaa6484b75bdbf2f5aaee7f64a,194,153,41,Africa,23,1188.05
5e443c1790884d238c6406761677177f,329,298,31,Oceania,20,2539.43
5e491a576e4a4f1ba2cb8a658c6c506a,118,63,55,Africa,19,488.26
5e4edcba19eb4c2c86f0f3d1f71835d2,229,181,48,North America,20,1164.61
5e50ad86e4fd4236a89734d2ea726337,364,345,19,South America,20,2540.61
5e5562e0e7114597bad56bd770de7eac,253,212,41,South America,20,2027.37
5e55d2903ea74a9090964b95ab2dae04,262,222,40,Asia,22,1207.79
5e5664ca80064c7195a6fcaf15b8aa9f,365,342,23,Europe,20,1466.5
5e56a05be49b400aba658437d618e141,157,111,46,Asia,11,674.45
5e56f60119bb474abc0df0778e345f1b,120,75,45,Europe,20,575.13
5e57783cbc884c90818e4bc3ecdf85cc,236,184,52,Africa,19,793.56
5e57f22b45e847ae8cbfad9008634779,171,125,46,Oceania,18,1150.44
5e595eff4c794a09b13eb396d0a98175,181,146,35,Oceania,21,1141.65
5e596f6c0b5447a0958f08c3d3aa0791,39,9,30,Europe,22,479.53
5e59a6bff4bb4d23879ba297ca3ec7db,300,243,57,North America,19,2118.79
5e59d2d1568746f5bac2595183e2fc5d,178,157,21,North America,15,1507.44
5e5a30baa853421faab1122d0ff4ec70,117,70,47,North America,24,449.25
5e5b744c91f34ecf9e495d09955c5bd6,145,119,26,Europe,17,1072.62
5e5ce99fea2e43658bb3759964a8f268,57,29,28,Asia,13,365.61
5e5fab88c2da4c05b5b4b79bec9edbb1,340,289,51,South America,25,2135.95
5e603c40180845719db08bfe194bf714,31,8,23,South America,22,252.94
5e630174118945b881a0c305f36e37ca,291,242,49,Europe,25,1301.16
5e655f00f3ac4687ae7edfae608cc32d,364,361,3,Europe,24,1915.42
5e6642777e7644d5b0fabd41558f11cf,365,328,37,South America,20,1609.76
5e67cfcf166144f4b8d6351ea7d8675f,144,107,37,Asia,20,937.83
5e67e643371a4fc4a5bc1cdcebe9f7c0,319,288,31,North America,23,1802.36
5e6a17077120419abc98bd10bdca6a8b,173,144,29,Oceania,18,663.85
5e6a273a259f4fb8a7873374f4394a8e,205,163,42,Oceania,19,1116.35
5e6bafe452844d7386a829247a3d641f,130,113,17,Europe,19,1198.2
5e703cf0f44b4bc4a0d9316141ffbf01,78,39,39,Oceania,22,391.36
5e734b4922e8417a9f2f267ea81042ff,264,239,25,Africa,22,1850.75
5e74794a748443ae83789d10f0736c8c,362,331,31,Africa,19,2032.99
5e747bbd4f7e4a9ea58fad0110848e07,245,214,31,Europe,21,1962.33
5e75cf08cad74b2186118aebf985e859,153,100,53,Africa,15,517.04
5e75e5dbc5154f759bae479031c3f1bf,283,233,50,Europe,18,2537.59
5e775338674740c0a5b20e860426f7a8,202,174,28,Asia,19,1938.1
5e77858bb8f24f72817b40c7f8e95531,53,3,50,Europe,24,215.6
5e7798f7042044eb850784c1f6aa5e64,315,264,51,Asia,23,1644.95
5e7871fea8984be6947c4182b95bb1fd,324,281,43,Oceania,18,2685.34
5e79bd705f89422c9fb01a4c17a293be,173,134,39,Oceania,19,1401.37
5e7dc655aeec4a6180df65749f276d68,365,320,45,Africa,29,1972.78
5e8064120c0c46ceb0603f387881f1d8,272,216,56,Europe,22,1269.02
5e815447dc144791bf568efa9e3ec303,139,104,35,Oceania,21,962.43
5e83d73cab6c4a80b4d9df71ede354e5,355,319,36,Europe,16,3042.15
5e858a83dbc1460c859389cea2e4223d,168,114,54,Europe,16,541.11
5e86150a9d624331af4cfd3c03157505,324,292,32,Europe,17,2458.74
5e862abd81014314965348359849a05b,128,105,23,Oceania,18,825.76
5e898aaeb6a5450fa296ed7a37fce777,291,252,39,North America,21,1608.04
5e8b24b0b7984845a5e71d7c7fd52644,122,86,36,Oceania,20,767.56
5e8c63303296439ca9ee62330c12bec4,315,283,32,Asia,18,2033.29
5e8d63b4f1744a609ecd7366857c5f4e,365,331,34,South America,23,1717.3
5e8da64d452b4825a34f092cf35dfa59,316,286,30,Europe,25,2152.89
5e8f73144c1a478b92b93351bb1e6576,110,73,37,Asia,16,858.75
5e8f7351190649c9aa2d86c2bd018a26,141,102,39,Europe,20,1131.6
5e91a533989b4e25b7da0caa9b56ca0b,306,282,24,Asia,17,2211.55
5e95cdf9c21f4c9d8a270a9d5620eaa9,170,124,46,Europe,18,584.86
5e97bde28cc94afb919a6947e4af0aa2,155,105,50,Europe,13,625.41
5e980c6cd971463a93b3cce011fddd68,166,143,23,Europe,23,1184.7
5e9a72555a9446c5bc802e3660f4670f,213,180,33,Europe,23,1203.26
5e9b956b92cf4ee79b669924a4722ce8,175,148,27,Africa,18,1559.13
5e9dc0b1ff1f403399953f115a3ef575,190,133,57,South America,22,1147.48
5e9e3b7e574c4549a7d5ddaaf878c38b,165,113,52,Asia,19,823.81
5e9f354764ca4b73b019b5abbb2521c2,164,152,12,Europe,19,1005.1
5ea49966db284b7dbc7b33aac052aa01,279,257,22,North America,18,1662.75
5eaa93fe50d44b8db452c7e0b987cbae,186,133,53,Oceania,18,859.02
5eaace395caf442c883b3fdf5815d362,365,326,39,Oceania,21,1974.7
5eaba36a57034636af14c011957937bd,141,96,45,Africa,22,989.27
5eadde8ee0ec4230a95f986480924c65,271,223,48,Oceania,25,856.06
5eb089f79315402aa73a33b0fb6281df,323,298,25,Europe,22,2150.11
5eb2a24820184a54860935529de6d126,336,298,38,Asia,21,2074.35
5eb36f1c67f94b789550275456ecb2fc,365,353,12,Oceania,20,2118.46
5eb5a33dc2f248f2a2e030168f8fed37,365,356,9,Europe,21,1892.46
5eb60fe3c5d842eea140db81995fa19a,91,33,58,Europe,22,260.09
5eb6146392104ea29ff9c384fc60b654,227,185,42,North America,17,1585.21
5eb6286b61b34867920313e6d2526044,355,327,28,Europe,22,1945.28
5eb71fce3e424486b6bd0b14469c8efb,73,39,34,Europe,18,416.66
5eb7746b7e8140cc8e4821159ea1f3e0,143,120,23,Oceania,22,811.61
5ebce9bc939547769c517851eecfff61,88,47,41,Asia,14,471.64
5ebeafae44c34434896abaea3bccfafd,72,55,17,North America,20,853.94
5ec30247ba8046b89149640d486d5fe7,188,160,28,Africa,19,1278.72
5ec454d78a4b41cdb6694fa21d68892a,303,275,28,South America,26,2110.32
5ec50c25f1164778ba5f0979bd8c696f,209,171,38,Europe,21,1159.52
5ec5301ac3f7489e80b33d101bdbda3c,365,349,16,Oceania,19,1603.17
5ec53505509747d5a10fc21573d50e3e,229,198,31,Europe,28,1824.81
5ec5a07d45a54d58a070fec8ab2f8b75,364,356,8,Oceania,16,1639.13
5ec7381bdde646cbbd716318379a7ae4,98,69,29,North America,18,901.73
5ecba271a658438aa97513357633777e,47,23,24,Europe,20,177.8
5ecc363fb43b4c31941ccb97cd28a5b9,115,57,58,Europe,24,852.77
5ece728bb83340fb88319769123add78,365,365,0,North America,20,2691.3
5eceb048469947b6a4d82370622df387,286,245,41,South America,24,2914.02
5ecf3e19f8d04a128f98c32cedad8881,307,254,53,Africa,23,2458.19
5ecfdd12ef1f4285bc0929105984017b,352,329,23,South America,25,2865.81
5ecfe9bc4bc34db6bb4fdb2e829d15c3,164,123,41,Africa,24,1008.42
5ed0550ca2d94da4befedd95a0393789,363,341,22,South America,26,2157.66
5ed3be323dcc404c88675ed1db215434,60,25,35,Oceania,23,652.03
5ed43e57d0ea4134ad4f9a23f6d701de,170,136,34,Europe,15,1195.03
5ed46e0249244f9f8d3d51ec3ef199c1,342,305,37,Oceania,19,2594.81
5ed83ee717eb41fda34f406171346cb4,143,123,20,Asia,21,1152.93
5edaa82072b6408b93b061d0f2adee1d,167,114,53,Asia,16,742.64
5edaefe5182a4c0b8e3cf14e0ec63372,150,102,48,Asia,25,1281.7
5edbaef409854ad6b67951077e05ff06,223,172,51,Asia,18,1338.58
5edc944897a143cbb8259f7e1dc507d4,110,70,40,Europe,27,1191.81
5eddf5c72a9043a28e4e8171adff8b48,261,219,42,Europe,19,1993.09
5edeb9a17b2249c6bae487eea293b956,194,158,36,South America,16,1476.84
5edf48b6000b49aca33dd4e0236e9680,95,47,48,Asia,19,490.18
5ee01578f0ca45b4862f4613a75f2a93,314,262,52,Africa,23,1689.72
5ee13772e65342c89b3eafb49283e7ec,365,329,36,Oceania,19,1869.69
5ee215485bb34400b111d0dc90ab919f,235,196,39,Asia,19,2039.5
5ee8514850d442638824aab554434beb,246,223,23,Oceania,23,1799.77
5ee86bed86be43f6ad40cef56ea0e59a,233,192,41,North America,15,2049
5eeabb0cdb8d4041be15911e9d00f639,347,321,26,Oceania,21,2517.46
5eebd076a40247bca04307fc104ef8b0,47,26,21,North America,19,229.93
5eeda0d1369c4797a938b7bfa748ef38,363,353,10,Europe,18,2747.21
5eeed6e3fb5844128ecc4a962e62fda7,104,48,56,North America,19,497.9
5ef16f95b6ad46a3b10361b992e04c07,365,335,30,Oceania,20,1416.29
5ef172321d9749999114e05c54431781,287,265,22,South America,18,2006.63
5ef213588314442f9ab42f682e33f550,278,223,55,Oceania,19,1459.52
5ef92cd86c1c4bb599e5015cf5350291,322,260,62,Europe,21,1603.55
5ef9c24d99724d4cb42fd34a1e78427a,362,337,25,Africa,19,2737.24
5ef9f8854e564f05a8e5b98b9412e0a4,293,244,49,North America,17,1488.51
5efb340fd3264e0d92fe96b514904c23,67,12,55,North America,18,362.19
5efc4d86d5c84faead33878efad08da2,352,320,32,North America,20,2319.26
5efd3e89ca3d4d3c9e122a78e08d2ebe,289,231,58,Asia,21,1813.49
5efd4d2d0120429282911cca2fc5956e,148,100,48,Europe,16,540.19
5f01aa25d3f848c2af86e2ecbc9c2cf9,50,4,46,Europe,18,143.94
5f02ee2a87ec4502958db42f79d50292,89,37,52,Africa,20,682.28
5f052b5fb54a4b31923cec5ca0bb0021,163,107,56,Asia,23,716.86
5f074734d1474dd78a37162ca45fb6b1,259,216,43,North America,22,1241.45
5f079978c71f481b998d5d90600974f5,302,260,42,Africa,19,1497.63
5f07db031d5b4f2a9d5d6098d6707208,364,337,27,South America,18,2308.74
5f08fb45c3584791887bdb4f250f07d3,235,204,31,Europe,19,1602.76
5f09dd8378f9468bb7221d1961b44767,219,183,36,Europe,17,1698.24
5f0a3ce055914be881ebb28b0b915e44,161,136,25,Africa,20,1304.73
5f0c2fc5b99141598c631c73946cb223,101,55,46,South America,24,555.36
5f0e5c6c1b57479db5f4234d0236353a,229,192,37,Africa,20,1449.98
5f10d8a7db5e4754b99092abb352cd3a,137,82,55,Europe,21,964.02
5f124b2a9b3c49198b06234eb5c671da,58,8,50,Asia,16,89.51
5f146c88233649818f2b71dbb859a15a,365,348,17,Europe,17,3110.78
5f173a89fe3946e4af630b6bebf0a02a,352,324,28,Africa,16,3179.79
5f19bd3e8ee645c79b30228573978a30,59,4,55,South America,22,399.58
5f1cb97de8e64296b82368c5e8d9d8f1,284,242,42,Europe,18,1446.13
5f2148bc06804f099503dd5683bcecfc,334,280,54,Europe,21,1643.83
5f24e2da0ea5433184aff3a9379b81d5,262,234,28,North America,21,2111.31
5f269341492e4b5b8bb384093f353127,212,194,18,Asia,22,1821.57
5f282b58b37746c48946fc1a1e8d32d0,230,211,19,Oceania,18,1555.47
5f2852185fd34b3aa3b64f5810afe086,221,182,39,South America,16,1197
5f28ca4af4df4fc3b3f760e401737372,108,89,19,Asia,25,1015.45
5f2b22af78024c5ebc2f41b4f77afc80,40,15,25,Africa,19,125.93
5f2d39d103514d0aa2a64a78c6202701,174,146,28,Africa,22,842.64
5f2fa71e120946a8ab682c2633374f4e,302,270,32,Africa,21,1636.81
5f32a538680a42ff807db25fc244dbee,365,323,42,North America,16,2469.98
5f335dea02cd4421affbd5c20de2902b,218,170,48,South America,20,1190.1
5f343f3628d742e8b374cb8b0dc3612c,161,117,44,Europe,26,906.97
5f35006e77944f1e8acf25648b71a6a5,78,41,37,Oceania,18,132.49
5f35b6ddb02f4f5b9d26748b6b89a1f3,123,88,35,Europe,17,1024.54
5f36ee65558a4cb19b0b0574b71bf286,301,252,49,Africa,23,1575.2
5f3799a86b804837b96a9efe619a166b,297,273,24,South America,21,1664.78
5f37a003f7dd45f4b359cff71ad92f6a,160,114,46,Africa,21,913.07
5f3b755a512842168914d7ea8fcffabd,65,28,37,Europe,21,364.26
5f3e60daab1c47ba9988909c345c0902,273,258,15,Africa,21,2314.05
5f3e83f67e9c4f39b3b1ce822df1b77d,92,64,28,North America,17,497.41
5f3f958223bc454982fe6a571471e3b6,335,291,44,Africa,24,2599.07
5f3fd9576e6f41678defd116de627837,236,196,40,Asia,25,1022.44
5f418db71242464cb9d4cecfd8a1822f,105,79,26,South America,22,881.1
5f42ac14f09f4db1bf635068e0430f80,365,345,20,Europe,21,1821.87
5f46730c2c5b4303841c1b4efd92021e,163,141,22,South America,21,1121.27
5f46d46fc0994a61a97066abf7bc206a,363,328,35,Europe,21,2293.45
5f4b080ee49940acb77410bf059d9c18,103,61,42,Asia,23,461.73
5f4bb19226a04016a9b10129b28fe8f1,167,141,26,North America,21,1660.82
5f4c2a67ddb3442ba301c294fe8d2ca7,365,362,3,South America,19,3066.47
5f4ee3e4e4a6433ca384bc74ed627fb9,364,325,39,Africa,20,2433.73
5f4ff7a2ad6c400785a9f016f94f9400,364,359,5,Africa,13,2237.15
5f50306292aa4868a5de725f422daf9b,318,264,54,South America,12,1721.01
5f50acf4de084f4988406a368566c7cf,61,12,49,North America,23,495.88
5f5125914a6a424f92cc18e92e26ab85,357,328,29,North America,21,2546.66
5f5288c8cc544892a6e1c9796a20ab16,66,47,19,South America,23,457.71
5f544fbb33424f8698569d4d55d4422d,362,345,17,Asia,17,2977.13
5f54f6834c274491b5bbba6aca948941,114,75,39,South America,18,784.87
5f5577a1a9214548bdf037969622c0ce,357,335,22,Asia,18,3359.08
5f56e3949f3349518f06f76202709c07,143,105,38,North America,24,1069.54
5f56fb2376be4bff96405f93791bb2c1,163,114,49,South America,23,995.75
5f57811a8c1c4477ba597b44c91912a0,161,139,22,South America,19,1500.28
5f58900456304d408974c77152eb5fc2,191,182,9,South America,17,1206.96
5f5a81b1f4c246e2b731490afd1c7b5c,58,26,32,Africa,14,501.23
5f5a950f70fb48c394053cf1ecde3689,291,261,30,Oceania,24,1291.64
5f5bb8a5eaa04f3a8d78d76abb02378d,276,234,42,Europe,21,1899.7
5f5ee7d5a20d4b729e45609923ac5e5d,67,49,18,South America,20,460.72
5f6028866588493e8212e749dd579b86,233,209,24,North America,21,1779.28
5f62386075904b159f4fde7f1ae15cdb,297,253,44,Oceania,18,1580.57
5f632f76d6c146878da7c3e5d14728e3,178,155,23,South America,21,1903.56
5f63b37039034a14b4c7d6e4ada0fa3b,292,243,49,Oceania,20,1558.31
5f63d637824d4824b6cbf882e18ad912,333,305,28,Asia,18,3302.99
5f66419795be45299c8410baac2336c4,221,163,58,North America,18,993.08
5f675f3166d04687919ea6fb25147754,108,62,46,Europe,19,943.4
5f68dc8c6c494b4188551ea9c782053c,141,106,35,South America,15,850.64
5f6d32a1dc37411a8a58a4c6854dd5cc,281,238,43,South America,21,2818.41
5f6dd5beb73c413aac90955f7d589a3d,154,116,38,Africa,20,624.28
5f6fb6c1551e4d58a0609dd4d3586b62,350,321,29,Africa,15,1940.27
5f7017f3d28244a6bebe562164d937e1,364,336,28,South America,25,2124.59
5f70b4ad01ed47798c7da1186cc218a8,319,301,18,Europe,20,2204.62
5f7462b893a849859767e5ab7fec044c,259,224,35,Europe,19,2125.7
5f75abfd464e4fe08912837811e6d977,131,85,46,Asia,25,872.53
5f770d0fdeff44f791648b1da829716f,308,283,25,Europe,20,2353.88
5f7a8721ee5a493f8aebbe4e3a29f2c4,223,180,43,Africa,27,1793.92
5f7cdf1208cc4e15a1a7b5dd630caf73,267,223,44,South America,19,1134.37
5f853dce9c754ffb9fd3bfc6ff8469b2,201,152,49,Europe,16,883.94
5f85d122ffc44d31b2c7248520e62038,365,343,22,North America,14,1566.59
5f872a06220b4261b0f33ca257c2688b,332,301,31,Asia,23,2207.53
5f88e3e75e5e40e6b64b04f1de0dcd16,364,337,27,Europe,24,2455.47
5f8998318dd64a17bdfd43959301e31b,131,82,49,Asia,19,675.13
5f8db36a68d94da38e5fe98079be32f7,180,136,44,Europe,25,716.15
5f91266ca51c4e2cbb21240b6a3f5d2b,312,279,33,Europe,19,2603.28
5f91348001ec47308be93bb74aeebf0e,285,249,36,Oceania,17,1954.13
5f919db26f834f269e3217e7332021a9,118,80,38,North America,23,609.42
5f92e8737a3d475d9a2405a2ce527597,160,124,36,Europe,20,1069.88
5f94121c87ac48afb0f3228a6c882951,41,12,29,Africa,19,176.55
5f9527aad4104635bbfee6aff02e0949,74,25,49,North America,18,503.54
5f956bde26b74360865e67cdbda22d9e,216,198,18,Oceania,21,1911.32
5f967225f3ef4067a723b418c66d9d46,134,102,32,Europe,18,728.35
5fa3c80917ac4ddf95b97b008b024328,292,257,35,Asia,20,2704.96
5fa3dbae336441728a78e457d151ce7f,92,37,55,Asia,15,460.57
5fa4e648653946f4ac0041685021eea9,355,302,53,North America,26,1874.17
5fa563f3ac1648c2b0c7596fd2dc96dc,364,332,32,Europe,22,1494.74
5fa5c8a633a3464abb09eff4a143a146,339,306,33,South America,24,1773.85
5fabcf07e260411a89260424745e4128,37,2,35,Oceania,25,267.12
5fad2b925c1d491f91b88f8ace92638f,310,284,26,Europe,16,2150.3
5fae089ef47e473e86102fbf620e84d1,206,175,31,Europe,23,1618.48
5fae6092c00d4346b08f6cc34a24fcd5,82,39,43,Africa,24,668.78
5fae7e32bf7b48e78b8018c8bc22c09a,185,145,40,Africa,25,1325.45
5fae880cdb20464ebefe8c299e8cd69f,244,217,27,Africa,20,1945.64
5fb03a1300094640847bff7251089264,310,292,18,North America,23,2086.32
5fb21d448c81444aadaf9ca519f8b136,125,103,22,Oceania,21,1154.99
5fb2397c62c849e1a3bbf34eddf06f80,240,215,25,Oceania,17,1555.84
5fb3ef942a2f41ce83ca5ded38d7b691,208,191,17,Oceania,22,1395.28
5fb4dec23b324bda898034908a88ec3d,365,335,30,South America,27,2101.67
5fb5562cff754ff4b4254b9831fbc58d,160,115,45,North America,20,473.93
5fb588266ce948fa830624fbab3d5e9a,362,338,24,Europe,24,2406.99
5fb58c539b074cb092dba07b89ac2ab5,45,2,43,Europe,20,198.2
5fb60b9fefaa4a4faa1838c42b7fe0d9,365,361,4,Europe,14,1511.1
5fb6358ef3e240ae8d1d58a3d5e48ad4,363,337,26,North America,19,2663.91
5fb6a3cd420c48b9b420bc80ffeb5823,365,328,37,Oceania,20,2222
5fb6c37585b1481593dd12b9887909ca,142,102,40,South America,21,1194.55
5fbd167a47e6439abea29e5d5f8bda51,58,34,24,North America,27,434.66
5fc3d10350dd4be8bbb4790ec1566200,278,245,33,Asia,19,2263.36
5fc403ce4d5b4d2bb381543032dec582,117,80,37,North America,19,633.67
5fc42dd0dcea4e66a24de54ad221aa28,250,222,28,North America,16,2024.74
5fc4f98f578b4fb4af2d8def4da4134f,213,178,35,Africa,17,1573.07
5fc5d6677adc4f3b9e39603d4c78f6ed,216,191,25,South America,27,1923.1
5fc788eb8c664489b5c9edde7ff0d5ac,76,25,51,Asia,13,344.64
5fc85f0169d0441196ae9da80624b292,176,142,34,Oceania,19,1295.09
5fc9437dd5a6409c906803dc68697707,365,312,53,Asia,17,1799.51
5fc96a4536a34390b050086cc28f4370,138,95,43,Africa,16,1089.26
5fc99f0212444130b0f27f702bb64a52,120,90,30,Asia,9,1118.42
5fd540a57aad42719db8b49f4571663d,363,338,25,Oceania,18,2289.97
5fd6d96556b44e5b9d91da8a58e42428,252,200,52,Africa,17,1085.56
5fd8d4ac12c941fe866ae08a629585cf,88,61,27,Europe,22,609.29
5fdd6638d2da47eab3d8a748a1cb40c8,211,183,28,Asia,22,1841.44
5fde18f118a34dc5a2c8341aa93ea790,152,133,19,North America,23,1198.67
5fdfb9d46be043d7b22be926a592da33,134,102,32,North America,21,978.23
5fe12b1f75b343d58173e5aa5a775ea0,255,234,21,Asia,21,1555.63
5fe17430a63f4feab87a3c6e2a7160e9,203,174,29,North America,21,1315.1
5fe459a4c34d414eba3d47784301b477,74,27,47,South America,21,366.43
5fe4e103b9be4de797ac92e3f13205b3,328,272,56,Africa,24,1656.41
5fe54de09d48444881c9b9a5065a463b,362,360,2,Europe,22,1394.31
5fe6c160dcb1488ba6215ba2a2cf6a10,193,144,49,Europe,20,773.31
5fe91727a6494166a74f612733df88d2,132,82,50,South America,17,508.94
5fe95d8790344377afe25ba24bd3cb40,117,83,34,Europe,22,755.12
5fe97057610347e290b7236005638018,98,47,51,North America,17,600.14
5fe9b14b63f249e6b75ab6cc69acf5c5,115,66,49,Asia,19,1028.22
5feb19c31a6b446a9d0f14448565416e,170,129,41,Africa,23,1299.25
5fed05a7738148aba9dcec8a3d8b8abf,269,229,40,Europe,23,1597.01
5fef9e9a908c45e2beefc6696789a3a0,95,53,42,Oceania,19,425.56
5ff24ec980314978bcaafaa5330a5f2c,64,26,38,Asia,20,355.24
5ff2df391b6945869f1f0efe0120772b,144,98,46,Africa,20,787.25
5ff32a6df0c2406b81a8d4dd5a237425,102,74,28,Africa,22,1034.02
5ff65ee4d6a547698e0bb0ea6019d156,66,19,47,Asia,21,162.87
5ff69bc02fae4c9a8685ec6f82293c04,365,319,46,South America,20,2663.12
5ff7151fd1ba433d978ba749212ab54a,91,61,30,Europe,23,517.72
5ff82ee07c4742eaa340bee8156e3080,365,352,13,Africa,21,2858.92
5ff93aff8c9e4c5eb79c887b6b2ea394,255,209,46,Oceania,13,1623.62
5ff9a58208ee4730b68844fa67b165fa,177,122,55,Oceania,14,790.27
5ff9c9568e794106bb0001f940583c8d,177,138,39,Africa,22,906.65
5ff9de2dba7b48fabc5b3d71c0328a25,362,317,45,North America,20,1583.39
5ffa74af78e143b58396db0b512bb4fa,218,182,36,North America,18,1145.03
5ffaff0cef874733be3802d23fe30c6b,191,163,28,Asia,17,1227.68
5ffb77e6754949cf81927054e00af141,222,195,27,Oceania,20,1564.02
5ffbf7f8ce774ab8ba6c30c972874631,215,182,33,Oceania,18,1186.97
5ffc9a11a1494655bd9bb958b29d205d,112,54,58,Asia,11,458
5ffded855de142469638fc2bee7861eb,274,228,46,South America,23,845.74
5fff5b6b4ed548fea771da0b94b4d741,136,83,53,Africa,18,799.64
60023ad59b424744a871f00f0918802b,226,177,49,Oceania,21,1186.52
600c4f8e4a684580978945c795152cb0,82,52,30,South America,21,495.38
600d49ad49d84524a009ca4840253b57,365,319,46,Africa,17,1956.29
600d5b018adc402daf9f9d670d522d2c,198,143,55,Oceania,18,1170.4
600df084b24948c894b4ff041861d129,333,305,28,Oceania,20,3159.48
600facb28f9f40ae9d83f7a747f08c06,131,78,53,South America,22,783.7
6014091a4a304e16af7640bbc27c9644,265,226,39,Europe,19,1913.25
60148f99a3c04ac587de1c44a8895867,117,91,26,Africa,22,1227.13
6015b23a536149c7a55da40ef79f8ad1,77,37,40,North America,19,394.08
601a47d2046a4dacbe9b58903905715a,60,24,36,Asia,24,509.71
601a9e73830d45c2ab24aaab937a994a,159,123,36,Oceania,18,1115.87
601d02b9cef94ed1b2b8936d42887525,174,124,50,Oceania,24,1239.98
60200643917b403d9136d18828205ef7,342,298,44,Europe,20,1689.16
602224fc716847ed9de07baa943e2d5f,300,263,37,Europe,25,1914.47
60241b4bcb554bcfa565e5ec3783c325,264,224,40,North America,19,1993.54
6027c7aefe064075bac75865e28ec021,124,99,25,Asia,19,631.68
6028274f6c004db18e673c57cb5cf2f7,332,307,25,South America,16,2543.77
602951ab461445eeae6d50fa40bc2eca,315,269,46,Europe,20,1705.39
602aafc9d36b40398add8d1916328b7b,247,224,23,Africa,14,2064.89
602b4638e876420f83fcd8f86d4a5d7c,228,178,50,Africa,22,1208.59
602ba978bb584180bea0d100c09b8059,87,63,24,Europe,20,369.01
602ed4e693c845d48ee8524812bb57be,104,86,18,Africa,17,865.52
602f361f52dd4873abfe1cfb09319dee,197,169,28,Oceania,18,1466.24
602fa22289624550a6f44ed693088607,52,2,50,Asia,19,338.96
6033527f42524ab696b1ec00651abc9e,277,259,18,North America,20,1886.8
6033838801264eb4a2ecb6c35aa019dc,297,259,38,South America,20,2423.98
6034596fe5fe4f4aa236df7c84ec8b0f,219,168,51,North America,19,776.32
6034728219f540e9b5b45d16d52dabfd,168,125,43,Oceania,20,1565.27
603584d8b44c481daf7a4d68e56dfe84,300,287,13,Oceania,19,1873
6036677216ae4a85b780ebf378b0c07b,236,197,39,Asia,19,1721.22
60369578b0904102b308c364e09a8c82,60,5,55,Oceania,20,256.38
60370f942f9b4cbea05538d3c79b6096,257,206,51,Oceania,22,1369.6
603abf0a2476493494c1a9e32f65dfce,225,196,29,South America,24,1816.94
603b770e874844e6861c9ffed4d6c75a,151,105,46,South America,19,840.4
603ee4d534504c9aaf84860ce707c0be,188,143,45,Asia,17,1094.66
60407047d2df47039219223a379451ae,363,336,27,North America,19,2212.15
60437c226e57462491e4361cf0b994bf,41,16,25,South America,18,249.44
604386f335ed492b91b848d757b89b45,251,214,37,North America,24,1572.72
60458790771e4aa294ab26c6b4a96957,329,286,43,South America,15,2534.34
604e1221d0f8453f930fbf3182752d47,268,236,32,North America,23,1777.54
604f8abbf4f845c594126249023bc942,325,305,20,Africa,23,2667.34
60512b3effcc468380f0e049a7197f58,362,318,44,Oceania,19,2811.87
60527e6eb8ed42e6b75e53f11fa5b62e,184,157,27,Asia,19,759.31
6052d519b69c480a8a9fc621bc0c4220,352,319,33,Africa,20,2884.18
605363ffe5bf40adb2f3b5ab82463d60,224,181,43,Oceania,23,2353.6
60537a34338446d0b9e0e8bc5fb58825,85,31,54,North America,19,563.4
60556fa267ef40aa8cf7885a1298252e,59,29,30,Africa,16,211.33
6056039015524b88a5d9aa309f7bd68f,288,239,49,Africa,18,1507.15
605a8c6998824b548663854877bf763d,211,176,35,South America,19,1395.87
605c649e6398409fbb3a7078f9fcb198,138,94,44,Africa,23,1102.82
605eec33381946d18016ef07c3ca523f,98,58,40,North America,19,707.13
605f7d49e4b24fe9bdb4b4dca7c3c01d,364,349,15,South America,19,2582.27
605fbfe407c145fdb8abbd018c0382b4,364,331,33,Oceania,22,3757.37
6061d803e6324db3b43bd32e8512820e,72,17,55,Oceania,21,151.93
6064956ee99c470fa0b9a22b9c54966d,154,135,19,Europe,26,976.56
6065d91dc7134e47aa4addf5a3f9392e,223,189,34,Europe,24,1132.73
6065ecfc491540dca87106295d4c99f6,206,185,21,Asia,19,1559.7
6066fbffdede4658afeb0bac32dfd046,86,29,57,Africa,24,460.11
606829957c43499abf7a2c0b89e01b22,104,73,31,Asia,24,843.28
6068de1aa4d14a12a0d96d2315342979,353,320,33,North America,14,2076.75
606a2260a6b94f839befaa0bc7fcff37,235,206,29,North America,15,1580.21
606a872430984a1389e4559a88b7ecc7,225,187,38,North America,21,1418.61
606b9d612e2a455f91025077e33db4f1,79,46,33,Africa,22,732.54
606e13b0c4f84873a7262a1641cefce4,288,248,40,North America,20,1859.9
60719c2060474b21a279be60441d9598,295,249,46,Oceania,22,1476.99
6074b015a07c4e11ba9a5ea5b01e9e6d,214,172,42,North America,26,830
607524ae5f654d20ad4f56f2b51b4cae,245,224,21,Asia,22,1948.65
60753b025a97455a8a18d07db8ecba32,130,85,45,Africa,21,722.35
6075909859fa4af19c6dc6696d986c6e,145,101,44,Africa,24,824.39
6075ab7daed24cb3b88df70c1b93fbd2,122,80,42,Africa,18,357.22
6076087cdd324f859fccb9daf9b58ea2,269,254,15,Africa,19,2276.73
6076acfc2c864a9793bfa4a2a3f5c220,285,234,51,Africa,25,1719.46
60778a7bbbb341d18185fdcdad7be162,71,23,48,South America,16,369.34
6079c88d88314583a5b93e57b1ef2fb9,89,52,37,Oceania,20,753.91
607b18bef46c45a287e80bec0d8695d5,317,259,58,Oceania,22,1479.56
607e9e4b4f2041dd89a25bd60da38087,344,284,60,Oceania,23,1923.97
60821be417204b3ca33c8e13beb921c0,214,164,50,Oceania,20,984.37
608c713a2a1e4f5cacdb041cf768f38b,363,318,45,Europe,23,2547.64
608cd40d202b4a5e927d68052b31af29,118,91,27,Africa,20,1362.24
608f9ad0f64a4bc184c957e2894b376b,204,143,61,Asia,25,827.04
608fb3e4278943a38d8c72df78087c4c,313,267,46,Asia,16,1369.89
60957b07332c4a5c9c12a3768d5170ee,254,218,36,Africa,21,1663.03
60964989139740c4be1c946612d09283,141,120,21,Europe,21,984.74
609939051e9d4418bbf758b2c1f0db09,362,337,25,Europe,16,3855.94
60994b09423b4d198545268cdaa99064,197,154,43,North America,20,975.62
6099d97fbeaa41beac1a7f89c83ac55b,213,182,31,Africa,20,1700.19
609d7c4a6cef44e59bf928138bfba714,174,149,25,North America,19,1430.56
609da4a708234dcb9050c84eb9d98d6f,321,278,43,Asia,27,1915.36
609df318104143e58d9c2420002e4c59,87,49,38,Europe,21,775.09
609ebd62b82a40959ed3f768e57763d2,179,129,50,South America,15,896.73
609ebfa1636e42218de878932c7bd2fc,189,145,44,Asia,21,1173.83
609f4547394445e880c88f68598cc8f5,205,185,20,Africa,24,1625.42
60a0021443a741f98dd8cbc535c8d565,298,252,46,Asia,18,1579.53
60a04da7784a42fabb061f767fb2c03c,155,104,51,Europe,21,690.66
60a36e07dad04753898f2401846851a9,325,300,25,Africa,17,2485.72
60a3e41a693f47db886dd8613192ee58,58,18,40,South America,24,588.35
60abd0052c604f4fac1e087f48900434,211,182,29,Africa,21,1370.37
60ac58d7d5bb44708006a4171cf78d5d,115,92,23,Europe,20,1251.71
60ae6d519a85427ebf2e1e5990ea14ce,49,12,37,Europe,22,392.6
60b272082b994006a3dd8f9e7956b4fb,225,168,57,North America,21,1247.1
60b27c733fe041a59cce93a606845252,248,204,44,Asia,17,1561.77
60b44166519a42b1aa7e144f6352c1a4,62,44,18,Africa,16,478.02
60b50188e7ec4c3bb70526ebe4303626,215,168,47,Oceania,19,743.3
60b67746c724460fac9642354bb34841,364,347,17,South America,28,3194.07
60b6de72f1374dcd9951c4263dea9a26,365,359,6,Asia,16,2501.3
60b744b236774932801e22445e2a096c,205,176,29,Africa,22,1199.92
60b9f9b9f29d47e985507597264f9de3,176,144,32,Europe,19,1315.42
60ba353d430b4c39977dd6178c534cab,365,350,15,Africa,19,1854.21
60bb7dc035b24865b5878575270bf68a,69,36,33,Asia,19,691.26
60bc8322f1dd417bbcc188e614b08f1b,82,21,61,Europe,17,297.34
60bf6a70f900454bb14061c2b15807aa,365,333,32,Asia,23,1640.58
60c0d9c43deb4cc580c49c7530703db6,169,138,31,Europe,20,1246.88
60c2420e590e4d6da84dc87dbf75d49b,80,39,41,Oceania,21,594.21
60c244af5fe24b77b99b47ba28013c30,69,39,30,South America,21,313.75
60c5fcab316f4dc5bedfc1c514a5616d,55,33,22,South America,24,352.61
60c658feb7584903a1e8baf96d21d169,86,48,38,Oceania,19,632.03
60c8c44742184345b12a5fcf08161f0a,181,131,50,South America,19,1230.67
60c91b232cd84af0b7a2d3b9b3fc0928,139,87,52,Oceania,19,667.89
60ca640724b449a5967fb94858d2e62f,365,336,29,Africa,21,1686.69
60cb25120eab4fad9df5a990b2b29a5e,260,245,15,South America,25,1946.36
60d18677a86e49e9a0ec0c73b9af3b56,261,250,11,South America,24,2618.35
60d31975d6534960ae295ba5cc9ade26,142,126,16,Oceania,25,739.2
60d471a4b1ae4374b69a13b5433afec6,326,307,19,South America,23,2141.14
60d60ce9dcda4eb9be53d4b72e03fa8b,157,128,29,Oceania,18,857.04
60d73558da0c430693fe7606c6fe51a2,195,170,25,Oceania,21,1375.18
60d7525d5d5b45d6aa89cdc7b734dabb,243,198,45,Africa,18,1150.67
60d8536b165c4639915cf2c77b2930aa,186,143,43,North America,16,1542.81
60dacd58c6c84490b0a852615ac86b0a,90,52,38,South America,25,753.01
60dca32df6e343279da4c59f3dcdeaa8,137,110,27,Asia,10,1454.89
60dd3495289d4b569503100a7b36697e,101,50,51,North America,17,663.65
60de2d82d0d04122a94354327cf52ef4,160,129,31,Asia,25,924.43
60df2451cd08470c89b1c986abb9ddf9,92,56,36,Oceania,20,552.58
60e0ee0c31094beda368fcfacfafe159,365,318,47,Africa,18,1809.14
60e1c87cbaa0417a89d70565d11f8250,211,159,52,Europe,21,1123.23
60e22f8e7e7a417b99b5e7130c1788a0,140,85,55,Africa,16,999.74
60e36392afa04fd98bf7dcf4638fb684,193,149,44,Oceania,29,1011.46
60e454e954b3406a87bcc4e55ea43684,125,106,19,South America,21,811.22
60e63d5a7c264ab5887fbe4003d1abb5,263,217,46,South America,19,897.96
60e71cdc92a3477994d7dbdfaa021554,172,140,32,Europe,21,1387.32
60e9379eaa5e450f8396f5fc17c5d26a,159,122,37,North America,25,1298.18
60f14bffe61d42a8998e63f4092384f3,362,348,14,Europe,21,2466.44
60f2cc71b28d40cab159b0df93a8c9df,358,317,41,Africa,19,2225.08
60f3cd72da6d4ece8ad81eea5c4fc4fd,313,280,33,Africa,20,1910.88
60f40ac082a44a3f9df9902ee861871c,43,16,27,Africa,20,468.86
60f51341d4a444b1bc8e0625a36f2836,360,325,35,Asia,18,2297.04
60f5f0b4368842cb9e7920be661a9a32,209,162,47,Europe,23,1085.16
60f9856d32e141f487fcbcf74a4ae4e4,338,302,36,Asia,24,2171.23
60fde4c1afa44aafa7030828541629ee,190,144,46,Europe,21,1128.45
60fecee03fdc4c2bb2d24797f2b32bcb,300,257,43,Africa,21,942.6
60ff72d114a74f0e8879d6ceca906427,194,162,32,Africa,16,1668.31
610854bf6fe04d008cef610097cbc95e,227,188,39,Asia,23,1145.71
61085a71670349d48311bedf1bb7c9d3,365,348,17,Europe,21,2400.35
610a10a46f5049c399b8dc1c3ed0e347,333,286,47,North America,24,1497.87
610af50111764471838215ca407daccb,265,246,19,Asia,18,1879.75
610b066d2b7a4c17b359fc915ad80a74,169,137,32,Asia,19,1590.86
610d45e32aba41bba1100f7df9c37489,235,196,39,Asia,23,1220.4
610d7a9037824cfcb05f147f4a346fa2,185,133,52,Asia,21,1172.9
610e429d7a2b423291d905e7453d6a17,274,241,33,Africa,17,1843.18
610e7b61ddbe49b7a9baad02b5357c06,297,285,12,Europe,18,2481.36
610f1dc95e4043f8a8a65f8e3a62d54d,363,335,28,Asia,16,1363
610f57beca2244b0b6b21a62a7cbbb15,175,140,35,Asia,21,1088.72
61106a9bffa741678207d877f51309dd,271,241,30,Oceania,26,1960.88
6111837c5ce04dcd8de7f540659b49d8,118,71,47,Africa,25,627.2
61150a69f1b249eba25c04db578e1066,361,346,15,Oceania,19,2903.95
611832c5e8db41a3a303f7a1f091087d,47,8,39,North America,16,220.73
6119d7a366a44db1abdf878632c0fbc2,335,289,46,North America,15,2238.78
611b1baade3042809399abdfc0967b58,365,311,54,Europe,21,2180.5
6120cc8c36044ffe9cde7c5b6f983063,365,350,15,Oceania,21,2656.48
61232e2c632249cda10496c2d0e23940,365,335,30,Europe,19,2347.58
61240827d8d74e11986a4f4fe9e5bb8a,193,141,52,Africa,20,842.58
6125c8314fdd4194a58969cc2a7a99e8,67,12,55,Europe,16,469.97
6125d2cd8e8e43d985f0723bdd1e32ec,362,316,46,North America,19,2202.38
612d1a176b8041fdae1a49217381e7e1,285,232,53,Europe,16,1037.58
612ef7545627400db6d8e0f7d42d3ddd,316,285,31,Africa,16,2171.13
612f305b5d1240bfb9de542cedd9514a,122,86,36,South America,24,953.24
612faedf8ad846d3b6c18322051e7c88,282,261,21,Asia,15,2254.72
6130023f3a434fad8c4a7f2eccc8a0be,148,105,43,Asia,15,557.59
6130e9c2ee654c9a9b63640042899697,277,243,34,Europe,24,1968.41
61314e08b4fb43168c7c47c0dab48584,328,284,44,Oceania,24,1871.61
6131fc7bd0644a7f920cb942f3d094d7,186,173,13,Oceania,17,717.56
6134875b8a3f4a708820e5f3ebf2ab46,230,211,19,Oceania,16,2583.89
613778fc73c442f9a95136dbc24c878b,336,277,59,Africa,20,2177.19
613812d6b9724953be4faad2624053bf,291,259,32,Asia,21,1807.42
6139268cc7664ed7b8ce327c103545e2,292,249,43,South America,17,1110.14
61399195b39e41528be5de04d9fb3bef,174,157,17,Africa,21,1398
613b0f6b4c6a4308a0dc521f84a57b2b,145,97,48,Europe,24,459.56
613bc755c20f4b89a4f009d97683c895,172,128,44,Europe,22,1149.4
613c633d97da4102b33c80679b011f13,158,120,38,Europe,20,1279.47
61403e34a22c49e18c3f64c51917387e,177,139,38,Europe,23,1138.74
61410862809841a385adf579d8b02837,326,268,58,Asia,23,1565.73
614370b8f6c94492a8de144deace883e,311,256,55,Africa,20,1712.47
6143dbdba146476fb2a0b39bc1777f2d,250,220,30,Asia,17,1573.68
61441550c1174031ad25e3ea8b57183d,64,38,26,North America,19,395.29
614637a74e0e4067a8c1e8342df94481,86,50,36,Oceania,22,553.73
614c0eac0a644708a3b9d1b79dc414bd,213,175,38,Asia,23,1505.03
614e1b33ccd746e182af8ff838534545,105,80,25,Europe,16,610.75
614e99608f0145debedf428cc60c4d9a,77,15,62,Africa,20,315.51
614ff5c2f2534fd8b9740819f75cf24c,249,225,24,North America,16,1914.3
61502816339547128f2d1c6ca6d77b19,101,49,52,Europe,22,140.05
61520a5cf28b4cfd85a5740ffc4430b8,176,136,40,Oceania,17,1429.49
6153a6a6c1db43f297615b99200e5a03,260,210,50,Asia,20,665.92
6154785fb44548d5959a133c2fe1fea9,289,275,14,Africa,22,1989.75
6154bc3e9b434e01879e52b03329d3a1,248,204,44,North America,18,1074.05
6154ced03ab0425e92db61d19ba4ff77,45,5,40,Oceania,21,340.92
61552548f024494d9b732026a6f50f3a,363,362,1,Africa,22,2118.92
615a4c6613aa46a99040592766605622,362,326,36,Asia,18,1540.98
615aadaffe464cfe96faf11944c9e88a,253,220,33,Europe,22,1880.09
615de44740964967a15b5b95d841ab21,365,330,35,North America,16,2081.19
615e0d41ce1e42dea49b00a6a8692a23,220,197,23,Asia,25,1459.62
61659f593aa9417ead12e94c1aefbb05,128,104,24,Asia,26,1018.33
61668ed68e994f35b22b37e0e7a34bf4,132,107,25,Africa,22,1154.23
616a82f8c32e4a0e90562a82bc10876c,365,323,42,South America,22,2729.23
616c4f1ec8b947258055f0b617d2ca8c,207,171,36,Oceania,19,1212.01
616d065191224f49be2e9fdef738a417,226,209,17,Europe,20,1684.58
616db82143c746ddaa3e182be30220d3,364,322,42,South America,17,1557.75
616e7e6e0eb24039bc674992ce222ec9,249,196,53,South America,19,1110.01
616f4c11518f4e7e8b23300fded70f78,215,188,27,Africa,20,1233.81
616f4df3382744c588fdcf3a30925bcc,335,301,34,Asia,17,2229.62
6172af631b264c038ea2d9c08d3828b5,42,12,30,North America,18,308.95
6173952a8d4742768504523bd3fe5b3f,336,307,29,Europe,19,2667.97
617829c2641d4932bf79dae81cc1ec2f,226,189,37,South America,19,2150.22
6179f2b9841f43eea6f07209e194bdd4,63,38,25,Asia,13,537.88
617af29107c04df49b1cf58fa438df45,329,272,57,Asia,18,1782.19
617ecd39535c4eada5a382d33676bd41,71,41,30,Europe,18,865.3
6180f1423c5641ff96d92c6298be8c3e,66,32,34,Europe,21,583.75
6180fa32c8a942ef964d34290daee81b,327,272,55,Africa,19,1643.46
61819263235541eb8ca378e899c3fa8b,46,18,28,Africa,18,113.57
61825bf8f5904629960228c4ee1e2b5e,238,189,49,South America,19,1225.38
618aed3b20254855b9cb8a95adea7da7,151,123,28,Europe,18,1110.82
618c068441e844a891e2641dac47d6f2,329,285,44,Africa,20,3345.94
618c31bbbceb4c5ca14f8031083d317f,38,18,20,Asia,22,117.78
618d8d18f9ba40c19130bf51c2da5092,198,170,28,Oceania,17,1252.4
618e5e6d8678413e8036d2360c3146ca,187,154,33,Asia,21,1335.46
61900eadef774d54a7b0ccb10f66e7e0,320,279,41,Africa,12,2247.27
61905c5e334140f6a88aa50ce13a0601,246,224,22,Oceania,13,1995.82
6190a2825f6a4fcbbdad7978fcb0a764,87,41,46,Africa,11,338.05
61911d78ec9f4c259434db1b24e8ab72,244,217,27,North America,25,2303.94
6192091e120b4402b84fad4b846be55b,168,141,27,South America,23,1111.08
61923c3224b94fd6815c2acac70711f2,247,224,23,Asia,17,1659.62
61938e0e7a5a40b9b66b1327e2a0d5e2,310,274,36,North America,20,1596.07
6195cac68fa9497b9f298d60822487a6,91,71,20,Europe,21,1172.37
6197dd77272a4ebbaf0ff1eeb10e40b5,193,169,24,Oceania,21,1460.04
6198e942fdd545199e894549d3232109,347,318,29,North America,17,2886.71
619a2b5daf2c454b916fc942c12fb7b4,98,75,23,South America,23,1252.26
619ba8801af044508e6f3daecca79ba8,82,57,25,Europe,17,683.51
619c051af26e40f9b46efafd094a0641,256,216,40,Oceania,20,2038.42
619d5b1346c04b80bebf3cac06f57f5b,76,35,41,Asia,22,691.83
61a191b804354729aa354dfdb4e1376e,207,157,50,Asia,20,575.86
61a381b174ad4d20ae1527fc8538fcae,365,345,20,North America,25,1965.39
61a55e1fd73a4b3a9c6b3149e93bf927,163,114,49,Africa,24,1285.32
61abb62efdec497fb0c3e6330b9ba3c5,178,152,26,South America,19,1134.34
61ac4ffa454b47e09105ce46da4e018a,338,292,46,North America,23,1451.07
61ae2da4a54d4b1aacfa5191ec2963ad,335,286,49,South America,22,2002.88
61b0013fc4284996b4987431052f3822,342,298,44,Africa,17,2177.16
61b3c043ea6440e897cda03354dc3354,78,30,48,Oceania,19,519.05
61b418d9eff84769b353267f2712843b,147,91,56,Europe,20,847.65
61b4804a48f545ee97cc4514570a80d7,188,158,30,Asia,19,1238.83
61b58533f2ff4c7581c549a48660b268,365,338,27,North America,24,2053.12
61b5cb9cd6884790a3cca67c3c340e7b,324,307,17,North America,21,2725.06
61b5f708f1c1471ebf665d20f1d9ba07,263,213,50,Asia,20,1864.05
61b78d9bed2a4f8cbdb9fca59a12c0ac,58,33,25,Asia,20,394.52
61b7cbd65a3c4bca88e836adf63c29c5,72,48,24,Europe,21,434.19
61b951bfb01e4d32a0a3d51fd567a7db,349,312,37,Africa,22,2120.85
61b96df1965341b3886fccee021361de,286,229,57,Oceania,19,1815.48
61bbeb6a41d54c00bdfb9bd93401ccba,180,142,38,Oceania,21,991.06
61bc8531070543979ce46008f71f9ffa,80,29,51,Asia,16,275.82
61bd6208ac124307ab9fd98675cd2b94,214,193,21,Asia,24,2514.2
61be618780ea471cb1275e5de97c2c6a,354,321,33,Africa,25,1669.28
61c062eaf4034f439c0df2918be9c795,214,191,23,Oceania,16,1619.97
61c0ddecbc1a4b9984ee37f73a6659e1,114,95,19,Africa,25,983.73
61c3e0a76d87476484c26c43626fa29b,251,231,20,North America,20,1652.46
61c467639ec24ae2b7cf61f1622ea311,86,65,21,North America,19,283.8
61c608e2ba5841ec9d48c480bbb85bfb,204,164,40,South America,21,1621.89
61c9e0c3f0a740ce99b2da127d68a007,190,168,22,Asia,15,1324.86
61c9e17dae3b4d7295088bb629a1d7ce,363,333,30,Africa,19,2023.95
61cd6aeebdad4175b70d4e13de2eaf87,216,165,51,Asia,18,1459.86
61cdd624f40e4252b5339e64ae3b59da,232,180,52,Asia,21,1162.86
61ce8ff293b4423bae7c3b0967daa649,90,56,34,North America,20,752.77
61d08b7abc9445f5b1dc83fd0e9d3eda,47,23,24,Oceania,18,346.24
61d107f2ed0744fd8bd5ab7836461dab,297,266,31,Europe,23,2190.66
61d724a729b043bc83ec626577722700,86,24,62,Asia,25,808.66
61d82528f04b40feae9c81d8eff1af27,120,91,29,Africa,20,758.72
61d8e56234184e1aaeb43a4db5b9995a,113,73,40,Asia,20,832.84
61d920e182fc412e9b1e0c47a9efd2f3,150,103,47,North America,16,506.39
61da8a8cddc34e4aa311572df22ad033,365,365,0,South America,19,2571.97
61da974c0bac45b4921cb89c5380764d,157,131,26,South America,18,948.42
61dc27a41d32451aa0241050123a4b46,122,73,49,Europe,22,781.9
61dcaed8afd548669ce778814597059e,183,132,51,Oceania,22,968.08
61e147efa76341f0ad5d2a2a4b249610,80,36,44,Africa,20,783.72
61e1d0dab4ac4fd1aac499c5569c16a0,214,172,42,South America,20,1167.65
61e221d1fe2d454fb1ea597c290580a5,141,91,50,South America,19,624.25
61e3cb7429964fc5849336b3b6e0edd9,364,349,15,Asia,14,1772.29
61e55e226df14fce956a01407ddcbf4c,239,199,40,Africa,22,1403.52
61e5bc01b0d947268682540712aaf446,180,145,35,South America,19,1846.1
61e68f084c4b4c4aaab0bbcb456313c9,201,170,31,North America,18,1341.28
61e75f22ba24487db591999dd9e10f63,325,299,26,North America,13,2382.42
61e91ce938cd412da3692a45528b367a,193,155,38,Asia,18,1523.21
61ea0ee72d5240ccaa01a4d8cc6d7192,122,92,30,Asia,20,740.09
61ee829587e840b9894683baa8d9c9a1,70,41,29,Africa,17,710.09
61eedf57a07a4560979d3c555788cb50,170,120,50,Africa,21,1616.88
61f03144a1c14051a807b271aeb8cc4a,52,18,34,Europe,18,226.69
61f0bfc4e65641f398e0af877713e146,352,299,53,Asia,18,1231.66
61f21732b3b14d62b06c8976d63e81ad,343,310,33,Europe,24,2644.46
61f804c65d4e469894d423bd8bebc092,285,264,21,Oceania,24,1879.83
61f875e8b0824288b2f64fd7faf21d02,364,343,21,South America,22,3078.67
61f8d573b25a4ff6b98264cf0b48850d,79,59,20,Europe,18,435.98
61f9d9ec04de48968c18ef009b06ff59,274,229,45,Oceania,12,1568.44
61f9fe4bb6ed478692c6e9ff13e98e5c,74,48,26,Oceania,19,644.81
61fa7a3a0bbe475ca19b8d8a39e5e420,108,52,56,Asia,19,952.51
61fbcda409664d7c8df1a0bc93216473,363,348,15,North America,21,2698.64
61fee783574f4f00a47bba27906e142a,92,68,24,Africa,18,585.05
62000f7a8364499097d2fd9400c5275d,180,151,29,Asia,27,1571.79
62000f7fdd1a4011a539f232dd75bdbe,108,69,39,South America,23,473.15
6201207e266b4f56b12847cf233aa682,229,209,20,South America,20,1861.67
620168d32b9d478d95454fb173da7f24,364,325,39,Asia,20,1814.62
62035dc1d5be4d5bb9906875be470b1f,171,121,50,South America,16,822.66
6203a0b0d58a498993bef7fa920ba14c,351,295,56,South America,19,1435.84
6203eee7663c4d3a8adc4190ef2da27f,365,335,30,Africa,24,2213.95
620624dd6319444cb72039a6cec1de34,258,211,47,Oceania,17,1335.39
620cb72d2a6645b9b1e9f1993a63c517,314,285,29,Oceania,23,2318.66
620f1011305b4c5e8c2191e8aff067df,344,317,27,Asia,24,2466.29
620f1c91986e4ae0a8c4ac30e008745e,324,273,51,Africa,23,1958.23
62113b5677dd44dbb438f032201b770d,81,34,47,Asia,13,288.9
62120bdeab6f45b2ac8db1ed55082669,314,279,35,Oceania,19,1684.77
6212181d90f84deeb54995506e04e87d,324,305,19,Oceania,15,2039.86
62169c60bcf142a7a5bc9bac33cff90f,83,63,20,Africa,21,736.89
62197d032dc24adea43644507a71254e,364,359,5,Africa,21,2750.11
621d64898eeb41588f096e9b76bba7b6,290,237,53,Europe,12,869.6
6220e3c5a2e446a7849b6bc82acf81a0,365,338,27,Asia,23,2663.11
6221255a55db4513949c87f85e211d7a,277,241,36,Europe,24,2329.9
62222f551879480695223098550324f8,115,64,51,North America,16,539.48
6222a9a8c6824b33a59e7e59847562cc,203,175,28,Oceania,14,1302
6224a9d29df84f3b901ca00c40d4493b,252,218,34,North America,23,1557.27
6224defcad2f4ea2b9e61ce9f8e91fae,339,317,22,Africa,23,2780.09
622521bbe91d4819b5037aca3ff6c9ea,69,41,28,Africa,18,706.33
6226365692a04de08c079936c13ddba9,50,26,24,Oceania,22,167.15
622b01b4d6334aafa1323cd5cf18e05f,276,222,54,South America,23,1404.3
622fdf8ab74642c0adc698005ffc03f3,265,209,56,Oceania,19,1703.76
62359b29ea924a3d92b362a08431d243,331,312,19,Europe,19,2808.05
6238d530980e4f6bb44af1a453240994,293,271,22,Asia,18,2597.42
62397b4aa4ad4f67bd33c101da4556f1,249,194,55,Africa,20,922.74
623e33504f9e44d18f06e55f9c93ce54,188,171,17,Africa,16,1543
623f600a1d4c4a6ebbe8117b8e71bd7f,29,8,21,South America,23,177.35
62426ca4cfec493197314a10a30bb49a,150,103,47,North America,17,893.7
6244da1ed2e645f7abfb4bc11f0d9908,365,365,0,South America,19,3315.07
62452d0d560c4ff49341ea71c74dd24c,234,179,55,Oceania,18,1022.66
62458c1fee384aaea152ddf3f1543254,64,21,43,Europe,19,94.21
6246e5519cf342d5960adf9c584bdee0,265,230,35,North America,17,1477.68
624ecd6d67bd44b994b571689d9376dd,68,20,48,North America,26,323.14
6250e0ebbe7c4961be9ac916ffa13f6d,107,73,34,Oceania,22,553.64
6252010123f44a76833a7e914347c0ca,174,129,45,Africa,22,905.37
62522e0ca4234668ae202c06ed05b1b0,198,171,27,North America,23,1032.79
62531ab911e54f9eaf173654c5ae6db6,158,118,40,South America,22,1156.89
62575b096d8e468b8e85d697dd0d30eb,129,86,43,Africa,24,444.06
625a1367178647a28e25b57c1f2946d5,188,150,38,Europe,16,920.62
625b670f5c6e4c0e9e56db68bf2ee55a,365,344,21,Europe,21,1412.98
625b8c64db6d4b2db2f38a82105e4572,305,282,23,Europe,20,2156.12
625dfa0d263c4aad97db24e68aded93d,214,186,28,Europe,18,2266.54
625e2c3eaf7a41a6bbfd97e0f1d0a221,235,203,32,Europe,14,1188.88
625e4355be004dcea61d2c063bd745e0,365,364,1,Oceania,22,1676.87
626006fe331a419983d86bf09819380d,123,69,54,North America,20,649.87
6263117971ad463db1aa970367aeb09b,250,203,47,Asia,20,1422.96
6263e79ea759460ea171e30fc384b927,280,248,32,Asia,18,1975.46
62645e6a7ad34ff787aebaeb07cabefa,309,272,37,Europe,23,2313.56
62654b0710e64aca83a2a24db92b2bce,363,329,34,Oceania,21,2112.94
62655227ee2a4f1ab7e004fb032abed6,323,274,49,Europe,21,2024.9
6265926f9fdc4642a7866e02675ff391,355,302,53,Asia,13,1667.74
62678a774d3641fda8f6431a58567317,348,325,23,Europe,26,3068.65
62682c73d6d54628bb96b0f6f36696db,133,87,46,North America,27,735.62
6268d0b6e5204c648e75523a3f018325,29,1,28,North America,15,371.84
62699f861fba4ccb887ed0256f340792,114,61,53,Europe,18,391.35
6269eb0755a34f03bc20d8bab12ed808,365,358,7,Asia,18,1788.46
626ae0ea54184eb68516b2a7539981e7,86,48,38,North America,18,454.18
626b1fb661b64e36b84681da03bd34c9,156,105,51,Asia,18,1055.28
626cf0c39f8143e1a95991879945dbee,266,244,22,North America,22,1636.8
626d38077c6f46f2a2c2be0e8186b3e3,357,306,51,Africa,20,1370.34
626eeecbcfe24808bb23dd5313b8fa84,143,117,26,Asia,24,748.72
626f8add0c4742acbdf1b306bd66e7ed,365,331,34,Europe,18,3181.47
626ff2786bf442178fe696be93e4b412,291,241,50,Europe,21,1562.9
62704823f5d8414b9b93aa4fd623c93e,365,353,12,Asia,21,2170.55
62706e7efbe049b8a645a8c3a2d70208,77,32,45,Europe,22,320.57
627123a2904d42878a87cba07a6ba3c6,314,263,51,Europe,21,1475.84
6271e5660b624f9abbc54e7a5a81cfc3,71,45,26,Asia,20,654.47
627332120af3425aadc8062671555875,72,38,34,Europe,16,590.36
62734ec86f8847f99a23c4be62e895e8,192,141,51,Africa,18,577.86
62741ed49d104f9996b6323b3d70840d,201,161,40,Europe,20,1306.98
62766bf5ec09405abbb92291ae4dc900,356,334,22,Europe,19,1958.41
62774c63b70646ca8648861d59d5b8d1,82,27,55,Africa,18,466.11
6278f9841bb54afcbed4b679ab2dc23b,62,28,34,Oceania,22,522.83
62791d4448fe4259b00a78c81879446b,287,239,48,Europe,23,1353.77
627ad4e572784dd88b7e48a1e8d8ca18,168,139,29,North America,21,1810.69
627b2774b2b8454082470d3fadde6613,365,333,32,Europe,25,2038.77
627bad50dd224ed48b9aab8763b6926b,210,170,40,Europe,16,1708.61
627c7ab1a6fc406fbc8dc9f5b7813ac6,260,213,47,Oceania,22,1628.78
627f416176974dc69a4d958613037916,316,288,28,Oceania,22,1947.09
6280990596f64429b1397bdf57455f06,73,58,15,North America,20,413.18
6280b28d381a4624a8e348483ef0f526,283,230,53,Asia,17,1387.37
628303eb1e474c4982d1778c422df7f3,122,78,44,Europe,17,393.12
62834dbc9a874168bf416e6341147b6a,365,324,41,Asia,17,1871.26
628595837ad647b9b147529a345c118b,249,203,46,Africa,17,1042.01
6288a44f7b8a4133b778aeb20874559e,364,317,47,Africa,24,1746.35
628c2864997240db9e0ec7c7557cf5c7,263,224,39,North America,25,2225.63
628c945d2262490cb8c56b927d32c4ac,104,52,52,North America,20,681.37
628e40e3fcd5496fbb5e13bf0efbcda2,270,246,24,Oceania,24,1380.58
62915b54edfd4d218c935ad02b3fc134,194,174,20,North America,21,1432.05
62932abd084440409953abbbba029a68,342,311,31,Oceania,14,2274.36
6294d808d7b54108b02a83a7f1e13986,39,8,31,South America,16,346.7
6294f870d26c4c3e8c59470577095ae7,356,334,22,South America,22,2765.26
6299ef0e4f8a452da5fbe1a7c73607d0,188,142,46,Africa,24,1092.89
629a69d257b84c1fafb52fa88f3e2c13,57,43,14,South America,21,602.1
629dc125ca7f43a1b942af86b9048821,167,122,45,Europe,21,946.63
629f6226064d4469b23b71c549b858c9,48,34,14,Europe,22,370.68
629fd7eb36de4af6a640114b501b6fc2,322,278,44,South America,19,1794
62a0fb0e30ae4d75834ed923f125b379,297,276,21,North America,21,3076.53
62a21ff9cc18413d900940a39172ef09,109,85,24,North America,16,741.34
62a381346e87482e929a1dda3edfc026,60,18,42,Africa,22,289.98
62a7d813343f473d8df4ddf89395ce3f,192,144,48,South America,20,781.87
62a7fd70afaf4fc3bfa4c19a882bb0a2,188,161,27,Oceania,19,1318.69
62a9595822724591a755f83c3fcd00d5,365,326,39,Africa,19,2693.09
62aa2689bc824cdcacb7476442cbf02c,302,251,51,Africa,18,1276.32
62aa3d59179f40249a915bfb9338a638,220,175,45,South America,19,1121.96
62aa88df01a04c84967697d9f9a97c21,363,348,15,Africa,18,2112.62
62abd8ec5efc426f96b49fb72dd9633f,159,135,24,Asia,14,1376.15
62ac7bc70fa843038171f3a7065e224c,309,263,46,South America,14,1849.35
62b0b6b37f654ea1b7d451438ad59211,363,325,38,Africa,19,2311.04
62b1a001dba94ac7839adc89e285f2e1,255,224,31,North America,26,2011.18
62b2bd4fb6ee4f25821b3ad1ff85674a,213,171,42,Oceania,21,1654.02
62b4af84e8dd4351b1740c1321090d63,279,253,26,Africa,19,1452.37
62b4cef4d53c485fb2f2a515f4312507,223,170,53,North America,22,1300.4
62b58e354d664ce28ac34c548a22251d,363,322,41,South America,21,1837.08
62b6e7271cb4481e8612e3aab03dfa41,115,83,32,South America,20,685.28
62bc178d985b4890a2e9a670c8561745,365,330,35,Asia,17,1989.19
62c0dd0afc994b1cb6aafd67584c7bb5,120,101,19,Oceania,24,657.41
62c22873747a4c369a14895ab2df5c71,111,59,52,South America,22,709.3
62c63971108747b5ba81e78556959439,166,120,46,Africa,21,839.87
62c761dc469242a08856f12db23d28d9,53,26,27,Africa,18,694.46
62caa11c5b1e4ffb94d9fb41a12ca4ab,322,271,51,Africa,24,1307.12
62cc222e6b96416f93d1c972d8f51ee6,362,337,25,North America,23,2113.39
62ccfcaae7a646e8999aa8597e138728,201,174,27,North America,25,1452.41
62cf581baa9b4718aae53230b4a94430,287,265,22,Africa,20,2306.74
62d09120ae1242dea7e56dd44e035a47,354,306,48,Europe,17,2062.99
62d1ed7b2ebf42a89c453a236404f0fe,121,98,23,South America,22,882.95
62d3004c942947099e86faddc4604de1,114,68,46,Oceania,17,559.1
62d439410efd4b3bb561034698ba6647,132,102,30,Asia,19,631.24
62d6bad34b604cd3aaba06ebbe117b2b,215,197,18,South America,18,1533.88
62dc288e615b4f2c8134c9a52737c274,308,273,35,Europe,15,1602.9
62dccdc18fb442b5a82b789636ff5db6,242,185,57,Europe,20,1424.81
62dd31b8412b40debeb30d5314d03346,101,56,45,South America,19,621.53
62e0439c48584b16b0401b970a92bb9f,48,7,41,South America,23,317.05
62e2d6b9f850404f8bde1ffaebb99f12,198,158,40,North America,19,999.26
62e429f7d4fb4c1981da8c7031ac465b,51,13,38,Africa,22,288.17
62e4ba0da4c44cf182b5d291b2c7d650,360,360,0,Africa,19,2421.28
62e54663c0da49708d2d561ba76e0114,266,231,35,Asia,19,1922.41
62e782ed22624ecb931a36c4fb2c9a9c,334,302,32,North America,22,1933.12
62e9141f76ed4787bba024d45a41cd11,114,78,36,South America,21,1256.34
62e9d25c085041a8ab81f667539ca1b6,364,330,34,South America,24,1491.93
62ea16069c92483b9c817219f8dae2a3,334,289,45,Europe,21,1714.31
62ea34523f4146f6bb801f24ec209e6e,365,323,42,Oceania,27,2226.91
62ebb6caec6d46e5888b9a7179e7154c,188,147,41,Oceania,26,1415.09
62ecd16fc4014728a375d0a008725bd9,107,73,34,North America,16,629.91
62ed940716ca41318e4811c3fda0f6fe,223,164,59,Europe,19,929.77
62f36c81790b421a8da159bafa4d6c51,365,350,15,Oceania,19,2910.71
62f456292b4645f38dd57b076d449daa,89,52,37,Asia,22,497.38
62f76529d4174d3da70c391526308601,64,26,38,South America,20,422.49
62f8d2e07b6947edba40a93170a7fc36,167,128,39,Africa,24,903.57
62faf7270c2f4297aacae8a8a4877d27,178,138,40,Africa,19,1715.53
62fb5056921a42ad9b9f92a9d716de58,332,284,48,North America,18,1443.81
62fc70a4da71424cb340bf0a0cb8ab78,291,262,29,North America,23,1762.67
6302164cc3284fb1b16fa9f5d517a341,329,277,52,Europe,15,1698.89
6303001974e544e2a75fadca681659f7,106,65,41,Europe,22,542.05
63050d56db904ff48881d4f2bd621d54,36,3,33,Africa,21,339.13
63094622f779468e80d57adc77fde33a,50,5,45,Asia,23,411.72
630b00a00a444d1f9f9acbeaa7bfe686,336,309,27,Oceania,21,1927.95
630b57cb66ea4909ac49e9c1af89bb2a,113,58,55,North America,22,188.96
630df41ebb284dd3accb34dda5ed2c6f,202,177,25,Africa,15,1263.52
630fa0268ffd47c2b2edc18aade8a69c,259,235,24,South America,20,2034.47
63124ae507194c6995f5014ddfb7642a,155,118,37,Asia,17,1371.92
63140f4d29454760b4378b1df51cf108,231,178,53,Asia,23,1258.41
63141dbca6e34a6ba453ed10a06d9d3e,283,228,55,North America,20,1877.4
6314bbe49dec4f74aabb84fb854278b1,54,9,45,Asia,24,333.26
6317534143ca44b1a9aeb80899e4bc66,365,342,23,North America,18,2522.54
63197ac5a14e4204b7f147f5f3c69b20,262,209,53,South America,26,1190.05
631ebcf5ff1d4e0287418cd2338e264f,234,177,57,North America,21,1221.78
63206379b07d47288ce8a7e639609836,147,119,28,Europe,18,873.57
6321ce749c674a81bcd1055ec465d3f6,318,298,20,Oceania,19,1471.52
6326ae8bf1494fe185c1585d03318837,59,9,50,South America,23,554.22
6326c36de2ff47ca9d436bef4f7c847d,270,234,36,South America,20,1659.49
632745b1ed024fd8bd2f3fbd36b5fc72,133,82,51,Oceania,21,501.02
63279761491049a0b5a54b161ddfb0b2,365,355,10,Africa,23,1749
6327a6f88d1045a4bed99ad707635271,125,87,38,Oceania,20,675.46
632895dc3f3b415cb6285c1267577d0b,353,330,23,South America,19,1965.31
632c1285a59c426a9a2b75ba63bda7f8,155,108,47,North America,18,945.04
632caf1ef84643ec96b5a06cadab3ef1,257,210,47,North America,16,1107.79
632dca1bf68d45218bb0e9c846b1050b,231,213,18,Asia,22,1722.2
632f6fc5a9aa4823a0866dd2e99465c6,55,25,30,Oceania,14,257.96
6330eb900df047beb7ec7e643c465af1,365,335,30,South America,19,2462.09
6331a151b3c94c78af27770c02061858,268,236,32,Asia,18,1963.89
633657716f664f8a9916cf4cf66416ec,168,148,20,Oceania,21,1052.57
6339ef87eceb4f09aa4a26943fb61d42,175,131,44,South America,16,1131.25
633b6df387bf4e77872623dc2a978cc0,89,68,21,Oceania,19,629.59
633b76ebca294a9a88aa40c9369a47a8,297,242,55,North America,19,2046.42
633cc40260fa4e49a356f18d92ff0167,229,191,38,Asia,24,1160.8
633e303c3b9845e9a7f14672e985e374,135,88,47,Europe,21,325.26
633efb0703844e43b0b9777733e3cb51,58,20,38,North America,23,387.03
633f28a84925437db3ed6dbc44937972,295,255,40,Africa,19,1051.95
634193ced8c34a41a573971ab57b5b54,350,319,31,North America,19,2134.88
63430e5134cf48ce94aff8eb37ab9892,346,303,43,Asia,20,2028.31
6343276f4def4f67818e0e9e6b7bfcad,62,25,37,Oceania,21,267.6
6343be8fd4d54d58b2b0ca46012cbe01,37,17,20,Africa,21,360.67
634536c6b9fc401f920507c00bd7271a,333,285,48,Oceania,14,2561.96
63459688a14944b09cd42a044c600f46,37,4,33,South America,18,287.1
63481b043b9049d5ba203cc73da1b8fd,69,39,30,North America,17,671.54
6348ed4ebd3143a0b98b4958a73df137,205,173,32,Oceania,16,1310
6349cc19375e464e8e5c25ff00dc410a,116,86,30,Europe,24,1018.54
634a6f1bf15b4b8aa811ff95e2e263a3,282,250,32,Oceania,23,2142.41
634bcd792c6b4e1ab1cfa9eada3410e2,162,126,36,Asia,23,897.66
634d80a0c3d546659393658fcf10261b,272,214,58,Oceania,21,1565.28
634d93dc6c2245d68996ae507e280b6a,213,179,34,Oceania,24,879.52
634da33535d14f8dbcc9c28bd6b819ea,87,34,53,Europe,25,631.24
635aa8b6fe834ae0b9374b23fff1a89f,195,171,24,Asia,18,1914.06
635caaf3339e4907a7b19e95a012a2eb,345,305,40,Oceania,29,2103.94
635cfcae9b4642c5967d1213add68a27,129,73,56,South America,17,1202.95
635e58612db4461fa7327d4d572664b6,190,156,34,Europe,19,1279.83
635f8c8f380045b990770d20a64e462d,94,41,53,Oceania,23,490.28
6360041d2c3d43ff9c585ddc9fbba379,30,3,27,Africa,16,91.5
63603e06d566444980acd2f56b9ecf58,230,182,48,Europe,23,1185.1
636166bc901047ab897f50f603197bb0,145,109,36,Europe,18,956.89
636285d305844d48b880d7495f6fcdfb,328,291,37,North America,20,1751.61
6362a104b62a4028b0b5dc63a3605fff,287,268,19,Asia,20,2674.65
6365d332c6244018a97bd43ea3abca32,181,152,29,Oceania,20,1193.65
6366635ca0504e79a909f9a05b276254,151,128,23,North America,19,1075.09
636a32b57ffc44b99d31dfd91ef5ea8c,283,243,40,South America,18,1994.45
636a9af5f20a4a2fa19d81111f5eedfd,175,151,24,Africa,20,1413.15
636b980bca724671a0aea326f0e1a946,270,227,43,Africa,22,1298.79
636cbd3f30bb4036b65c25e4ddbae8ab,346,314,32,Africa,19,2254.95
636eb2dd416b44d2b2305dfc8e348810,256,234,22,North America,20,1920.56
6371d70cca2e4e59979e111cc216860d,307,284,23,Oceania,17,2808.48
6371f6f2bae8451e89bc1ab8efcd2673,93,76,17,Africa,22,721.04
63721b3361b54518bd504a05ae8d6bcd,364,339,25,Oceania,23,1523.14
63733589f92441a3a465387e3df4c994,363,326,37,North America,24,1472.27
63769006a2d14d8ca815af18b91dbe2b,325,293,32,South America,22,2141.72
63779bcabd0a47d8869ff49df2792955,201,170,31,Oceania,19,1297.91
63795dd5606a4ebcaafe6da147959377,356,318,38,Africa,20,3306.42
63798ca226574cdb9b87322ecdd9ef18,124,93,31,Europe,23,900.54
6379c80597a9460992c1fce1c78d8a6d,307,276,31,North America,27,1939.49
637c9911158b41d8ba4e1846265c1e7f,290,245,45,Africa,24,1766.32
637cae9f18344616823949e20a5372f5,51,11,40,Oceania,21,217.94
637d7e9cca624c95b5b3e7c69f4ec72d,152,123,29,Asia,19,937.79
637df3e8692049c1849e26633916d827,286,248,38,Africa,18,2182.45
637e9e00d204402e94df00d652f1f0ec,249,220,29,Europe,22,2115.57
63835496bafb4a1396b53a15dfa77086,227,177,50,Africa,17,1043.89
63859f3632174ad69e1635da822abfe6,80,48,32,Europe,22,441.31
6387192223d24c2abdbb6ba20b6e696b,169,133,36,Oceania,21,1295.56
638cf48fa50448c9a573082dd79729f8,311,280,31,South America,20,3195.87
638d2049fb3946b383bcf3134d5fbddb,365,356,9,North America,17,1532.59
63901c0c1294456298e743800a3bbc8e,362,357,5,Africa,18,2366.46
63913dc772e340a8bb14088f20fd501f,120,85,35,North America,24,792.56
6394f1a4e0a64d2bb496e29ffba118c4,201,161,40,Asia,27,1677.64
63979be48653416cb356e19586cee47b,151,106,45,Asia,19,902.22
6399579b70a34be7a43f93ea2fcb0f0f,195,141,54,Africa,26,677.55
639bfe769bcb4bc584be1e3fd70ba183,365,354,11,Africa,24,1864.45
639e09ee6d4e4f98ac85fcb9759cc662,78,52,26,Europe,19,543.33
639fd0b86bf0487b92d8bf88c93dba0e,290,247,43,North America,25,1867.02
639ff3f7bf5f450e9d35e004c1e6b339,229,191,38,Oceania,18,1548.96
63a1aa0a51bf49f38d6ee23767685dce,105,60,45,North America,24,513.72
63a2d9faacbf4bb09390a7848620796d,199,178,21,North America,16,1677.81
63a33d59463741b7a79ed2b62b577e29,154,129,25,Europe,18,1125.62
63a3b205d55b4ab5b57f9f7bd59574a6,231,194,37,Oceania,13,1632.73
63a52197d09c45efae2e260d408cc065,295,257,38,Oceania,18,2659.09
63a8669a89604216a475a7a0696990c4,95,45,50,Oceania,20,565
63a8c522c9254a1994d135c76d5898d2,203,156,47,Oceania,22,1186.23
63a9282d2ae04f3f8e7269587278db67,139,102,37,South America,26,1061.22
63aa4cc7e7614c29bd56e8965d780feb,184,142,42,Europe,22,1217.15
63ab07bfbc004b7aba485d705381d2b8,311,264,47,North America,16,1544.82
63ab21df03fc46b5a8542c54d463d119,203,181,22,Europe,23,1305.48
63acc6c793994b2d85686ae1acad67d4,308,275,33,Africa,23,2519.62
63aced7435204e859c9853690dd7dc87,185,149,36,North America,19,1312.42
63ad2f80baab40ef96e052e40b3b5322,350,303,47,South America,17,2153.27
63ae20520ec340aaa67de052cb9fa54a,345,307,38,Europe,17,1767.19
63afd75ae7e442a0ad24b64b1eaec325,259,233,26,Asia,23,1593.58
63b10c71f73a434388ded77a0dead8ff,363,354,9,Oceania,19,2723.42
63b209b9c2484ebe99c5862deec830b3,101,63,38,North America,18,787.74
63b23f6e7b0043a997d5c7b39c462101,359,330,29,Asia,27,2430.99
63b2f7132cb749f584c1e772f9b9bb02,225,171,54,Oceania,24,831.14
63b48cb285274451a9deff14d6ea251c,65,38,27,North America,18,453.98
63b7044031914d858e5f2a02153a4e26,365,333,32,Europe,17,2490.58
63b86ab5d10e43b0b252b54a9dd3114e,298,259,39,Asia,22,2715.71
63bd2a2f8b444915a110387c2a81f06e,272,225,47,Africa,19,871.99
63bdc55bb7074a159b2b965ca0c259ff,275,234,41,North America,19,1426.38
63c13753f29c4baca29e0cc83199213a,180,144,36,North America,18,761.46
63c137f7931c457bb2828b7ddcd59eb9,77,37,40,Europe,27,542.93
63c3e3d2cdfe40218275c500a8fd3905,342,294,48,Europe,23,1997
63c678fc54ee43eb83d6aca6027e4971,214,163,51,Europe,16,1014.6
63c7042eeedc4982ac6b9c07882f6fbe,364,351,13,North America,14,2352.11
63c7d42e512a4510bc1146244278ee59,263,217,46,Oceania,22,1257.15
63cbe3191a57497194142b9ec852f828,122,80,42,Asia,17,739.17
63cd383d44674aff9cbebb8a56ad58a9,353,322,31,Oceania,16,3179.27
63d2366386024e37b24185983be6041c,252,220,32,Asia,20,2020.24
63d35dd56b9243f59754aca3ee4433be,20,1,19,Europe,17,76.57
63d407972eba456fa323fa04d7920b26,119,71,48,Europe,16,347.51
63d4a6e30d7b4bdaa1bc0e92f9c8eb65,291,240,51,North America,16,1765.91
63d4d2219b6b42c3ac27c5299e051c23,364,340,24,Oceania,23,2909.85
63d5599470c6463191463e2fd70de904,251,231,20,Africa,21,1771.25
63d597306317456894a456b241b5528e,365,351,14,Africa,22,2873.24
63d5ef6361f44311ae881e76140774c0,108,61,47,Oceania,18,618.14
63d70e21ccc34987a0905a50ddfc3b3f,123,91,32,North America,19,947.59
63d9a221509b401cb28fc3886d347ed1,355,326,29,Oceania,18,2271.98
63ddba811edc4d46b2cd2ba7a83ab0a6,339,299,40,Africa,17,2585.01
63df9b2736284e24a4514dce9a044c03,171,120,51,Europe,24,719.45
63dfe8757f144cf3a1049d18070609e5,245,191,54,Oceania,15,1647.24
63e1a3c65dd84feb8c8b3dcbb2e1e8d6,299,252,47,Africa,21,2320.88
63e2d695c0764a32be7d23c0250eec98,64,31,33,Oceania,21,480.65
63e53d57fc19411fa47b89a3db03df3d,172,132,40,Asia,24,1263.44
63e69f1d4c404174b2a6f7af928b4ea2,276,252,24,Europe,19,2592.97
63e884ce93a04e3bb5fbe20b0dad3e22,357,328,29,Asia,22,2411.38
63e8d0866de04d0b89510953fdc00a2e,232,182,50,South America,23,1062.59
63eab66ab06e489fbf7030b4c903d351,364,330,34,Africa,18,2688.5
63eda71b14984874be57647f450f1b9a,311,257,54,Asia,16,1568.53
63edc53d110949459690fc5212766136,44,10,34,North America,17,458.74
63f25bd1e2f348eb9cb8fc011903b681,230,197,33,Oceania,24,1879.38
63f35e1834a743bd9ef90692873eeaa1,115,84,31,Asia,22,850.19
63f3828c61bb41139b684cd85e99c454,66,40,26,Africa,20,543.62
63f53d103f8f4503af9ff5d950135a47,156,117,39,Oceania,21,966.86
63f5c8e326c24a2ea9f3ef1126bb7306,153,112,41,South America,17,1052.37
63f7027b5d5b488d8e84dc8b17c6bd22,96,58,38,South America,25,845.57
63fa3ed729894e6a94ee2874b8954a02,49,29,20,Africa,21,448.41
63fbbd5ae3064f5c9610d45abde284b9,200,150,50,Africa,22,1088.83
63fc59005f0b419481646113c1cda1c6,251,204,47,Africa,19,1681.84
63fd2f0ac19244e98974c1d0480b7242,194,155,39,North America,18,1412.58
63fdce58c1a142618bf940b5f2b9ac40,299,259,40,South America,15,1934.35
63fe875fb859405bb9e69183740f5138,165,107,58,North America,17,749.45
63ff695cca37406796ff348018ac1676,56,25,31,North America,18,308.96
640057fd77de4bd2aac6d9fb7deefc42,274,246,28,Asia,18,1783.92
6403bc807a9a49dba05a95970dea939e,303,253,50,South America,20,1673.5
640426512e624dbabddb9703dd144ad0,254,209,45,Asia,23,1194.36
640456892e004c4889fd6b68b926d610,60,37,23,Oceania,23,589.82
64097872f6c8491dacbef2e19b5ac97f,287,258,29,Africa,20,1917.12
640c37a2c75147ee92f63c7cd6265608,171,131,40,Oceania,24,767.53
640caf517e0b45c48b6835d5c7117188,189,149,40,Oceania,22,1189.87
640d8220c404472aa8017d57810a9df5,215,195,20,Europe,18,1873.37
64108a0b3c41448986e01b164b0e7f3c,132,95,37,South America,21,1042.35
6412b2a822204d569c0c6ee67e3d4ea9,333,282,51,North America,22,1132.58
6413ec536d0d4ad3be41254e4edccdb3,305,275,30,Africa,22,2743.19
64140e706597451f9a1d8ba701cd1cbc,41,11,30,Asia,27,519.27
641509fefd6b4e0cbda83c47ba5fe435,307,275,32,Asia,19,2158.12
64189c021e674aa8bbebc5926a484465,113,72,41,Asia,16,752.28
64190725cd7f47e9b43fe9192a7fd8a4,101,69,32,Africa,12,1272.97
641910c593dd470c8de54d365e53648d,143,97,46,Oceania,18,1112.4
641a52e0f5444d69a3047664b3045d22,365,361,4,Europe,20,2865.05
641d44e271f049f7b02ae8f1834bb646,156,119,37,Europe,24,934.05
641e48c748224bdbadd3e2c7a2461e5f,328,266,62,Europe,22,2163.15
641ff3eacab048abbe60b0070ce57406,346,294,52,Oceania,22,1902.81
6420093a1cf74286a587e718dd770c5c,46,8,38,Oceania,24,673.26
64288c447cf4456eae46f115bb934f63,353,305,48,Oceania,23,1553.41
642b2877054d42b0a9c03d36fd91ce02,207,181,26,Asia,22,1892.25
642da833613d474a8537a93c41d426fb,147,108,39,Europe,20,566.95
6430fabfa0b9495ab96359cec5c02ff7,277,257,20,Oceania,21,1941.71
64311b0d9572411c8d338f8ce2669b40,126,86,40,Oceania,21,285.36
643421bfe64a44b7a12f8eae7067c06a,244,204,40,Africa,24,2006.39
64350cabbf4a459fab2bd1de6ba1c92b,362,348,14,Europe,21,2959.99
643533f407ee4a24867bfb35fa941b1a,123,78,45,Asia,17,890.92
64376551656945aca91e9e9425b586de,259,206,53,Europe,19,1200.64
643849692caa47eaacec2edc43f99d1e,225,186,39,South America,18,1375.48
643880dc803c4434be2425a4970bbafa,365,336,29,Africa,15,1744.36
6438ad78e0904871af2c9a61d88f6b91,290,240,50,South America,17,1577.29
643a90302df34d57bcf205fa95eb0093,263,211,52,Oceania,17,1342.89
643bf26c7a8540b9a097fb37344e8eeb,151,107,44,North America,17,955.15
643ec21e7eb5448e81717649bace5c8c,97,63,34,North America,21,626.75
64403e85089a43f09814e0c842fdc1e1,108,58,50,Africa,15,360.78
644871e5e3c54da49544dba45bda7a82,296,261,35,North America,21,2823.59
6449497a70ca4a92a71f976057fb8d85,181,154,27,Europe,23,1109.45
644a4d6d18b84c73930dfcea4e5b779d,225,187,38,North America,15,1753.29
644c2c0103274cb6a4835cdece0055d2,365,325,40,Oceania,19,1651.57
64513e6d9a8e41c9bb57792942274bfa,241,220,21,Africa,23,1895.25
6451d2c0368c4abeaee9d0d37ba1e77c,159,113,46,Oceania,18,946.67
64530e4d043f4d1eab4ffea456de308d,139,88,51,Africa,14,849.45
64539831512649199ab2288a8745388e,158,106,52,South America,22,968.58
64558adb14794ae1b84e117325785bdb,125,67,58,Oceania,17,563.07
6455eb23a1c84fd3bcfe3847602a3cda,314,258,56,Asia,22,1520.47
64567addcd4e44efbd6004d99056a422,275,239,36,South America,26,2615.33
6456802a59454c75bf6b12c6c97f9a71,104,75,29,Asia,22,640.36
6458081c0a614794b563ae8153a95a7f,127,97,30,Oceania,25,964.67
6458fa4767a4454498a97c09da6a3915,327,280,47,Europe,20,2590.27
645910942463420c915cd3004f91680c,283,249,34,South America,24,1654.25
6459140318e14642aea6e69869e7a736,256,209,47,Asia,21,1372.26
645a9e4d4d134ebf8656ae662add7bd2,328,295,33,Asia,20,2069.37
645df75ab5974c499377064ff58e4d9e,298,249,49,Africa,25,1676.79
645e1e9f0a2240859fa3f020b3919f12,77,56,21,North America,26,838.97
6460dbc2c0b24d98830954942bfb6a09,245,196,49,Asia,16,1952.86
6464b591026e487499aea4e01a5bdf71,133,86,47,South America,24,476.31
6467fde405fa4530aef1b50b0ea4b7a4,192,163,29,Africa,18,1253.88
6468008927074b36a5bcb9e4b5922d52,109,57,52,North America,21,737.69
646ae18537f84840a8c1e9ccc752b849,313,294,19,Africa,22,1760.99
646b2fb6dce946799419c04d78b0e893,96,57,39,Oceania,18,327.25
646d51d82ae9490c8cceb1f2fe7f7bca,76,37,39,North America,21,155.62
646e941e16ca42f09ebddc2dd35544c0,263,235,28,Europe,19,2220.14
646f60af34734d998b0bdfdf4cb75da7,203,160,43,Africa,20,1076.91
64703320568049ac8692fdff58eb4f8a,363,344,19,Europe,23,2348.86
6470f1c05ae14d548fd49f7ed62a3846,285,231,54,Europe,14,1400.88
64717f287b8d47b6adf8938771b9be89,226,209,17,South America,23,1265.87
6471cc1af3ad4e499d57a5cfe9e0c4ee,266,246,20,Asia,24,2228.35
647283563a3a49bc84e54177cbb9c443,104,59,45,Oceania,21,780.57
64728768d6ba44a89d3d954216f8396e,84,57,27,Asia,20,571.25
6475306d1d91472c94f255eeeea8c736,90,52,38,Oceania,21,653.37
6476814cf7f842f99ee88ef48084a4bb,114,74,40,Oceania,20,984.96
647c0a54ae704d5a977eb10038e445e1,182,155,27,North America,24,1179.66
647cc879ce95474997c3ded1cdb395e8,242,220,22,Europe,18,1476.03
647e25428dfe4bfbbe10f19ff05a9427,365,318,47,Africa,18,1432.6
647e634b9cbc4d89889adea378026658,167,122,45,Asia,19,1109.9
647f3f5308474b68a6569ebb39ee6a1c,139,78,61,Africa,22,828.84
6480227ee0454e5ebf6c2e8a801bef84,108,62,46,Asia,20,469.42
6481420feef3487dabc4e6a0e93dc343,159,132,27,South America,23,1068.73
6483411feb5546e2b83f388b4d75de71,185,139,46,Oceania,15,1637.58
64892a5a10f945c89034f54ccc33798e,329,279,50,Africa,22,1939.38
6489a27ae4494d90b655edf014f1bd9b,328,288,40,North America,17,2747.74
648b6537738d4d75abd0aa044a9c2326,95,71,24,South America,20,445.17
648f34e372e34c409696d33e8cc2f4c9,143,117,26,Asia,16,1656.87
649049e68b33434e9b6a35edbe0e8f55,364,357,7,Oceania,19,1511.39
6490d48e727b48d7a7a27bedb48ffd6b,268,236,32,South America,24,2171.25
64911c4f00fd43faad6b5749432d6092,231,177,54,Asia,19,689.73
6496e5a31d434fb095e9688bb21abcfb,149,123,26,Europe,24,1358.01
6499aeb1c34b40e4931b4036df6121bb,157,118,39,North America,20,596.97
649c80fc6653439c84bc31e0a654a0e4,141,109,32,North America,20,1021.13
649efaf3401141bdadb22ff21cd9053a,153,129,24,Asia,20,1040.73
649f4094246a419fbe9a1351cc1230c7,118,76,42,North America,23,665.58
649fb0acbb5c41faa6253c7fe018355c,208,170,38,Europe,17,1042.74
64a00b49bf3f4f2886853bb6ffeaf084,259,214,45,Europe,19,1431.82
64a1463e738b48b0ac7d13e02a4bd33b,173,152,21,South America,19,1102.77
64a19073441c465e87cc6968098e21db,119,75,44,Europe,19,918.35
64a19d1d69b44ba3ae19fcd694ba253d,83,59,24,Europe,18,593.51
64a4c5a3e7834be9ad878ed79b0d1cdb,365,359,6,Oceania,18,2004
64a6f22284084e21891d62cf07d95f4c,130,96,34,Asia,18,856
64a71203f71c4d4b9503b3d66c451852,103,57,46,Asia,23,799.84
64a77d972f6747dd994f3f95fffd94f3,222,171,51,Europe,16,839.49
64a8172d612e4cf59aa0769f5d808565,365,345,20,Europe,19,2846.71
64aa931ec4cd4f19a6630cd5ed9f7249,358,355,3,Oceania,21,2683.2
64ae0fe525a649e697539c54bc031be2,365,321,44,Oceania,15,1438.25
64ae7a05d61943d5a32edcb80e080aba,154,115,39,Asia,22,1273.23
64b08611d4f24d9981d1de7656ede4ed,268,228,40,Africa,21,1333.27
64b4b4711c40452e86f664cce921402d,312,256,56,South America,24,1560.64
64b717017df14a60afcc125d95c9897b,267,213,54,Oceania,19,1094.92
64b98c9f485c4ae9be8513948cab3e7d,186,147,39,Africa,17,836.41
64b9a9a9feb648bfaaab4c8c6164f3f8,35,8,27,Europe,24,297.91
64bb2548e1f84ae8a2b458edeaa1af63,96,39,57,Oceania,20,444.44
64bc7d98cbdf4ae8b0e7769f8c9a3355,82,39,43,Africa,20,438.06
64bd1bc6bb9f4ce18072779f4ec49b54,84,33,51,Europe,18,466.11
64bd2e0c3979471898387c8eae1bf3bd,67,41,26,Europe,28,740.21
64bfc55bf11e4c21a8126436b3adcc88,283,248,35,Asia,18,1933.64
64c23a63bb95405ca70bb5673e7c3817,140,106,34,North America,20,1479.01
64c2456267a64462a39aaf400ab44109,325,283,42,North America,19,1721.61
64c7791bfed84e638d4428daaeb1d4f3,332,289,43,Oceania,20,2155.1
64c94bf12c214cb48a0611d35914d071,155,108,47,Africa,20,634.25
64c9c494f26c4844b5c9b716927ea2f7,326,301,25,Africa,21,2482.12
64ca792fa3344c72940ef2bfcf932f0e,350,320,30,Oceania,19,2516.1
64cb5a98af2549318ca478516f515acb,91,59,32,Europe,22,646.66
64cc22e74d4940779b49aa25ccd13108,72,30,42,Europe,19,283.67
64cc36a1663b4822aab31fb929c33772,199,157,42,Oceania,19,824.38
64cdfb74de29481e932e30521f7b666d,113,92,21,Asia,18,807.82
64ce4e8a010a43eb802a2eef66a4c424,325,280,45,Europe,17,1957.39
64cef612ff2a4794a4c78baee3142f92,285,228,57,Oceania,19,1916.63
64d02b6682214b88ab3293bb3dad539b,310,284,26,South America,17,2271.26
64d0972039884f2098692980ea418ee0,115,78,37,Oceania,25,923.83
64d7e7f023d84460928638dcef5ba39d,338,293,45,Asia,17,1609.31
64d80cfa2864453a82e1c59a78671bd9,159,126,33,Oceania,19,1294.77
64d9ff1ab033425e920e4a632e71c7be,83,32,51,North America,20,410.96
64da0a5977d74e7396616c76f2aceddf,185,152,33,Europe,24,1562.41
64db2f135cb7404f8d4c1269d2fad51e,194,153,41,Oceania,19,1286.91
64dc98ad62924b30aeb0cffd5b81cece,102,64,38,Asia,15,667.53
64dff2150ece46a68d3e47db4ac0f338,365,329,36,South America,26,1870.42
64e1f975e05e40f39ea0bef50972468e,267,228,39,South America,19,1626.47
64e6de29f46849bb90b2d05b45e7d2f9,179,143,36,Europe,19,1065.28
64eceebcaf6945c88aa4bca137e3f0c2,90,62,28,Oceania,24,705.54
64eee919d70d46898a240ea795f32569,267,220,47,South America,18,1518.95
64f10154dfa747d99010f7f6ba246811,271,243,28,Africa,23,1211.29
64f192623a224a5e842dd881fc09acdf,314,275,39,Asia,23,2266.85
64f3c797e0e34464a415256cb205a743,320,279,41,Africa,22,1997.04
64f47db261d549c39ecc86e51bf42734,47,15,32,Africa,20,365.3
64f7e97456fb4bce8036aa954bbde5bb,345,297,48,South America,24,1554.52
64f898d4c3bc4410b9622aa9a8f23c61,360,315,45,Asia,22,2334.19
64f91cc7fe36428aaaae80851976f7a5,126,101,25,Oceania,25,946
64fa950b76214108a956214a71cecd7b,209,192,17,Asia,22,1861.3
64fad2fa5fe242d5af7fbbea7ca07fe1,314,258,56,Africa,26,1366.79
64fb118334b0490c8887207a3292afca,168,113,55,North America,20,724.03
64fbbd5be714426ab1f50bcbc42c8f44,229,189,40,Oceania,25,1407.47
64fda8ac3ed44a8e8236a99693dae57e,332,301,31,Africa,19,2321.59
64fe196f395b41d88824226bf204e702,211,185,26,North America,24,1565.78
64fe25858b1f4add8920d5e046e3e9f1,305,260,45,South America,20,1506.92
64fe41214a444e60aa78d9a864ef5b0c,345,295,50,Africa,20,1308.99
64fea0e8677348b3a04aa7bd02107b51,131,95,36,North America,21,698.21
64ff1e37e08947d59cd503f36d1fd0aa,258,212,46,Oceania,21,1463.99
64ff9c157caa467f80d78c637916baf3,247,226,21,North America,15,2662.8
6502cbc3db3247cd8c77366f2eba6d9c,322,288,34,South America,29,2694.63
65030aa4a66842c8a33c68b1eb4d2fbc,294,243,51,Oceania,18,1762.39
65033f7863b24a62b327004f70a4ae49,365,321,44,Oceania,21,2068.29
6508b4d358b64060b33089743f3d5f64,271,246,25,South America,23,1726.73
650931cd44714fd980bca74107b8554a,177,120,57,Africa,20,954.92
650bae8bba184810824f57e62244f81b,142,99,43,Asia,15,900.3
650d35fe3b3c4b7fa6cce3e8f6efb223,326,274,52,Europe,19,1960.38
650e51fc1d1c4f9ca45e768b2609b727,230,207,23,North America,23,2148.78
650edc9e03ad4d9fa0df6e4f5f74b95a,333,290,43,Oceania,16,1989.42
650fcd989b764e0e9a17caaaf0443829,231,194,37,Africa,17,1161.21
65101233efbd44ef969a328cb67723ab,267,213,54,Europe,20,1205.46
6512ba40c9314a8fbfb5300e95503360,194,174,20,Asia,17,1247.46
6517b6d09bb045f8a56ea996470ab84e,176,137,39,Asia,22,1131.19
651acbf731b9438abb924028adfc21d7,314,290,24,Africa,22,1768.93
651b377f09344bdf88d7f054d28d3733,146,104,42,South America,14,390.91
651c0e669d9140bd846ef00b534f3370,297,253,44,South America,16,2235.39
651c156d59b041eb856c7286e9577eae,67,14,53,Europe,22,314.2
651de0c28a1440699feb4c37303dc7b0,351,310,41,Europe,20,2185.44
651ef0c329b84785bd1a859442027ce6,145,119,26,Europe,20,1022.65
651f12c807964b99b8bb62dbf7e240f5,283,255,28,South America,16,2703.35
65209ee7169c406d97f0ee4d5e1eadce,356,309,47,North America,23,1612.52
6520e19fd14c4c67b1f69b7207f5e110,361,321,40,Europe,24,1824.77
652154c5b3f44ffe8068e7fa6c8b892e,184,145,39,Africa,17,1055.73
652233c37a4c4c09b7b9528635681b30,96,67,29,Africa,14,984.66
652351c71cff46ffa1f763d748b0152d,314,277,37,South America,28,2050.7
652392ff7b084cafa7e69fdd344c633f,354,315,39,Oceania,20,2260.5
65249a809b254e26b77b85a5b9878fe4,53,9,44,Africa,24,229.77
6525bb851d9f4911bbd42f4746fc4d4c,170,125,45,South America,21,1232.41
6526af9dd15d4d2aba2e609e10217ca7,356,306,50,South America,25,1806.6
6526ba61f96540269a1b65f114fbc2f5,214,168,46,South America,21,1277.31
6529b9ead73e4839b8d0e9f34544a671,68,37,31,Asia,14,358.33
652a5b3f66ba4217b7a3918ac457e00f,310,282,28,Oceania,29,2101.56
652d07f5776e4102be2da24076b2d290,288,258,30,Oceania,17,1675.78
653166a5666d46569a0447c224b004dd,186,150,36,Asia,22,1309.73
653211c7a54c4173a83e168e66d99796,244,213,31,Oceania,19,1986.21
6535225f39df4c4599d2ba362eb43117,305,257,48,Asia,20,1686.04
6537cb5efc3c49e08f90c3d9a407e4c1,58,27,31,Europe,22,603.58
6538f78ee2754d60a05cbd4ec5e26046,217,189,28,Europe,15,939.92
6539699d90764a48832140a3fddc18a1,151,121,30,Oceania,13,933.79
653b3a43cd1d44f6a4ebd2d3ee45a71a,310,262,48,Asia,22,975.91
653fdd14d4de4db7b3f8fa906fb8dd60,364,350,14,North America,17,2665.38
65401d519ba841e2a813f3b59fde4088,283,234,49,Oceania,20,1613.89
6541060894504f5aa2189388a6da4408,94,58,36,Europe,25,543.35
6542c972eebc464fb0ab2ca28f74f258,142,90,52,Africa,22,656.4
65435c26f07741889fbf43d59ae48c6d,223,180,43,South America,13,1511.8
65452ef20f124b8cbced25202925d556,129,75,54,Oceania,22,632.42
65488a9b1f9c4166beca47561d43e73d,294,250,44,Europe,23,2513.43
65494e0970b54ee2b925f0e88fd80fef,349,333,16,Asia,18,2402.7
6549ba2d8af049d19a158f1b0a8eb75f,339,293,46,Africa,17,1687.53
654a540a02dd4cdba67a98911bb8adec,73,41,32,Africa,22,107.98
654a74f552214fe3969071eb08f13791,107,73,34,South America,21,1000.07
654bb6af43844ac59f97bbc4a245f353,364,323,41,Africa,19,1905.96
654d6d7572c0463694f01d87cd01ecfb,364,327,37,North America,18,2056.69
654e71e6c37d41d782e6447f06178883,236,198,38,Asia,24,1171.7
654f926f888a4a7dbfbc265f37f746c1,43,17,26,Europe,23,345.47
65527c9b5a304abdb90cd7266e63c024,364,351,13,South America,24,2725.21
65529f917bc94a61851ef7fcc5152c0c,254,210,44,North America,23,1626.78
6554237a1295451eb6f8ab3d6e6b4efe,184,164,20,Europe,21,1075.75
6554fd326d07444db43954e34f889557,255,220,35,Europe,17,1370.85
65559c93931b45afb42a201bd882da1f,363,351,12,Africa,19,1736.05
6555ef2939f34faaa3e179df884bfb4b,58,23,35,Africa,16,411.14
655790b54a704cbdbc10bb1785719041,55,2,53,Asia,18,242.94
655cbb5f4f7c4148adfd9b9bb0ceaff1,243,200,43,Africa,18,1727.99
655e040276424c55833facff2a07c4ff,234,214,20,Oceania,19,1783.51
6560ec1da496442cac6b3a462ab58d08,120,92,28,Africa,20,827.25
6560ecfc2f9f4e02bff52cc44f7bfa34,318,292,26,Asia,21,2532.54
6561187b44504ed7b851593feb30cdda,192,150,42,South America,20,671.73
656327c2773d4dd5bc4e559a70a7f7b3,135,86,49,Oceania,19,675.98
65635172b64e4d2cbf901d7029275551,331,289,42,Oceania,20,1518.32
65654ceebe164668ba67d488ff923265,83,58,25,North America,23,649.85
6566067e11d34006960467fd2d4151b2,192,156,36,South America,17,967.52
6566690264c84f5f98d4a6f33b0f08a4,365,347,18,South America,20,2070.45
6566a1f84fdd42bea5270b2a1b3577fd,363,342,21,Asia,19,2112.21
65683b6ffa0442ca89826887c997b1f5,365,344,21,Oceania,18,1773.34
65692d5696d547fc816374cccc7bb863,364,326,38,North America,20,1608.02
65694cb08d8840dc8cba6236d1296c90,276,230,46,Europe,18,1118.83
65697d9243824448b9cb4275d1d5bffb,318,265,53,South America,19,1189.61
6569d76203e749ebb6fe25d882d6c68d,190,159,31,Oceania,21,1514.98
656a8d932d93407292befecd8e8eaef0,59,30,29,South America,23,230.43
656abe0db1e740ca8c6842baafe06dfd,134,107,27,North America,22,1058.16
656b94ae0534407486d083785af296ad,267,241,26,Asia,18,1345.49
656d6e030ed74030af36d90aff92a765,238,216,22,Oceania,17,2030.61
656f19b09315469b8d7035823b91bd9c,261,232,29,Asia,22,1901.73
657277e313f14e948f179498bb67177e,74,46,28,Oceania,23,427.45
6573f96afc1b4dda8be00c037d96c648,63,35,28,Europe,23,447.24
65753d3d98c849e3a4ce6db6fc741411,286,247,39,Europe,15,1409.03
657845eb28114f8994f455c7953ccd07,364,312,52,North America,19,1626.24
65797020b92548eca94b096f1ea69f8d,186,159,27,Oceania,22,675.31
657f53f47f0046e1894ed7140588a7b9,362,359,3,Europe,19,1980.86
658015b214aa4a0a925388019f4b1048,77,23,54,Europe,25,219.66
65801b461cab49b0ab33a6f3138019d2,88,42,46,Europe,26,328.29
6580d92f5f6641af878cc9697561f1ad,49,15,34,Asia,19,14.84
6583addba4df4e828e57b340775f314d,181,163,18,Asia,18,1914.1
6583f380bd7846ec990ad1f566a2ee84,82,32,50,Oceania,22,598.32
6586ad96ea6f481f94e5fe00bfd9a79d,52,14,38,Europe,23,361.61
6589343f2eec4049899b2a93335123cb,170,120,50,North America,24,753.21
65893f9354824d4d97dac56bf8d3697d,318,293,25,Asia,26,2513.07
658a2665bb9c4f34ba201495a1d1ae84,113,71,42,North America,25,442.25
658b2266c4184055aa28b3b59240313b,174,148,26,Africa,17,1060.24
658cbda9b1d14e3195a02b1951aa8d88,124,76,48,Asia,20,802.75
658d6bf55f084f9ca4cac35f4dd731c1,28,2,26,South America,22,92.52
6592206e53e646aebc64cddb50b556f9,73,28,45,South America,24,453.03
659285612bd04b1ebd0915cd61b7002e,212,170,42,South America,18,960.14
6595b0e3e1224b3eb4bc1b30e6c3861f,336,289,47,South America,21,2159.58
659af9c191804b33bf6b3f79422e13da,110,58,52,South America,18,885.18
659b19cd80db43028dbfae534268bbb6,365,322,43,Africa,14,2095.01
659b1c4b771c4ed381931ba260514aa1,309,280,29,Europe,18,2262.53
659b6c3f3e1541c79df0a1430f1e2280,362,338,24,Oceania,22,2729.12
659c43691c1b47d8bb82ab47fbe35644,83,65,18,Europe,18,603.44
659e729c707c40e9a05ed90c4ba73380,356,316,40,South America,22,2613.22
659e9f752ccd45fdbadfce3bd6edc766,198,180,18,South America,23,1699.14
65a0b8367bc64afaad7d03e2d4f82d25,193,176,17,Oceania,18,944.65
65a25f23ae37450282a5db34f76c9952,350,318,32,Africa,25,3061.85
65a376603977460f88f9dfca14d1db56,250,207,43,South America,21,2295.8
65a8ba6d3c974a39b036c93a9b4f23c5,129,91,38,Africa,15,911.3
65a8dd3c68ff420b82781f14272c1729,327,306,21,Oceania,16,2705.99
65a99b8b130d4150a514f6dcc50f92b9,294,240,54,Europe,20,1641.62
65ad9e2094a84972a88c4627d0795b53,42,20,22,North America,22,305.17
65adab9f9ec84345987436f099be042e,337,307,30,Europe,24,2007.67
65adea8927c2439390ec2d7f324108ab,62,15,47,North America,19,666.39
65ae54ae3bca4d64960ddacf11b0d0c4,209,163,46,Africa,19,975.32
65b293f7aeef47d2a4bc21ef38d4a27c,122,77,45,Oceania,18,766.54
65b2ab83dbed4be3be6463e0ae83ab6b,100,57,43,Europe,23,373.83
65b2bd1c496c41d1b95d04b870dfc5ee,312,258,54,North America,21,1648.42
65b7387858fe4dfbb23b017dd80aa8e0,276,233,43,Asia,22,1318.85
65b8030cbd71478199318055e5f61409,191,140,51,North America,18,635.29
65b90975bd224155bc823bd40c2812dd,271,239,32,Africa,21,2161.65
65b9f534808843fe95d9649a9d2b446d,143,95,48,Africa,14,941.85
65ba4a225315442eae67d0354aeef905,340,311,29,Africa,21,3136.62
65bc1129710f44d8a2a44ee89ee26742,327,304,23,Europe,21,2386.74
65bc186edf67443bb942547296ebb22d,103,72,31,Oceania,20,582.46
65c0c6e4970043938e2567db500a82c1,181,135,46,South America,20,1197.05
65c1af1c12a34367bf70328aaeef66c1,172,147,25,North America,21,1231.36
65c248141c164fd39be2ec14c9ba5ef3,188,145,43,South America,18,1410.2
65c37a09522544c18224a927a0453ea6,97,52,45,Europe,17,456.14
65c3ab64a1294feb80c4fa5eab5fae96,146,109,37,Oceania,27,1010.85
65c4e09c4d7640d693c8df9e9b4ce9a5,365,352,13,South America,19,2312.59
65cb648a2d4f4c96aacc4a50136ce2d8,270,232,38,South America,17,1926.84
65ccfe0ce2b945f489f1780fbe1ca2b7,200,151,49,Oceania,17,1120.6
65cee4e3ad6f47abb70a7cc66752b04b,347,301,46,Asia,18,2123.74
65cf17afd706420a81e60d9ec3e0a9af,365,322,43,Oceania,16,1834.98
65d06c929e3445e297b296bd0e7df3e5,316,275,41,Oceania,17,1249.35
65d1bcd1394643068c74ac55bbae34a6,335,308,27,Oceania,18,2278.88
65d309160b01462e94a407e56005e50a,172,152,20,Oceania,16,1598.58
65d41d621c294df588a73397f55f22c6,281,230,51,North America,21,1705.66
65d4780f829d45d988ffede667141473,52,12,40,Africa,18,485.38
65d5b74476304c0ea6a925d823e4e6fe,270,246,24,Europe,18,2069.92
65d5fe012e63427c8e3e7d7dfd365889,200,159,41,South America,19,1036.28
65d68fca02144719aeab3217909ef89a,335,284,51,Africa,20,1500.07
65d6fe6414184a008c7ba184460e2add,181,134,47,Oceania,22,1003.52
65d71cd35f234c7d992278688e66201f,264,227,37,Europe,23,1400.01
65d794a176234a2f99e041b79d45a590,303,270,33,Asia,26,2142.23
65d7e6d007a44806be9404ab6a2e20e8,197,174,23,Africa,21,1674.65
65d7fb1955a14a098ce81c738938fa67,64,32,32,Asia,24,510.39
65d84a33b2fd466daec6d2fb38b6a128,194,167,27,Europe,19,1110.62
65d8aabe160f4526a50f08ebca5b2eaa,191,153,38,South America,22,1631.82
65d9225af22841b58d1a73cb1d121cd7,52,23,29,North America,19,251.1
65ddb0a7a0b844fc8e200ecdf18579a0,211,186,25,South America,19,1386.97
65de3dcf7911411c9f7eefad608de61f,233,176,57,North America,22,1486.13
65e23c2e44c34ec9990b9e8ad2001705,304,277,27,North America,18,2194.91
65e9331452cd45fbb57abba6b311ed73,167,113,54,Oceania,19,1255.32
65ed51fbaefe4e0f81ab46f9e7029a13,82,47,35,North America,18,461.94
65ed5e3dd47445589e53e0ff065dfcd2,242,204,38,Asia,12,1650.97
65eda632b3604512a8f837ebc54e435c,250,199,51,North America,23,995.53
65eefa260c70452680949aeb6c2b6d6e,206,159,47,Africa,22,1365.76
65efd7112c2947f8a460fc896ff8de81,201,156,45,Asia,27,1280.96
65f0eec3b80c4145b87188c061056acd,259,225,34,Oceania,21,2237.17
65f1402977b04441888a7108d30eab37,139,94,45,Africa,21,647.25
65f2b9a1f76c45c483d74c181e1c7b5e,333,292,41,Oceania,18,2954.55
65f64cd74fac410fbf283e8e883a49ff,232,190,42,Oceania,26,1673.94
65f7c967119e42d3ac60aae04aa272ff,365,346,19,Oceania,20,1953.88
65f8e27f768b4fa5aaaa747fb16ef0ae,199,173,26,Europe,20,1505.3
65f93b55f45249f5b0f85abf6a2d6635,38,20,18,Oceania,14,473.33
65f9510f711741c0919e9b9cdf441a42,240,194,46,Europe,26,1356.06
65fa96ebec9d44e79eedf308b9359dc9,75,55,20,Europe,23,457.48
65fb7e5d19aa4eeda95b7c3363340ef0,247,218,29,Asia,21,1404.85
65fbc75c9b3849eba0d0bd6b5db14b0f,258,214,44,Oceania,14,1394.1
65fc731d67ca4553b8349ffe027bbbb7,347,309,38,North America,26,2670.4
65fdb686a1b446dda0577cab191fdd52,122,72,50,Asia,26,553.17
6601e98280684622a475e6b39bb1efee,330,312,18,Africa,19,2676.61
6602ab80a8344d91a8da73054dc640e5,250,226,24,Asia,23,1811.35
660865a2c68540e7beb0ef31be21994a,147,103,44,Africa,25,1235.47
660934bc0e844060b556523adad1df04,80,38,42,Oceania,19,482.32
6609f9489b2d463a82b5d6025b8bc76b,365,357,8,South America,18,2631.32
660c4bdc3e1148f1a861cb873a6985c4,172,124,48,Africa,15,517.01
6613609e8d7c4b24b26615fb38de5ddc,186,145,41,Africa,21,1254.8
6613bd28d06f474192fdd3b494326165,292,273,19,North America,21,2608.51
66148a9bff77404e96517348a0e9c2db,365,320,45,Asia,19,2015.51
66153266eedb455d8d219489b18668e5,254,221,33,North America,17,1161.55
66155ca386a849dc9b20e0a5f05298dd,84,29,55,Oceania,18,446.08
66159100326846f692edf1d23ec77961,286,226,60,Africa,21,1444.16
66159c21cb07453b84b0b5f0340baecc,282,224,58,Asia,20,1429.63
6618b0633e514154a849b3c166722b3b,345,317,28,Europe,22,2342.97
6619c903e0d34af5af51ef59dbe4a234,365,350,15,North America,16,3402.1
661afdc988d94fccbb0244802685a06b,250,224,26,Africa,16,2012.68
661d9924c0c94fdc87744fb427efc870,74,47,27,Oceania,23,585.52
661f69f606f948ec9761172bf2f26176,83,40,43,Asia,27,296.99
661f91598a71423faa7608c21524fd11,69,23,46,Africa,26,158.34
6620a06bc38b4c15b5d675aabd751837,364,340,24,Oceania,18,2346.69
6621b6e7499f4a119b10e1a1d5053c5c,177,131,46,Europe,21,1436.48
662212ed885a4173bbbf457613787e7a,185,135,50,Europe,15,729
66223e673bd9414988f20236cbe86663,96,47,49,Europe,24,477.07
662485a3d0bd4ced951ce20a92051dee,277,254,23,North America,21,2375.76
6624f8d247cc440190858122b7ca5d42,261,216,45,Europe,16,777.06
6626d560106c4fa7a625044de2fc986a,32,17,15,South America,17,183.44
6628534fc4cb4dedae39b4861805e083,101,54,47,Asia,19,729.46
6629a2d6fe1c48d8b26e295c230509b1,158,108,50,Africa,25,339.73
662ad14a5348440689ba96c9a7458705,129,83,46,South America,22,631.24
662ca2db813f4ad78a937b8ec73203be,85,58,27,Europe,22,688.37
662dcf64458f461d8e7b02adc11b3e0d,125,73,52,South America,16,494.13
662e4d8a3dd54056b000dd75920aa5e6,48,13,35,Africa,20,227.16
66321c0ab70e476d98b2b8d3c988bf58,365,333,32,Africa,19,1722.36
663347b946014842b692b1508007ed6f,82,44,38,Asia,19,508.24
663686880fbc43ed89fe4039d41e5969,209,160,49,Oceania,20,1302.12
663812758f824f30a536ac54bb2b355a,364,344,20,Oceania,21,2725.09
6638df120f5c4409ba3106ac1e61f080,175,145,30,Europe,20,1156.16
663b96802f3a4f5fa1fb8603b143af72,245,215,30,Europe,22,1659.4
663d32867af04f19a4b36e2a36c8596d,246,212,34,Europe,27,1978.03
6640a0b1956247c087a32f1099f7731e,141,102,39,South America,23,1416.26
6640fba8ee594e88b3deb197dc6bf2f9,158,135,23,Oceania,16,1461.29
6646385840c844a2b6074247fd438099,208,151,57,North America,27,1176.7
66485649bef341e799f4282ba811c013,327,302,25,Europe,22,2040.2
6648e4311a514360bf083530d7e7aedf,340,291,49,Oceania,19,1240.04
664a10183f4a440aa6537ad8108caca9,134,104,30,Europe,14,1048.81
664f22ab882f4d1b93a2c60c94cdb424,109,74,35,South America,19,581.86
664fb1b487ea41b5ae0efb9c47bd64a9,279,236,43,Europe,25,1830.89
6652d67845d74d28be0da01c3cfb598c,330,312,18,North America,21,2548.92
6655e0d889d046a3960e605a75be6ff6,351,306,45,Africa,17,1271.55
66573606dae948b7a86133a8dbf86cc6,258,222,36,Africa,13,1785.39
6657d380f17d4a61b6013bc7e8134b09,249,228,21,South America,18,2169.51
66584aa16e874cde8f14c722b469a0d1,363,355,8,Oceania,15,1822.25
6658afd20b3e44e985be807a52c2ceb1,363,358,5,Oceania,15,2591.07
6658f5a8bd924169b8ff20584d29e1ff,60,42,18,Africa,21,285.02
665adeec899d4f7cb8c41687e06429cd,328,292,36,South America,22,1818.2
665c6119bdf04e779cf760f03d62a098,100,46,54,Oceania,15,372.15
665ef40c0cb04346ba9b3ff442b6fba5,172,121,51,Africa,22,487.37
665f0e9fe11f4e7e95dfe50cbd98809b,58,23,35,Europe,20,306.23
66601c0dba45429abe8b8802a1e295f1,184,154,30,South America,20,802.76
6661827aaf65466dbca1e1157c6e6096,292,275,17,North America,22,2360.81
6665c0327e2a454183fdaf6a697bd634,250,225,25,Oceania,21,1728.62
66677607c9a747d7b610904c05d8b18e,362,327,35,Europe,20,2554.24
666af6276f0e400b8659e24c4a9fb8a2,210,183,27,Europe,20,1204.62
666b3aa0213a4a85914121c51e059e47,364,347,17,Asia,21,1988.98
666c2731a0534d11b034fe547e2c6d98,352,306,46,North America,18,2182.03
666c8c354e2a4bc68498c40d5bc1cbcc,307,277,30,North America,20,2241.8
666d6cfc66f84e8d96719264bc16db73,316,289,27,South America,17,2911.23
666d8497c84443f0935f67086fbbd9d9,120,83,37,Europe,18,630.52
666dc5c04834400b8476703a45f694a1,102,73,29,Europe,15,598.54
666dc82b0edf4ac0ab13e0f28e327d99,65,49,16,South America,18,512.64
666e257a214e49a89e0c1910b0b12b15,130,104,26,South America,16,1026.98
667186da310b4aee970d47341071d804,352,334,18,Oceania,16,2679.2
66725a4ba5014498b329a66a0f1d524c,275,235,40,Africa,22,1836.77
6672b05fd0ba443f966dc9d5c46cfbf3,189,162,27,South America,24,1322.96
6674476317fa458a80bd99d952398db3,149,119,30,Europe,18,903.32
6674cc16da094e83b63f4df888ff0f3f,100,68,32,Asia,20,977.68
667639f2190c4e46ad81d1ce73caf241,301,270,31,Asia,21,2157.79
6679bff8d8b14e6c807898ef4cdc453c,193,158,35,Asia,16,1389.83
6679cde1750146668589778040098003,155,108,47,Europe,21,816.26
6679febb70514246aea01ca91188bef6,270,241,29,Asia,20,1885.14
667c828c02ee4be080b4fee1f4a32c91,323,304,19,Africa,14,2426.86
667d2a14779a4afcb95f0269678d6ecf,289,265,24,Africa,22,1905.77
667d9a1746a042d5a7b9ea67c61678ee,87,56,31,Africa,20,865.17
667e5b1825ee4f2dba0c7992930fcfb5,261,224,37,Asia,20,1034.78
667fe1b083104212b1a76ee542a43606,203,181,22,Oceania,18,1695.9
668025fa85544461b328c283286252a9,276,220,56,South America,28,1907.68
66817dfcc30541b79082f8173a624f3b,242,217,25,Europe,20,1787.82
668282a5adf14c99ad652ac4289ba9ff,55,32,23,Europe,26,393.74
6683a6659f774f9e8522a84003614037,76,52,24,South America,21,1067.95
66841a1ea09843cea3c2db417281e620,268,227,41,Asia,19,2801.28
668560e7c9894baba2c08f75dc2c4b13,277,226,51,Oceania,22,2238.9
66857851bf0344d2abec49993ef56275,209,184,25,South America,22,1190.28
6685c7e76faf46fc81daa5ebc8712593,68,33,35,North America,15,385.16
6686f8072f914056939d978a2b86a6f1,254,226,28,Asia,24,1807.86
6689f83aa77e4d73a0385e62d36b78fa,213,169,44,Oceania,20,1160.82
668c452c41ea4010ad010811ce660240,250,210,40,Europe,20,1997.77
668d4777ee674227ba26dcd76380202c,365,315,50,Europe,23,2155.41
669025f0670b4ba59c0654ad1f1d72d2,101,71,30,North America,22,386.39
66931cb928b746208fba0a07b8ffc1b6,345,289,56,Africa,20,1946.32
66943e01934e4384bb642316cf6d1ea8,241,201,40,Africa,20,1122.38
6694b24cc9da484dacf505bc91b69cd0,225,169,56,North America,27,692.8
6695964046e14b3ca8feddf4df082394,124,107,17,South America,18,738.01
669c6972cb304e12a66228f1ff15d669,286,249,37,Europe,21,2418.65
669c8b24a0314170af15cd4faa302865,341,317,24,Europe,19,2536.29
669fe295f19247daa5c86d373dd073fa,129,71,58,Africa,23,603
66a03a5cf0ac4f1cb07fec3aaff320f9,221,197,24,Asia,23,1423.16
66a055337b784ec6b2bc0545894a569a,153,107,46,North America,19,805.89
66a062d18dfb47bb860a644d47f37752,304,255,49,South America,22,976.98
66a19c5ecabb4d868e8b5c8f63ef8fb5,340,318,22,Oceania,21,2462.99
66a2ab47836f4fa4baf9ec1ab340b9e8,129,89,40,Europe,17,797.85
66a691c506b04640b5a045e298d0117c,264,228,36,Africa,22,2222.88
66a6d5dd21734dfe823b12ec0cc7d1b7,86,60,26,North America,21,685.58
66a7323b900940f6b2ecbc91a10f9a3d,215,171,44,Europe,21,1521.88
66a7ed5f0e734d2b92a1deef4e23f8a1,285,241,44,Asia,25,1588.06
66a896167c354ec89c1be7ba89711b36,178,141,37,Asia,19,1510.91
66a9c0ab70c2447494be9dfcd586fc6c,39,13,26,Asia,19,255.23
66abfdc975fd4e3da6421f57ab802743,131,85,46,Europe,16,645.2
66acef46e5ac43e3888f9f4ab6425175,174,129,45,Africa,25,1219.56
66ad0d2cf12a43668e9f50252135771b,59,29,30,South America,25,781.8
66ad48c261d34664940b5a60ffe1d15e,364,355,9,South America,20,1328.33
66b0ad0658cc45a2b8e3a814357d3935,365,317,48,Africa,23,1759.71
66b21938af1745af8b0dfb7070449b05,235,205,30,South America,21,1492.09
66b46f789af84313a0fcdd2e8a81d152,116,76,40,Africa,21,699.62
66b60e881b8c47528f167ec94c21a168,167,116,51,Oceania,20,1009.74
66b760bc25a94c14a1181d0c3941de06,364,358,6,Oceania,18,1509.98
66b7b02dbfbb4c3aa9bd35b343220612,95,51,44,Asia,18,378.08
66bb398a0249457198cf90ad47d63328,107,71,36,Oceania,20,579.01
66bbce6b48704ca696120f35c15e7a00,267,239,28,Africa,18,2113.72
66bc28435e514c14a46a102840f2b508,326,276,50,South America,22,1597.04
66bd8476b78a450d931b3b7448f6f1bf,182,156,26,South America,17,1902.25
66c020a2d30d4449a7ec44b5fe4dfb86,79,35,44,Africa,21,880.79
66c2bac8a033450882fd5c71a2f5f476,313,283,30,North America,17,2099.47
66c3227f079841d6b8bb88e70f98ec6c,365,316,49,Africa,18,1998.16
66c414de1c954525a9992970fc1a91be,50,27,23,North America,16,645.85
66c6927292fd4e11927bf92b25626e0d,363,307,56,Europe,27,1831.45
66c8f7596d8a47f18bddc1b7b3826fab,365,324,41,Europe,22,2559.75
66c91e50686c4799b8ef8f8a2994222f,105,67,38,Europe,20,946.08
66ca367f14cb4222a8012ad13710b4ab,212,174,38,Europe,27,1176.16
66cb384935ae4854b522424c2fa0e56b,51,28,23,Africa,19,364.13
66cbe27455584cafa4bcff5c703d4b80,153,100,53,North America,17,896.94
66cdda56d8b547798975f7761eaae092,340,316,24,North America,22,2389
66cdea1b432c49e198f319475c1f100a,153,110,43,North America,16,787.62
66ce45c0f0e149f1812a0fc337daa8bd,264,233,31,Europe,13,2163.76
66cfa8ef6e434691a2ae5fd7a09f02bd,364,309,55,South America,21,1976.11
66cfff3f11ce43eb965ea240f1c99de8,364,347,17,Africa,25,2766.4
66d4743594ae418a8b2a54cf904bd3c3,317,283,34,Asia,18,2345.76
66d7f8be34d54638b9724d0742ea9c69,356,321,35,North America,24,3610.79
66d8b55db78e4817aac800fbe8089e99,231,209,22,South America,17,1819.94
66daa6388c3f4e5c9300768c095017f7,363,331,32,Africa,20,1940.25
66db9419a1064373ab39080af09283aa,67,24,43,Africa,21,592.36
66dc3c66f0a047bbb20cd395fd7304e7,188,138,50,North America,23,798.08
66de2d43d1eb450a9818db32f22bb031,74,32,42,Oceania,22,755.07
66df6370b32b4b60896936a0ecefa4ec,138,121,17,Asia,22,939.44
66e53472f0b94111a85a8995c6a4be46,328,283,45,Oceania,21,1899.54
66e891d597f6413585784edec77a311e,299,253,46,Asia,19,1304.36
66e9da0aa11145e7be86ea26fe5ea59e,113,72,41,Oceania,21,454.77
66eb2c479737423981c65b05b61bee55,248,201,47,South America,18,1451.85
66ec0db5d9e6458093660991a624b487,193,162,31,Oceania,19,1096.31
66ecafb45b9e4073b777d4391ba93bc4,268,212,56,Asia,29,1910.75
66edd46f83ca4438a8fa5fb5ac15a105,156,112,44,North America,25,386.46
66f11294ef314d3093b1efa2f1915183,145,98,47,Africa,20,878.62
66f11f8e02ec42f598e98c6512170e50,200,163,37,Africa,22,1821.69
66f3457aa3ed4ab695637923509a9c04,365,326,39,Africa,26,1657.9
66f45e3bf50b4ff7a4bb298fff9537db,349,318,31,Africa,20,2774.75
66f6a5ef11b9466cae2eca99c2f402ec,100,46,54,South America,23,674.45
66f7cd6b9505491b8003d1884f76df2d,365,359,6,Africa,20,2288.27
66f8a9c6a1e9449dae645d50452a9fc4,267,217,50,Oceania,21,1229.93
66fb8773c05f4a10b615a76acba51746,365,363,2,Oceania,18,1655.95
66fe7e686486433a9184214495f3d84b,89,46,43,Europe,20,208.82
6700335418b7476bbf2ba3d4ba8684c0,148,124,24,Africa,22,1287.82
670153b5993f427bb38b0270df4f8dc2,271,224,47,Europe,22,1415.83
6702bbc8690d4bb69af793de896af91c,141,99,42,Asia,21,637.82
67039cc4dd104bd8bd60c477dab2400d,265,236,29,Oceania,19,2280.75
67084e35b94140fcb51e8dc0cd8e982c,290,243,47,Asia,22,1170.39
67086e324f194ae098239f210966cfe2,82,56,26,North America,21,564.3
67090f9ceb9f444180ba89baf8c763b1,207,180,27,Asia,22,1397.38
670c0c81675b4cb7af5148ecee1d5704,193,178,15,Africa,17,1640.67
670c7079adf04d2ab6c9267953c3cb34,215,186,29,Oceania,21,1240.05
670d567390834e6eb49e9a5f273d9c35,357,306,51,South America,18,2049.6
670d87183a314104b90a323705a92337,128,98,30,South America,20,877.92
670ddac49538416da22ddd5a0a7add55,118,69,49,Oceania,16,624.01
670f9d102d9e4606abefd3a1aeafe1d0,348,317,31,Asia,20,2508.69
671061e5a67344aa8d37bd8cd574647b,272,241,31,Europe,20,1870.27
671082f9452d44e1961976e98ff9667e,175,122,53,Africa,22,990.88
67143f8a5f4a44ceab638f03dce9c2a5,240,193,47,Asia,22,1588.66
6715562f6cbd4bb8a1b5fbdbaec59f81,150,111,39,Africa,20,1091.3
6715c3840a194dadbc32bdfc83c288e0,70,34,36,Asia,17,478.37
6716f6173b044cc6a0594f9e2a9259e4,296,241,55,South America,22,1260.18
67174ede23264cf5bf409bee10df082f,130,92,38,Africa,15,877.8
6719ef1ca0594bbca4bad208dd28b4ad,323,272,51,Asia,19,1621.75
671cfeb0f3524c7584b5a24592a77f99,53,7,46,North America,25,217.01
672088198f564d8582c5e9e39efa071c,364,309,55,South America,25,2044.36
672092dfcd9141ef9573d8a58ed132be,365,340,25,Asia,20,2462.58
6721628f228d4341a90804da1f4ae37a,272,216,56,Africa,26,1589.25
6724bc5a6c34489ebeecec89da4269db,103,56,47,Asia,17,539.19
6726d0a0c19044d69e812826b7460a3e,325,284,41,Asia,19,1623.41
672830f015b342ed82a56dea884cd935,96,54,42,South America,17,619.92
6728693ae20e48a3aa5b331971ffcda0,279,226,53,Asia,17,1702.33
672ac159e86642c586e143b8e6ea3046,32,8,24,South America,17,253.18
672ad7ddc4b84cc7b1f849872a5b2af1,307,289,18,North America,17,1665.09
672c23c40dbf45c1814a4f0d671b3ea6,252,208,44,North America,14,1273.92
672fc2a85423435ab9de099dae855b26,349,309,40,Europe,17,2279.64
6730005b026440e9bbd1422ab52e0ee9,365,344,21,South America,26,2096.98
6731ef41a62e44fba12ec8040cf478f9,278,246,32,Africa,19,2524.26
67321f4ade1848bebdcdb4ec3c2b9eec,45,22,23,Asia,16,476.01
6733776a6ef74a7cae74bb5423a94895,285,258,27,Europe,19,2044.52
6733d0a610ae4fa6814cac4e9a1fe66e,54,28,26,North America,19,496.02
6733f86dcc1f4d6a8fa1adfff8913804,365,365,0,North America,20,3015.31
67353616a4614d1287bcb2d9f7a0d34a,107,76,31,Oceania,19,888.12
67359bd564de4866b7419c59722fdfad,203,151,52,South America,16,1024.94
6735b4f99085458e910b8065cc6fb24c,258,225,33,Asia,17,1407.05
6736b3c6fc3a4f4cbba95d7133553a31,292,241,51,South America,17,1158.69
67375815d6004612b6430845da2689d4,301,277,24,Oceania,19,2522.51
6738ce6c673c44a48887526432003185,357,308,49,Asia,25,1818.32
673ba6a5723c4490b0422e0365bec3c1,364,347,17,South America,20,3151.68
673dbce2c90443c6b7cf4fd438070828,345,298,47,South America,22,1996.42
673de77d2fdf4c24b3a0bbf4611e1204,301,273,28,Oceania,22,2162.73
673ee3ff77c2440092729a73cf27cd1e,364,349,15,North America,18,2816.91
674009800f414c0193e0598cf0a353b8,90,34,56,South America,18,586.37
674272a078d146df9ba16755631f0ba1,252,233,19,Asia,17,2542.57
6743e4f03af546bfa25a239f5cc22f3e,348,302,46,North America,22,2146.89
6744019e4d8a4012843a9f812f9dd9c9,95,58,37,North America,19,463.89
67466d19dc86462da35e19a8dcaa3c6b,348,298,50,Africa,18,1886.51
6746def14f5943a78099e2b8deadf87c,220,161,59,South America,17,1004.56
67484bf33c444bffb92a948e6c0c472b,123,61,62,Oceania,17,854.48
6748b4fd353a4ddaaa0980e391535b9d,352,324,28,Africa,17,2663.78
67498ff802c144fb9e3bdb2065acbfe4,227,174,53,Oceania,20,1351.85
674c6ea5d1cd4584a2f2115c322d2dd0,308,263,45,Africa,19,1760.34
6751d6ad522f46cb818403e2f0178d3c,365,311,54,Africa,18,1824.35
67523783fd7e4d9194a5d929f7d4d45e,331,295,36,Europe,14,1417.08
6754f804aac6442a87edd0d1e692fd41,306,287,19,Europe,20,2517.18
675962ff47a1434e89bcb89a7f341f52,298,266,32,North America,28,2266.59
675ba8ccc40d4991a52d0ee12c71cd73,361,340,21,South America,23,2389.8
675bbfdb2c9a4647bb4f36e5ae62fc2d,245,206,39,Asia,25,1535.45
675c3d30f50048e88762ea0e03247101,201,171,30,North America,15,1467.8
675cfa12bbbb4c0a8e35adc27bcb3341,362,342,20,Asia,14,2628.55
675d4568d0934f9d9cc3a7a88e780a62,251,222,29,North America,16,1749.89
675e2242445a48b3b16b5339a18353b9,240,208,32,North America,20,1300.17
67628adec5664c6eb3d4317d0d274f74,79,25,54,Oceania,17,333.66
6764c23e837248778af8f7de86133550,192,151,41,Europe,18,1024.16
6767376d815745f7b1508033003050fe,297,268,29,South America,18,2312.16
67678a8065374143824a13f567836e4f,108,81,27,Oceania,18,455.9
67681c91d35744aea1fce1e887efca63,365,325,40,Africa,19,1935.96
676923297ac94b9db114c6aeb183c5fb,241,211,30,Oceania,18,1865.79
676a4be25c4c4a988d133102e4f2926a,238,214,24,Europe,20,2183.13
676f8eee1698479fa4cecaa4c2bbda86,325,278,47,Asia,23,2015.12
6771e10428df4e0ab5ed84eac6ae9f96,92,58,34,Europe,23,612.95
6772b3363652448e9c71c750b3e8ae22,170,145,25,Europe,17,775.11
67744bbc9b14419dbca167aa3151d369,223,174,49,Oceania,16,513.54
67745e1ea7554ce3bf08e3d95e6bddcf,97,42,55,Europe,22,418.33
6779edb994f0496e800f80925d10aadf,336,290,46,Europe,18,1785.41
677e14bf4e5e418782790c7e00c24a7a,361,360,1,North America,19,1932.36
6781a2996ec3456a8c06d5da8871cdf2,91,52,39,Africa,19,966.91
6785be73eff848568ad23dd293da4f54,365,320,45,Oceania,23,1846.54
678681450f3d421381b9b21f9921f7a4,135,83,52,North America,20,501.32
678779c6f3e4453182339b31b58414fd,169,112,57,Africa,18,1140.1
6788242e791d4fb2a5641089a2622d13,364,352,12,South America,19,2197.61
678b8d31e3b24ffb9012a711af9f7ef8,78,40,38,Oceania,23,225.96
678e95244c854c13bd79ab4ec4f6d020,234,190,44,Asia,22,1624
67904ec8e7f4449c98ad60cc98551599,109,78,31,North America,23,778.42
6790dc0c285e476cba8210f01151a3d8,238,199,39,Africa,22,1853.85
6791686f50dc494b9b10255e7db32cb8,252,218,34,Oceania,21,1816.14
67929fb229184d4ebea90a00f5a57362,234,206,28,Oceania,28,1764.18
6792d3345f0244c29b7cb74d07288dbb,54,22,32,South America,19,454.88
679443a241e74cd5a4ebc8e5e3821188,279,239,40,Asia,20,1965.19
67948527785d4cc7a990f9b5039b66b0,154,123,31,Asia,20,1205.72
6794a17e83c94386a31b8947d1665645,208,176,32,North America,16,2039.69
6795c916413347ef9d0faca981d1a33c,281,225,56,Africa,26,1355.4
67969a654db44a6bb1cf8e2680821037,325,287,38,Europe,20,2473.52
67988375541041108ef2dfb1f65442fd,119,86,33,Asia,19,560.81
679a3e6b2b634eec94c8f5875babc423,166,139,27,Asia,22,939.54
679aa083c1bc42d6be39ad4d367f939e,306,275,31,Oceania,22,2151.79
679b1fa0d3524f27a52c0c676e8c8088,124,91,33,Africa,16,759.12
679b54d81faf4e01b81dfb2d4c459147,365,336,29,South America,19,2173.15
679cbf1309634c7a9805c20a8f1ab639,60,11,49,Asia,15,220.02
679f3555e41d4c919ffd78b3d4893037,333,293,40,South America,19,2172.55
679fd8cfb2814c64bbdc71ed91a9e80a,171,120,51,Africa,20,1161.59
67a20b05cb444b0baa750399b41f534e,119,89,30,Asia,16,597.96
67a7412c2a6c4b51a8747c44c771536e,189,167,22,Europe,19,1257.2
67a752882b624ea7b2aec424826e46aa,262,234,28,Africa,20,2179.12
67a79af0f6174857b48ac8ac2af8f2f3,324,294,30,Oceania,24,2184.28
67a971c5acb944d78e5b48535b6dddbe,141,99,42,Africa,16,1383.53
67aba74c733e4edbbb6a0971b1950bc4,343,293,50,Asia,16,2124.09
67aed116a4754d9b8ef25d0004529864,45,15,30,South America,22,157.29
67af7292efee4cc0a5817e788346954e,197,151,46,Africa,23,1091.41
67afd090ff3d43509f8776436ba4a59b,80,42,38,North America,17,926.62
67b15805b7cc44aeafaa2ad798db929c,269,241,28,Europe,21,2410.84
67b22e1c23e14bdcb9590eb1502fa47e,134,98,36,South America,26,1054.22
67b6b1c5ceb542f99491ed2205f1ae8c,314,273,41,North America,27,2442.07
67b7800148c74911bc3d1316aff91c96,341,314,27,Europe,24,2682.34
67b8f044a6ec45e2996be64b9209371a,335,310,25,Europe,19,3003.12
67ba7cba257e4599b471e63ae894fadd,83,51,32,Asia,18,677.22
67ba899dbcc447c3920cb3bddad540dc,264,222,42,South America,20,1686.01
67bc695b1b8240e3ba6255966f928758,104,66,38,Oceania,20,576.41
67be565762b949918a04bdd86821ca75,253,219,34,South America,19,2262.37
67c0b3fb2aff40cba834665c21bb9e78,307,262,45,South America,16,1657.53
67c153473ba047b8b368816a2a00f7f8,276,227,49,Oceania,20,1233.71
67c208a976574950ac166a4b842d3f3f,158,113,45,Europe,22,967.34
67c94c76567f41d7a9dd82488e6a09a6,349,306,43,Africa,19,1783.61
67c94f9340694a528cc2822dfa3bbbbe,141,98,43,South America,19,665.06
67c997ccd1174f2588f133a5b9370711,268,224,44,North America,23,1660.17
67cb5f1ffd8a4d10a977e32678379f94,163,137,26,South America,21,966.29
67cb7e64a4434255a66739e8e3c12dcc,295,259,36,North America,12,2463.39
67cbfe90afe4432b8f21435132097931,161,113,48,South America,17,789.69
67cc1075f9184e97be682069cfa30652,49,30,19,Africa,23,557.08
67cd759a046b45ccbaf8dc5018b7a710,51,9,42,Oceania,15,468.87
67ce849800e4483fb6c6382a83edad51,351,325,26,Africa,21,2414.95
67cf77f1311941ee8f4171684c01acb3,43,7,36,South America,20,225.29
67d1635ffe5e44348e51b9848dee0d1b,255,223,32,Oceania,17,2494.48
67d46bfb00464a68b7a9ed958b30884c,229,184,45,Asia,22,1878.84
67d6cc89ea6f4c7693c3c582cb424b4b,344,293,51,North America,20,1634.57
67d84b613cbe4cf6928a964b6d34cd84,363,359,4,Oceania,23,1774.2
67d9ebc9bbb64e01a7bebcd686eaf0e1,363,354,9,Oceania,22,2613.63
67ddbfa59b9f47ebb77610d476a735a5,126,102,24,Africa,11,880.94
67ddd8de86f44ecf8d21a71f18a67d82,42,11,31,Asia,21,288.87
67df34ab2cec404887f354c773d78b5d,338,302,36,Asia,23,1845.66
67e006dbb3204587bd06adbd94bc1f2e,329,277,52,Europe,23,1398.7
67e0b3377b8640e29eb2ad010a978a06,130,90,40,Africa,22,551.42
67e15cbe0f0b4568b215c3d81a1c9279,364,358,6,North America,18,2213.79
67e3a6cfd2304db6b2a2c28023e8b776,56,35,21,North America,19,418.44
67e4da31df834a1f81029a4d521a7094,308,261,47,Europe,22,1186.08
67e6d2b3a7754f87a3543be1eba91a92,340,315,25,South America,20,2847.27
67e77c3013254b989ee9650df7297393,224,180,44,Africa,27,913.29
67e7e7da34ed4b5aad983d948aee7ffc,167,143,24,North America,15,1111.56
67e873f6ecd641438e5601a5a2959f73,98,69,29,North America,20,830.85
67ee3b7719444f729a22fd930e399363,151,103,48,Europe,23,790.94
67ee736e312c4a82ba7a6ed2ffca613f,66,40,26,North America,23,484.21
67ee95e932ad4961806d51c8277d2b1f,178,145,33,Asia,17,1220.89
67ef47f7627148c8847a2cb0644d95e1,364,350,14,Africa,30,2448.57
67efa90f459c49529deb8900a9a75650,269,227,42,Asia,20,1687.83
67f03b71695a436da81d7ab0fd3d3489,162,107,55,Europe,20,789.75
67f1247a3661437c92d9cd14a79ca390,166,136,30,Europe,16,1263.14
67f1a3acbd0c47b0a51e6e4f1b46d03d,187,157,30,Asia,15,1227.69
67f3b344f6094a449ea7a278d1655f6b,326,297,29,Asia,26,2341.91
67f4209d673045ea8c9ca65e788558fb,79,31,48,South America,19,272.07
67f4533f865841ec823edda482f207ed,104,70,34,Oceania,25,502.57
67f4e107218248f2b64d8a6a6b275f6a,203,154,49,South America,23,971.78
67f55641b9dd4bf7bc48f240e63069e0,231,188,43,Europe,19,1244.74
67f6c44483b546899e6cc7fb031ee215,229,182,47,Europe,22,915.54
67f92f2e70f74dc896ffc43e63f33c32,91,45,46,Oceania,18,424.15
67fc2d9d545c45ba84604eaada35b123,228,179,49,Asia,23,1661.53
67fd172703324b238f609c6eec22d1f1,362,345,17,North America,24,1556.17
67ffc3ea3681453488f08cdf9076b91d,239,190,49,Africa,22,1044.67
680053a1a1bd45e981fc1c7ac2b6c0b5,82,47,35,Africa,22,882.12
6800ffadc65745b7a44d763431f66079,279,240,39,Oceania,22,1760.65
6801050e0f4f44d5bca0d609630e9bfd,49,11,38,Oceania,21,336.66
6803aa2ba0054a839c3e636725a2e560,71,32,39,Oceania,20,643.9
6803b73375c44b6fa28451eb80c8bb4e,365,350,15,South America,23,1861.18
6804719fa194437486ed7aed71a39e0b,74,59,15,Europe,16,713.91
680504fd0cbb4bc587d9ec0702aa64d1,363,333,30,Europe,17,1505.56
68056b90ca1745b2b5d9c55d2f3f14d6,297,260,37,North America,20,1487.56
6807feb1573f4195bc53d63c2a858c38,61,34,27,Europe,18,324.07
68089aa892564f99b062a0c9102c72dd,365,342,23,Africa,20,1514.31
6809a09c58b0410eb7b48884e6919d15,43,3,40,North America,19,290
6809cdedbf8245eb9bb9d4d23cf798b8,303,285,18,Asia,21,2332.82
6809fa31ebe4460ba26b8e2d9da4570b,223,189,34,Africa,22,1316
680a1d0657e745cabb88807c1aa8e66f,72,45,27,North America,21,572.75
680d497e7c3d46659cfb5d1b03c0e3ce,159,135,24,Asia,19,1709.87
680da1c472a34076831e8eb9b5739d71,352,320,32,Africa,18,2087.77
680e723773964268a1d1ef5b68b07f4b,240,214,26,Oceania,24,1327.4
680e7c6634e04b8887f92db86e28bf98,362,340,22,Oceania,18,2503.11
681118925c52425e84ec6f2b9d89826c,178,142,36,South America,19,1353.03
681180b60f244627935ed67d38573602,208,182,26,Europe,20,1728.77
68131c0d7e004cd787556ac77f4429b9,317,288,29,Oceania,19,2923.13
68160f0cb306485181240c6918fed9d0,106,57,49,North America,19,803.14
68193165676044b1beb636cc957f2847,138,100,38,North America,19,1150.25
68198cd96da74d8b9b423b75dc6e9866,347,317,30,South America,18,2297.62
6819d88e65974bada6cb28b5aacc8820,274,256,18,Oceania,23,1984.26
681ae398ee304b3d834bd68ce41862a2,112,95,17,Asia,22,589.01
681cc11b11c04baaa3eb5b57e8088bfe,144,126,18,North America,20,668.12
681cc441558f42e8bd99bf93d792274c,84,59,25,Europe,22,802.73
681d13c1d8414694ba55aa8d5688a4ad,287,237,50,North America,22,1505.94
681f5426a64e4fedabe5cab534e2b366,201,180,21,South America,12,962.52
682075c6affe4d4fb6d54a4b3e5ab3a9,148,124,24,Africa,16,1293.65
6821e947302146dd93f29787c2689590,199,138,61,Oceania,23,637.17
682388946d6b464caccebb64739cb165,332,295,37,Oceania,23,2220.64
68254a433eeb4f8ab1db25ac3127acb4,282,255,27,South America,17,1871.58
6825ae72282a468ab9cff9b8375cd5dc,254,236,18,Africa,21,2204.26
6828a305c959407da315efac62844dc5,224,200,24,Europe,20,1430.81
682a27b3faf64612897c6d0541144f63,174,127,47,Asia,21,945.84
682b6b6334404cea8a5db56d03e56c34,109,80,29,Asia,22,993.54
682d70823bef4349ab13cbe83e7c4786,290,270,20,Asia,17,3143.91
682df7ae5be14650a73a165471ce5c57,268,233,35,Oceania,16,1690.41
682f0d3d11ab4f38a1ead3295c5f2a1c,292,245,47,South America,20,1281.61
682ff3588d734cabb7f3f47c1d364187,223,172,51,South America,18,1503.63
6830e23fce45493abc719cd51cffb980,139,86,53,Africa,19,459.9
6832ced891084b51bfeb0dc4241c9bb1,156,119,37,Europe,18,879.79
6834aaf1f9884b04ac5f8a3913b068b6,101,52,49,Oceania,20,176.81
6835212f938c4cd2a7ceb8663a927637,267,212,55,Asia,21,1201.83
68353bbc30154008b31cceb8ec5a2c06,276,243,33,Europe,19,1691.9
6836f1b7d5eb45a792f81bb86d0e9522,227,182,45,North America,20,1511.3
6839d519d0d4488a95b98cd060dc6699,299,275,24,Africa,22,2985
683c8a73e27846b9b7783d431d66f7dc,45,17,28,Europe,19,354.93
683e3a4819ef445f8c0a4c65bd64dad8,216,190,26,North America,24,1248.81
683edbfe6e2248909513b04b4e50fe43,345,300,45,Asia,16,1561.45
683f514d73a54ff9b4ce26d8e1dcfe32,119,99,20,South America,20,574.39
683fc740e58547caaecbcc8570f62a09,110,66,44,Europe,20,466.86
6840ca945d294668b0dd92b535af4c97,188,168,20,North America,20,1634.71
684135f8ad7c48adb4a0122b7da48dd8,78,51,27,Asia,22,495.93
68414d713ba3462f8ba26cd9bbc3aa2e,164,119,45,Oceania,19,1090.25
68430b804c8644719e11e1283d32c2e9,126,96,30,Oceania,18,824.84
68434c18060d40028666ad5900bb2602,143,120,23,Africa,22,904.62
6843923eb6894fc895db0bb434d997d9,89,47,42,Europe,26,1069.79
6843be675de0442cb52f24e59dee4d47,173,151,22,Africa,17,1653.8
6844b5c591854d62b2cde809bd1075f9,158,108,50,North America,20,862.65
6844d00779a64386927c81bda2b1e519,260,210,50,Europe,19,1736.28
68454957d3224f20aaa9dc5dc5f4c2d0,67,24,43,Africa,20,336.69
68458aee6a5a4dffbcc3b75e6be08bd4,315,277,38,Asia,20,1578.8
684638baf07c4824853e01cf3c406ca0,279,233,46,Asia,20,1342.84
684880c710cf44feb41d094104870c9a,313,295,18,Asia,17,2677.98
6848e094f23a4d9c89aba33a7db14abf,252,215,37,Europe,23,1420.28
6849169f76f64e85b38800a3e6d4b008,90,69,21,Oceania,16,1047.7
68495934c29d432baf2046b7bc5e603d,206,156,50,South America,16,1411.71
6849c97418264cd58c80153ede2f8801,129,71,58,Africa,27,971.33
6849fc5ba26640a8a7b4771f5a41e847,347,294,53,Oceania,20,1352.38
684a355eb30d40e5b2b45cfc308ca2cf,124,100,24,Europe,20,1082.02
684d72def04a4fafa3288414d5c74c1f,364,348,16,Asia,21,1773.34
684e17345dcc4db78e36b3b20c9f37d1,261,222,39,Europe,23,1900.96
684f11ebaba64531a875c9425ce0d46a,154,118,36,Oceania,16,1055.5
684f7b7aa9fe48d4a5cc031eec59b0b2,305,291,14,Asia,18,1544.57
684fedbaa4cb4c0a9ee050cf538eb2fb,37,11,26,South America,18,380.73
685066ca94054892bf6976ae3b0836f9,31,6,25,Oceania,16,422.27
68549adf840346ed8c52782cd245d22b,364,346,18,Asia,22,2443
68581869845d409389d86507e46c7118,202,178,24,Oceania,15,913.22
685963413ad94550a50ca233ee0c2f3f,158,123,35,Asia,16,811.46
6859713e9aad4c649faf1f0029f05980,158,118,40,Asia,20,894.98
6859c70d45e04818a6a748c28b30f318,307,256,51,Asia,24,1299.63
685afcd9a5de42a5a4564cd79f861705,220,196,24,Europe,15,2094.2
685b1ab9910642e1a1adcadd70305d39,362,322,40,Africa,20,1696.61
685f68f61e284441bbf6a2c068dbe619,65,28,37,Asia,20,132.87
685ff025d8bd492284d0a232fc5df940,62,32,30,Europe,23,485.85
68601a1383cd46e6955cc3aacfe0b2da,98,74,24,Europe,15,595.48
6866d44bcde443b6b883015f58e3ecc4,56,19,37,Europe,23,192.44
686ab80a99a743d185254b6829204c47,330,304,26,Europe,15,2892.94
686b7a381c1946e4a749e368bc9c163e,170,145,25,North America,20,1467.15
686cc18894234b398455689e6ad2e902,206,175,31,North America,18,1262.97
686ce12e46c4436bb95d165fe883785a,121,74,47,Oceania,17,448.05
687125ab18fa46a99e6de3a2eb9a8581,77,48,29,Asia,18,549.71
68719ff03070408c940aa3fc99c290dd,197,141,56,North America,20,1097.07
6871d7568a344b14810d43726eaa3a4d,326,289,37,South America,18,2073.04
6872b3868cb84f2292df0b2cd61e99e1,242,208,34,North America,22,2109.9
6878e86e62b940c5b127f1e97d6de81e,205,179,26,South America,19,1904.69
6879ccd61fb84859b26ab07494386a97,364,326,38,Asia,20,2786.2
687a5a6647574b349090c65ea13aa263,251,220,31,South America,16,1346.52
687ca5a5abda43049408c51698ff3594,358,317,41,South America,15,1941.33
687d3bdb514f45f7853fe68ea16a414f,170,112,58,South America,16,759.33
687d6312fd5a4cf2a891ffcf0cea064a,323,299,24,South America,20,2475.48
687e3b8eb8b1430a848ae2daed9428f4,240,208,32,Europe,20,1472.19
6881ea92ffcc4e028d349ebca8148682,328,292,36,Africa,20,3074.71
68823072357f46449e1f5212cc0b7275,211,162,49,Asia,27,1297.82
688383b87d2b458fbbe4c4bcc2c12be4,325,285,40,Oceania,21,1877.14
68842dc2e2e54187ad32e01ce686b3dd,218,170,48,North America,26,1117.91
68858816300044f7afe9a12b1fda7e5c,168,134,34,South America,19,1494.43
6885debd76644038b208f2f8d47e92f2,129,83,46,Asia,18,684.93
688affacebc8462fa42404ee98b1964e,278,243,35,South America,18,1859.51
688b84c378f64070b62d1967ecdbc35e,310,275,35,Asia,19,2450.32
688c44cb56744b2597515123877a1f72,60,15,45,Europe,16,488.49
688cf93e02394be9802cb74bdb806580,173,150,23,Africa,19,1192.2
68916e8f7de2492298efaff32cf04d6b,66,15,51,Oceania,19,290.78
68929c66a5bc4a529a853d0e9e885e78,86,47,39,Europe,21,289.83
6894033b699a4c25b230e65feb450cec,169,153,16,Oceania,24,1193.43
6895e5595d3a4da389d5463154c43ccc,61,11,50,Africa,17,164.67
6897caf3c4774f9e98727692ad97a616,365,344,21,South America,24,2713.4
6898a3fce59a4099948715dbb2c050f4,125,97,28,North America,28,682.04
689a8fbef86645328d4c7f3b54da0b19,131,91,40,Oceania,16,447.59
689c687368244c62aa24277a9271e14b,69,17,52,Oceania,22,288.4
689cb19b936a4cacbb9423242cf539a3,260,236,24,Africa,22,1885.56
689d53f89118418daa788b29f1a1a960,365,354,11,Oceania,21,2259.06
689ddcc754c848309b7014ea103587ab,31,11,20,Europe,19,273.99
689f264aec03475cb9093abde74aae8a,234,203,31,Europe,18,2159.25
68a48949d7c4414e9ed9750bd7c8038b,52,31,21,Asia,16,408.83
68a63d2206a74d0d83d226c54ab2ebe7,70,38,32,Africa,21,618.63
68a67382004d452483259eb7a449387c,173,132,41,North America,22,964.29
68a7a17d803842ebb577f2ce176401a0,180,139,41,Africa,19,1563.79
68a853c450ba4d1aad2bd7259284ef49,55,17,38,Asia,16,413.77
68aab8d9e7e14547b2b3fad57d3ac232,349,307,42,Asia,22,2409.3
68ab2f7ac9084f0abc545941fa184c23,364,326,38,Oceania,22,2566.8
68abb2b904ef4e0ab8f35d51bdec667b,132,90,42,North America,19,928.95
68abb3a4be364dea902835b92efb132e,364,357,7,Africa,15,2166.05
68abf35d7a8640efb0f9d32c5c8bfe69,220,181,39,Asia,20,2154.17
68ac4108ff8a4e8e8ccceeadfe69f05d,242,217,25,Africa,18,1507.96
68acadd0b5624d749b51c3f9af7a5581,183,129,54,Africa,19,1105.34
68ad2d9ebf0e417ead8ba8ddcaa594ac,266,213,53,North America,19,1130.23
68ae0db62d664881809686aa0926c9c0,310,283,27,Asia,19,2601.99
68b2475856624315ac0af052d9ea5774,105,58,47,Asia,24,125.66
68b51c7f62ce4a54bfa899e6c815ba19,111,85,26,South America,22,1054.35
68b67359195e4321806d65342413f61a,361,343,18,Europe,25,2646.27
68b6b72b5ea24ae1bbae268db80965ca,264,206,58,Europe,23,1390.88
68b84043e39241bb8a3e17c18cbf93b0,111,55,56,South America,23,606.87
68b84d3241d54f56ad24dcb120674a2f,272,223,49,Africa,20,1517.04
68b8777c5f3d4275812c8d2935289519,89,61,28,Africa,22,805.75
68b87f8cda4b4b6fa6243279fb9069df,133,105,28,Europe,24,758.87
68b8daaddcba473295dc1004162c9bc3,247,233,14,Africa,14,1724.99
68b95fde04c1428e8c4bafde5d0fba14,116,89,27,North America,16,748.58
68bb7d37b266419d891163e3139ff08b,364,319,45,Africa,18,2043.88
68bc343a563b470b962f0f700bab8f1f,203,148,55,North America,19,1034.95
68bd986d15e74f7f872b12fabb4a9242,49,21,28,Oceania,21,350.08
68be0850637c4ac0977ae5101f5ddf57,345,302,43,Oceania,20,2858.45
68c1a2de03dc482a9729baf1cd7c0077,53,23,30,Africa,21,349.86
68c3ff7a84c4452582a0aaa30cbe0c1d,333,308,25,South America,22,2638.63
68c47b903ea4408c8016761f22330093,244,189,55,Africa,18,1105.87
68c93b5488d749bd8417b335ff35c6b7,88,37,51,South America,13,360.73
68ca3b5cf8444f4ca3f63a06339e79cf,364,322,42,Asia,21,2611.2
68cf65866c744c6eb07f893f01807e3f,294,267,27,South America,17,2546.63
68d478950f5b4e65935c15354616f107,242,212,30,Europe,24,1651.27
68d60ace085440088dc317997392fd50,319,269,50,South America,19,1691.35
68d75b42ac644e03b7efbc2a7537c8ea,259,212,47,Asia,21,1465.42
68d8de0fdf9e447983d83e0936a0fb21,365,343,22,North America,21,2774.21
68dc14f256f541df83c2e05186b3de18,235,190,45,Oceania,22,942.24
68de142ee3264776a61ac70cadd8d426,173,142,31,South America,13,1803.19
68def69c7dcc453a90502bc6aa69d57a,184,151,33,South America,26,1296.7
68e0fd8f49bd4a4ca609d5b79814fbdf,163,110,53,Africa,24,714.68
68e1b16d6ada47dd863296541b1ca5d6,74,55,19,Asia,19,806.31
68e26f4ee62248549f6327c3e29ee945,357,338,19,Europe,23,2682.75
68e2a338ccd0474384fe9e835bc80124,96,71,25,North America,13,513.7
68e4a0f0a6a74b3aab2f92fe4cc9d9ed,305,255,50,Asia,19,1650.03
68e6f1ca3ed24193aab4bc8594043207,295,274,21,North America,23,2008.96
68ea62828a944eddacddbcd82da84427,97,80,17,Asia,17,465.77
68eac23bbc674ba7b457b6284c7ed78e,193,146,47,South America,19,762.32
68ec050aebe14fc09f36c54fbc12e61f,69,16,53,North America,17,257.17
68ee98a1dcbc49c7998877f709c9c4b0,59,23,36,South America,16,254.91
68ef787c89d14d7dbd8a57de58d6ee77,144,129,15,South America,22,1061.59
68efd5ada6d6453e8519178fb44da2d1,61,10,51,North America,20,343.47
68f00b545f1a4d0587ba633cd92b560d,70,18,52,South America,21,228.65
68f2d5c94bf6474dbf4cf93ffc026bf3,250,201,49,Africa,20,1373.34
68f3e93cc22a4da38f9c2c9df36dde96,179,141,38,Africa,19,1421.49
68fa7a95b0e14a29ae5e33f84f7f9c6e,169,115,54,South America,19,1002.3
68fad1643b9f45c5b629516a8c12b296,260,206,54,North America,22,1226.96
68fd25ea354b4a01b5418590d778e43a,365,349,16,Asia,19,2454
68fd3b118d8240f390d897e6f3676dab,100,51,49,Europe,17,934.56
68fddeb5f52545d38e24cdb9615a200d,314,298,16,North America,18,2346.66
68ffdfc56dcd4a4ab6bac0e34f68603a,64,31,33,Oceania,23,550.52
6900047aa73e4e95811acd7ce359f5fa,288,270,18,North America,16,1782.22
6901ef90f92048fda960860602f611c7,252,195,57,Oceania,18,1172.66
690494a270624518afe3638cbaf30ed6,143,106,37,Asia,21,1040.99
6906d8409bc24ad8ace3ad4d849b2c9a,360,328,32,Africa,16,2295.04
6907575ac4984fde8747385827b0c639,302,262,40,Africa,21,1587.52
6907976105c7459aaece5619b989853f,35,2,33,Africa,18,307.65
6907cb9b78a744a8a42778d65fb0f0dd,171,135,36,Africa,18,1161.53
6907f2d351a840a89a441f0dbf7992d9,196,155,41,Africa,19,931.07
6909407dae5145d5a80a90e11e611b54,241,199,42,South America,17,1076.78
690b833ee826428da45a5607eca6bd89,363,346,17,North America,20,3100.39
690c880b7e9c4f1489a474a370d99b45,209,189,20,South America,21,1771.53
690c9f55d1db408e835546f35e70e0ea,233,188,45,Oceania,16,1017.31
6913faf43dfa4058abb11befe569bdf7,353,300,53,Europe,20,1407.86
6915ee1e4f264857b5da500a4aca3599,324,279,45,Asia,20,1409.54
6919c286927c45179154991c182d68b5,119,81,38,Oceania,15,1422.86
691be6f3e6264c52ac78368744956156,365,343,22,Oceania,13,2237.04
691dfd2aa5c14a889e43b1428f412ef7,251,225,26,North America,22,1516.96
691e5adcb6a64ef390688c0a713d9b09,332,302,30,Europe,22,2202.98
691f3663c61c49998e64b7a8090c2444,221,178,43,North America,23,1981.11
6921425eab7e4af9a424852320ab98a7,365,365,0,Oceania,19,1501.82
6921aa4f88cc4c19bdbaaf5c2e914045,113,80,33,Asia,23,614.97
6921bb56998344399d62b0fd36be63b7,229,181,48,North America,16,1375.03
69222878e7cb45fc91b7d824564f09c8,308,268,40,North America,19,1615.44
692348f160734ee1afe0cb3c6d7fdfb4,364,364,0,Oceania,22,1912.38
692463a2a8874639af98459ff5a0e98b,243,195,48,Oceania,20,1415.21
692513304ad0488fbaaca1c18153b32d,228,176,52,Asia,19,1289.35
6925ab8e15cd4d1ba77103c05f489ab9,365,362,3,Europe,21,1705.89
6926d8281db9414d83c1102507a37278,84,29,55,Europe,21,531.37
6928bb8ae59e409eb0f6c7d3c0a4973d,279,260,19,South America,21,2255.29
6928e230a5f24577b4ebaeb119577dea,360,325,35,Africa,22,2868.84
692e9ed2414f4b89b8944d5c4fbbd3bf,169,125,44,Africa,22,1076.56
692ecb7fb11d4286b272ed90ffd1da4a,65,38,27,North America,16,385.93
69308f9b8b534a41972064f035c00a61,46,12,34,South America,20,131.86
6932e41163b7499298849312f2737567,115,62,53,North America,19,366.73
693378142e06448e816ace0ca4ee2269,364,354,10,North America,23,2158.59
69348bc22ca347418c2cc368cbacecce,365,349,16,South America,20,1650.83
693491add767481daa5cf6e84facf70f,95,75,20,South America,25,858.19
6935e5fa60c7444e8dc8b0b7cb25c334,363,340,23,South America,21,1501.11
69365e0630424f819f4fd7f624cf72bd,134,87,47,Asia,22,628.85
6936e6c4664546c4832905ae87fb96a9,365,332,33,Asia,14,2653.71
693b98a60c6e40f2aa26caba0cf23d3a,269,237,32,Europe,20,1590.34
69425e4d74e74b36acc0b777d11ee40d,302,253,49,Europe,19,1385.53
6943253e0dca438996274cb71eaf4a13,189,144,45,North America,19,1314.72
69433888d5da478b8dab08c39cbea6a0,96,51,45,Africa,20,575.47
6943e8e652174aa985a196c6796c9a90,331,307,24,North America,14,2550.64
6947099584764231af253f840b06cafe,196,143,53,Africa,20,813.18
69484d016f2c48a78ca6b85cf23bffc9,152,102,50,Africa,12,546.41
694c1dd19ae44732bd1651309456b38c,182,128,54,Africa,17,1218.14
694d2c79a7674bc29bfd7f09ebfb1b67,243,212,31,Africa,16,1565.9
694df1a89bbd4206ae2103c553816448,164,111,53,North America,25,780.94
694e93a149da495a90a244afc1f54851,99,57,42,South America,26,367.83
694eb46023f4477fa13f18330d81f43f,103,68,35,Africa,14,506.82
6952d0f4492743789e357e2b17326d2b,120,86,34,Oceania,23,896.63
6953eb67fa684ca9b4ec115ec40ab58d,120,66,54,North America,20,602.1
6955b28a75ae46429923ba4696abc061,146,98,48,Africa,17,477.77
6956714fe06447eebf1ca92d95cd7973,166,143,23,North America,20,1486.28
6956d83c7cf64bee98e1b6460a3b7a78,355,312,43,Oceania,18,1888.11
69571f75a5c84794a8f1fbefccb5e705,147,113,34,Europe,24,1667.66
6958d76b44ed49a98a7a3d2f847de2d1,38,10,28,Asia,22,440.52
695acde3ec4c4e26a60936c3dc33d810,117,84,33,Europe,14,960.42
695b26cb793840b2a480fafe766073da,66,19,47,North America,23,572.31
695c2756687348119da5d7189f66748e,321,273,48,Oceania,17,1288.16
695daa86f0764b41927fa649bd82ffb9,256,206,50,Africa,21,858.31
695db2001b69405d800322e8b2264de9,50,29,21,Oceania,15,282.29
695dcfb4b02e43da899efd0b84650cc2,205,181,24,Europe,23,1805.09
695df9918d2d40f294c83dd914b551ba,73,28,45,Oceania,15,203.3
695e4b435dd74bb6b65e378bce407a3a,199,175,24,North America,17,1388.8
69601fbd4f8543019e09f99e3bdfbeda,51,23,28,North America,18,578.12
69617a6589f840e48998169c1bc1a4ef,101,70,31,North America,20,995.17
69625f282ce1447eaee31b19acdd819b,160,121,39,Europe,23,669.83
696375bf7e9e4d088afb57a2171ecf66,93,57,36,Asia,20,428
696c368a9a6240de9354e2930ec0fea0,62,33,29,Oceania,18,629.11
696f4f1f16f743ef933d37cc90af6bcd,297,245,52,Africa,18,1763.51
696f652f714848f9a800c8c69930fa1b,273,221,52,Europe,22,1107.77
696f85d8b9f84526b52553aa8ff94c9a,141,94,47,Asia,22,547
6970fd0e53eb4436a77222ea2b460272,191,158,33,South America,19,1318.3
69717b3bd3424167a7e29601219bf572,365,330,35,South America,17,2684.4
69732d11c38241dbbaac5cf350276e81,365,363,2,Oceania,17,1552.1
697384c1e68f4648b1d5add45378464b,251,224,27,Asia,14,1812.47
69740c9163ed49fb96dce88981b1f828,224,172,52,North America,20,1025.1
69746869dca14beeb807dd21fdfa8a0d,190,153,37,Europe,18,1304.63
6975cce76f094dff83ca3508469515aa,73,40,33,Europe,21,609.6
69767786245a4b50891e65245f98d94a,117,94,23,Africa,21,506.18
697690cce4e64f1cb7640712cc1a388f,183,162,21,Asia,22,1991.41
6976a9b031d54f5c9e6a9829313f9f20,323,299,24,Africa,19,2315.02
6977bad29c5e451196ebebf409ddd5ec,268,231,37,Oceania,18,1781.57
697cb63393834e9c9f670c7c3ef24c24,248,206,42,Africa,16,1706.6
697e41b5588649d8bcce2405ec09b302,365,350,15,North America,22,2651.78
697e9b03356e4662aafd9b1388a54816,204,171,33,North America,22,1127.33
6980d7de103b4b6883093c18853ccfad,144,107,37,Asia,18,977.76
6980e6bcbfa24094a78bea338776eb64,160,131,29,Europe,21,894.34
6981dc3b37b1496397e420f6cbd6213e,250,198,52,Asia,24,1627.14
6982895457054e9e8c8d1b25fa52b758,140,114,26,North America,23,1487.52
6982dda65aa549599410f2833c726c54,172,154,18,Asia,23,986.6
698604912cb34d838c54b5d27b31ae5f,281,244,37,Asia,20,1660.87
698ad7e78b2b4c679a915ca5c2d8bea5,255,231,24,Asia,20,1958.43
698b940bdc71483d929d2ad02ef018f8,120,71,49,Europe,15,965.99
698e26a7b92a484587d30ea0fd45eafb,37,13,24,Africa,21,140.04
698e30ab553c4da49819ac3e60dbbd72,288,276,12,Europe,21,2357.75
698fa9e066ac49a4a6691de0b61aef94,52,16,36,Africa,20,173.93
6991b54b8f3f45f280f41b4b396dc077,200,155,45,Europe,16,702.87
6994258537084af7b5ac2527494a9256,186,160,26,Europe,19,1324.74
6994b12749e4414a92be699e0c28ca17,56,37,19,Oceania,23,177.64
699570380e9a498a8812e9e0f642a5b2,142,92,50,North America,24,686.67
6995ada284fe4f1bbe8569347d31e180,345,293,52,Oceania,29,1961.72
6995bc5d0eef477e8543a28d20bd09f0,295,262,33,Europe,21,2561.67
6996bb9b74d04745bcfb5d4ca4ad0f57,360,308,52,North America,22,1719.51
699910d439954a58a96c173ac6188f9b,65,41,24,South America,18,513.98
699a82a9ead24554b388438b855a4e23,66,24,42,Africa,25,533.92
699ad1f292394562a88d094b945b1a40,106,74,32,Africa,18,637.88
699c05631cad4114bb26493a68f03902,259,209,50,Oceania,22,868.4
699c09b7984542bbb7bfd7186baa3e26,36,16,20,Asia,18,278.01
699cd00a85574ce9841e437a08357f27,131,82,49,Oceania,19,684.11
699d645616c3471bae4183bd047a6256,146,120,26,South America,23,867.34
699ddaeb0b8d4823a213c3677a5d519c,172,144,28,Africa,23,1187.38
699f5795627440b69c4637d5f8c02140,155,121,34,Oceania,18,909.95
699f9ff4235949f594a9f6add344d1ea,305,267,38,South America,24,1592.4
69a0525455e94bfa9f2add30d7eb7c9b,201,152,49,South America,13,868.67
69a11360e49e439abdfd6a85d2aba0bd,143,111,32,Oceania,23,1462.2
69a1cb2a69654303aa6a8c20e55c756d,301,260,41,Oceania,18,1896.96
69a45999d5c44f3e8c942c0e22de3234,272,247,25,South America,21,2747.06
69a4baef7ab64639bace2edd846659a3,81,41,40,North America,20,539.52
69a6c0aed6484a51b6b4b7c3d872f6a4,59,50,9,South America,24,591.15
69adfc512f2c4ea5b0aad4eaafd559fc,138,103,35,Oceania,14,1211.19
69ae2e7f72d44f84b884330ae45b75cf,26,4,22,South America,22,206.08
69ae2f8706f2405d8365e0709417a6df,259,225,34,North America,21,1942.94
69ae4d979aeb41d588eb895c8c623d80,127,99,28,Asia,23,1266.8
69ae60eb806040339d30f11d9df3ba12,67,32,35,Europe,24,370.92
69ae777ead6445c3b99c504da95b4548,236,203,33,Asia,11,1606.26
69b29b95c6eb4f12a772f0b0f5be0b4d,118,95,23,South America,21,764.46
69b71ffd8a2448bcb0f701de7dc5bcf1,131,97,34,South America,18,1285.34
69b8cdfc05ef41a5a94c66fb6bc16e8d,261,203,58,South America,18,1316.42
69baf92065c34564bcd8c0895b667836,305,260,45,Africa,16,1531.16
69bc680ae5a24e93b05696116d3db821,220,175,45,Africa,19,1070.15
69bd5f3a96494a23b64b38d42cb38069,287,258,29,Asia,25,1840.25
69be7d27bddc4d91acd8fcb95debab11,235,212,23,Asia,21,2134.06
69bffb14ccd84db5a7b83aeaf93518e2,98,68,30,Asia,21,811.88
69c423913be44c3abe803e9aa9cf698b,159,128,31,Asia,25,1086.39
69c426dd41d04580aaf063e293bdce82,355,327,28,South America,20,2114.74
69c6d9adfaa04260a3638133e9885106,62,33,29,Africa,19,329.84
69c6f27f799d4dbc956505a21756b9f5,64,9,55,South America,18,181.03
69c76cdcb82c4288a4c649ece9d57ed0,181,147,34,South America,20,1343.74
69c87c0e91904c84825a1b415b25ee16,148,110,38,North America,26,1382.36
69c8f3774e8344a184f165c340cf9f6b,266,229,37,South America,21,1379.43
69c997fcbe7b4f78841a84e266a7b6a3,224,184,40,Europe,19,989.58
69ca79be0e1a4836a790ac4359c8411a,218,195,23,Europe,20,1482.29
69ca7c5af8364ce68ba53ba3a48b06a3,111,81,30,Asia,18,758.54
69cab0f8c64d40629fa3d40cfcf0bf0d,60,27,33,South America,19,310.38
69cb116c97ac48bf96e314bff49fa583,59,15,44,Oceania,25,669.33
69cd0405b08142f09b7d33a7c5da5170,349,310,39,South America,20,1869.49
69cd6389565541758dc80ab7a12dd3b1,362,347,15,South America,23,2475.09
69cd6ebc203a44e490e2668a18a48177,280,255,25,North America,22,1689.5
69ce96be36b04683a877ff1236eaf36c,181,134,47,Oceania,23,1258.51
69d0c622954d4d45942dc15ab277d78c,110,69,41,Africa,20,591.67
69d29c747116492d965f8538bb510ada,365,350,15,North America,18,3061.03
69d2f61f8dd84415b202fffa92f13533,258,226,32,Oceania,21,1749.15
69d65db68729474aab07ebf8ed3c1a3f,130,104,26,Oceania,22,732.71
69d6a635b8af4c45acfa266b1b4d6b24,194,141,53,Africa,17,1302.43
69d7bc9be8974f568f14557203ee1cd1,306,260,46,North America,24,1365.43
69d888fc79d34abcb1eb176662ab34f6,164,122,42,South America,19,780.14
69dc6c7cfd6240d996645d9879832fe6,158,129,29,Europe,17,1570.22
69dde9132b0f4557abd46adbecdce7ce,229,208,21,North America,16,1816.37
69de3c4f9ecf49de81f36c4a0dd9f262,197,178,19,South America,18,851.82
69deaab71fde4014a40e24bc92a295ac,266,232,34,South America,20,1905.51
69dff8feac644f2ca5eed4d64d0d0b68,242,214,28,Oceania,21,1913.66
69e38299b3e64a29afcfb9744ef3ba52,141,86,55,Europe,18,479
69e390372f1b4eb1b2a842f5963243b0,71,19,52,Africa,22,833.3
69e3d96df1264c65801cb005e969f653,64,4,60,Africa,25,410.55
69e40d7a6aba4e30a04846f2536bb7e7,79,26,53,North America,20,514.32
69e463cc91d64913bda710ca60ed6d6a,365,340,25,North America,19,1462.52
69e47e55f36e4d5399629d0eba2c3797,208,165,43,Asia,18,1279.46
69e5035cd0b445419170774a5028cd6e,86,68,18,North America,23,891.23
69e5d7661a4c47b68738c7acb58fba2f,237,212,25,South America,23,1973.91
69e5f9a03f794075b828952cec1cd7db,95,54,41,South America,19,675
69e77855222749a6a2fb6c82c025a81a,241,200,41,Africa,22,2077.23
69e811ebc77a47d08821965199b21393,67,18,49,South America,22,341.81
69e8146064d548a2a32bc0b90963851b,335,278,57,South America,17,1992.55
69ea4cfdce554c2ab94ea61eae8e8b08,268,221,47,North America,21,1158.85
69eae67b130e4438bca4e4d8541f2ac1,321,279,42,Africa,16,2799.05
69eebd2557e74ef88b95df83a9adbbcd,277,237,40,Europe,22,1465.04
69ef48a910f54acdbfe9f0effc942d8e,238,212,26,North America,16,1488.87
69efffc7f99f40c58ac0ddfc5302aabf,85,61,24,Asia,18,639.35
69f0088ba493447fb60dc11b4f039484,215,178,37,Africa,25,1607.97
69f1ea3363b54c8faac77a9a5f99910a,62,15,47,Oceania,22,68.25
69f4c539bb2b426085b27326331ad2f7,208,186,22,North America,22,1776.32
69fcced5eb924579b7e3ab30c572548f,223,202,21,Europe,22,1382.06
69fd7ae6033b45bba89e33d44a3e9fdb,239,197,42,North America,15,1115.51
6a05420d3c92446cb7d6b95f72235849,92,60,32,Oceania,19,335.59
6a05873c67c54f6a91ecee655f1263fd,51,12,39,Africa,19,371.26
6a05d246eb3647bca7390239312b1a91,57,15,42,Africa,24,213.06
6a065f6cbdeb4ce0a225621bd9eda5ad,271,246,25,Europe,20,1783.55
6a07e06137724438ab109c34dcca8060,365,340,25,South America,18,1703.94
6a0846c53aaa4e9cbb62d04da2387ed0,34,14,20,Africa,20,300.71
6a089d1621524b49820ddafaeeca5ec7,365,332,33,Oceania,15,1786
6a0917f42d9849b4b250c05453da4384,81,53,28,Africa,21,624.82
6a09f33a536e4d1c98b768a98138f86a,165,123,42,South America,19,1275.46
6a0b9cd9747143a39ff89224b314b4d2,274,240,34,Oceania,22,2324.06
6a0c9760e0ed46c28622dc4b843a6311,77,60,17,North America,21,367.03
6a0cc05ba3bc4b03a71e979701dfe74c,175,139,36,North America,16,1755.55
6a0f078c07df419f9a71c57f902c7c95,246,213,33,South America,22,1791.48
6a0f112f9827424a8a4e9d60e0e1a9e1,116,94,22,Oceania,26,1422.27
6a0fd81362e148eab795a173e9e1275b,16,5,11,Africa,24,167.2
6a110f54d89441ce81d5f3106e6ca549,267,244,23,Europe,21,1819.42
6a118d5f89e444c1baab464f0be28b3f,111,81,30,South America,19,708.06
6a11aaf164f1481a807f2f006770d761,152,133,19,South America,22,1485.24
6a12765980aa4630ba3171439a481580,208,179,29,North America,17,1519.15
6a152d7d292e4e1d8b4c7d21e431b58b,123,97,26,Europe,23,888.97
6a17a03cd6d148e2ae42479208e19d3a,330,276,54,Africa,21,2334.08
6a1bc5c4d6394e2ebe55259cc3587acd,175,137,38,Oceania,17,1169.31
6a1f476bb88f4227ab8f713df6c5d62d,365,337,28,Africa,25,3532.04
6a1f9662d5af4c1cbf4df3a907a75c55,362,338,24,Africa,20,1794.81
6a201affdfa140a48606096aa4382395,232,202,30,Asia,23,1953.1
6a2276ccad7c436d9e908d6f028caaa0,157,110,47,South America,24,1032.73
6a24d1663f4949c988feaea83b60e992,143,124,19,Europe,22,934.3
6a256965d0664f939011f3f97b1bd7bd,353,328,25,South America,21,3142.31
6a260f51e2ad4b50b9ea9ffcb1d09e86,196,182,14,Asia,20,1375.73
6a27dbefa9094d3785e1df530cf2d05e,343,290,53,Africa,19,2034.22
6a28891b22ac4540b7ce595150e0f5db,100,60,40,Europe,19,644.85
6a3120a2d8234d36b44e50f9468e9ac6,97,64,33,South America,15,820.99
6a32c84c64c743ecbc847093d3e3969e,45,25,20,Oceania,23,213.61
6a338d04b2664c43b1a4a35d6d8a149d,195,171,24,Asia,17,1796.16
6a3432223081409290873f0bb24ab3bb,337,296,41,Europe,17,2105.85
6a349a3e598049b7ba483b8f9b8c6d50,52,5,47,South America,22,281.77
6a378b5f982d44b09ffd9e53278ccdc5,353,338,15,South America,17,2122.56
6a38445e35b54ffb8e3500f6c73f56da,350,322,28,North America,19,2919.59
6a3c047f5cde40b4adc2982037b26e37,262,211,51,Europe,26,1060.97
6a3ec0e318b64550b56854f635d81ff6,280,245,35,Asia,24,1592.76
6a402b653bc8462aa74684754ee68ffe,137,83,54,Oceania,16,514.77
6a404a4eb7964cb2a02a29928b48e60f,89,52,37,South America,17,601.61
6a41f8c1578e4f2bb231d07ff6d9a2b3,365,331,34,Asia,18,1255.8
6a4369b9d7454f24b2e7c5675455a4af,352,292,60,Asia,21,2569.97
6a43cd8e7ec14cc3a8009cd0c931261b,108,67,41,Europe,25,985.9
6a4590e4e6934629963198b43f0addb5,251,199,52,South America,21,1543.27
6a461308a1d8474c99430148103d7dd4,212,174,38,Asia,19,1485.06
6a47b21fc6674f87b8c98ea14123ee1f,84,29,55,Africa,19,111.24
6a483eb6128448398ab23a20c774dd75,101,66,35,North America,23,237.35
6a48fad987fe45c398631210d8a2e70a,283,256,27,Europe,16,2422.52
6a4adae878554b75a614cce456e30c74,138,89,49,North America,18,905.87
6a4d914c953c40cd938cf7b3852832ae,201,157,44,South America,20,1110.06
6a511543a93c485db67e436b05ca9f3a,256,234,22,South America,21,1738.24
6a5520d3094f4710b000a2770ea2a667,179,138,41,North America,18,856.02
6a554eb0117844c2810cc412a1acf4ab,202,173,29,Africa,23,1122.9
6a562b99e6154bc0a199aadd6eda7da4,208,186,22,Asia,16,1419.61
6a587a70676348748dc8218e5d565834,145,93,52,Asia,19,668.62
6a5a05082f1244b296c9a75749a5b863,354,335,19,Oceania,15,2201.27
6a5c0e96804f46ce879685bd1c1614ab,356,305,51,Africa,19,1138.73
6a616be6b8034eeba5a342d6dbfdee5d,124,78,46,Europe,20,841.82
6a63f0ecca164f82a015ffa02aa6393b,114,94,20,Asia,15,1075.91
6a647283295a4fa6a49be33e4031c1d7,365,345,20,North America,21,2244.74
6a650c4ae9f04ce98b5413ff2f1e0363,235,212,23,South America,26,1554.59
6a66c0cc26fc4d6ea01d37f74beccdea,95,75,20,South America,12,601.38
6a69cfd7f12e404fb368edcb16eb7bbe,207,161,46,Oceania,16,655.08
6a6adbf7b58841c4be47cbd7b8dcdf1a,365,337,28,North America,20,2165.24
6a6b279b4c9d4952a2a90fe25bd261f7,365,352,13,Asia,18,2145.2
6a6b3c5f16504575bca61215fe997523,130,87,43,Oceania,26,1201.44
6a6fe92c59c049d1a8e06e6ef1df45b7,351,312,39,Europe,22,2029.83
6a72b96b5e8546ef880707bfe6914d2c,214,182,32,North America,20,1512.17
6a72d297db0943af9cd0102c6c5ebf89,58,32,26,Asia,24,517.45
6a73adc5096e4a559b16eced294bb110,201,163,38,Africa,20,1699.69
6a7513e581414bc48dabd39c669f1b23,162,114,48,South America,21,870.98
6a79a013267248759d8067364a549482,355,328,27,South America,23,1880.22
6a7af1722fba4e2db78b2148c7db5cdd,224,180,44,South America,19,1585.09
6a7bfd940c154fbe9d1d9537821d33b0,281,252,29,South America,22,1764.27
6a7d3e1846bf4a60bc16ae78d1b0dfb1,188,161,27,South America,18,1326.65
6a7d72c968a24c5594acf2872f37587e,261,235,26,Africa,18,1968.06
6a7d7a5f7309403eb7a08482910e2b7e,365,364,1,North America,16,2417.76
6a7da0acc4cb4fbcb1163db5b4202c7c,100,65,35,South America,17,442.8
6a7da424462d43a092029bb0aa0ae680,190,155,35,Asia,27,1082.06
6a7dc8ade6c34284a2ac18ea7f71d479,365,353,12,Oceania,23,3256.72
6a7dce2eb11141ba8742dc7aedf223a1,342,299,43,Europe,18,2672.53
6a801bf36722493b92fdfcf78d2519e9,239,208,31,Asia,13,1704.17
6a80626c0afe4f85b40e8cff94e1390f,338,300,38,Europe,21,2441.51
6a84ae1a6d014c17b43dc576ea60e2ef,215,181,34,Africa,19,1396.5
6a8519ba1ed9418eb10f03eb567bbd17,314,269,45,South America,19,1448.22
6a8c630b455a443d91e761a66402ea48,93,67,26,North America,19,760.11
6a8c9e534ec748069060b7ab97b824f0,87,39,48,Europe,21,815.42
6a8de9912029476f905d033e88b54902,187,152,35,South America,17,950.38
6a8e564d7ef9431ea6a202d9007dfa73,126,84,42,Africa,19,648.93
6a8fb1d590df455e8a1f03fae644e92d,352,339,13,South America,21,2239.16
6a91b627e54c4d81b979018524391a27,168,147,21,North America,23,1059.13
6a91f72616a4414d934fc9aa99783a5b,108,62,46,South America,23,637.99
6a92ea6f5cd444d0851df3b7ffd18493,248,216,32,North America,25,2064.05
6a9496537257482eb106d2ab00b54cb2,46,11,35,Europe,18,333.03
6a97d5df806c43b98d3b39e8bfb6beac,318,281,37,Europe,21,1923.38
6a98dd3c2cd14864be8c03939102c32d,242,212,30,North America,18,1899.48
6a98ecd514ed41329f633a2183f13fa4,232,202,30,South America,21,2231.12
6a993719213d4b26b962c3d80149c293,275,239,36,Oceania,18,2006.15
6a9a18c71597440591f1e1d69a44279a,150,129,21,South America,19,900.66
6a9b8c04029441138d2495ed8846cbc1,290,241,49,Asia,20,1488.69
6a9bbf58b154466592b43263696415b5,238,180,58,Africa,23,509.81
6a9beb889c754f59901719243ac434c0,73,54,19,Oceania,16,484.86
6a9f737f9d17480ea6e0ab500ce2c565,115,59,56,Europe,21,885.17
6a9fbf18c22b469d89ac2f266bfba8c5,188,146,42,South America,19,935.3
6aa0dbd7bcff4db2bfa200d1c66c5cef,322,280,42,North America,21,2186.88
6aa14eac34674b21bcb56bc84bce9bb6,238,188,50,Europe,14,1307.96
6aa3d52b634148d38d476537c925323b,364,321,43,Europe,21,1841.72
6aa4e9867abe438698f3f61764023195,343,317,26,Oceania,21,2911.89
6aa7080ff9974b1cb10a4a3beff5adcc,364,336,28,South America,16,2114.1
6aa8aa8219824c8a95f7eeab51337efd,357,323,34,Oceania,20,3125.62
6aa94ac7dd73458186db2c82326ba46d,258,224,34,Oceania,18,2083.65
6aa9d168bf50442b86ad1d043433f222,145,110,35,Europe,19,1123.84
6aabeeaef0df49fea086cb4aa312f6b6,155,109,46,Africa,13,563.27
6aac17dde12045c49077a7987bcf6064,358,318,40,Africa,22,2292.52
6aacc87df044495c8e08b7439d329488,340,301,39,Oceania,17,1912.05
6aad637ead1840ddaf8ad1acc1b836b9,94,55,39,Africa,16,653.77
6ab02e1314f94509a4fa71f8d1fbc053,279,250,29,Asia,24,2218.4
6ab1bf8603504a5fa61bf84cd3c0bd73,365,359,6,Asia,19,2460.55
6ab1d037e3464953be906fc5f6f038ff,361,350,11,South America,18,2518.1
6ab2071acec34fa590330f45c7a42409,198,149,49,Oceania,22,890.89
6ab352568bf44884bc59e8dac3c5e6b9,242,219,23,Africa,19,1648.33
6ab3544fbf6748438b3d12349ed422ce,305,277,28,South America,27,2141.1
6ab6cd08205e4dfbaf379076b47e85c7,276,233,43,South America,18,2087.86
6abaac32d3654711903da4924987ecaf,301,261,40,Asia,21,2530.85
6abb7003c6b34399ab7dbd854545b7e0,102,60,42,Africa,17,741.6
6abefd426b0f4b438d17979aea96452d,362,327,35,North America,22,2325.86
6ac1231556194488afe1130c91cb9f23,113,69,44,Oceania,16,580
6ac3b062082d4ff1bfa835bd914f8946,194,146,48,North America,27,788.11
6ac4e5f2285c40d386d74e19c4216127,101,51,50,South America,20,482.44
6ac5e47812cf496d9ea1f3172b0c6d81,222,189,33,Oceania,21,1590.87
6ac7fd8d2cf14010bea7c58091f0ed69,362,339,23,South America,24,1963.39
6aca69479f62468290e67b0a4b43de49,57,33,24,Oceania,18,101.96
6acafef1ab8d43f3870d12646d5f0710,303,276,27,South America,19,2536.05
6acb888334a54da690fac977538aef9b,363,335,28,Europe,17,1588.81
6acd4401e3d24e4dabab962af66d491d,288,238,50,Oceania,23,1046.05
6acd5d08a79245fcae719e66378a761e,137,102,35,Oceania,18,1002.66
6acddec410264cad8dc7bd998b5edc97,212,186,26,Oceania,21,1411.99
6acde8d0f30441e4985b606629ec123e,311,289,22,Oceania,19,2600.39
6ace24f6ada244649dd60385ac1637cf,164,122,42,Africa,24,783.35
6ace4b189bc2452db47803a3bb19af59,174,126,48,South America,22,406.37
6ad02108f3554fff87e0f7ae23b310f1,359,326,33,Africa,17,2297.33
6ad1180f7fe04cefbc03f482ce9121f5,353,321,32,Oceania,20,2083.2
6ad6d6e52b214b53be9d65b2caeccf12,96,55,41,Africa,18,541.22
6ad89603d4d34ddab96981b31e5f7804,224,184,40,Asia,18,1292.49
6ad8a5afc2614b27b218ec7716fb1570,32,7,25,South America,16,184.61
6ad94d1ed2af400681588dcadba82724,238,206,32,Africa,21,2347.9
6adac1ec878b4282acba89870a7a54fd,63,32,31,Oceania,22,780.21
6adc98f399254c28b64ade3b7d8ba5bc,90,45,45,Asia,22,385.4
6adce8f40361430eac996b93f2baec44,50,6,44,South America,18,394.9
6add6889b2394ed9b0ed32d517ff5323,196,173,23,Oceania,20,1494.37
6adeff51cddf4cc693cb2fd51fc1628c,263,223,40,North America,17,2153.58
6adf5cce84ac43c2928ac105a8482b22,219,180,39,Asia,22,1416.42
6adfde08f606472c81a3ed18f8a6e6bb,165,116,49,Oceania,16,786.1
6ae2c2d0be3c47438fb75e15a55853a4,365,349,16,North America,22,1552.19
6ae3878c77024a90bdad6f2c05c5f436,298,265,33,Europe,18,2151.63
6ae3937213234a20ad9d7d8038de06ae,43,6,37,North America,20,96.15
6ae7364a06cf46e6aa1ad6638561ee4a,58,17,41,South America,24,241.03
6ae9a8444b294e1ca3a767790d8a6df1,95,68,27,Europe,23,840.35
6ae9d7a2ae284bcd8b140b4f6033f275,362,341,21,Oceania,16,2270.46
6aeabfe6e35c4567bca7a3eec034ffb7,202,157,45,Africa,18,1047.11
6aec4f3589b24303ba41b0c13fd6017f,317,293,24,Africa,22,2058.43
6af4910421664fa8ab98c21498bbf208,232,175,57,North America,19,1073.24
6af53162767b4ff590da3dd3c41b7f80,72,24,48,Asia,19,616.63
6af5ca246e124702a0d7dd3a444a8a38,365,359,6,Africa,20,1768.58
6af731d4403240b299d52a69b7e90139,365,331,34,North America,17,2397.01
6af78e5b5d2c424a94fc08c339a8f29d,214,192,22,Asia,16,1257.01
6af9c6496d8d429f87ff53e453a97f50,276,266,10,North America,11,1587.88
6af9d6a6d92541a296f69fd776763cee,363,321,42,Africa,21,2416.45
6afa43fa147b4df99c8d42fb6da46857,233,195,38,Africa,22,1556.42
6afab0119e1742d8b4aea0f2dad59900,105,67,38,Africa,19,1085.63
6afd054d717645d09ebb5ffcb3d27d83,266,248,18,Oceania,16,1821.89
6afd0dcd1c1243a78ecb89d8096704f2,301,262,39,South America,24,2413.48
6b00d55e6f044aa0ae3a03cee3f0c989,335,294,41,Africa,18,2083.54
6b013f7080ed4fdeb672bd8fcabd86a8,209,174,35,Africa,25,2075.49
6b04a3a3c2c44e8ab343005b576404c3,220,175,45,Oceania,22,1043.7
6b05334f53e0402b802d99ae17129142,155,113,42,Oceania,24,796.74
6b054560cd5843faa3566ea31b88ce84,241,200,41,Europe,20,1336.06
6b05a95b8f7449f693e5c11baa7d054b,321,277,44,Asia,20,2596.83
6b05df19885a4d29ab0fd56dd53e1c21,333,286,47,North America,21,1979.05
6b06f68ce02042e38ffe82eeb37d6d1a,54,16,38,North America,20,217.15
6b0771a2b9234bbf8dcaca840fb4a900,155,117,38,Africa,21,1122.24
6b08e03e9be54e18836550e3b2ce9cfc,203,150,53,Europe,20,720.79
6b0a233a8da845fbb575a717a2d9e05f,280,242,38,Oceania,19,2077.15
6b0c27cf78e84c58bb2a6d5c1df94bc6,270,242,28,Oceania,17,1343.25
6b0d222ab9ce4c919dd541e62bf0a6de,347,312,35,North America,17,2720.53
6b0d65dd2919495ea69b20388b50b044,365,343,22,Oceania,20,3145.33
6b0dc6044a3e4596b0f00793fdbc07b9,312,278,34,Europe,21,2355.3
6b10a848847942348c48f0051f753149,364,338,26,North America,19,2286
6b10bfd040884bc9b4e893fe7282b5d0,89,64,25,North America,22,769.67
6b11b341a0644696bb3b81bd2d7956d4,348,312,36,South America,18,2870.49
6b1245508cd64053aa80d071ce6898ca,277,233,44,Asia,19,1717.29
6b133bb35b804da3bf1fc2b2105efdbb,168,132,36,Africa,14,1443.73
6b17a8a204894fdc9bac8110dc32f42e,335,311,24,Africa,20,2397.91
6b17cd19dbed44aca489304e2003b72e,276,231,45,Oceania,16,1365.69
6b188c182f514a9fa3c183bdc806792f,347,328,19,Africa,22,2542.84
6b190ed98ee14107aaec05c3ed8f7690,187,147,40,South America,21,861.95
6b191b9d268249ba949440856857094f,330,286,44,Europe,21,1510.02
6b1aa49bba294a279e5d82498b93d93f,285,228,57,Africa,23,1641.6
6b1d517508cf4a2abf86b43cf4c5bd0e,229,200,29,Oceania,22,2063.26
6b1d93a2be3e4194bd937376f83175d6,365,353,12,North America,21,2321.86
6b1fc5fcf51f4ce3933d16619b88da72,56,5,51,Africa,15,241.8
6b204527d92a4dc8b71b0c6a179020b5,319,266,53,Asia,23,1278.21
6b225644650841e69dcfaf51462cca4b,117,94,23,Africa,18,999.18
6b243a7f9d0246f2ae674c555b68bf2d,42,17,25,Africa,24,232.53
6b257910cbc54889b150727f60af38bb,266,228,38,Asia,19,1456.85
6b25b74030984c18b0087c1685e13aba,177,120,57,Africa,19,1100.67
6b267ad4c20d4c158f6a06f14f1ccf37,82,61,21,South America,21,458.79
6b27bf9262b94f48a32d468ee0d8c6e6,244,197,47,North America,15,654.24
6b28e4b85da24a98b13998d1b6cc67f5,348,306,42,Europe,24,2676.38
6b29cb7832a4449d9cf37917fa3db5bb,365,360,5,Africa,19,2392.58
6b2a1a9fea6d453eae8e575d10709e93,166,143,23,Africa,20,1669.03
6b2a30fdbaca451591a80da087076936,365,347,18,North America,15,3036.16
6b2a37bb1c714b6aaf7f066cb52753de,362,349,13,Africa,14,2413.91
6b2a9b88d2d74cecb3d38a9b3761ce21,225,183,42,South America,22,1805.7
6b2aabbf18f94ae9baf40bcfdce254b9,157,119,38,South America,22,943.79
6b2e0fbc8be64ea5ae3f6c9a964e5a6b,92,50,42,Asia,22,932.42
6b2ef20321a147d0a3bd8334ac6adf62,364,323,41,South America,20,2799.91
6b2f02c83e81487b8e1da3f113b6889c,98,43,55,Europe,23,419.55
6b30880b92de43f0a2d361a24a4558fe,301,274,27,North America,21,2206.91
6b315a693a59420694550da7f8aef4d3,308,286,22,Oceania,20,2200.9
6b3172b9cb484b30845024245ddb1f6b,70,27,43,Europe,26,519.88
6b333f37f08945bf8a47616700b9744a,365,314,51,Africa,25,2600.38
6b33f43bcd73435fbbc48c229717d7aa,362,339,23,Africa,21,1829.67
6b354abc6d8d4c4c99ccf92e29623b67,228,200,28,South America,21,2455.69
6b36ec84bfa5437abbd1bae6eff346cc,343,288,55,Asia,16,2415.58
6b374893e033454d965e6bf227c8c3f9,317,258,59,North America,19,1555.47
6b383e85bff945048347eafd2ca7273c,54,18,36,South America,21,248.97
6b38934d027e4664b75a53fdb3e547a4,247,220,27,Oceania,11,2397.92
6b3a78322f9e4a328d7a42410c5050f5,320,273,47,Africa,19,2241.72
6b3dd29da6a347528988942117b3e96b,274,226,48,South America,22,1273.67
6b410f480a344df38bfa24280ed7dbb1,218,170,48,Europe,25,1468.65
6b412ae76e244f23a1cc9786f754ae94,339,310,29,Oceania,23,2303.75
6b42d7f0893b4529b79aaa8a98804293,321,269,52,South America,15,1039.56
6b46af80668a43ed832370f05624186b,141,102,39,South America,15,1107.46
6b4a6b53f0a74c72a36c5c2c38d8917a,58,11,47,Africa,19,257.14
6b4b41f505e841c785774de1418c49a0,325,287,38,Asia,22,2544.16
6b4bba521cd8448a804ec9a51758d8b4,298,263,35,Europe,17,2033.54
6b4e26ed7bb7497fb03bafde20c00359,99,61,38,Oceania,17,603.86
6b4f587641d14bdda0120a89bfa99037,219,173,46,Europe,21,1308.2
6b516dbbba9045ea85012efaeac700ef,337,302,35,Asia,19,2106.94
6b545752521f4cbd86586b78930ab2a6,340,312,28,Europe,20,2430.59
6b562bd22b894decaa621f66d54ed071,365,357,8,Europe,21,3430.67
6b583b9dd3de494d88ba9c3d57097cd0,319,272,47,Africa,21,1615.94
6b5b0170343e444b8557422a814db4d4,347,319,28,North America,18,1992.92
6b5c20924f1041d5ad9ad3273e5db2a8,365,363,2,Asia,17,3025.25
6b5fbed37e7b4fcfa168c0eff959c6d3,166,129,37,South America,17,784.56
6b624377b3d847b4aebb7a8d4b29ba04,268,223,45,Oceania,23,1295.65
6b667c5a77eb48a79496490f06477902,133,73,60,Asia,18,653.73
6b6691e6423d4251b70e403a77398b06,237,187,50,Oceania,21,1357.06
6b6788b1bacb4463ac9dffead2d36700,163,125,38,Europe,22,1193.95
6b68137aed5145da91a5f0b499e8b046,306,276,30,South America,24,1975.26
6b692618ef7349299a2d98b458499180,222,196,26,South America,19,1852.85
6b6aaddd63a44cd78d8c0e6d5850cde0,175,130,45,Europe,20,1217.82
6b6b886cfd4c4993b32ea29db5cb3bc6,337,307,30,South America,18,2560.77
6b6b8950c46e48208e9e5c0df4ec226b,221,197,24,Oceania,21,1891.8
6b6c0ff61dbe4bcda6c2adb29e8678de,364,340,24,South America,19,2374.97
6b6c9804d92349a5ad8a85c7ea178524,231,210,21,North America,21,1698.06
6b6ca54a76034c83ba5a0b88fb4152fd,365,334,31,Asia,20,2502.42
6b729d4268bc421eaab73293d3fa2fac,112,57,55,Africa,23,670.52
6b72beb3ba444e78a227edf868037321,354,325,29,North America,22,2199.51
6b72c2c661974781b78c94b1c14df5ef,329,278,51,South America,18,1589.58
6b732924232f4adbab149de08fd36dc4,45,3,42,Oceania,21,619.04
6b76adbae20e43a0bbf2c185682dcdbf,86,58,28,Europe,20,745.6
6b7736ac4c84492186266b6438f25601,52,2,50,Oceania,21,473.24
6b773dc973dd42638033de32d3ec97ea,75,47,28,Africa,15,895.4
6b77f796560e4e2685fdd7e0bb08e0ae,86,51,35,Oceania,20,969.43
6b7a59f8f82c4e88b1f59a480f6e4059,299,286,13,North America,23,2434.95
6b7bd1e5b5d0441e8e13ad9e94c1f9ea,160,106,54,Europe,24,914.71
6b8080c9b0844205bd44423f20b18864,314,268,46,Africa,18,863.16
6b834204a2c74d2f9fad63b02a3b7601,332,274,58,Oceania,23,1497.17
6b836ce3c12b45e0ab401cad5301cecd,201,171,30,Africa,18,1751.62
6b8953be6f794a959f081248f52e0c5e,341,316,25,Europe,22,3171.05
6b8dc2b8b936430fb6c4cec160cb4d80,360,342,18,Europe,21,2265.84
6b935a1df22d4e6cb3b53ad8c9b6e465,139,108,31,South America,15,534.57
6b976e16e074436ea9778c408fc49261,134,95,39,Africa,22,439.67
6b9826ea9a144f1e94ae1a1ec7839f49,84,23,61,Europe,16,504.2
6b9a0b1448044d569f586925bfba72c5,67,21,46,North America,22,627.46
6b9d9ace241446229e44ffe23ac8ba15,288,252,36,South America,22,1900.13
6ba1423044694b6aa1141f53a67ff263,297,247,50,Asia,20,1634.19
6ba31bf71d894ed0984819f3f4e6e4b1,329,293,36,Asia,18,2091.14
6ba405a1e5a245d3bb43e6eae7ae2b01,365,365,0,Europe,24,2611.25
6ba49b1e997f45bf900c624a79034731,69,28,41,Asia,24,197.95
6ba5d391eff84576a0393a649eb58644,322,298,24,North America,19,2553.35
6ba712b018f84e659ebd147d5bf1f5b1,75,49,26,South America,20,624.03
6ba89a18d53d4a3faebfebb1f9b729ea,295,244,51,Africa,18,1424.57
6ba9a5f4f91f446f9cbf667404aed406,51,13,38,Asia,19,430.14
6badfb0122224fedaecc9c1674e1ae8f,169,125,44,Africa,22,937.52
6bafa4a4445f4222a3d7e3a86bfa0c07,363,360,3,North America,19,3086.9
6bb2a27d8da44583aee8eee534521e45,365,363,2,Oceania,20,1749.24
6bb2c47ca063439190dcd3677b5abd2e,335,290,45,Europe,24,1794.11
6bb59785251548529338106fb705ce87,102,58,44,Oceania,19,237.36
6bb62aebf2764524985edbea70ab9043,309,275,34,Oceania,18,2165.59
6bb8c6d2de194d879452fc1b1049cb6b,337,281,56,North America,23,1438.12
6bb8dbf887f64774b85a2f227e0c6359,275,242,33,North America,19,1737.23
6bb90aad647b41df90586d701de68c75,56,26,30,North America,21,366.16
6bb934c1fdf64ab6ac7b8cf3088df1a7,364,337,27,Oceania,21,1778.17
6bb9f0f76af64711bdd489a4ebc7bad7,248,200,48,Asia,20,1253.41
6bba7fb7fb14459699f79ff8d7825266,148,111,37,Asia,25,1004.33
6bbcb5356ba34d068b6c53b9e512f84a,341,305,36,Asia,21,2359.2
6bbef6c0329540f3aab59ae3a83d5149,194,138,56,Oceania,19,736.95
6bbff7bfcf874b43b458e02d282bbb6a,145,108,37,South America,19,1052.34
6bc44021efaa4a30b68643c4cbc4d0ea,133,120,13,North America,16,1034.78
6bc6417ce8474f0f8e2c1ea84d0c080e,133,104,29,South America,22,978.7
6bc778bf563a490ebfe242af4c154aee,250,207,43,Oceania,18,1345.06
6bc808e886324474a3c3cff765e0bcc6,50,10,40,Europe,23,285.96
6bc837ef7e694dd28ba9f8cfe2fd4935,242,221,21,Europe,21,1531.59
6bc83cb8218b4c128726eb6d50021364,272,248,24,Asia,22,1308.69
6bc8533c7a064437aa7bd21f5af8a5e8,364,359,5,North America,22,2266.14
6bc8f7221e41441ea8b6517f9633a131,186,143,43,Africa,16,1330.54
6bc940a5957b4a28bbb7ec464a84e1d0,109,65,44,Africa,24,639.96
6bcb5a2721394f81b132eb9cb00e7f3a,142,92,50,Europe,24,476.17
6bcbdce432464c15bd29fe92441b7518,224,189,35,South America,25,1225.06
6bcd87ac0fae4c15a56f8d11ea140e20,364,355,9,North America,20,2343.42
6bce1ceeaefb44ed99514e1fb1e24516,62,21,41,Africa,19,220.68
6bd006b06d5f4cb589d6ca30a8245763,272,249,23,Africa,19,2055.71
6bd0ab65fbef47529679de5719707037,135,107,28,Oceania,24,904.61
6bd3a8e21c884f3584cf12d537cf38b6,67,21,46,Oceania,16,322.34
6bd40bc6d0ec42e5b707fd3b33f5b4e3,74,27,47,North America,16,239.11
6bd42c3a24c84fe28fed513ce000840f,107,59,48,North America,16,674.35
6bd534908b9c44218822d65659d053dc,111,76,35,South America,22,969.61
6bdacfe1ec0b4ea183ac01959667d33f,134,81,53,Oceania,12,399.4
6bde130a530741c480d9affd54a56333,130,79,51,North America,22,395.84
6bdf4e66aa1e42e29674a36a3c35e24b,38,17,21,Europe,14,125.04
6bdf51b108164da689b787e634e21fb5,134,94,40,Europe,19,726.45
6be2c98361454d2e98cd3c3d10031c41,100,81,19,Africa,19,924.08
6be345128be74d088f8685605196651b,235,190,45,North America,21,1377.47
6be45de99d684a3bbb41ffea636dbf74,100,62,38,Asia,18,650.3
6be4add15d634da38220ccf4f0445fb6,365,345,20,North America,19,1746.87
6be600314932493c942ac3d5507fd28e,264,229,35,North America,26,1313.05
6be624c073ac42dcbd65182a7a499466,259,234,25,South America,23,2200.58
6be653b999c14ba3b909753df60fca27,106,63,43,Oceania,25,675.28
6be89ae67c80477ea863d77667503068,239,190,49,Europe,21,779.4
6be93ff629774ac7bbfeab1bed37c4b8,61,31,30,Oceania,21,361.19
6bea6f2b3bde49a9a231d3cd9edebaf9,311,264,47,Africa,17,1442.15
6beaa0cb1e134384b5bf1f14979eb006,115,70,45,Asia,15,619.42
6bead485cc0f460480dea3a7476787e6,346,314,32,North America,24,2611.32
6beb14b377e64515bf243ea0697a1cc4,314,273,41,Oceania,20,1858.24
6bec2dd14b324eda9af758a1159fd174,365,343,22,South America,17,2527.84
6bed2d924b794a19862b282a990ae88a,363,344,19,Asia,21,2811.75
6beea18b54e44344b8b3066b36bad36b,332,308,24,Asia,20,2032.42
6bef8f29b0934fe29e1690f254f8e491,120,70,50,Africa,17,709.24
6bf0ea22fea847d080757ff92b6afc22,273,225,48,North America,22,1156.42
6bf11bf89bed4644ba158514e348343b,155,122,33,Asia,24,1255.08
6bf16ab193ae4ec6b6756d15c2174c1e,240,185,55,Asia,19,1198.51
6bf18a08373a4177a5f781c047947361,290,258,32,Africa,21,2044.63
6bf285413c574c4494bb17c9630fa59a,206,157,49,Europe,22,1096.06
6bf360afce8142f3ac573b7c623c67c1,73,18,55,Oceania,20,399.97
6bf8342fad03484a9ff4112b400f8716,322,292,30,Asia,21,2465.24
6bf9b4a39268441ead70568738a9dafb,64,25,39,North America,25,657.14
6bf9c07292e44a319a429820fa40aaa5,324,276,48,Asia,21,1448.4
6bfa7b17df954d3396dd36d30151bb96,274,229,45,Africa,22,1439.9
6bfaaab996634a3d9f45db2995ec1fe0,279,248,31,Africa,20,2131.92
6bfaf4eebb4f4d82aefe00d8541fea72,157,115,42,North America,22,613.16
6bfbf650504d4d9197b69b189df93c1e,147,94,53,Oceania,21,478.69
6bfd1f9a6bd74d809ad60b754c5683c8,315,270,45,North America,23,1723.32
6bfe9d77cc8d4625848c726d7070d233,358,309,49,Oceania,18,1557.84
6bffe16be87c48a09c55460e45e4b2ec,257,202,55,North America,19,560.43
6c027ff1a14343268ebfcc05034e61ec,92,50,42,Oceania,21,489.18
6c05858a6f1f46549e8bfb95273bb190,212,182,30,North America,22,1450.21
6c06ff10a25942beae1e8773678da852,136,89,47,South America,21,611.42
6c07dc07497d4217833186082fc0af80,61,19,42,Africa,18,429.96
6c07dd759e944a0f9a1abfa3f1822ff4,180,130,50,South America,18,929.61
6c08af48882342f68b1c6620e56699dd,363,346,17,Asia,26,1247.48
6c0ad262b6084bf9be94723cf395b860,249,206,43,Africa,22,1243.28
6c0d48f4c9a74ab6986ef2e05daecaf2,85,42,43,Oceania,18,709.1
6c117e19b75240c68cf22e816a01e5ad,184,137,47,South America,19,1054.81
6c13aa9d0a27443cb20c5a3b0ebdbf7f,361,331,30,South America,22,2179.02
6c164ddca96f4078a212c8fbf195f732,111,84,27,North America,22,864.11
6c184c0859a64bd9aa833724aad9334e,68,26,42,Asia,24,835.53
6c18fb6a021b4e9b8b4ea2dee370d7f8,363,357,6,North America,21,2353.7
6c192bb7ad644ad0892ed42758b35e02,263,234,29,Europe,20,1797.76
6c1a235289b84e018810a459be7ec554,147,121,26,Europe,16,498.48
6c1adbe9b536466a974d1aa9f4be7648,164,142,22,North America,21,1316.88
6c1b92c082ca4bf9b35333dfe17f6fd1,231,184,47,Oceania,25,1018.62
6c1f7ae09e644864965bd7f8ca0d045a,345,292,53,Africa,26,1802.3
6c207577bd1c4151982bd8d1d3798f9d,190,164,26,Asia,22,1674.96
6c21f2e5e8784ab0a817a93bdf70fddd,251,213,38,Oceania,17,1388.77
6c249f8d7fd8447e9f99442b3dd8d1c7,35,11,24,Europe,24,342.47
6c263e8542864b96adca1d18cea1107f,150,103,47,Africa,23,961.48
6c26474c8ee246fb8edd4bb8d8febb8a,360,319,41,Africa,23,3027.24
6c271107d50e45358e3bb134b7ac8a03,365,332,33,Europe,19,2113.86
6c27fd37726149ef9ba8bf19f0a835cb,153,94,59,North America,24,600.31
6c2828fa316a46168c54aa12fddef6ff,115,58,57,Europe,18,375.41
6c29594fb33a40dd912d79699c0f9797,248,217,31,Europe,19,1876.55
6c29a7c9808d4c28b07c3ca095a1cd0a,208,167,41,North America,21,1163.64
6c2b1605af4543b0813d7e9418fc401f,301,271,30,South America,17,2216.91
6c2cb3d9eddf450dae59384149ed8637,247,225,22,Asia,21,2274.74
6c2ea3a4fe4f49deafd4171c32271765,184,154,30,Oceania,20,1455.32
6c305efaa0674932ad85a5e677aa9cd0,361,344,17,North America,18,1515.38
6c30ab1e05fb498cbcbd6e6d251cd291,365,334,31,Oceania,23,1715.69
6c35d9ca6bcf4c369e170da5d3a1ddf5,327,286,41,Asia,13,2927.26
6c3637bc3ebf4fc7ac4deeb00cd4609b,253,207,46,North America,26,2133.09
6c39b8f4191a41d5b75bbb404f8f05bc,353,319,34,Oceania,20,1988.92
6c3d8d6e5e3a4285a5f117f5eb31a68b,364,346,18,South America,15,2806.15
6c3d9983c011416ca4526eadbeacfa5f,122,97,25,Oceania,22,1204.07
6c3e7a7dd433488db0a386f7a2c67f72,190,147,43,Oceania,22,1434.11
6c4132f98c204dbca023462ac94b7e35,31,15,16,Africa,21,344.26
6c445d091b184579ae10f9bff2de89b0,290,252,38,Europe,17,1985.91
6c452d776f304c63ab02d326035b0e13,109,58,51,Asia,20,680.76
6c4546c6a12e4b4c9b5ca516905e4bb7,274,229,45,South America,20,1705.35
6c47de48e56e42e78e61c7c765a93a68,120,92,28,Asia,20,560.04
6c4871a8012b452196152ab1c063e938,308,283,25,South America,18,2238.07
6c4b73712a5d4057a476ee369525fba5,188,154,34,Europe,22,1047.79
6c4cd75cd94d46b2a895166f540679b3,181,135,46,North America,18,1342.12
6c4df1d45dcd4146a95bb4080b3f25f8,355,313,42,South America,15,2590.78
6c4efe6743c84a1083b089ee5fde18c4,336,304,32,Africa,19,2950.9
6c55d8a071284b24a6135c48ef8d06d5,161,116,45,Oceania,22,798.21
6c567a233bce40b3a0527c48ec3797e5,210,183,27,Africa,22,1499.68
6c569fcccb46427c9bca7a80760c8461,324,298,26,South America,20,2550.19
6c57987ba64448688de250a9f0dabede,94,41,53,Europe,19,493.32
6c5d9168fed749d79f04f2c736fd494d,337,290,47,Europe,19,1716.62
6c5e5c50df85455eb5966f952ee9c023,149,94,55,Asia,24,559.43
6c5fa65eef80465299e031b341db15e1,58,18,40,Asia,18,549.73
6c5fe4f9b5df40089230d4d9bb65a3e7,53,29,24,South America,22,232.75
6c634001c4884bffa10697d8c97dd04d,364,341,23,Asia,19,1418.08
6c63a95eb3344d58a52e451d4b1aa0a7,331,301,30,Europe,27,2568.73
6c646f208e6d432e824a857755c32112,345,299,46,South America,18,1662.03
6c647d56d1e3409994c6d0053031e9c5,292,250,42,South America,21,2074.72
6c657dda5167463db372a05ac5e620af,142,98,44,South America,24,713.7
6c67004c0f5149ef8c8a590a08021931,365,356,9,Africa,21,2544.43
6c6b930f5348432e89233ba074fefdf9,293,240,53,Africa,20,1677.86
6c6ccc828f694fc6adb961a4217480dc,52,30,22,North America,18,383.55
6c6e8c9435c54131bee0372e06cd8162,216,181,35,South America,14,1306.09
6c6f345d123a4dfdb568690ea209ae57,91,48,43,Oceania,21,537.48
6c70128db8744eebbb494e000fbb123c,294,257,37,Africa,16,1539.56
6c70855dc6f04b8bbeaa0e34d9685818,61,23,38,South America,17,172.05
6c713e16f4b94a7e99af5bd6d71e1909,115,74,41,Africa,18,772.43
6c714a6962484a4891144eda3f5cbc84,230,192,38,Asia,24,1679.32
6c73b27b20bd457cb7bab3a45f8e0853,90,34,56,South America,19,565.12
6c73d8af5eb848a78d59ed897434f4f3,97,56,41,Europe,23,635.11
6c75554e96954082b5c4e831448aa4e5,107,65,42,North America,18,280.79
6c7555db733d4eff8808beed75691a50,365,343,22,North America,16,2308
6c77cc733a9649738bc9c8b3d48c0c6a,315,289,26,Asia,19,2196.33
6c77cfcb2481414b9493e4794c9f112e,288,251,37,Europe,22,1840.64
6c7a491d4b634750a42cc33f9279ae73,170,134,36,Europe,20,1197.77
6c7cc9ae954f474f92bcbf483d780fbf,264,208,56,Europe,25,1368.89
6c7d04924bec4e8297ca0b4b2a76a0f0,90,34,56,North America,21,648.19
6c7f5c6cd9da4f60b1c11f2624d1af1b,130,119,11,Oceania,20,1157.11
6c7f9dfff25d445bbe45c12df9ece702,290,256,34,Africa,20,1365.31
6c80c21d10e44318b62da904b758954a,34,1,33,Europe,16,482.85
6c810b58f13b4c3b8d925d69360c265e,147,126,21,Europe,19,645.5
6c83882eaf514a11bdd98f8675e72e1d,229,206,23,Oceania,16,1468.2
6c8698291a5748c5b59b654e14abfd16,124,90,34,North America,18,734.06
6c86ff01063d44c0b20ef082c4cb60c3,313,277,36,Africa,26,2193.58
6c88264cea1c4f03b2a0dd1e7e1743ca,344,288,56,Oceania,18,1494.18
6c8a3168866c41c685d2676a53cdf09e,339,293,46,North America,25,2676.63
6c8bfac6dad847409af7eff7684368eb,42,6,36,South America,16,183.42
6c8cf06a971b4b02959c0dcf131fad7d,258,202,56,Europe,25,946.39
6c8e17aa4c9c4eb681b677a738cd2e6b,121,92,29,Oceania,19,583.2
6c8f2c0608eb48ceb82d011421ea9578,61,22,39,Asia,18,351.52
6c8fd9fc93ce46eeb2804b09e8ad684b,290,239,51,South America,19,1903.35
6c9090b33e4647538773b5bcf697b1b1,161,104,57,Oceania,19,930.33
6c91f4d35f6a423581f2c1059269d6dc,105,80,25,Asia,24,598.81
6c96134d9d0541dd9eb040842ec7da8f,234,183,51,Africa,14,1154.66
6c96a07d1ba840308ab9de5abc83bea1,333,310,23,Europe,16,2499.02
6c970e52bcd64115bfbc42d0323a7b4e,304,267,37,Oceania,18,2210.38
6c976ba5d3a843d79352d033fcf81642,126,101,25,Africa,23,939.59
6c98f0ed6d034853adb10e67ad00474d,364,311,53,Oceania,22,2441.01
6c98f54b23f34ece9678d5cd04e3d988,65,32,33,North America,14,347.46
6c9c0aca87af427493f8d5d6d7135a9d,354,330,24,Asia,22,2682.79
6c9c40640d354177a120babdb78f6824,325,276,49,Oceania,20,1319.11
6c9e2d8ddcdd4aedbe3b2ac975d83171,241,205,36,Africa,19,1276.76
6c9e44c1a78c421ea7379947bbd1d596,357,328,29,North America,19,3073.79
6c9fadcd107f401a8ac857ca3761b2ab,258,206,52,South America,21,1682.61
6ca11b192bf84458b0c05f2f894295fc,301,267,34,Oceania,22,1794.65
6ca18e0c575c4bae9ce5531f0097e8cb,363,357,6,Africa,23,2419.07
6ca36090e06f4e74a272094e196d2206,206,161,45,North America,23,1132.31
6ca521119cb24368ae170377f2df88c3,240,206,34,South America,18,1986.12
6ca54f0b40334cd79d198a8d3b2d466b,241,199,42,South America,21,1268.71
6ca92e3d0a6f407586860c0d76afd012,82,30,52,Oceania,21,394.17
6caa46e619a8435f8268f9498be06d6b,339,312,27,North America,17,3448.32
6cab95ad1a1645a29844b7efe62cce7a,365,365,0,Europe,17,1905.52
6cac5b8ebfe94a929bec75a822400109,264,244,20,Oceania,22,2047.59
6cad979023b84714bd63d4eda846df17,298,270,28,North America,25,1654.29
6caf5134cb0f44ab8482173331d79c4e,101,53,48,Asia,21,271.99
6cb1eb06597045a091ee2d11db066b0c,347,306,41,Europe,25,2755.54
6cb2219065a64d69b60c9d03b1c230d5,365,340,25,North America,17,2369.17
6cb48fcb0fad490fbc36e0e4dfa3c84a,359,313,46,Africa,22,1590.19
6cb4c4a56aee49d0b70f361ad59610d6,111,74,37,Oceania,27,825.73
6cb5f96d14094ae18d799e18a296f57e,180,139,41,Oceania,21,1057.84
6cbceae399cf4752a29ff34674ec4501,281,230,51,South America,19,1701.37
6cbcf0cb1e0c4a21a2513025543bb05f,245,196,49,Europe,25,1295.86
6cc12c6759d6444784a295ee97e63352,150,112,38,South America,23,755.06
6cc47d45593c49d184dccc604e50e12b,277,241,36,South America,23,1908.18
6cc4db20fb374832acc8d6cb7996ef76,337,298,39,Europe,20,2301.79
6cc52033ad2346c789f228d8841caf7c,124,70,54,Africa,26,232.66
6cc73518796c47aa91bf30d117617150,77,28,49,Asia,17,415.56
6cc9f6867c0046b1acf600228b20445f,81,64,17,North America,22,823.87
6cca494968d344f98c887b7f4fd1ec63,106,86,20,South America,20,324.97
6ccbabd7b9d445c18d88e6d07681e9ed,318,283,35,Asia,16,2225.42
6ccbf5d294b44157984f62dd0d61ab6e,268,226,42,Asia,13,1462.1
6ccd0061f9c44e118a4fc96454df111a,22,2,20,North America,22,49.94
6ccd24b5a1dd4d448db30426a5b51af3,150,134,16,Africa,20,1202.64
6cd25d771bde4ac7bc55e70e9617336d,316,296,20,North America,22,2559.22
6cd4739cff654b2b8d794e43ec1fc173,365,348,17,North America,18,2636.38
6cd4b1155928489a97939db9a3dc770a,134,76,58,Europe,25,794.29
6cd775a5a9a6402dbea35eec56098c4a,28,2,26,Asia,19,172.53
6cd8b5661b2844d4900658166b982dfe,102,82,20,Europe,23,874.14
6cdeae5653e349f393af20ef20835903,365,349,16,Asia,19,2907.08
6cdec45316ca4fb699226c500ce6c2ed,172,138,34,South America,22,1218.1
6cdfc734ad2547b3a2fdeafb3e19a813,189,136,53,South America,18,863.52
6cdfcbde579a45a0a8ca93f3d6a43284,209,180,29,South America,18,1331.57
6ce28162e5f34665b297aca1eeac83d7,159,111,48,Europe,16,821.78
6ce36b73c174428ba876f1e4fbef3739,365,336,29,Africa,19,1827.48
6ce38107eda34124ad054ad3ab4be4f0,208,163,45,Africa,19,846.73
6ce6ed4037fd44da8385d6f3ca5b6422,57,1,56,Africa,19,373.76
6ce70c2f8f834cb3acc44ddf8ac51d4a,363,348,15,Europe,14,2496.82
6ce7e596f1034e90aced13a00d52ad78,96,61,35,North America,18,769.95
6cec992143244267bc9d5fb9e9d537c9,336,289,47,Asia,20,1602.56
6cefb104fd904798bea5df7faac50e7d,311,278,33,North America,21,3047.16
6cefc0443adb4d6e85d863dba6aaef62,310,265,45,North America,20,2129.03
6cf22178825d499a9f2fef94e7fc71e1,222,198,24,Oceania,16,1813.52
6cf251066d6e40069a94743757e644c9,210,181,29,South America,21,1727.55
6cf62fa1bfe94591b062b9a80e787bfb,167,121,46,Oceania,25,788.57
6cf811048b7d43ba9f40ac2613d25681,225,175,50,South America,19,986.82
6cf89284327c427b97f876cf7730a37c,185,136,49,Europe,18,1124.84
6cf908f130d8477785bc0d7e95bbf82a,358,309,49,Africa,24,2281.2
6cf9c918669b4d75824b739cc8860242,283,246,37,Africa,15,1462.05
6cfa98656c38430a96948fb1da27c5cb,182,146,36,North America,22,1159.05
6cfbd9d84db64680ac4dedc52e02d845,364,325,39,Oceania,17,1693.01
6cfc11cfad4746ad96b64e0eb7fa3e11,220,182,38,Asia,27,1417.41
6cfca8f6e8364b2a887f56dad57d1de0,183,147,36,Oceania,23,994.27
6cfd0f72235746659f06d391253a5bb2,87,31,56,Europe,22,175.25
6cfd6163aff648b4a241d95745cee848,178,140,38,North America,17,936.27
6cfd976980af40d686d3455019df7d29,81,26,55,Europe,24,395.15
6d02ebde2e1c4e929120dd00026a95b2,175,141,34,Asia,16,1274.99
6d03104d5c8c47aea316656eb108f638,55,2,53,South America,24,168.36
6d04408996754b58ae510f3ab5907a4d,356,317,39,Asia,23,2219.81
6d060ea8a4894b2a9f7ad9241dcadf28,343,293,50,Europe,18,1492.41
6d06793c375546d7adee1e046fb026b4,281,233,48,South America,20,1689.36
6d069033aeac4e729826d33b56e6ce6d,265,219,46,Oceania,19,912.28
6d06cf39c31d4134b3d83b93de7907ad,281,226,55,Asia,22,1064.45
6d0702f4be2f4870ab485125bb941f14,363,359,4,Asia,17,2367.41
6d098a61e1a448f5a2668fc91de4c203,276,226,50,South America,19,1489.25
6d0aff63a52543ab9e17ee059cc38110,205,174,31,Asia,24,1404.33
6d0b98eb873f4493b031829da0e30e82,271,223,48,Africa,22,1613.87
6d0c5a3bbfaa4558955301b13e67ba40,362,327,35,Africa,12,1932.74
6d14de409dc740bc834f9c97367b263d,365,322,43,Europe,22,1991.28
6d16e38e8b9f45efb266f48698185f69,177,124,53,North America,25,979.46
6d1aa1e35f494a71885266b0ade17fa8,196,172,24,South America,21,1434.18
6d1b166e17274eebb660c10bfe9e592b,204,181,23,Oceania,23,1504.31
6d1dafbccbc34065bb7038e61e0fd9ee,287,262,25,Asia,19,1553.72
6d1e7b53123e43a1a65f0e2fe74d749c,194,161,33,Europe,20,1585.1
6d1f104fc7be4e8388c79f629940a579,56,37,19,North America,24,400.28
6d1fa13087df48398dbfd148dcc0a59f,278,248,30,Oceania,18,2208.53
6d1fd8e91cbe43829a877bcb942ca0a9,242,218,24,Oceania,21,1872.41
6d201d016bac4ffd8f44e981a37e8fdf,144,120,24,Asia,20,860.8
6d23907f8ead44f1818f53aeda371f14,363,349,14,Oceania,14,2218.72
6d239ea49d5c42fc85e981895922091a,152,114,38,Africa,14,1100.62
6d26f329e41b412cb80f3b28787cb481,178,148,30,Africa,18,850.11
6d27a7ae84c24811916c8383404425bd,199,171,28,Africa,20,1484.28
6d2a3419c4494d58ab5d1679f60277c4,212,188,24,Europe,26,1429.77
6d2a760f90b142f999a33a373a031066,217,168,49,Europe,20,632.45
6d2e42f0c82941ffa7c5e0c0f2b0609d,326,298,28,North America,19,3086.01
6d301e2b7fcc4079ae7d9a97ec1c3ccc,164,139,25,Europe,22,1161.66
6d30d9b2054a4e24b520bd19b90efec1,343,306,37,Africa,25,2632.8
6d32e319c55641e1a739ae8dde95d5ec,292,265,27,Oceania,19,2124.51
6d3330cd4ddf4c8cad30d7729d16171a,252,236,16,Oceania,17,2419.13
6d36abedddc7470391ce8a3ed1a9643b,324,295,29,Asia,19,2395.48
6d3aee2940dc4d59a04d5ca273cce4cd,99,65,34,Oceania,22,544.42
6d3d962038ac4b04a27f0a794a6db97c,365,351,14,Africa,19,3229.53
6d3fb434dc6c40e8995eba6202d009b6,365,318,47,Asia,22,1658.8
6d40e5d5f10847859503102b5de52385,61,25,36,South America,25,612.68
6d41580bbbc24bf0a41210b7fa2d5e56,263,210,53,Europe,16,1491.25
6d415d9bbc6944dd80724bc3198cf349,325,298,27,South America,17,1713.21
6d417186f7ac4364ae1df119fb66c20d,113,79,34,Oceania,23,513.21
6d42d18ed71849e7b39bc647f437d62d,362,361,1,Africa,24,2707.24
6d439a28ff004ef8a4aa989a29114710,109,68,41,Asia,21,558.59
6d452ce4780b4484b4b83791f467d4a7,291,256,35,Asia,16,1774.04
6d45848edcb84b3fb146d203f45012b0,287,258,29,Europe,19,1908.4
6d47042494d640e3b19f29bf9c60d9c3,52,5,47,South America,20,130.71
6d4744d8bca948339d417d05b59edcef,51,7,44,Asia,17,375.56
6d476818f8fe4693bb2cf0bd801addee,34,6,28,Africa,20,188.34
6d481c79234944b6947c75bf8e3bbb4e,232,182,50,Africa,21,1119.2
6d486d6edb614b4b818c9f73ec6d565d,195,161,34,North America,20,1784.21
6d49b74b040e44ecaeb9ed1ddbb5c9a2,63,40,23,Asia,24,338.77
6d4a270397f341a99bb549e593131f1c,330,294,36,Oceania,23,2757.61
6d4d054a4d4f4717ab00b7d9a1cc6a32,365,340,25,South America,28,2239.15
6d4ee094621a4a0eb7bad0744f4d634a,260,212,48,North America,14,1081.71
6d4ff731e893491a8442db7ed4f6e666,294,259,35,North America,20,1896.57
6d52dd1e3fb5438ebe2fab3c0b350857,70,29,41,North America,16,662.52
6d54648c62de43f5bdd949f06df12bb0,294,261,33,Asia,25,1975.9
6d54709d64fa477880bcbeb6bd8052ff,133,103,30,North America,16,743.44
6d57638eee9b4656999a95de11edef57,244,203,41,South America,20,1657.86
6d5a03cb72784d6aad764d8dca62eace,342,279,63,Europe,21,1915.04
6d5aa06bac524efe93815e16e0a0b50e,324,290,34,North America,23,1895.25
6d5bc530e5934d37aba414ba28eb5c49,312,281,31,Oceania,23,1661.52
6d5c10d899c34bcb91128aae5ead0400,338,316,22,Europe,18,2845.05
6d5c3e1358154c02b903e94cc3a25354,364,332,32,North America,24,2424.41
6d5d300580fb4423a5fb95c88e0602ca,216,174,42,Asia,22,1237.8
6d5fe072af0a4bb89e900d358852bd4c,365,345,20,Europe,20,2592.76
6d61690be0ee48e7a81b3920f514cceb,46,14,32,Oceania,16,383.87
6d61d10ec4cf449ea90f061ea2521b78,190,167,23,Europe,19,1322.45
6d658c5cb0754259b2b85076f6ba1873,206,160,46,North America,16,1589.07
6d6945dffbe24c568dbfaf082eb19ae2,122,96,26,Oceania,13,949.13
6d6a2f1f3340400b81d6c8c11dca314a,321,288,33,Oceania,17,1953.48
6d6d0fe39781401f9d782c36170ebfe8,225,193,32,Asia,20,1848.59
6d6f1e3bb788474f97e25fa25b6a4149,85,43,42,North America,24,286.92
6d70a504e1af4be2816c4e348ff24591,364,333,31,Asia,21,2582.59
6d710e16350346f39b72a35da1aebaf1,94,45,49,Africa,20,667.47
6d74e5ca96be4b529300bc7bada5e061,365,348,17,Asia,25,1628.51
6d7666c4cbe144a6a369fb093d854861,278,247,31,Europe,15,2702.79
6d76ef22fb3c462fb2383c9f9fcf70fc,134,95,39,Oceania,21,945.63
6d77da73716346e194c8df65e39a583d,201,149,52,Europe,20,1140.78
6d7887755a394d768b8313c48808a21d,163,145,18,Oceania,20,1246.61
6d79f8f56f6244a8bc180997e5563af0,107,73,34,North America,22,999.94
6d807300fef54194970cf79aeabccbdd,327,272,55,South America,23,1236.1
6d81438968bb489f8b887f1e520016d6,363,358,5,Oceania,26,2324.67
6d823698e9af440dab39d6e1773e20de,353,323,30,Europe,17,3379.68
6d82518204994903b67fddd7b1cff143,104,78,26,South America,18,508.58
6d847a87721b436a879e1d89ba58eb3f,327,280,47,Asia,16,1646.48
6d854edda5d14fe8bcc2029e01a981f0,363,328,35,North America,19,2107.85
6d863be54af541d7a6e7ea863d7d9b34,83,39,44,Africa,19,78.56
6d8656a966f341de86ff383d365f489a,266,232,34,Asia,18,2069.86
6d86b88ab39641b388177840527d536c,224,205,19,Oceania,22,1584.41
6d87213af1784da5be63f12590ab78f6,352,332,20,Oceania,18,3192.46
6d89b926c8bf4610bbbaae92e82e3aa1,62,8,54,North America,13,63.53
6d8b02713e0447bfacddaec4e13bf2a8,365,358,7,Europe,23,2804.73
6d8cb69e3b2f415bbe343f1ea068cbcb,220,185,35,South America,17,2060.69
6d8f2f6c05f24444ae87498c9c4e2000,278,230,48,Africa,17,1036.6
6d905ac46eac4dea845588d0c1e80007,224,185,39,Africa,18,1537.59
6d92ad4952e5487589c241fa9765c641,365,351,14,Asia,19,1378.98
6d95c09e66c748639fe27eb64656e956,338,293,45,Africa,23,962.82
6d95ecdad23c43a984da9c8af88f251c,351,306,45,Europe,23,1719.72
6d982af64cd1452982f72992921a3686,329,292,37,South America,17,2336.66
6d9848d6d70e42e3b19be8d019873660,114,67,47,South America,24,506.77
6d9b63e0f4e3423f8e6ed29b07f83097,129,91,38,Asia,21,899.39
6d9d20bf2f2c445daf79f2b9ad231507,365,350,15,Oceania,20,2642.12
6da0097835fe48c7879a6cad91e6d996,134,84,50,North America,21,782.76
6da3e81cd48b4aa1a2c0e7070fbf2a5f,181,160,21,Asia,26,904.65
6da487b8a9bb44d3b8f18934de778014,362,331,31,Europe,21,1939.68
6da6bf34c0e942b6ac577d693fe7e711,363,326,37,Africa,28,2537.78
6da8557724d54344b1e1819c9802d3af,106,64,42,Europe,20,410.07
6dac1b1e675645179d3e2d2fd4a080f6,251,222,29,South America,22,2072.07
6dacf3ce34224bbe919e93cd99ef1251,292,247,45,North America,22,1639.07
6dad400e35df4d78b7d2a700260020c9,364,338,26,Africa,22,2377.84
6dae351fd31a4c2b9dd9fb1eaa5d5c2e,155,100,55,Europe,20,583.73
6daf8e0bd2034bbfae895264724c3d3a,363,346,17,Asia,29,1426.49
6dafa43ef3354f81b7936d5b5961d2cd,312,260,52,Africa,25,2311.91
6db1a1cdaf3b4d819854c8ff2a7295d4,364,363,1,South America,12,2806.47
6db2bb407f03461b9cdf52d9c95fd6ed,101,78,23,North America,22,853.22
6db345d189bb4d3c8b2cdb85d69ff28b,245,213,32,Asia,17,1835.29
6db521e7bd944dd282584368fbfddb74,110,56,54,Africa,25,598.03
6db732fa4f944b1983fc8be697dc2324,75,44,31,Asia,19,405.12
6db89b502f964a79bb1c7afd3b8f3eda,63,17,46,Asia,20,651.93
6dbab25c4c7646149f45746c60ca1c18,135,99,36,Oceania,17,1515.91
6dbbd4b008ad4c36bce92a44a9dba7ef,90,49,41,Europe,21,481.57
6dbcc95b4aa64834a1f276b928981746,245,200,45,Africa,25,1073.39
6dbd48b6ec954046ba1029a535291d96,44,3,41,Africa,21,27.62
6dbfca14d95044f1b3b8b6cf8a9cabdb,84,65,19,South America,21,730.9
6dbff4ef9d1e4cc29f7eb56b37ffd4b9,296,260,36,Africa,21,2524.26
6dc86de50d884cc38f73d8e59a1d5e42,56,17,39,North America,18,305.66
6dc87e36934b45efbe0c34f9939e790a,218,170,48,North America,19,991.31
6dc8da692b7a49deb210039de10f3632,244,200,44,South America,20,1659.21
6dc9ea475b8c462082e7707f289fae60,43,6,37,Oceania,20,350.14
6dca805635654848b2dd2a256e1a7a51,82,46,36,South America,14,518.83
6dcc6f02f4d242b89d13c505ee4b36d1,268,223,45,North America,23,1469.84
6dcdefcf01d04c16aca3cdbdd6ac78d4,355,312,43,Africa,24,2795.13
6dce2d72f663413bb1b7de446d6942e8,156,132,24,Oceania,18,1557.82
6dce4f5da717477997acdba78849250b,259,207,52,South America,22,1592.35
6dcee5e6d62d45c58e64a050ab23cf97,81,58,23,North America,25,356.12
6dcfbcd1b3104597904ea4b1e570653d,365,350,15,Asia,17,1433.77
6dd12cf7f3934733b875498baada9fb6,51,16,35,Africa,24,558.12
6dd1602c48b44e79be73479d7637bffc,226,179,47,Africa,19,1225.22
6dd1d3bd8f79406c98db2723319c95da,265,256,9,Europe,21,1737.55
6dd28423d76444dc8510f4ae1ee50530,182,125,57,Europe,18,911.83
6dd2a8d333df447a9293da507e2bc71e,292,264,28,South America,26,1984.16
6dd4930034f349919954cd58099ce35b,365,364,1,Oceania,22,3340.83
6dd6babfbb64481398be371014a129a8,363,332,31,Asia,19,2996.29
6dd7e1a70c804984aad7b3e801a99014,234,188,46,South America,27,979.84
6dd9038569bd4c43a8f58d2dd5b0e3fc,266,239,27,Europe,14,1786.05
6dd9d33fb0064d638ac82f4c91d6959d,147,92,55,Africa,26,843.63
6dda328a3c074714939d67b9721a760d,303,268,35,Europe,22,2205.11
6ddaca344c54421d8ebbfdce984bcc6a,336,293,43,Africa,24,1961.59
6ddb4e0697bb43d68b606f2a2f5fda4c,90,58,32,South America,16,630.87
6de0c95a26bc405b9df88981b4a524ac,119,81,38,Asia,21,570.3
6de79159ed064ceaab0497d9be6947e6,170,125,45,Asia,21,765.19
6de9e2d5d4c644e1b95ee93d622170df,329,279,50,Oceania,20,1784.32
6deab16e0e5f4fe7ad584d7c700c1a61,200,151,49,Asia,17,1331.02
6dee95c8bb194eec83cd94879f257e42,302,272,30,Oceania,12,2498.54
6df2c3b7ac2442ccb08c63933a6c092b,93,41,52,Europe,17,616.89
6df4360d14b14dc8a35b88062cf08431,211,171,40,Asia,18,1717.82
6df594845c3f495796111dc10fc654d9,38,4,34,North America,23,235.9
6dfc00e8e9e844bb89de83542ea8a00e,203,153,50,Oceania,17,898.04
6dfc29751df84835aaa8151e87bc2dbb,296,264,32,Africa,21,2133.39
6dfd844fb8dd42f6b8ebc82796593ab7,364,344,20,Africa,15,2691.12
6dff72f4b8e3456d8f5b2aa077d5b5c5,226,185,41,Asia,21,1175.44
6e01f994dcd545fcab0b42ae2a650ff7,334,308,26,South America,19,2143.42
6e02ecc1391249c6af54a03e8b05549a,185,162,23,North America,17,1482.25
6e03188aa640475aa424f10f3a3adb44,222,171,51,North America,18,1007.09
6e034fc15cfa4251af27089da059e934,201,149,52,North America,19,882.7
6e04d6de9e1a47fe978ce035d5013fa0,175,125,50,Europe,22,555.69
6e05455343364079897bbaad60573020,150,95,55,Asia,17,754.86
6e057e6e73094c268ba870f8d2c78cb2,307,277,30,North America,16,1826.44
6e05c94eb75840beb6343c54c7e48c91,185,150,35,North America,21,1466.95
6e0603b8e28846a8888c50b6afcaae75,122,103,19,South America,27,1130.15
6e069f410f9c41a6abd60a166b4f7309,66,18,48,North America,23,271.29
6e074043b5b84ae2ac5c1c2468ece733,253,219,34,South America,20,1466.87
6e07be37ebb3473bae43bc23ba8082b4,349,300,49,Oceania,22,1911.1
6e08750d221e4ad7aa8cce37f03931dc,341,291,50,North America,18,1579.56
6e0954c2497648329113a798880e3c65,350,326,24,Oceania,14,2822.19
6e09e6cf5ce64c469c03eea63a9b3fb8,290,270,20,Africa,24,1960.1
6e0a81bc4f764233a3e9e70ed4078bda,337,305,32,Europe,20,2258.4
6e0ab7401d8c471e841c5d38da6da819,202,145,57,Africa,17,766.36
6e0e59be4711497b88c0e79442278a28,144,94,50,South America,27,386.79
6e0ed9d6d60e4654b9fef0dda9907ac5,286,247,39,North America,15,2242.79
6e0fa90af398432bbfef82a8d6958674,224,209,15,Europe,23,1997.42
6e11f676ae9d426381f7ba3b1f4fed23,276,230,46,South America,18,1828.73
6e122c3ad45b412b9091c3babaabed18,365,356,9,North America,15,2642.92
6e127da16fcb4ba6b8d354a1460825e6,244,200,44,Africa,22,1504.06
6e129f8516e142cdab43f5087bfcee72,350,328,22,Africa,25,2720.24
6e13dec4367143dbaac48a2ff4c2dd68,365,327,38,Africa,13,2655.56
6e14cb007e8341aba6c7e74c6da77e08,342,282,60,Europe,19,1761.97
6e15e94144e64d819b29a85729e8eb1b,321,274,47,South America,22,1950.88
6e17f9cc7b524c23b8ce874f3085e02b,80,47,33,Oceania,20,514.06
6e185fc5ae0546d396facc176ba8085f,95,62,33,North America,21,883.19
6e188263e8e64e9d9d793edc19dbb07b,345,323,22,Africa,21,3375.59
6e18e8cb3c7e4c1d94554681bbb24975,272,231,41,Europe,23,2222.84
6e19a0cfe123480994f64d1b95a4004d,159,100,59,Africa,20,943.29
6e1b625c553b4d2f9a108b0b2e2b716d,41,25,16,South America,27,302.43
6e1d5a05b821459e8129a484b884387e,152,114,38,Oceania,18,1138.38
6e1ec02f25a54f6da276d6cb66e65509,168,140,28,Asia,24,1236.38
6e1fbaac74aa4a478a4cb9b6c9662a9a,98,60,38,Europe,21,987.8
6e217d0c86d440dd9a34b2398afbbc7b,103,83,20,Asia,18,553.88
6e24aa5cbb314b86864532b3b06254e6,127,103,24,Asia,19,976.69
6e257f15c17a4c42a2aac1206aa0ac96,167,141,26,South America,20,1233.61
6e25d2097fbe4e7bb78640c0d2d3afa6,359,334,25,South America,22,2463.34
6e26dc3869e1479fa760c699ca0e2b37,171,150,21,Oceania,22,1169.61
6e273dd66c214242934041d72715472e,128,96,32,South America,20,1126.06
6e285c6436074f0cad5432a4fda4cfab,204,174,30,North America,20,1229.35
6e28c99ce50b417e843e9c7a5af6e790,145,93,52,Europe,21,689.01
6e2949b0b1304e4090fc5bc6ccf535b9,362,327,35,South America,20,1740.72
6e2b5a106a5842c1bc45b84573f097ea,264,212,52,South America,23,1394.09
6e2ceffb4d174e2b8691d8b1979c3b50,150,105,45,South America,21,1050.55
6e330d0b9eb14832bedcbc5676c26eba,163,146,17,South America,16,1438.14
6e333431757e482b84baaac2782444a6,361,321,40,North America,21,2203
6e3397e80f994d3fad16013fcb64df36,126,84,42,Europe,18,494.33
6e34712874134a7f8c4ef04cf2241dcf,287,247,40,Asia,24,1739.46
6e34c2f750e24b3db96c7ca3b87970fe,299,256,43,Oceania,20,1765.36
6e34e158860649d39412fd7fb116419d,214,169,45,Europe,22,1256.24
6e35acc9adb54a009ae76722c2dd196b,365,347,18,Africa,21,2088.83
6e37b33448844af5b2719c2a18d46cfb,180,137,43,Africa,17,817.43
6e389fc5750a49ac945484bcafe932b8,72,39,33,Asia,22,506.35
6e38e3daceca44db838e7e64ab93e88c,148,94,54,Asia,24,623.26
6e39e128231849ff822eeee7a3943b14,156,128,28,Europe,19,1409.87
6e3ec178d3bc45539c044979a7abe1c3,268,210,58,Asia,25,1412.86
6e403292219c43caa601fd20cf0f3555,115,69,46,Africa,21,574.97
6e40775bfd4e4bfd9ca0deeb92d9872e,79,21,58,Oceania,18,417.17
6e40f4e3914d4439a554fe2c401e1dd8,223,163,60,Africa,29,1211.82
6e421e574c0e4b0d95f6552473623d36,356,327,29,Oceania,19,2747.67
6e424522bb104088870f1395e5ba5c37,335,290,45,South America,20,1972.62
6e43d8b9e4464785a2da8583e0d25deb,321,284,37,Africa,24,2383.2
6e440e300f904907b1f5ecf089745ebf,257,206,51,Oceania,21,916.35
6e4436d34a024831bd79415b4655242f,286,248,38,South America,20,1674.62
6e45c0ebfbd1457482f07fd027a5c4c8,171,134,37,North America,21,991.72
6e460f6425b04ccdb930f0975bfd0ec7,365,330,35,Asia,24,2007.68
6e474e1fd49046059f8216c490a33928,196,177,19,North America,16,1395.04
6e4794e8e83c485c88c3cde937a637b8,199,166,33,South America,20,1295.89
6e48bd834bb248ae9dfa5b197513e726,144,95,49,Africa,21,965.77
6e49a10d0cd641caa5009d5a1e2908dc,342,317,25,Europe,18,2276.53
6e49a268210a4d978c565fa10f75e82a,56,9,47,Asia,23,502.11
6e4a219eeca44c54847f055969bcdb12,99,53,46,Asia,22,286.9
6e4a716dd9374590b2433a3668ac7977,291,253,38,South America,22,2541.62
6e4c6be61c1f476cabdfbdcdad217c22,70,44,26,Oceania,21,691.16
6e4d275ef53244d6a709a3eb233ecb9c,80,37,43,Asia,20,774.8
6e4fa891fb8b482e972b248ab101e393,230,194,36,Europe,19,1639.64
6e512da170d4412bb22850f32d081168,365,353,12,North America,24,3158.73
6e52d198e6874ff1b2e2c8b11fccdc18,94,48,46,Africa,19,227.54
6e53625134c0438b81036e7d33be7431,48,26,22,Europe,24,597.65
6e5580cbb69542118812af8afb764c70,339,307,32,North America,21,2676.32
6e55e35cad6747cdafd3c2a91e0aa50c,322,296,26,Europe,22,2931.41
6e568944011c43b2866bda9d9ab6d2f1,268,225,43,North America,16,1298.4
6e572d908f2c491d96d25196e0daa253,69,23,46,Oceania,17,579.23
6e5786e4894d4f6f9f48078f31e2d278,82,42,40,South America,18,1007.07
6e593f8bbdcf4b3194a6ffd4e22c56da,179,125,54,North America,19,924.8
6e5b6803f3f446c7804c4d70950706e5,183,157,26,South America,18,1247.34
6e60a4c783da40a3971faccd1c1b72f0,142,125,17,Europe,17,739.39
6e618cd047ac4d22a79ddd4c4328a25b,365,331,34,Europe,21,1875.57
6e62e3ea187048199eefeca12aa574f0,314,273,41,North America,20,1616
6e63b9d3a4a84e81bc54662b5d361bad,225,200,25,Oceania,24,1848.27
6e6406bb9f7a4c1dbd683ff9bd7c3ae5,69,33,36,Oceania,21,539.2
6e66a1c54e724ea2aa8104a2a88afb75,192,181,11,North America,19,1440.42
6e6cbac37f03431096fdcb2d2313cbc1,89,59,30,North America,17,867.31
6e6d39dd1e3046099583f5c7c29422da,245,195,50,Asia,21,1516.32
6e6f1d220a5b4e999ae7bac3c1ab5940,273,239,34,Asia,22,1860.4
6e717dd9dcf14056906a4b73cc76a4a8,216,191,25,South America,20,1906.5
6e718fde6f184071a5cc4fafb2f29935,71,47,24,South America,27,785.47
6e71ffac4c4442de9619b34b65cb9621,50,21,29,Africa,20,384.32
6e74673186ad45b39a2ea278694c494f,365,350,15,North America,23,1884.24
6e77afc02bb0476ebeeba77ff9d9b7fb,191,158,33,Europe,18,1430.1
6e7bd3845c98448b8f5bb4f33312c6f6,274,232,42,Africa,16,1886.12
6e7e96a2c9aa4a6dab0c65ea45a393ae,364,312,52,Africa,19,2465.4
6e816f9510684f4d9ed45bec4c842bdf,259,243,16,Asia,22,2105.02
6e820e7a0aac4d238f617d3e57f948ca,323,287,36,Oceania,19,2198.09
6e82b31ce7aa4626aff76260b74a609a,196,173,23,South America,21,1220.54
6e82b8a338724be79c73b5d103c8199d,134,80,54,North America,22,686.66
6e8438be831440519b21efb3130d5b3d,246,205,41,Asia,21,1409.27
6e8531b10cd4455f83b306db0dc5f4c3,330,279,51,North America,16,1765.21
6e8761a985fd4d82bb986e675e2a6fed,71,39,32,Asia,19,734.6
6e87c93fda6547eb8c8aaafcf92a49fe,287,253,34,Europe,24,1686.99
6e8a01ebe6cd4d439f41b9c466f88ade,300,277,23,North America,20,2289.35
6e8a43e4abf44c0a891c11b6bee3f8eb,178,149,29,Africa,20,1367.95
6e8a72c546774ba6a015af977557e641,186,158,28,Oceania,19,1523.62
6e8c0f593e7b43a3a916ad4a6ade2867,256,229,27,Oceania,18,1998.25
6e8c8cdec46c4f1a9225e5446ada549a,44,16,28,South America,15,161.51
6e8d9cb58e184541b511d01047ad7f48,88,40,48,Asia,22,247.9
6e94a178b6844e9a9f4de041524a57d6,137,95,42,North America,24,1039.43
6e94f38f72594b24ad1d1fa9bb6ee28d,129,98,31,Oceania,20,919.25
6e981681453e493180fbcffbc2dfbe8c,195,168,27,South America,20,1317.85
6e9b914b61c04cbc88fe26e82d4bf1ab,239,211,28,North America,21,2379.58
6e9c794b61ce42ecb45ffa2fd1466eeb,192,136,56,Asia,16,1116.78
6e9c81e02da24788b5c96d245e8b6eb9,176,156,20,Oceania,24,1418.38
6e9ce7ccb2934123b809c54766e570f1,235,211,24,Oceania,21,2055.6
6e9d1f021c7f49909a8ab1f63edb5b14,278,232,46,Africa,21,2340.13
6ea07968f6b04a258b15944effaa7e6c,338,305,33,Asia,21,2536.1
6ea1cb85d3f3431cbd4d5d0c76bebe3d,340,287,53,North America,20,1293.55
6ea29f8688b949398e2bae89042e7517,295,251,44,North America,18,1564.01
6ea37217e447416f8281b840895fbde7,186,138,48,Oceania,17,1557.31
6ea4e2009a164199941dd46c9554294d,247,236,11,North America,27,2235.25
6ea50e074e7544cd9deb3fa9b2565aa9,24,5,19,North America,21,275.33
6ea522153fd94f7cbcf8a6f43ffefd2f,171,113,58,Asia,17,854.16
6ea5aedcaed34197a6adc19ea5fe281f,305,284,21,Europe,19,2032.01
6ea76e3195ba42e29f5994de2760b82e,99,53,46,Oceania,17,668.21
6ea8e8bbe1974c60a140e186d77d8937,211,162,49,Oceania,19,969.14
6ea9e6ee48dd4368a20a1f24e24901c5,220,198,22,Oceania,18,2302.63
6eaa651fcfbd464da713045f38f57555,352,327,25,Africa,23,2777.79
6eac778fc29146c68c380b74aff199c7,221,182,39,Oceania,20,1082.44
6eacd1410eac46b6b90e436f12b159a9,298,267,31,Oceania,18,1940.24
6ead3a4f7d59441cb6184f14e35b33b1,60,21,39,Asia,19,446.21
6eaef1cbfb4e4712919fafe05a647b5e,217,187,30,North America,19,1748.86
6eb0d7bb64b84dcfb8b4f3f2cec5d015,362,326,36,Oceania,22,1741.72
6eb0f2f5155e48ccb7523ba1d9fa2d3d,363,356,7,Europe,18,2732.25
6eb1a5778093486c974b430548123759,365,353,12,Africa,19,2931.52
6eb3b69e0e204654b4ecfa3dc31350cf,365,346,19,Oceania,24,2030.87
6eb4cfe8d6b643a5ba88b7aed0cd913c,288,254,34,Africa,22,1762.41
6eb7e44e9caa4f7aa2f44b8ac66b1a61,317,279,38,North America,20,2184.42
6eba1657f8894c4e9bebe52b1e9ced79,95,74,21,South America,21,375.38
6ebb54ef94a047ada1d18a419bb6d43f,112,59,53,Oceania,21,744.63
6ebbfcf1ee964b6d95db7b3a935fcd90,123,74,49,North America,19,614.76
6ebda06caa0342de99a35b8529b9ec1d,308,282,26,South America,18,2822.12
6ebfd7e85ad74d84be8fb50231738f61,365,346,19,Oceania,21,2070.81
6ec1163ec47a4884aaee2e21b9f03548,345,311,34,North America,22,2995.33
6ec133c5e2794ca8a0ba0abbf3b3db2d,85,64,21,Africa,19,514.26
6ec147b5da454b508be24632dfa41af2,48,3,45,Oceania,15,152.07
6ec29028832948d69bbadecd0cb50240,178,134,44,Africa,21,1178.03
6ec39fed8ff04ef6acc815d27187fad9,67,27,40,North America,18,376.33
6ec46fa2e26348c485cfe15761e6f4c6,69,26,43,North America,21,363.98
6ec5deac6e0d4a16a812c7855f383d14,279,257,22,Asia,18,2620.82
6ec91e3fb10443b6aa2240bfb0e6ed35,256,234,22,Africa,20,2378.71
6ec97168b15a464c960cc59675affc8b,83,31,52,South America,18,390.25
6ecc3d9fe2724f9db398de8b2be2d217,71,50,21,Oceania,23,309.91
6ecf1f8d37ef4bedac0813b2cfc02784,195,175,20,Asia,21,1378.57
6ecf335b228b4d75962465f53f45d141,73,48,25,South America,17,549.71
6ed087ca47a14adc8dab220c4fbf237a,188,145,43,Asia,24,1089.45
6ed124e5bebc48ef9535572e087c19ae,364,347,17,Europe,18,2118.96
6ed1caf9150042daaacff66f0116f54b,96,62,34,Oceania,18,756.26
6ed22e9c3d8147d28192a30f253aacd9,343,318,25,Oceania,16,2591.63
6ed26b561f54401581a4cc16f8adfe2b,169,133,36,Oceania,28,1181.41
6ed519591cd549d2b1aa34b291e3dfee,232,204,28,Oceania,19,1763.6
6ed61558fe45418586600f8d58a809ba,283,235,48,Africa,15,1765.87
6ed86019e3ee4f528cac0ea4f7f8dfe4,195,175,20,South America,24,1157.14
6ed91c55d446433bb9148dcf15b33a90,97,50,47,North America,21,516.17
6ed978ddabee4f62ab2aece57d59c46f,175,137,38,Asia,14,860.17
6edd110df9f244798ebd25f0e14de580,347,328,19,Africa,19,2510.07
6ee04d444b624afeaa714110efaa0605,282,251,31,Asia,23,2006.83
6ee250049c7f426cb4808fa615dd198a,342,289,53,Asia,17,1679.25
6ee286f62533412e80cff3a36e1e5244,144,119,25,Asia,21,1241.08
6ee2bed8086f48ef90665759cfd868e2,83,35,48,Europe,12,377.32
6ee50c2b84b844099e7c265d40ab4c7c,212,182,30,Oceania,15,1456.58
6eea470be2664790bf6625dff1c72aea,51,17,34,Asia,19,287.29
6eeac0d39d48451ea0327b0416bfac62,163,102,61,Oceania,22,502.62
6eed4aea6853492394200215294f8a8b,352,320,32,South America,15,3311.46
6eefeadffb8941aea606ec8b44c6331c,365,352,13,North America,17,1169.09
6ef1c1758a444baaaeb85f2f2e82e008,222,188,34,North America,15,799.03
6ef21c975ec942c6a3bd6268428a9002,249,198,51,Europe,16,1140.27
6ef3a1fcbaf34607ae49af50287606d3,180,133,47,Europe,15,848.12
6ef9082fc9a5450c84b51924a49f7e58,131,94,37,Europe,25,983.28
6efb616d059b4d88ae4f05b08178c5f9,100,58,42,South America,17,681.93
6efb72ffb55240d7a475021cc9fec238,307,250,57,Asia,21,992.7
6efd17bfd71047ea8bc95edbe6d2dfe0,365,363,2,North America,18,3056.58
6efd9520cc804163bfe3f03ea098b7ec,363,316,47,South America,17,1764.06
6f008ae889024188a83c069adbbe97ee,349,324,25,South America,23,3008.9
6f0143eb82d647dc97e471c2dbb5d78a,243,193,50,Oceania,21,918.76
6f022e42e5444fc7964f672d26ed1fab,122,75,47,South America,17,1064.3
6f022f4b030f43439408d9191fb5adb8,81,55,26,Asia,17,645.27
6f02c325f56a4217a7d18a5d657cc921,344,288,56,Europe,15,2317.54
6f0439b81fa04ed6880ccd3e7c01fa3c,355,327,28,Oceania,22,2659.63
6f052eec936a42faaf23f2079ea5e718,54,5,49,South America,21,231.46
6f09e7a81d15413da0e30950e76386e0,275,224,51,Africa,21,1383.75
6f0e2045d9c04bde8343eb1b88dc83f8,221,183,38,Europe,18,1029.82
6f0e5a551c684723aa2b1d62100ec16c,363,349,14,North America,19,1079.13
6f133c4fca1f40e7925576db12526b2b,364,350,14,Asia,17,2481.84
6f142d8961a84ef09948203c27e75380,143,114,29,Africa,21,1746.81
6f17c93e3ac04bc1ab27c216c10c8d56,362,324,38,Europe,19,1657.53
6f18ec913967439fb55be50dd5ce690d,232,206,26,Oceania,17,1078.98
6f1c5002c6824e25af4ec0934bb3493e,195,163,32,Africa,18,1218.79
6f1d7771e9d942729c1642d68bc8f379,240,213,27,Africa,18,1390.4
6f2051b67e3b455f93ee1215353b9fb3,288,247,41,South America,17,1930.46
6f2058dda8ed48c39686765addd5c896,123,102,21,North America,18,1204.4
6f24994f6db44ba1a185823e9ac75ad5,86,56,30,Africa,18,724.24
6f24e07df1bd492ba36ae17bbb7093ed,225,209,16,South America,25,1839.23
6f2513f0821b4e7ba6170e3e4802c46d,123,94,29,South America,23,1161.97
6f25bfeede664e72a5a9ea51359b8c2e,312,288,24,South America,26,1807.72
6f25f6c20cea4cbb808dc06dc72bbea3,167,112,55,Asia,18,846.17
6f280c30cb54455bbcfe5e795aaffc86,347,323,24,Oceania,19,2222.27
6f2866260d654cd793c12a5ee338c42b,190,156,34,North America,19,867.5
6f2d0daa63c745bcb7e30111a03504bf,184,154,30,Africa,18,1270.76
6f3280b65a3b41d78a8cb2a0e0939ff6,114,71,43,North America,23,345.65
6f33928a2fbd4902954c58f4725caea4,88,46,42,Oceania,15,582.33
6f33d19cebcb4004bce10f736cf9200a,93,44,49,North America,25,379.04
6f3501bb1ca64a178367473ee6e746a1,152,98,54,South America,22,874.61
6f371ec4cef04de98d6122b8a2d22480,167,125,42,Asia,21,1250.08
6f38ade8ec054936b08c81ab04070e40,127,78,49,Africa,20,561.9
6f3906f709ca4d159bc47b7521799fcb,207,152,55,North America,17,1172.01
6f3b9fa94cda4c69b5efefbfb94e45ec,194,162,32,Africa,19,1269.48
6f3c40bb24374309a752e1ac0c524573,219,175,44,Asia,27,1461.86
6f3dbe546be54cc5b209571d43429dda,318,280,38,Oceania,19,1806.65
6f3e576bfffd47d9809f9dac726adbf8,364,331,33,North America,18,2040.69
6f3f214111c5480aa90aa7c31a68e88d,362,318,44,Oceania,22,1329.29
6f4020d34250484fb59b0b6082cfc1a1,95,55,40,South America,18,535.85
6f41145ffca24af9b9b351d9924b1fbe,365,345,20,Asia,21,1857.49
6f43d464579f4e0c91d7747b2f1517fb,106,85,21,North America,25,983.53
6f467f67707d4a178230a9db85bf5585,251,217,34,Europe,23,1350.68
6f4929f730144699bec3ccc2a97dc024,206,165,41,Oceania,24,1119.31
6f4ccbeab43948728eb7c32a75985623,208,160,48,Africa,24,789.81
6f4d330a248f4ce29bb3e346dea37054,364,359,5,South America,22,2650.49
6f4db28076714cf89ed79153f1397e48,365,327,38,Europe,27,2490.23
6f4ed72b365b4134aca9082e7e31ef52,122,96,26,Oceania,17,1017.59
6f5142fba2394aedbf0ad87f9848a5ba,365,357,8,Africa,16,2909.05
6f51dda80b16474ca8153306dc8b0cca,49,21,28,South America,24,364.9
6f5aa3d26a5b4821b89756eadfb1aa12,241,228,13,Oceania,18,1361.93
6f5b30a20b8e43f7b982745219e9b5f1,67,26,41,Oceania,19,721.34
6f5b589ddd014ebb9ae8b5c52ab143e2,355,319,36,Africa,23,2382.13
6f5cb20b497449388273e37256fed75b,36,13,23,South America,22,354.84
6f5e139b728a489791d06213942e7978,278,243,35,North America,20,2317.66
6f5e2749a808492aad2850b430e5ee2c,91,69,22,Europe,19,1010.31
6f60fc338ce94c8582bfca83596522de,127,87,40,Europe,22,723.7
6f61529d34894cc6b60271204585f9b2,358,321,37,South America,19,2219.49
6f62905ee45541deb05aac13e3bb1687,337,296,41,Africa,21,1772.63
6f63aa3786904cb3a34070b54dd9632c,206,160,46,Europe,22,1284.61
6f644121d1224829a6925ea56670701a,362,344,18,Oceania,17,1914.7
6f686b30b04e4e3f97db752b579e1b9f,186,133,53,South America,19,872.48
6f6b1c25f7eb4de2b2847b6723ea68ff,159,131,28,Africa,23,1493.8
6f6b6e7485174ce28e99b2c117e4c8cd,79,39,40,Oceania,24,677.01
6f6d6e605abf4934bcab899e5fbbecfd,166,124,42,Asia,21,1040.1
6f6f78c1fe35499b86724aadd8cb34de,50,2,48,Oceania,22,207.95
6f6fcd4193ce4559b0abe92a86ae6628,85,56,29,South America,15,582.52
6f70ec97914e478abc9dfe361e447e96,50,31,19,North America,19,163.1
6f711c79a5804a4c82cc0d17bd25a231,97,74,23,Africa,22,591.66
6f72afe055c94e3daae4203af80ebfc6,274,232,42,Europe,18,1804.52
6f740d3ab8e545cb82b195bce39493d2,221,186,35,South America,18,2215.51
6f74a6eb6a3b4b0bad406dfa8e7140b5,365,345,20,Europe,20,2530.08
6f750dbadb88429bb9d2d3ebfd838a2a,112,67,45,South America,24,573.01
6f7822373f9f496f8c9afeea43d692a8,32,6,26,North America,17,341.14
6f7876e3df63488389a27e7cd7a02dec,324,288,36,South America,19,1939.41
6f78f82a39ec4a299d897f11e5a48046,95,43,52,North America,25,683.25
6f7a7b60b7e0462b8124ccd108fd7253,68,37,31,Europe,21,742.64
6f7bd3ef9cf7479382e5b3da99bf8dc3,365,344,21,Africa,17,2266.95
6f7c0daa97964d198656b137944711a5,142,101,41,Asia,16,812.36
6f7c14e52fd6442faa3b05b6481953c6,224,180,44,Asia,18,756
6f7ddd4b867344dcb4fa1cead4b28d40,59,26,33,Oceania,15,652.07
6f7e68e70aad4792a1a66c5cb152d597,150,100,50,Africa,24,1294.15
6f7e91009df440cead0f8df08fc3be2b,218,171,47,Asia,16,971.32
6f7e9b027085490ebef8e8052da63841,264,251,13,South America,18,2039.5
6f7fe071771f4b8195a4563e32e10692,153,125,28,Europe,20,1968.34
6f808e3cd5934531b18b1bb2bb4f9f7d,365,322,43,Asia,25,1811.32
6f8274103ece46b1abe12b4db75bd824,53,18,35,Europe,18,188.78
6f8296707eb14aeabb5a47a55dfb2f45,363,358,5,South America,20,1507.31
6f85d73901694777b300f7e0c6aa6cba,309,266,43,Oceania,20,1643.64
6f86ccaf713d4efe9c6b834c95332844,123,92,31,South America,25,893.85
6f87004373584c5e9d5b7c172e597181,341,285,56,North America,18,1449.67
6f8aeb800c8442e49957f073b52be431,41,5,36,Oceania,24,246.33
6f8bc92007694362a924c027c2198126,210,174,36,North America,22,1402.98
6f8ceb1f3e5544a385e16eecebf58cd1,216,168,48,Asia,16,917.82
6f8d10b4a2fd40abbb4db87ca0a1c589,194,171,23,South America,17,1656.16
6f8d563724fe4913acefaf69dca3d805,129,82,47,Oceania,17,474.58
6f8e8f74db64441295d36b80f1014b48,364,350,14,Europe,13,2142.43
6f9118060f174fefb14ff6d1041e88ba,101,44,57,Europe,14,681.08
6f92375960ab4775b35066abd55c2939,364,343,21,Africa,20,2378.8
6f9621ad83834178a98f79c854dea0a7,364,322,42,North America,22,1849.58
6f968ce9b2e14fcd8b54714bf6f33f52,258,218,40,Africa,25,1688.76
6f9a08fed6c449f0b46c64260d046072,364,319,45,Asia,23,1801.13
6f9c975d7f0d47348aeb35c5b90e7d81,180,128,52,Asia,23,1056.05
6f9f7924a7de43c780a93a19f40dec98,123,96,27,Asia,19,628.73
6fa12f9c2d9841d9870b9e91ee661f6b,213,163,50,Asia,24,1516.26
6fa25b3ae1ce4105bdb7552c742e9e29,225,186,39,Africa,27,1109.06
6fa3bbabcc3747a8ab09dba3ac504dd2,346,329,17,Europe,16,3006.14
6fa7486c1eae4d0baa996e06b69617df,131,106,25,South America,17,1037.54
6fa9543b1628430ca83c506b271583f5,104,63,41,Africa,17,663.81
6faa3b6a78c64b3688e5023eda3abd94,242,218,24,Asia,20,1821.08
6faa71650f5a4039a44a02f3ccffea13,281,232,49,Oceania,22,1043.86
6fac51384c73409ebf058ffc1050adfd,101,77,24,Africa,23,1045.23
6fb04a37569543299a2edbab0423bb99,66,35,31,Asia,22,557.79
6fb3c2d90f324b2e976145af8ae6a1fd,205,183,22,Europe,20,1292.95
6fb4f7567a0f4bcab0a4832dc07c0178,306,257,49,Asia,24,1753.01
6fb5e77cb702466c9d1a2fd97a4f2230,153,118,35,Africa,20,629.38
6fb7c21751064aab93d0f96b2724c360,321,287,34,North America,22,1323.81
6fb8cddde2114304810c03300e3dc149,138,88,50,Europe,20,670.08
6fb9328d879d4f16883bc416e9c1f308,247,191,56,South America,22,1453.15
6fbda86cb6524c40a0b7382a3d693697,199,145,54,North America,18,774.53
6fc092bce3d5406591efa2dcf92f24bc,285,259,26,Africa,19,2204.52
6fc1fe3ccdf945d086a81868d863e1fc,363,362,1,Europe,17,2285.67
6fc43987585b4449bc4e573f581460dc,82,58,24,Africa,19,747.91
6fc61d5aa9b54431a5c31fb6f9f2b33a,365,353,12,North America,17,2139.94
6fc6d584bb7147f1a9d9056334bb03b5,233,206,27,Asia,20,1851.06
6fc71cae819f488b94750024b9c7af30,310,281,29,South America,22,2256.45
6fc72c768ffa494ab562b68bfefa9600,243,194,49,Europe,18,1180.48
6fc9116250d342a6b757b2b704a2e0ef,200,162,38,Africa,22,1626.58
6fc921b9597c4e7292931a210fb37a50,276,233,43,North America,19,1270.63
6fcad93f316a4dcaaee75631647d3238,334,296,38,Europe,20,2431.7
6fcc355460ef44dc8aacc18c50f1e74e,253,201,52,Africa,21,1521.6
6fcd5bc011ab4f5abd7df7c7f7993770,295,263,32,Asia,20,2007.02
6fcf5ca40cc04e7c958a1f924446dbff,102,47,55,South America,18,649.63
6fd09043eb8042b497ee417c51db1ee7,284,267,17,North America,20,1945.08
6fd1999ddf0d46939fda93fbfec90b99,362,345,17,South America,22,2314.4
6fd2e2fd91814c8fadd0641bfe7ac42c,149,113,36,South America,19,1115.64
6fd45e95b089458db6b04c0f89c88291,188,162,26,Africa,26,1639.45
6fd585fe5cc84a14a4da358aef1aeda7,142,103,39,Africa,25,724.11
6fd5bc790358410ea4d0ef68614ac945,120,69,51,Asia,20,507.02
6fd81357b5564295b9f49d911ee79774,355,323,32,Oceania,19,2761.4
6fdaa04f7b3e42d48bd13dde7a7e21c0,217,175,42,Africa,18,1796.68
6fdc90d20f8342e4903f806d019da809,272,237,35,Asia,21,2242.18
6fdda1d6225947ac96404ab3ada0f278,178,156,22,Asia,20,1906.9
6fddbf3ec3004dd4988c5c77c4580c2e,267,248,19,Oceania,20,2230.66
6fe3155df41f446d97cd7533fee52fc5,364,360,4,South America,14,2727.81
6fe394eb5cd545e19e5f636ea281258b,212,171,41,Africa,23,1424.9
6fe6135a2c4b4f0ba4463f989ba40778,88,71,17,Africa,23,656.31
6fe6497024e0497083fe32d19d29256b,185,146,39,South America,24,352.57
6fe7892f09a1438f9ef1c634a0586b99,230,172,58,South America,23,1575.02
6fe8e6e248b4437d8480bf3fff54aee9,356,338,18,Oceania,18,3098.13
6fe98da150f945ec8ac4c9a587c0d430,216,183,33,South America,20,1373.7
6fe9b080177341628ab1f829a00461c3,62,4,58,North America,26,265.94
6fea983ca7124b2abee84f269aba4fcf,267,212,55,South America,19,1670.05
6feed8e6b57342f9943330260d87ba62,118,82,36,Europe,19,806.85
6ff17bb5a69943d5afd4dc90a9894c30,324,274,50,Oceania,18,1471.52
6ff34aa298b441e68a7928beb7e1ed24,109,62,47,Asia,21,466.44
6ff3a187677446b69e7fbaea0660ea23,365,336,29,Europe,20,2544.97
6ff4b136934945bd88a01f3a597831d2,203,172,31,Africa,20,1293.89
6ff62db3425f4ba1b2d531c4e0ada67f,207,156,51,Asia,23,1407.22
6ff7561513de44acbd1cf17593e7e105,321,266,55,Oceania,14,1336.52
6ff7b54a5c4b43d5b9df377b39dbba83,342,322,20,Europe,23,2316.7
6ff8811529f344cf86261065d300f81b,160,96,64,Europe,20,904.27
6ff97f2ee3184727bf70f46a469b793b,353,324,29,North America,12,2736.26
6ff99fae33b04a5796186aecabda337e,257,224,33,Europe,22,2522.82
6ffc06fa6a3b4702ae4bdea88e93c620,318,297,21,Europe,20,2221.94
6ffde457a9fb40be8a9af17bed4f7422,192,171,21,North America,22,1320.01
6ffe8206ddb4429aac968ac82bbe5de3,239,215,24,Europe,22,2025.25
6fff25c75542430f8266beafd64697b7,47,13,34,Europe,16,511.62
70006503ed134e44850f375673000bb5,194,161,33,North America,22,1498.74
7002d69f7ff8451b8194e7bbfa8de0ab,136,114,22,Europe,20,542.41
7002f211f2ec4932b57586e7ba6db3db,168,120,48,South America,19,910.42
7003ed9861a44cc8a1745de2f585787d,232,208,24,Oceania,25,2283.2
7004166fdeb24363b092f0b6e81c84cb,149,107,42,Europe,18,861.54
70062fcec43a43bba080571d85205a0a,162,112,50,Asia,23,728.67
70088105286445158d1004e1f277348f,91,57,34,Asia,15,303.66
700d4e6d1dd0442aa5a4cf5e39d687a9,327,287,40,Europe,24,2272.93
700ebc040325426d9421b314396a7435,190,134,56,Africa,23,925.15
701362106a3d4210a92ba02346ef0673,365,323,42,Africa,23,1654.72
7013884deb9c4c0aabc6ca9e2faa20cf,264,210,54,North America,16,1309.79
7016bcc676dc47628b02b99d8bc1a62e,33,12,21,Oceania,20,262.5
7016f18ea9fb4c54ba09484201e9e9af,236,209,27,Europe,21,1096.23
70178ca2b09f41d8bab60f02179081ff,343,297,46,Europe,21,1433.02
70179b2d0266437aaba2b74c8dd44b12,269,233,36,North America,23,1576.13
7017c76628c14bbdb6bc759dc8be28a3,142,93,49,Asia,22,425.84
7018b2b7886e429e82afa852874fdef7,83,38,45,South America,19,515.95
70190b321320494c9f5be6bcbc35991e,71,20,51,South America,22,319.28
7019d6c714e9434189fca8865c209e90,365,326,39,Europe,22,1469.27
701a848ef7374cd1b05bec388c382029,356,318,38,North America,24,2521.84
701a986e2c5c4e1ab3634240b59ed8b2,99,80,19,South America,21,705.79
701b2613e2144bad844717faa000b612,49,14,35,South America,22,445.17
701be1c0586b4c12951c37720316a847,177,135,42,North America,19,1139.19
7023919b01844acab84a6471dd591368,355,330,25,South America,24,2876.61
7023c2981fc24537a5fcbb22ee7c3cbe,239,190,49,North America,21,1066.97
702563d82ff84f5db70f99f35882c68b,63,26,37,Europe,15,464.75
702b5fc333f74297a753f8fda5326e56,335,299,36,Europe,27,3125.12
702b6ff89c8f4524a465da282c94c723,58,19,39,Oceania,22,249.31
702ec8b44ea14d48b729bb9301f6229f,309,272,37,Asia,21,1714.22
703168c83df14462a6bf35b4dc50a14b,365,323,42,Africa,20,1763.31
7031d30349334c14aba2a3931426b997,353,332,21,South America,17,2789.5
70330479cc5e438abf6206bf7aacdc4e,361,355,6,Africa,19,3770.05
7038f1483e61490aa0072df61f9e00c4,263,225,38,Africa,21,1827.24
703b2f5f0c9849798c24abec2720ca47,206,160,46,North America,23,983.07
703c68814ecb4fc095ad0d56ad38bbeb,308,277,31,Africa,23,2100.78
703d11a7bd774dee95b65ec3a28bb9f0,153,98,55,Asia,18,936.94
703ec7a7a1a54d15994aed065f17737e,68,31,37,Europe,20,520.45
703f5551de9548638b12dd840223cde6,46,19,27,Africa,19,232.44
703f87b76b734097a5ad7984d8876ce4,158,143,15,North America,21,949.74
7040c98ab0b84f0ea11692761dd47263,365,330,35,South America,23,2194.46
7040e03194614d57bc5a845f98a44420,282,240,42,Asia,19,1698.27
70422e0f7b924ab29cd2b27e0f5cfccf,64,29,35,Oceania,22,241.16
7043fd529655415b9a9781e6d978b399,221,191,30,Africa,18,1527.99
704ac53ef9f642f5adba530a7d416c51,179,147,32,Europe,22,1700.63
704bf61b2ca94aaa868b87d396f32b19,252,209,43,Africa,18,901.59
704e39f4ca09447a964c4260b1c88fd7,228,196,32,North America,20,1428.42
7050344d7bc2484781accbd7823f465c,92,59,33,Africa,17,636.82
70511587f22f48c38598ac4385703cbb,66,29,37,South America,17,591.63
7051595378cc4caebaeaf007b26b1260,344,316,28,North America,14,2045.17
7051df0066fd48bda6ca35af8f1aee57,171,114,57,Asia,21,1795.86
7053874c7f0741e2a741fe9910ed2be9,64,16,48,Asia,23,311.38
705423649f214856b64c226442c81a7d,235,200,35,Europe,19,2112.72
70583ec33a004737a8027bf0e08a8702,362,340,22,Europe,21,2997.5
705934b03f214be9949d7c41f8bab74e,103,50,53,Oceania,22,469.78
7059cbef39494366a87050aec958b7be,340,316,24,Europe,24,2643.19
705d29fbf45f49e09ec845aec5a3801a,365,326,39,North America,19,3122.77
705dac0107fb48ad992b788d4358f1c2,261,211,50,Africa,21,951.64
705dbe5b63ed427c8df69333f1162934,264,232,32,Asia,19,1923.87
705e4e6ad6054f5e913b400b2d16b1a2,153,107,46,Asia,22,961.11
70630663b40445cdb63babdeb628b604,99,43,56,South America,20,397.74
70632e69ac7f4b49b47953036e569b76,285,257,28,Africa,19,1852.84
7067d5be947342fabb23b23869858316,337,290,47,Europe,13,1847.82
706969b1526e4b6a938cbf22837638a5,149,132,17,Asia,16,1120.2
706a6ef9c029496590cc08571e90f6ed,151,100,51,Oceania,24,821.62
706b23b60b8c45debfd94b9d406c2747,310,281,29,Europe,23,2405.54
706b8b9d08a64d009ddce880a7edde0b,358,324,34,Europe,21,3149.93
706e678b64ff43e389490bf006f17695,328,305,23,Oceania,23,3380.4
7070b044f8ad4ba0aa2a50eac07e84d0,221,170,51,North America,19,1091.91
7070ddac20424099b76a7ab0c352c6ee,57,2,55,Africa,25,153.01
70716ab660b94331913eee439f82f0fc,152,116,36,Oceania,19,831.68
70722fbcc5b94e3bb2c535de517446ce,319,267,52,Africa,18,1864.39
707296d9989a4b32980755404cb9b311,79,45,34,Oceania,25,507.4
7072a51dcfee4775b4a76dbad72cd2d2,221,192,29,Europe,16,1261.59
707501d373434a9088c3216f3491c608,289,247,42,Africa,19,1915.27
707595a87b2947d7abbeb2e480ec4ef9,118,72,46,Asia,24,432.57
70763c99270e40adba31b847e5b96c53,126,77,49,Africa,20,913.93
7077f5e373f4447b9c04ad7f3f858a51,209,156,53,South America,19,1111.59
7079bdd9a93741c086cae382bd64b77b,94,71,23,North America,19,644.66
7079df285b2a42a4998d2b00fb1d34f9,95,46,49,North America,22,431.6
707a61f9294b4f3ebdc1ebe94e602f43,170,143,27,South America,13,929.92
707abefc652946d38e7cf143ce7bdd23,137,89,48,Europe,25,659.81
707adeac00f444b0bea68e1bf7dbd7bd,356,327,29,Africa,25,2600.39
707de32296094cd281d80510df85443a,287,247,40,Africa,20,1481.54
7083e3b1f4bc472cbb880960f6c5cc70,130,99,31,Africa,19,893.3
7086727e338a4215976177921e31556a,85,33,52,North America,19,653.58
7087d2f05a75479e883aa8192ca63480,50,28,22,Africa,21,488.06
7089c43423d84ff18b2ff6df85265e5b,114,82,32,Europe,23,770.32
708eb9096c6d48a593c69ac63380a0e9,120,74,46,Asia,18,595.88
709008794b5e4485a0292a42fce42552,92,55,37,Europe,10,312.01
70915fa0e9b042168bb1d00dd0c4303d,255,209,46,Asia,13,1683.25
7093f4c8b1f14a0da3aebe745be6527f,121,105,16,Africa,18,907.4
709764b60a904efdb0c6e85fe87fe947,158,115,43,Oceania,21,933.58
709b58791f8b4232817921db5deae73a,347,312,35,Oceania,21,2345.07
709c7b51b5f1488bb85e0056a0b1fd22,250,222,28,Asia,22,1890.94
709fb1f6d6d24b96875f6a0b49836c5e,98,60,38,South America,20,782.41
70a24a3fa8eb4db4b92313575ecc22f2,145,116,29,Europe,15,722.92
70a277df6c894ea69f62afb908681b77,127,101,26,Africa,22,668.79
70a35ce516cc45dda5cebef423f12993,202,189,13,Africa,18,1461.06
70a38d09b80a4cc9af01d4d2c5e4ffcc,80,18,62,Asia,15,471.76
70a4e45140954521992f4c641cb54351,364,335,29,South America,20,3190.31
70a82bc7ba9349c09802d81408bd04f2,122,97,25,Asia,29,662.7
70a97c63b41240aea557756afc095719,57,16,41,Oceania,13,481.97
70a9a53380ab4695b4dc0be678e10a7f,365,337,28,South America,19,2259.12
70ab82a84d4640dfb1002689be1b7832,259,209,50,Europe,20,2186.16
70ad1eaaae874921a36d2b578a30de23,173,119,54,Africa,13,933.74
70ad1eee991e40b4a10ad249357885c8,132,76,56,Europe,18,624.42
70ae4142996c429487ee11fa9ed4c46b,46,4,42,Oceania,21,212.41
70ae661a706c49288db83f71611ad7b2,161,112,49,Oceania,16,1023.74
70b0f874135142b7b5d994ca53a7299a,204,180,24,South America,21,1097.02
70b412dd3baf41a8bc85c66c91a77365,52,25,27,Asia,22,40.71
70b41d9313154990a95c0824a1a041f6,360,317,43,Europe,13,1990.48
70b63b481ca5477a89e94313e62d5b1d,184,149,35,North America,22,1310.97
70b6426f51464f98b1cb9e21d671134f,34,13,21,South America,15,485.41
70b7249b1d2548bfa4386a7800ca23f8,78,46,32,North America,21,607.39
70b7f313a18343c99fe34a5849a41912,87,37,50,South America,19,407.4
70b85ff5322849f795ea4f9769f95d2e,181,154,27,Asia,20,1242.36
70b9008af0d84fedb19f98ba34af1434,103,79,24,North America,16,865.66
70b94356c9894ead8becc52f013ff48f,286,261,25,Europe,23,1739.81
70b9772e578748b58c72ae1236bb33cf,352,301,51,North America,21,1572.63
70b9ba1e738d4730969952ce882bc4d9,244,191,53,South America,26,1745.55
70b9bc301f6f4eefb3be7ffac4900b64,41,1,40,Oceania,20,502.06
70ba3e576cd34819bc38b2bffa02b0d8,355,308,47,Africa,23,1346.9
70bd02760c0943409d09660a5ad94788,229,180,49,Africa,24,1107.04
70c0bd3dc53f4928b5c6285d6abef6f9,292,271,21,Europe,28,3127.86
70c3fa7c8e5f4945908e7412ce9079e5,318,277,41,Africa,18,1701.03
70c53c61c85f4372b4ddf17859cbd958,337,306,31,Africa,19,2639.73
70c7d16b767b403f95578dca804d77b8,324,279,45,South America,21,1360.13
70cb292506f34e75850b0beb7da877c2,287,262,25,Asia,21,1935.3
70cb44a5c2514dc09267c684ce9639a8,149,120,29,Asia,19,1070.15
70ccd81c458b45d59ac28ba8bdac06a6,160,115,45,Asia,16,979.6
70ccea14a963499f8c4c4675242b8a92,81,52,29,Oceania,20,444.01
70cd69a8d552472caac31b82ff8c4dd1,185,157,28,Europe,26,1234.12
70cd84082e7449cdbb7964e610bb449e,246,211,35,Europe,16,1807.24
70d09afe6f6f4339867a2fb101b259a4,118,89,29,Africa,20,894.01
70d13e300ef040be8cdc5f62ea0a70d1,365,358,7,Asia,23,2175.64
70d3787110b34d3480a3ff476d47e53f,128,101,27,Asia,19,878.71
70d3999abebc4d76b70efc0d6bc88739,359,319,40,Europe,27,2420.8
70d39f77c08649dcbe3f37bc3f80ffa5,33,6,27,Africa,27,261.41
70d3ab1d6cd54f04b1c7e7d74595d893,351,325,26,Africa,20,1942.81
70d589dee37b41d9949f781d19ab4e6d,178,132,46,Oceania,21,715.27
70d6440badf54c4cab450de31e721f40,322,288,34,Asia,19,2593.59
70d77abaeaaa4ed3a76022810ef8f50d,195,171,24,Africa,23,1424.24
70d841df282c475984e15897d9b181b2,155,128,27,Oceania,17,1325.06
70d851392e0a4fa09217965547785fd0,87,39,48,Asia,22,614.27
70e2448bf58a4af6992fd6bab8c9b06d,188,152,36,Oceania,19,1083.03
70e357a9e21e4a71ae1b09fd52df8ac3,128,82,46,Africa,23,645.76
70e4ffe8756f48e08255ae14c7e24b54,102,55,47,Oceania,18,412.29
70e779e18b6349efb0634322a19c6da6,309,293,16,North America,25,1959.38
70e98fe95ffa4e04896100a016a4f98b,140,99,41,Asia,21,807.88
70ea6f0220464d54a6a94d7015dbfcb1,252,211,41,Europe,16,1413.22
70ebcce0bada4f1f877e0dda4d5e8083,89,53,36,Europe,17,910.02
70edbe82122a4c84b23193e1704cd85d,308,286,22,North America,20,2673.17
70ee850392bb4f999ecdd399af72762b,70,30,40,Oceania,19,270.76
70efbecd03f340bf8ab8f381494971ed,284,257,27,Africa,19,1791.77
70f01565626546e1813508839866248e,292,243,49,Oceania,21,748.04
70f285c1311b4e539156e13a0d72681d,359,311,48,Europe,17,2096.54
70f3dc5a140e46139911383bb87aac60,306,257,49,Oceania,17,1857.94
70f5e6ce83ac441d9f2f77c3f701ff3b,282,232,50,Europe,19,1635.43
70f651596a3f4aeead4ae4cdb95ac0ba,365,343,22,Asia,21,3101.61
70f80d1271484b8f9b2211d648d5a23d,365,363,2,Oceania,20,2129.8
70fa76b49df4415a9fa8cdb195e74065,97,41,56,Europe,19,605.32
70fb3635723a447fb0705b92cf18c707,163,107,56,South America,22,629.38
70fcafc5ad014de5ba4c8e4e731701c2,52,20,32,Africa,22,200.8
70ff76ce13a6472aa1dbac872496a895,281,231,50,Africa,19,1426.32
710028dccd9a4e6ea6978acbce7af69e,363,315,48,Asia,21,1173.49
71005c58f21f42a68dd39235dd774779,353,328,25,Africa,18,2748.52
710108d6372f40cead392bd4ca59e75f,271,233,38,North America,22,1254.03
71047a0634864cbe9a9f2210f895b1e5,334,292,42,Africa,16,2328.71
71054d60cc084d70b0deb229d9c1578d,290,263,27,South America,17,2719.87
7105e67b226b4865a7b4773502472f98,213,168,45,Asia,22,1119.89
710925efa5704961a6ac52d0e056e8a2,364,344,20,Africa,22,2577.96
710a0a7d3bd347cf94fca1544b69a8e1,206,170,36,Oceania,23,1612.65
710b20ad142a4108a6ace2e414e787fc,282,231,51,North America,17,1265.82
710b602bb4574bdc94cd9cfc518f8e06,336,316,20,Oceania,21,1946.89
710d22b6a2124747861f50b41522d290,238,185,53,Oceania,17,1112.68
7110db4f6b5d4bce93593696bf9bef27,361,347,14,Africa,24,2165.3
7110f9eebe40418ba0bf2bccf90bd91c,173,141,32,South America,25,955.49
7111a938bce845b0882a0b9918d615ad,269,224,45,Asia,25,1633.73
7113f39c8d8f41d2980ae48648067b21,363,363,0,Africa,22,2052.79
71146a1a62944046a53a2176ba9bf433,327,276,51,Asia,24,973.33
7117359b34b746aab24e2c2a379c12c2,301,239,62,Europe,19,1674.72
711840be65a047ee8878a319c48d795f,319,267,52,South America,16,1458.39
7118596cb88e4a7f983e5ba18ba656ce,42,2,40,Africa,21,193.31
711e15d1b7ef4a67ad2dc00fc0417d6c,294,271,23,South America,18,2489.67
711f569497f64f71b5be5b8bce46ab76,51,3,48,North America,18,233.72
7120ff6307ff428686f4ec2c80304e1a,95,56,39,Oceania,17,707.93
7121d54fa43c43859962446d774c648a,221,168,53,North America,22,1085.62
71224f3c36874a069219a6085f3b4160,134,111,23,Africa,19,1372.31
7122701e67ca4cdca0f2204f5f97686f,321,291,30,Europe,23,1503.7
7124ac99b1e443d2a9fe1bc0bb9af402,174,131,43,Oceania,17,951.56
712702bb7f8640158e0b316cddf588c1,365,328,37,Europe,22,1902.18
7127ee3336bf4b8c96498d9b31e6e92e,337,300,37,Europe,19,2487.92
712b9c251b5f4d4ebbde96115541d63a,182,157,25,North America,26,1552.6
712d93d4358e464784394d24e20e1157,359,336,23,South America,21,2993.32
712e21878fd64d1c9fa3e3126bfe2560,198,157,41,Oceania,21,1033.48
71306c6fcce14897aff719c134271649,362,343,19,Africa,19,2387.58
713539f846a54559a8e6c556f0d927fd,364,359,5,Oceania,15,2613.98
71362c4f99d04801aad9ffe7017d130c,162,115,47,Asia,16,518.32
7136da2e39a84875917c1621646098d3,140,84,56,Asia,26,881.76
7138aa1385c34284b954d5011ed3697d,287,264,23,Europe,21,2338.75
7138b371b15e4acf9b0d1490700d3213,359,349,10,Oceania,25,2488.57
7138d7404305436b97e1498f2821d214,236,220,16,Oceania,22,1648.34
713a923a439b47cc85f09186bbb82c5d,332,313,19,Europe,20,2063.13
713c8a9d45004d4da46dbfb6390a7ecc,216,165,51,Europe,19,1374.09
713ee21cd8eb403f95c94bbf6bcce3e7,298,243,55,Africa,19,1692.74
713f47856daf44ff832f53008347aede,49,29,20,South America,17,162.12
7140d8c639c1430f961cf094c52216bf,363,332,31,North America,19,2746.61
71441417dbba4a5590b09cd51de42520,303,274,29,South America,26,2003.66
7147ce53c5ed4d68a1b6b1ceec3ad26b,154,131,23,North America,20,1046.62
71482b245c924e249fe6955b33c778ee,188,167,21,Africa,15,1467.25
714b3ceaab814e628d9c4db3410cebdd,335,308,27,Africa,19,2552.97
714eee3561ac46858388b9e46193aaea,184,132,52,Europe,13,1032.37
71525e4a7a5b4a7d913f399e61056e82,223,174,49,Asia,21,1328.52
7154c6b8a7ce4634bee8b08ffcada336,52,1,51,Asia,20,317.83
7154db746bbf43ab958a895cd25471cc,365,356,9,Oceania,15,3332.96
7155a696a0184414a2f0b7a555212ae8,268,233,35,Africa,23,1744.64
7155c2f24a154402abd1f44ce593745b,209,184,25,Europe,21,1608.86
715624ce5491486d81a3595f000d54e9,336,301,35,Oceania,21,2462.17
715706d6b4314325a0f7af9531d88d3c,94,72,22,North America,18,530.48
715ab551c0d344e2bf650cfed455771c,94,54,40,South America,22,759.34
715d33c793fa43cfaa6584519709a67b,108,62,46,Africa,21,658.79
715d57c95a2248d481d3f85af691449e,316,277,39,North America,23,2596.41
715da312dc37478ab0242db8fd12773d,195,170,25,North America,14,742.46
715e0199c30a4092a33802e208ca6ada,203,175,28,South America,23,935.09
7160a6f27ed24c869c226c321f4ca9cf,124,95,29,North America,19,1109.78
71613491b56b4e62944d02bd9c2ba20d,242,204,38,Oceania,19,1827.57
716501daa77943d28ddab272649e410a,274,245,29,South America,25,1904.4
71669ccab935485f9456b774a4907021,294,265,29,North America,25,1762.74
7167e5d26fcb42fea3dc50d47bc940a4,327,300,27,Africa,24,2799.59
7168a56fc1e241bdaaeb3d28651e2168,328,280,48,Europe,18,2028.43
7169cf5219bd4aee9bbd6618cdee8242,170,136,34,North America,24,983.22
716c200571cb426c96e88bbfe4b3604c,341,288,53,Oceania,18,1150.64
716c5eb63d544949b473032e24eda3c7,63,13,50,Oceania,20,390.65
716c73e649be429c97293156df1f665c,90,63,27,South America,19,749.98
716cb758a1ab4302a07ad1795720ef84,363,321,42,Europe,22,2021.37
716d763a96c946bdab033c954b009718,281,252,29,North America,19,1973.38
716e1aeb23d3441d8deac1339fc2232b,31,17,14,Africa,20,260.4
716e76c5c9134c7c8ea4cc9aeea02b5a,113,76,37,Asia,23,651.97
716ff39415bf4555ba05c11fcddb6dbd,145,115,30,Africa,21,618.81
716ff7b034eb4558a879a850d92ed6a2,46,2,44,Oceania,23,518.93
717056b3fdb641898ffe7da14799c15f,361,328,33,North America,21,2570.58
717193442278485f956e319b0aff4c1a,311,285,26,South America,21,2985.73
7172fb571047475b95de1f4a1a92e167,232,209,23,Oceania,22,1527.15
7175291252d44cddb5db0d4628690229,285,249,36,Asia,17,2577.63
71774c0b99854b70ba2186dd53c4a8f0,365,343,22,North America,19,2712.97
71785b9b30b94a59839eaa24905971cb,338,298,40,Europe,19,2111.8
7178890cb4d349a8b41e7715ac027d49,109,61,48,Asia,22,641.41
717a203db01848df90c0f6eae99b0ea1,164,113,51,Oceania,20,551.61
717c8ec4db4c4877aa85c21025809167,296,273,23,Oceania,14,2440.29
717f48d59ccc415ca08b8d51ef11f2d7,88,61,27,South America,19,810.12
7181580ad095488b8223d6c5b3e0addd,308,263,45,North America,20,1555.24
7187da0364e34f338551d85b1d0a79da,221,168,53,Asia,18,1290.66
718879f2dee14cdc8d9598f1852fd05a,164,113,51,Africa,20,1468.35
718b8cf4985b4846b4dee1c98fea4e2a,364,346,18,Oceania,20,2767.19
718cc5c6b47e4a61946cb797c6c9890c,156,112,44,Europe,21,1043.92
718cefb592ec4f68909581d2a381168c,195,164,31,South America,24,1263.81
718d63e1e2e44ccfba09090934ef035e,270,215,55,Africa,16,1082.2
718f851383674b73a05cdc9da1eb3ca7,337,307,30,Europe,22,2610.36
718f884f534b40a4822c11806794a460,47,8,39,South America,23,346.43
7191657a8afc43c59f842420251ecf8c,202,169,33,Africa,22,1373.54
7197fb553d0a4efd97fda5fe85f94b86,286,233,53,Oceania,19,917.24
7198a9fc1cda4b4a8bcb0af6039d77f3,159,112,47,Asia,17,1358.84
719cead6bc8749928601dd4be2519dd6,361,319,42,Asia,23,1973.16
719e8e7a7abf4048bbf535ec9091b86e,226,171,55,North America,17,1201.8
71a02680904147cc94ac492d65652d88,160,124,36,Oceania,19,1086.99
71a1a2d04dd74322bac91ff6482ca4b0,164,134,30,Africa,25,1118.03
71a67c630e7446c1b5c632600ea2df55,122,103,19,Oceania,16,724.57
71a67db64e054bbeb30ea20310ccbc10,81,49,32,North America,17,729.1
71a82592f1684aa38a0200095652e1da,299,259,40,South America,25,2643.54
71a851e3d0ea480693b39aebe247c536,225,204,21,Africa,23,1533.06
71ab64de6f57464ab13ff272dd10e5e1,226,186,40,Africa,16,1216.41
71ad187d5d7544629fbf8c15d6322f04,110,67,43,South America,16,273.52
71af55daa963485cb27db9242594c939,131,78,53,Oceania,20,717.23
71b05aad4c7940eebc27bf2b29262d94,274,239,35,South America,19,1790.5
71b0b53ffeba486980d9851a405c4d0c,104,62,42,Africa,24,1119.54
71b2b2dcc3304d6f9bbaec3093b1b8cf,68,12,56,Africa,22,438.68
71b5cb08ae9d4c1cbc18d46d37226c13,155,131,24,Asia,22,1198.5
71b9dd5ff80e45759abf690b214d9cb4,172,147,25,North America,17,1537.31
71bb3a8b30554cf6bcebf6fce7d6c65b,134,98,36,South America,23,761.89
71bb5f99d034447a86b00f3a3c78cdab,351,304,47,Europe,25,1581.12
71bcce7f19304554b99ea0ad3df145f0,57,12,45,Europe,12,541.17
71bea6aad790409f9374b6265be4d2ac,116,72,44,North America,23,450.01
71bff5f7182b4e27886d60240a2c0fa0,190,154,36,Oceania,17,1903.4
71c05ff74c894489907c1307799eb3a9,365,359,6,Europe,16,2581.14
71c25716fd77469c980a13a30a6f91e1,112,75,37,Asia,19,799.48
71c294533c864889910f8808b2156f51,206,153,53,Africa,20,1008.98
71c596840fba42ecbd5af048434fd16f,221,170,51,Europe,18,971.93
71c6dcbaca754e9a914a058db53edd23,280,244,36,Oceania,20,1492.26
71c8e73b071546c492472dc1c28dd7f8,314,291,23,South America,20,2356.29
71ca2a27438948fd996ec4e1f5e70992,229,202,27,Oceania,22,1722.39
71cc50dcd38640d1a17a204fc5b48e4b,364,344,20,Asia,19,2720.53
71cd8b0d02694ad1bcfb972bb90ec72d,252,224,28,Europe,26,1855.95
71cde615c810472c9ca58eb0bb1c1cac,66,26,40,Europe,22,454.98
71d01783a577469e91376709422f5198,364,345,19,South America,22,2120.83
71d470089c64473ca3db04a3f7fe24c2,97,55,42,South America,15,385.12
71d47b2a731c4e02a217455632f7f240,153,114,39,North America,19,1032.86
71d66aadf45b452181e61659a383662d,278,250,28,Asia,26,2344.3
71d687da4abe4984b992d47c6903cdf9,338,306,32,Oceania,22,2727.72
71d724775aa948ebb0614de526dca6a0,213,166,47,Oceania,14,1227.25
71d74e6622864a979e94f20878d1674f,188,167,21,Oceania,19,1465.42
71dab81cceb442cc805db7c3f5473b2f,90,48,42,Africa,24,620.92
71db276ad6ba4cd4b6f95d0ee633a5f8,284,243,41,South America,19,1379.39
71db3e115ce5403b9b452b79766baa1b,48,17,31,Europe,21,429.4
71dba6c3d0b5442f9aa211d6f07600d2,365,346,19,Africa,27,2432.48
71dbf0fee5794f509352591aa9bca6ab,134,99,35,Oceania,17,1040.79
71dc4f827aba4d73b26a6ebea992a067,225,184,41,Africa,21,1251.45
71dfafadaa804be0b05af65410f6ee3a,365,318,47,Oceania,24,1860.96
71e42096f5ed468d8912ad1a74df6ce0,165,123,42,Asia,23,1054.37
71e7742e024547a98942e703b4c7a828,91,44,47,Oceania,19,659.39
71e7883f8d9e4d2eb4d4316c69fc8dfc,264,224,40,Africa,20,1719.68
71e7c17a16da4cbd8fc0a1ca18867c40,54,9,45,North America,17,155.66
71e845643c164e1586c9a0637c943dec,275,237,38,Oceania,18,2237.95
71e85f7e5cbb46f9a077453971f36ef9,208,178,30,Oceania,14,1588.62
71ea0341f73e429492b134bd7abfb8db,167,146,21,Africa,22,1360.3
71ed415060254438881407facc4cf1b8,365,363,2,South America,18,2317.59
71efd57e0ace4cfcad9fd02d97dd6efc,74,19,55,Africa,20,395.14
71f122d99fa7450b805dc8935b951c97,107,54,53,North America,22,803
71f2b798985447749f49b699530e0a78,213,169,44,Asia,17,961.59
71f4ffaeec0842e9935f917e9213602f,348,318,30,Asia,16,2891.86
71f58840a06a4726bcadb7c9e8c9c72f,91,47,44,Africa,20,614.63
71fa065a07c04c3aaffab2124f83cdd0,355,337,18,Africa,20,3098.53
71fddf83012d4642873b2f89ddc495dc,360,351,9,South America,21,2330.78
71fdfc1f7de54055aef39e9b48db5e49,175,153,22,Oceania,18,1115.26
72022719e7d34cb5b7e7e5800842f71f,124,96,28,Europe,21,963.92
72036a3830b84d5aaef0ab0b1b70ad62,224,178,46,South America,23,1176.56
7203994d9d1541b7baf916eb27576ab7,242,214,28,Asia,21,2345.12
7204b3845ab1436d90376698cae5da36,75,29,46,South America,13,567.36
7204fe485abb41eeb6a36368248188eb,364,312,52,Europe,23,2193.32
7205a95f068e405f8501fb9ebd1ff837,352,304,48,Oceania,20,2467.17
7206118df4644ce0b10e63891feb41ab,355,310,45,North America,15,2617.63
720c8a9de2374f16a8d3e822bf4c2918,352,309,43,Africa,14,1376.41
72117bc7948c427bafac0e112e5a5679,123,87,36,South America,19,935.57
7212065620f647c5a5afd3517581383e,360,352,8,Africa,19,2580.19
72128446b0bc45df9398ff90b3ecc243,322,270,52,Oceania,17,2476.98
72133b8162a2498abb74502356255d22,94,54,40,Europe,17,545
72135b0a5f914f0e840520579edc8d67,251,208,43,Asia,18,859.26
7216168cb1ca4845a5a0cd518b3af1fc,151,110,41,Asia,18,1516.73
721781e9bebe4d5cb5628c47bf50617e,263,231,32,Asia,22,1441.98
721c731ce6004ba98284611189a46f96,163,126,37,Europe,15,730.26
721ea396edfa4f3b9f3b6518bc3ad3bc,162,133,29,Europe,23,1404.49
721f35df4df84c00bc1c466462ae6c0e,93,47,46,Europe,18,188.81
721fea2a44044cc1885fcd364f310cd8,364,339,25,South America,21,2474.7
7220aa8ad16740aab7fd412d14a83ced,322,279,43,North America,20,1415.14
722241473d1a4c7d8e4f8e6973365bf6,132,85,47,Europe,22,406.28
722365747f224bf1a2476f48ec77b498,79,51,28,Asia,18,535.84
7225052fd5ad4062976e3e186ad58af8,326,291,35,North America,23,1971.82
7225d6199c3949448cc9cf43e911ddd4,244,191,53,North America,18,1455.29
7226ce9094294025a9bc8d8f864a7c08,225,196,29,Asia,24,1118.19
7229c0d0bea6409788c6ce236b412945,261,229,32,Oceania,19,2001.25
722a4412b15246f1806fe35304bbe063,118,76,42,South America,21,790.17
722a58c0a8f2453a8aa5a2674af5e35e,172,129,43,Oceania,18,1550.75
722b12b7439b495f98fbe249a33371d9,191,141,50,South America,19,1018.76
722b203cb57442d1865271279913780a,88,52,36,South America,17,713.32
722e3360ce294e82b5da038f4893491d,37,10,27,Oceania,21,209.61
722e92b3bdc74d66833e0c419c2f6042,268,222,46,Asia,19,1720.28
722fe0c948a24e67bceddc2f6f94ede7,116,77,39,North America,16,730.41
72343f1c10454fea856002fe85cc99b0,179,133,46,Oceania,21,1093.43
7238315bd935451ba019da7a82bc7bee,130,88,42,North America,14,864.24
7238f87435d9492188601f019d34cdd5,135,88,47,Asia,24,403.01
7239a13b85be4ba6b0cc14555a628bac,208,179,29,South America,16,2244.07
723a367419314e7eb9f2aafd4139803f,364,356,8,Asia,23,1395.91
723a4791a5a545259551214f2897405d,96,62,34,Asia,21,606.31
723d3e801ca744b8941a17be761d63c7,48,16,32,North America,19,162.33
723e82a8d9eb4904898d8a636c03dc44,146,98,48,Oceania,18,708.73
723ea2974e3348c099e4622813294169,103,59,44,North America,19,639.46
723eb71589c642e78aede882fcfb1063,365,353,12,Oceania,25,1486.34
7244375fdf2d4c2ab4714c2d3a735176,31,3,28,North America,17,403.79
7246f53f11504e609491ff15d956c9b1,173,136,37,Africa,15,1789.28
72471ebc54af4d5e9aae8f9389fdbdf9,206,168,38,Oceania,18,1819.18
724a7e66e7df40d3822b02d296f769d2,209,182,27,North America,21,1611.88
724bebe167ad48ae87b48db22541cece,111,68,43,South America,19,825.34
7250b356d6814efe8a3bbceb520c6532,292,262,30,Asia,18,1778.78
7250f653d46741df92b9a9fff03b274d,171,151,20,Africa,24,1647.05
7253b1bf0227408386700ed5ff9122a2,197,161,36,Africa,22,734.97
7254dd64ad464ff984abc6d8d46d1e06,272,237,35,North America,19,1980.41
7257a046fbb2415788c8c147110b9d1f,293,240,53,South America,22,1903.53
7257d3b6be924372b28780fabac15988,327,286,41,Asia,20,2436.44
725831db55654cc09ec2427e8da186e0,364,347,17,South America,16,3099.95
725be8e1875049b895e7ee4203891a78,204,182,22,Asia,19,1341.5
725c4ff787f44828ae7c95b214e39867,355,305,50,Europe,18,1694.96
725d5fce870745c7851b49556d9fb7e0,365,360,5,Oceania,20,2817.69
7260db1f14464f09aba565de55f064c5,305,292,13,South America,19,2790.5
72613db5e51f4b7ab91db11be67e64b3,361,331,30,Oceania,18,3453.68
7267dbac7106430c984b8ee1ad77c70d,245,208,37,South America,21,1900.2
72688dbd5e4948ddbf910e24ddb89040,156,135,21,Africa,18,1265.15
726aac1c62164c8380fb07c5ebb32385,188,141,47,South America,28,928.41
726bef5d43654644bdf2e84aa9e9e433,72,55,17,Europe,17,413.71
726c8e82ba374a598eeecf7f71fd8c13,45,8,37,Oceania,16,361.43
726d1f17057e4adfa6356763d84271d4,360,305,55,Asia,19,2314.2
7270601daa3c456891fce9bf6f333e10,364,349,15,Asia,21,2461.66
7270f0452cad474ebec132c71e3f3464,151,105,46,Asia,15,879.61
7275e203c39c45e59749a4c17b4e0c8c,145,115,30,North America,21,1231.6
72768545584444b09df2ede1de4bcabe,48,16,32,Europe,24,487.45
7276cd5a795741bfaa244325faf0c474,365,351,14,Europe,23,2406.21
727743860f544dd0ab9f93414bbfffb7,242,200,42,Oceania,17,1702.49
7277c92a6b2647969c1baf5592f7172f,262,221,41,South America,21,726.12
727b2567a22246baa957ee78312d36ad,274,237,37,North America,21,1341.41
727b34a918574df7bbd9545ff8f95cf6,365,359,6,Asia,22,2895.83
727f683bca1d4ce7af9ff4d9ceb4c329,232,194,38,North America,18,1730.32
72800c615cdc41b78b1b7a8f0c75c529,361,325,36,Oceania,20,2145.01
7282293e41d94880ac4ce5fa4034adb6,356,321,35,Oceania,25,2055.9
7285424a4efc4498937d7a32b0a8a0cd,364,364,0,Oceania,25,2906.71
7286092674d945fdb407114fa29213ac,318,267,51,Europe,16,1472.81
7286abffb67143359c2794af7e7ef139,211,197,14,Asia,19,1318.55
7289590aa3f84332add2d2bdf2c34ba0,190,171,19,Oceania,20,1497.86
728a3e25acd441378bee07cfefb1d818,169,134,35,Oceania,23,885.17
728b89bb8bc04a64a3321e553a316d95,112,70,42,South America,18,454.25
728bb98dd252441d8656056d03f26892,131,108,23,North America,16,887.09
7294f74bdc0942c792bfac1dffe236fb,247,229,18,Asia,25,1553.88
7295042a6d284b2593cd87300b028ebb,226,201,25,Africa,15,945.15
7296cedf98c34453a2c6390268adc60b,197,146,51,South America,22,915.97
72985595135648adb3eb3a4cc336d404,193,173,20,North America,22,1346.28
72986bb326614b0a9775ea271d3afb55,365,344,21,South America,24,2370.56
729a1e6b8fcb48a2b3192d25388d4263,362,356,6,Europe,21,2094.34
729ab3c2c6cd46d088a010d4949c8c43,76,51,25,Asia,20,327.52
729ac2b286ce483a9754bf7703ac389d,84,26,58,North America,18,433.33
729c369e5b944e7e8aef866375febda6,71,49,22,North America,16,552.91
729c4ef016c141579c9f2b17d659878c,112,90,22,Europe,25,976.51
729dd56fedbe439fa0ae12b53b3c6ebd,347,311,36,Europe,26,1645.72
729df152efca40768c9b2b182825c231,80,44,36,Asia,24,646.24
729e7af04b444236913e0719dc034020,128,107,21,Oceania,17,1000.53
729f266a476040bd937b35c09b6008fa,157,122,35,North America,23,1137.3
72a07aeb88ce40ec92b56f16df0d2bde,129,84,45,Europe,20,749.72
72a122b318e2403f86134b0a714cd79b,317,277,40,Oceania,21,1989.45
72a1b9f1ba054be8b1f143e84a7fdaab,221,191,30,Oceania,22,1963.38
72a201abeaa04313a8fb1c320f157636,64,15,49,North America,23,403.13
72a2049ff3704808b598c89489497fc1,276,220,56,Europe,20,1715.23
72a2a666289f48f085c78b78fe4ccb09,199,169,30,South America,15,1176.66
72a62e8a2a514d09bb1c3c2c4cb9617b,89,38,51,North America,21,354.11
72a6894713ca4825b72aec647bc6a906,50,9,41,Oceania,22,637.45
72a70eba015b465ca2420bb135a4dbbb,363,347,16,Africa,18,1646.19
72a71cc2b7be4deaafec414763922de6,246,194,52,Oceania,19,1003.7
72abf6a31ff54ad4af67fdc92fada4da,335,289,46,Asia,20,1780.39
72ad01c4dd4d43d5a184d6bc2a8e9849,242,194,48,South America,20,1124.1
72ad131d15d749c3bbc46f1d60a6b46f,30,1,29,Europe,24,194.72
72af0ea2ee1d4fb5a50697927d82248c,94,55,39,North America,22,460.58
72b1bec7918e4697bb8729c7ecf78b2f,364,346,18,Asia,19,2324.73
72b1d1528f1044b8bc5aa694f96376bd,360,357,3,Asia,18,2269.14
72b2197a3074408682e5f9aaad5d0967,263,206,57,Africa,17,1098.36
72b3c605c20a4afba9853257f5ba8997,365,322,43,Europe,24,1794.15
72b3dca08c7441079d410b407d12f041,199,146,53,Oceania,18,661.57
72b5d91b6ffc4189881d6c131195bdd7,318,267,51,North America,25,1773.22
72bbde4f7b564a53b94e48097f096c93,359,333,26,Africa,22,2512.97
72bded7e3e50446dafe23af306c6230a,194,143,51,South America,21,1689.72
72be379924d841c3842c924568782543,335,290,45,Asia,23,2335.72
72bf8722072647f69004222df3421b6c,219,184,35,Africa,18,1506.26
72bfab92fa214536b83989d2b5b6f5f4,191,135,56,South America,22,863.84
72c3401fc67b4aaf9baf642c272f8d56,128,88,40,Africa,17,653.04
72c3e9daf9014f29b0e0a804e6aeddfa,210,189,21,Africa,20,1474.24
72c4a93a04bb4ef39544a29effc510a3,336,288,48,Oceania,19,1565.97
72c537ef09ca406a84ff118c6996e026,98,69,29,South America,17,452.31
72c93f397df845b29ba6d51d3b2ea1e1,229,183,46,Asia,20,1240.54
72cb1cce3ca947b29cfc619d1a14e921,106,81,25,South America,17,1194.42
72cbf85deff54c5daa0bafb517cb5fa0,304,270,34,Europe,25,1933.33
72cc04650225402dbfe8f0e6034f0345,365,354,11,Asia,18,2405.28
72cd72baa9034b9298a4de49c3c6cdaf,215,177,38,Europe,22,1380.27
72cf26ed1d984259b50f3456b2659005,111,93,18,Asia,19,803.73
72cf41d8d2f642fd9871bb4818af4275,173,118,55,Oceania,19,926.91
72cf95818281476c8da165e51bc0ffea,365,356,9,North America,27,2692.14
72d709aeabce4c95a34d11efccf44f93,32,6,26,South America,19,204.96
72d8593c34d34f04a713a7254e960621,354,303,51,Africa,22,2023.19
72d995d8e126461f868d6fae0aa47c6b,68,47,21,Africa,23,475.77
72da432496e64811936308572d3e06d4,350,309,41,South America,25,2415.95
72dabbb45f7548bba664ca11683b71a6,26,17,9,South America,18,285.81
72dbb07fa5e64d37a2d4fe4473e97e86,148,107,41,Europe,24,1032.8
72df67d4508c475a992b090f856cbe75,73,44,29,Oceania,21,478.56
72e04e0a4e9844e589a229d81c094714,79,38,41,South America,20,440.33
72e2e9cd3783475c933e43f658a2b145,242,200,42,Asia,18,1475.42
72e5ec84b94c4b9daa8d251507df13d9,321,290,31,Europe,21,2704.37
72e688c3ca3a423f823f2a89f8148739,166,138,28,South America,19,806.29
72e76edc5a6740fb84c5e1a02988b3ef,77,40,37,Asia,25,554.87
72e92db20c6640cdac6dc19b74187a90,354,324,30,Asia,23,2676.9
72eab1ab2b0f4bc08acbfdc531b3f825,314,278,36,South America,20,2078.27
72eab8e7071549dca8d266efa8318080,356,338,18,Africa,26,1428.11
72ed6e15332d4ca59bb1615ddb245481,81,52,29,Oceania,16,640.76
72eebaffc3d744c9a9d69dc581400771,365,327,38,Asia,18,2321.04
72f0512fda4e40c7a7d867e1a9f9bdd9,131,80,51,Europe,21,1042.56
72f165598f2948b9ad46da8e9cc174fe,281,260,21,North America,17,1861.09
72f1794020e541a2b64eb83aa1c2e8be,100,53,47,South America,18,393.47
72f3e08157564a889410df151a5d314f,115,83,32,North America,20,963.57
72f66ee922d64a6e8cc1c8cb6ad0f330,130,93,37,Africa,23,930.1
72fa560bc07948a7b70bb6d7ebdf92f1,152,107,45,North America,22,732.7
72fc1b1ee00a461795738e1b95a3f695,61,29,32,Asia,22,648.07
72fc7a2bc4ac4da296c4bda0f6e01a05,344,289,55,Oceania,19,1615.85
72fea5e71a5c4bd18098e86709e0a6d5,94,71,23,North America,20,606.23
72ffa9785f97482fa5fdb1f094d349ac,237,199,38,Oceania,16,1185.32
72ffc9d112e44578af5afcf273358f0f,276,241,35,South America,19,1908.34
7304c3020cc24a8898f06fe050f2f048,157,125,32,Oceania,25,1541.7
730597ae37bc4d0893e248239a81d1e7,319,286,33,Oceania,17,2189.42
730a6c59dfdc4acdb3dcfadac42ce520,105,69,36,Africa,20,614.27
730d5457ef3c4876b19aedbc7fc88147,235,197,38,Oceania,15,990.2
730d93d66e554071a720355162ef2d3e,296,252,44,Oceania,25,1234.89
730da4f3c51a46dbabafea0b7eb05c01,106,79,27,Asia,18,753.59
730e9653df6c4187ae2abc1ebf75deda,218,186,32,Oceania,24,1180.46
730f72c5657242bbb8729f02d589cf77,52,24,28,Asia,23,240.34
7311e48371b4470a9d1539f1943b51bf,232,174,58,North America,19,1383.34
73121fdf3ddb478bac55335d38b6e3fd,131,72,59,Oceania,21,546.5
7317a362fe5247b0b5cd66662fb75af4,261,223,38,Asia,23,1875.45
731891de537a4a3cb425ba3c56a93b7b,365,342,23,Asia,23,2772.81
7319618b9fdd4d0aa96ed150711423ac,220,161,59,South America,20,1652.56
7319addc91ed4f3ab7222d041cc3025d,256,214,42,South America,21,2301.25
731a12f21811466b8c79e8b361b43be3,65,44,21,Asia,19,614.59
731bccb30e42412db20fe19dc9e76e13,304,275,29,Europe,16,1614.46
731e6485698a4ac79c94f7bfd6fa148e,315,270,45,Africa,18,1025.05
73205af48b364c0e8fe394c80e1286a7,194,178,16,Oceania,15,1850.79
732098d9ced24d54bc431b80b83b5818,191,167,24,Oceania,16,1299.9
7324b23e417846d8a7b2539a58d9f99d,115,70,45,Oceania,18,445.56
732651a2b142435d8f1d9f893b22927a,364,352,12,Europe,19,2673.16
732aa542b1fa48f0bc7aeb77b341371c,331,300,31,Europe,18,2843.73
7330410f639647c9b14a95ee54d41200,338,289,49,North America,24,1679.18
7337919f956140adb0a697f4500340a7,196,162,34,Oceania,21,994.04
7337c438f9c1413e96f391480c928558,277,238,39,Oceania,16,1785.36
7337eb9bec1544c29141fd335e5baafa,282,252,30,North America,22,2055.61
7337f4d86a6347d991574bd3f736edd6,127,91,36,South America,18,1242.36
7338389e30414ee2beef410521313ab1,62,44,18,Europe,16,508.07
73390fd0e2a8408385390c6c1ead1060,335,295,40,Oceania,17,2190.03
733996c5a6484e71ba5a78b1fbaf7b0d,169,141,28,Europe,16,1383.77
733abdf05f044aa983922d2a5d72943e,230,210,20,Africa,23,2132.68
733bc63412f44dfd89ba2d26e25d11fd,48,26,22,South America,20,498.44
733bc83eaf30410580a6d04d7898c493,306,258,48,Africa,16,1586.94
7340553df8a749acaed97fded05240ec,104,70,34,Oceania,22,849.92
7340fd17b8cc4b87be9490f0ca7daf1e,365,358,7,Africa,19,3334.42
73410bed576b458c8cdb8fddd7e2386f,144,113,31,North America,19,868.45
7341640540a84294bdf3020efa1d02c7,119,91,28,South America,13,950.8
7341b46c6c314dfca1d652f123af6e60,141,118,23,Europe,20,1061.67
73446282fc264d8385f5341c21151d41,216,175,41,Asia,19,778.06
73454fb8b088487e9353acb1a0f76010,363,343,20,South America,16,2385.79
73459b4f0a604992848524b19d77e7cd,101,74,27,North America,19,1229.45
7345fafb65c44077af56aa664ec4e39c,58,21,37,Africa,21,146
73474e147c1f4e32952db0bbe13918e7,31,18,13,Asia,15,170.84
734802212cc943ffa08f72188ae67eb6,181,138,43,Africa,18,1062.99
734b56853588428e892763259e1d45ec,365,352,13,North America,22,1446.34
734bb08bd4754b19a5cc098904d75aae,71,53,18,Oceania,17,539.75
734bd0111483472e9c61bdfb1f12f3ad,365,316,49,Asia,16,1039.99
734cacb2555746869d7d2a40a922e60f,45,18,27,Asia,19,403.65
734cb7eee694479291a65892f15b76b2,197,172,25,Oceania,25,1376.14
734f34f1c1f34cedb0215338c684f925,206,173,33,Oceania,22,1774.67
735339d4bf9c4b9da656677780fff1eb,279,246,33,South America,16,2234.29
73550e3073d94e3db5903434c3350d65,181,141,40,North America,18,1184.95
73557775660a45f49ae715936c5a032c,173,128,45,South America,20,642.37
7355af422ce54bb18090081159365530,200,161,39,Europe,21,803.5
735678779d2a49a18f0c4dc77538e6e7,365,324,41,Africa,25,1577.4
7358f873f028483ea58c2ed902173c59,52,10,42,North America,19,274.98
7359850d5b0746e88a3635d5cd922f34,185,172,13,Africa,22,1593.88
735c71975d4441aa83986e9b532c07ad,182,154,28,Africa,13,1274.96
735d7cf31269442eb6b3177cd14a1175,227,184,43,Asia,17,740.28
735d96c7e15740e2ace0b587d9c1fedc,225,203,22,Africa,16,1516.25
735f3d1198814dcca8f017439b80bb2b,300,252,48,Africa,18,1805.24
735f65f37a454524a606d83fad992b04,302,251,51,Africa,22,1709.98
73604a9f556742c9b9016917832054e0,138,90,48,North America,21,537.88
73628d346f2c420e91e4eca091e30543,103,80,23,South America,16,743.4
7366e40bd9c94f2f8ebad2595d8a52f6,135,91,44,Asia,22,692.44
7368f6ae74fa46a69e185c85b3ba6b79,363,347,16,Asia,21,2916.86
736a1220966c4825b29157a7f906c877,249,219,30,North America,23,2026.47
736a15e2b7124910aa8c8a8730084649,113,61,52,Asia,18,705.85
736dacec33a44f5cb0e4519c2c2a8391,54,9,45,Oceania,23,229.11
736e19ac18d54350aeaf763b35cd5f33,164,140,24,Europe,18,1306.93
736e84a178d5422d92f78d4601f9ff53,60,25,35,North America,23,261.2
736f0c0e18e14e5e8c230075808b3307,46,18,28,South America,12,553.67
7371d283b14e4070a0a2abee422b7eaf,332,297,35,Europe,15,2164.13
73731af7091d4e44829f6b252f289465,365,319,46,Asia,15,2094.17
73785671df3c499b8f4f4f1f6fb1cfd2,49,26,23,Europe,21,254.9
73788e9dae7d405ea384b3070020bb4e,363,330,33,Europe,20,1485.09
737ac5c24f7549b9bb0b6598d36a8056,329,301,28,South America,25,2164.61
737b5197edbd4c62a54bf3fcabf00ccd,185,130,55,South America,23,1321.64
737bf90fa3964c6dbfc013501dc90af2,250,202,48,Oceania,21,1078.64
737c98bcd7194aed8b1720cbc194ec1e,221,200,21,Asia,23,2111.82
73834e90a4be4aee9fe92853aa31eee9,361,357,4,Asia,19,2988.22
7384efd8b2a145e2ba246d4c236a2556,193,171,22,South America,21,1752.2
7385fcef8a6645c59d56c573f41ece52,80,46,34,Europe,27,522.28
738aa3e1b6f94f5cbb690aae7459501f,266,247,19,Oceania,14,2515.14
738ae3cc28134e799587a21dacf351fa,76,53,23,Africa,16,735.53
738d0d0d3aa5432182ce9d52325bd213,208,189,19,North America,21,1603.54
738d47820d2e475eaa814fa2985a6c32,134,91,43,South America,23,1133.48
738dc1a3d28f44389123402307a56379,89,47,42,Africa,20,429.3
738dd9bbe4204db49b070d4845e58c90,345,311,34,North America,24,2167.43
738edfa80b66443389a618366915f961,187,146,41,Africa,16,1490.84
738f365585044f18b07942f2af636a3f,257,224,33,South America,24,1485.04
7392f09eb22a4ed8b3f963ba1639b8d8,249,222,27,Oceania,18,1640.71
73932db8711f442d8dc4aeda6ef490aa,93,60,33,Europe,14,867.17
7393ba9bc9ef42d2abe937a50a9ac950,91,32,59,North America,24,457.07
7393ee3f30c64d78aae4cc0871b2430d,263,235,28,South America,19,1361.22
739552308b3a432daadfbf28d055c4b0,124,93,31,Africa,19,668.19
73978d6347b74900a0da99b0218568f5,283,259,24,Europe,23,2347.28
73988dd0e540463194b065c691935a61,341,315,26,North America,21,2918.61
7398adb1977d4456b80cda235ba34a59,362,323,39,South America,15,2782.74
739a0f82f0384c2ca777cba03f652fbb,228,199,29,South America,20,1627.78
739a174e23034129bf7907e6352a1704,296,247,49,Oceania,22,1636.55
739b113d11074ceb9d741bf7f7b13ef6,139,107,32,Oceania,22,858
739cbac8dc444f05b7c9d0d37361b2bf,163,121,42,Europe,23,970.37
739d9f3117a64095a2ba6d24f80d133c,215,183,32,North America,27,1371.63
73a03a7eb385406f96d285411b201835,267,211,56,North America,28,1631.44
73a35958e78441cfa5867f4cfbb0c73d,287,272,15,Africa,21,2227.74
73a3b5544c0040e79d329727ec3f26d5,154,131,23,Oceania,23,1304.99
73a74e8c73bd4196a878ed5d43cc70ab,69,54,15,North America,20,431.42
73a8f2aa72534d6187b53b1cccee08cf,192,149,43,Oceania,26,1115.9
73a936d852f04d36b910e12faba05fc0,149,128,21,Europe,14,1336.71
73a975b6faf54c6c817f58de1ac6497e,113,73,40,Europe,21,700.4
73aaa76dcea04586833535561f8dd44e,236,193,43,North America,21,1334.29
73abf389934a411fb2cf122ed1bcd4d8,46,4,42,South America,19,240.07
73ac542551bf4f4186e134c00efd6148,192,170,22,North America,21,1202.33
73acbff89bca427bb55d920e0a18ded7,179,131,48,South America,21,1273.99
73ad149f506d41c499f63b628af9c7fb,333,292,41,Europe,23,2082.92
73aeddaf249d426181927a7989f41767,316,277,39,Oceania,19,1863.59
73b3445e4e53472698c06c4b0eefd5b7,62,32,30,Oceania,18,490.32
73b4db98cc9448c4970fa0903906a524,233,195,38,Europe,17,1952.92
73b593ba319a49a4b6a74c6e776bee58,365,347,18,Asia,22,2876.13
73b5f43da0a64410899c2ff884f20b7c,358,315,43,Africa,22,2118.32
73b6f038d5674668ae2aa33a710ec7e8,239,211,28,South America,18,1915.41
73b7207c42f5467583b2f4b112067d29,122,95,27,Africa,20,1183.63
73b8a40d87f3440d977308fd77154c49,364,361,3,Asia,17,3162.38
73bb7f3c82434fb5b151109785279017,331,290,41,Africa,21,1523.01
73bcc2865a0640ab9830ee9ae9239c39,95,53,42,South America,16,690.61
73be1d920a964237bbe05d2ab95f0595,126,83,43,Europe,15,709.58
73bf11eff8194e819eb49f62e55599a5,283,248,35,Asia,25,1774.8
73bfcd9129a44b1d9310f5a86217c5c3,255,226,29,Asia,20,2069.01
73c2f1975fd34751a0478d102e06fc86,364,328,36,Europe,18,2850.73
73c54f7dd0ef42c0b4357c27badceea0,365,360,5,Oceania,22,2946.74
73c61ba97727437d9a8a7c099480962e,217,164,53,Asia,18,776.53
73c8535854dc49e0955c3894e9b92b23,242,192,50,South America,25,1140.63
73ca802b214e4caf8fb65314a07d6abb,162,136,26,South America,22,1559.88
73caeba914b34154ae5605476a629457,83,55,28,Oceania,15,342.18
73cc26346a874499ba7f44f42ccd8308,292,270,22,Oceania,27,2373.47
73cc34fb8f6c4307839f47bec70ec88a,152,125,27,Asia,19,980.04
73cd5af3204c4517aa914180d11092e0,186,165,21,South America,21,1597.88
73cefd9d20e644318fca740b3bd5590e,363,327,36,North America,18,2553.31
73cf2c8fb601486484c9960522c2907f,354,324,30,South America,19,2966.71
73cf8fe964c64ba98ce3828c110b631b,365,358,7,Europe,25,1412.87
73d12055196e4f97a37b13a711153571,365,340,25,Oceania,22,1707.63
73d1c8960a744738bf76e8aea2fce149,157,116,41,North America,18,568.3
73d47a3bf6ba44aab0850cd07424e83c,40,16,24,South America,23,199.14
73d4dcd702e542a0a9d9f98d4c9f9d0f,326,292,34,North America,20,1999.14
73d597a216ce4ed7aabff43d32f1ba24,96,57,39,Europe,29,151.99
73d8e7bf97f94edaa99dd9f874a4b232,364,342,22,South America,23,3326.82
73dac8b4051d44e488984f01ca9fd8cb,169,139,30,Oceania,20,1214.21
73dad1944c954845ba8b711879524540,343,287,56,Africa,22,1216.11
73db7c8046704bd482c551aaae925966,280,233,47,South America,21,1379.14
73dc00f6c8094961887e567b4d6ee227,86,55,31,Africa,16,673.85
73ddbdbc456d4c719c63a57268bef7bb,249,202,47,North America,22,835.98
73e007157c7848e6aa56bb0a21db7fd0,354,296,58,South America,23,1601.93
73e1e3919a5342089a62f4273717c1e8,60,32,28,South America,22,332.77
73e586b554be43df86b00296ff9680b7,259,233,26,Oceania,18,1966.64
73e6f822cc9f4296baffad0281bca1b4,318,266,52,South America,19,1609.41
73e7f96e39394d359ed1b4b4b6fdf928,105,74,31,Oceania,21,1069.15
73eb9150744f400e84d38b41e11e2c38,138,110,28,Asia,16,1061.96
73ec06ef34934ff69cbebccae8128915,121,100,21,South America,20,762.87
73edd891c41d42d0ba66601dae627e94,47,19,28,Europe,19,398.03
73ee56b2c2d4407fb6bbe37e2510164d,254,213,41,Asia,26,1518.64
73ee7d80cc314cc4b751cbd628e254e2,220,192,28,North America,16,1849.02
73ef6e9bc43f40d284f1f08c06ee82a6,180,134,46,Europe,22,799.55
73efa18715df410bab221ed0af04d4cf,106,85,21,North America,19,597.34
73f02758e4594b25bf3c17bbff5bd272,180,131,49,Asia,16,1052.1
73f45e1d7fda4f0083d644959a1569dd,282,248,34,South America,18,2303.92
73f6775b1a9846d9bbda6168a70af262,186,140,46,Africa,22,811.38
73f73083807a4fec8843782ae015c575,145,99,46,Europe,20,853.53
73f76fa6924e431682b3ea6897371b4e,150,124,26,North America,12,1045.92
73f8f2b243ea4ae68fe7e80d0ce1a507,324,270,54,Asia,23,2671.98
73f93c253c3544e88e6e7ccc2b1056a7,299,259,40,Oceania,18,1796.22
73fa4ff198174e4c81508aef44a38d18,82,53,29,Europe,25,457.92
73fb335482e24810aa2efdd1f0c2c666,97,64,33,Africa,13,762.64
73fb38a3a37c41288337ec2de43e8114,360,314,46,Europe,25,1813.6
73fc5ba2b5054bf8b350fa260800b4f1,364,362,2,Oceania,22,2440.17
73fe08adedc64dda9fde93f2e37e7d95,247,196,51,Asia,17,1541.72
73fe1580fe6741f9a14609d9096be615,363,330,33,Europe,19,2404.32
73ff227879244021a205e4cf3b37e4ed,248,219,29,Oceania,23,1571.13
73ffd76b812d4384b5afbc0c1e9c3441,326,304,22,South America,21,3008.03
7400893855bf468ca2f17267cb6a3033,213,192,21,Oceania,25,1989.44
74021b015caf401dad79a5ce96e728ce,74,17,57,Africa,17,165.59
74035d22685a4bbaaa02741e4e090568,289,258,31,North America,17,2059.95
74048ce607da41aa85471b218ee69c0a,365,357,8,Asia,21,1577.33
74059661536b4faba6ae2ed3f8b85b9c,83,60,23,South America,21,562.49
7405a99fd68740e4abb12a10d5e9c388,165,138,27,Asia,23,1373.91
7405c520e2954d119644abf97b423982,62,28,34,North America,24,494.44
740baa02d2ca4b9381f34ec81fca8f12,309,279,30,Europe,23,2113.16
740d9ca9248947bba3d2358a38c5accc,119,84,35,Europe,21,564.03
740e7786b0154aa183299120ffa6de6b,347,306,41,Europe,21,2447.58
740eef346aed4615b290943b9c343117,94,71,23,Africa,19,462.41
740f3ae30a924570b624cef01c659abc,132,86,46,Europe,20,703.65
74109e5edf7b44639045376711df132c,246,218,28,South America,22,2196.84
74123a600a0a4343a387e8e26dd87d98,137,93,44,North America,18,561.88
7412f0ef7fd0401a8ca831efdc0386c3,358,335,23,North America,21,2243.24
74176830fd0943ca952708366e61ccb7,94,47,47,Africa,19,423
74184bd52e664f3faab9e1a12229b125,79,29,50,South America,16,551.71
7419edd1f2814223a4fd1aceda54b63d,67,12,55,North America,14,465.15
741bb7e3ec2a410995e3d1040992d8bd,341,300,41,Asia,20,1551.98
741c4c5349154430ab8815620caac444,213,175,38,North America,18,1657.53
741e063b749d4f2186b878f9194af61a,313,292,21,North America,18,1960.02
74215737bf89497bb8f599cf59321932,46,12,34,Asia,17,370.63
74224b34075e470db4d9b8e554dd0961,195,142,53,North America,23,1260.01
7422bfc15989499b9911fd3f4ae693ed,301,281,20,Oceania,17,2418.34
7424bf4d6d4246cdb2e0d2e68cc79358,105,45,60,Oceania,19,564.73
7428e6bc9fff4ed3bfd49dc22a33f2df,363,358,5,North America,16,1460.31
74290a2af82f41599dd471fd9b280421,145,101,44,Africa,18,813.11
742c42bca2b943d18f922c52d8150310,240,206,34,Africa,25,1484.5
742e17fc27924119b944df5d785ff17c,301,260,41,South America,22,1948.64
742e5e26f7fd4d218da0386f18344211,53,28,25,Africa,23,328.09
742f736329144de6a185610a62537276,364,348,16,Europe,18,2957.9
742ffb67bf2948b5b4c608f12c3fbfe8,99,54,45,North America,23,642.36
74300d7e103940e19057bed4af0ed8cf,93,46,47,Europe,17,331.91
7430e39bd33f4caca99f27fe16de7439,307,263,44,Europe,19,1638.08
743112898d3a42eb98b720b98d83c84b,325,300,25,Asia,20,2922.46
7431d89fc7184fd0b21853405e2e5fc9,357,323,34,Oceania,18,2624.07
7431dffd415349039d964ed084e37ce3,264,245,19,Africa,22,2084.74
7435b0f4ecfa4957b872866a0b3d0e48,253,200,53,Africa,17,1416.88
7436322486064c33b6387a74d8199d9d,65,26,39,North America,20,428.96
7436e1be841c49c9bd3913bc050f1399,150,93,57,South America,19,719.46
74381a65231d4b0b9972120e50736314,363,315,48,North America,17,1832.07
743a29aaa1f74823aa737730cc9f8aea,115,66,49,Africa,21,538.78
743c0742749a462da77655408eb32394,76,53,23,South America,18,373.23
743c13b02b904df3931c760761a73955,200,180,20,South America,20,1986.97
743e1bef885c4f8b90f737feb9a6c280,228,172,56,Asia,17,1463.76
743e1d350cd14d9c9d9fe7aed968dd1f,272,236,36,Asia,25,1987.9
7442b367a87b4c00903b45183b1bc919,177,131,46,Asia,21,947.8
744349bd5f7c45c38d28e6050ce22e62,359,326,33,Africa,19,1835.12
744472bd22684f46822e7c82150d4e4d,365,327,38,Oceania,26,1734.06
74479c4171e14fcaa5fcc1da927f2fa4,365,343,22,Africa,21,3170.92
7448cf3cd21b48d7b608c8bd08007692,303,269,34,South America,14,2374.76
744c81feca464c0c9423986875ca0bba,51,10,41,South America,20,340.04
744f0b2557504b5abafd64b2a41e7e47,50,17,33,South America,20,237.55
7450c0bf189b40dd99b51c2cc21a742d,365,343,22,Asia,20,1321.73
7450f91257bc401eb4041aa7498e929e,279,233,46,Africa,21,1324.65
74527a7133ff4dd7b22be20b12ed4449,260,210,50,Europe,18,1434.75
74532b4dd4314ab0acfca41b53cb4094,155,107,48,North America,15,914.3
7454342660434984a1cfc51fefa58530,244,194,50,South America,20,1948.26
7455e6b26ba8494abf9322bc053abe13,95,73,22,Oceania,19,700.55
745631e547b840cdafbbb704198fbba9,228,188,40,South America,18,1316.47
7457849359914427aeeccfbbc4f92621,260,213,47,North America,23,2077.58
745931d4867141d5a96cb82d30213138,105,70,35,Europe,19,1120.65
7459e09ece16485e8e7350498acf8cb8,63,39,24,South America,19,657.86
745b1a8824da43039b0da51fe148ba60,36,12,24,North America,20,397.43
745cd9ad07254225b22275bd084fc278,77,50,27,Asia,19,622.88
745de08e9efd4c099f26f867f49d8608,62,29,33,Asia,17,203.76
745f9f03a2f94ad6bbdabf27320a46a2,217,183,34,North America,18,1444.87
746002f002684356ae32a7f0a0ee881d,289,253,36,North America,24,1588.81
7460094b4c6d48aa991d8030bbcf458a,88,37,51,South America,23,554.12
74638fcb64ff4bed9746210e4cc29281,357,320,37,Oceania,17,2456.64
746455966eae4400acb2c093f9300c5a,185,158,27,Oceania,18,1485.17
7464888a844c4b80b723b9fd3a62ec85,343,295,48,Europe,13,1680.67
7465318cfa8448099d0a42f5e59053a5,342,288,54,Asia,23,1828.12
7468a9995b924077808f25da43b07a4e,61,17,44,North America,24,523.01
7468bcf8844d46ca89de0d9895c5cfae,59,10,49,Oceania,23,62.08
746af4daab5d411f9ce2390f9689f55d,68,16,52,Europe,20,529.22
746cec3d960d4c3586f077278725e721,146,94,52,North America,18,561.42
746d8b9beaae4f74a4e87e9d4713aa94,156,107,49,Africa,19,514.06
746f4b86851b40aeb54ac22dbc0ca48c,290,232,58,Europe,20,1653.63
74708708f3744e0982f4d15457b74d55,79,40,39,Oceania,20,512.99
7473c7124d364e43b5587b69cf7f2448,290,267,23,North America,19,1996.04
7473d1d6cba749b382170f021eabfdfe,191,166,25,Europe,20,1499.69
74758322544c4865aa7093e3af7dbac5,365,357,8,North America,14,3023.04
74770b4af4f241989cea549dd9afbfaa,267,237,30,Asia,15,1396.23
747a965262c2419f89ad8e80c091e7da,318,279,39,Europe,21,2004.59
747bfd10f7a841859e8ee3d4af06842f,365,328,37,North America,21,1669.46
747c29128bbe475abd02ffeb06c93a01,103,75,28,North America,19,1107.93
747e5b0789304da4978d49184eaa251f,170,127,43,Oceania,23,1217.43
747eccda11cb41b19026ebb296778eb8,173,123,50,South America,16,726.67
74812890e67349ac8b5611e217345633,266,243,23,Europe,22,2121.3
748197e361a04795bd8f383dcb64b994,337,315,22,Europe,14,2335.43
7481c3a6afb44523a01bfbc6419c205a,202,141,61,Oceania,23,1131.23
74834b94a59b4faea4f69dbc8969cd0b,210,190,20,Africa,21,1350.7
748355d3f19c4effb8bdf5272306a9e4,365,339,26,Africa,16,2007.28
74861786c68449d9ae061d0e0c508b6d,76,41,35,North America,22,367.4
74889c12d6414d8fb3e731eb3955677f,300,252,48,Europe,23,1336.74
74896b74d0ce438c93440666a8616e08,155,137,18,North America,16,1055.17
74898bed8f8f435c8d50ec7c22b20aa8,294,256,38,Asia,20,2064.4
7489a49446f7432f9c1c5a91a4ca1934,250,196,54,Oceania,21,1107.33
7489d27dcf2144d69600b1fe3e7e2641,124,96,28,North America,19,1032.79
748c15db1bb74055b63cf0eeaea94e0d,363,353,10,Oceania,17,2208.44
748c766a8eba4a84a1e6792ecbeaee4e,238,222,16,South America,20,1421.94
74905640f5b34c70bbdf80c930782abf,339,295,44,South America,17,1419.74
74941525ae994f809d9e1738e0154974,117,70,47,Oceania,24,667.44
7494d9d4d154472ea2c31582eb68e01d,117,68,49,Asia,18,489.05
7496feff8f1e45c08192b346fb1665d4,107,73,34,Europe,22,692.16
749d39b8c5f64c52926e9dc1c3b3831a,255,219,36,North America,16,1572.04
749e6e364db3463487101fd0ee042336,79,55,24,Europe,17,665
749f059f799d4a908fc08772235ed942,161,104,57,South America,24,859.04
74a11ecf6de34a7a9c48641f9688a42a,33,14,19,North America,19,180.21
74a3c99818a2432a82ca2e388e311173,188,165,23,North America,20,1753.87
74a660f932354732b978e3b7d6d88133,123,97,26,Africa,22,518.63
74a6e8ea59a34f4caeb375f5c4a34cac,134,76,58,South America,21,716.94
74a8998075bb4cd393b56a6680cbc3b5,129,80,49,South America,18,819.48
74a9c07f605a45778c4c04e4ffadf996,129,84,45,South America,25,576.23
74aadc5144194c8ebbd866fff95801c5,227,202,25,Europe,24,1268.47
74ab5a08d0504eb29b3ece8c515f2d8b,283,243,40,Africa,22,1886.7
74adf2aa112b4d40bfe6355fd332f2e2,40,4,36,North America,24,321.34
74ae01f8ea6746b1bba36ce7d0fa8edd,336,293,43,Europe,21,1961.05
74ae5a559ed7408a8404d1f1e13d08fd,44,24,20,Asia,19,279.75
74b1a3cf347d4e95b7265d829a19db64,302,276,26,North America,21,2492.37
74b43315f9914c38ae91fd44c034a501,344,307,37,South America,23,1920.81
74b4b33050294e4095007e31cd577a3d,198,175,23,Oceania,18,1534.85
74b5ba77a5054b198b99c072e4181915,101,57,44,Africa,18,828.14
74b5c60f11224130b46f2af1b895aa2e,141,121,20,Asia,20,1173.35
74b5ee688122416f959a778852fbd062,228,187,41,North America,24,1791.38
74b71bdbc4b5472d89c99dcd84c53c14,348,308,40,Europe,22,2079.58
74b739156aba4a82aa9e7c945fda1a2c,250,216,34,Oceania,23,1804.97
74b9b32ae8364f97b4fbabd79b16d4a1,361,351,10,Africa,17,2270.36
74bbf675e9c949cd91a2f38f58a315f3,134,107,27,Oceania,22,1439.79
74bc25d6423e481dac65e26801af8dba,261,236,25,Africa,17,1888.81
74bf7d68582444efabbe34c91cd93ae5,163,115,48,Oceania,23,639.95
74c08c8b55754572b0eef0137bf7bb35,365,354,11,Oceania,19,2598.3
74c17fda4ecd4a44a4e908595dff6942,106,73,33,Asia,22,1003.89
74c19943ba6747cca525e253cdf59edf,231,211,20,Europe,25,1985.76
74c2c1b4ecfd462886a9e6db056dfa5b,163,111,52,Africa,20,500.74
74c36c95166843bfa19d3d5c844ed83a,88,55,33,Oceania,16,573.34
74c430787d294339a8b78b545f0c5118,229,188,41,South America,23,1064.77
74c4e0a1153c44f2ba8c34884383fedf,364,342,22,North America,20,2736.57
74c8933ec7014fe8b38583d5d53e8b4d,192,151,41,North America,21,1587.11
74c978cd7cde45e4ad357ec8a7918318,364,346,18,Africa,17,2971.26
74ca44221102414fb37b80c360f1ff80,318,280,38,South America,19,1922.38
74cb18a6c1a04be89179e22cce5d7ffe,365,354,11,Africa,16,1752.04
74cc55c3b0734cc18fe6501fe246b7e8,188,172,16,North America,24,1593.66
74cec3b84d1e4ef29b176dec0426f22c,356,337,19,South America,17,3008.58
74cf6120b8d84e2e972a28df7ca46e97,171,141,30,Africa,23,1200.9
74d0a1d8f4a045bf9e22cfdd2c94036e,106,68,38,South America,21,559.39
74d2191dc5534f948286916693a266fa,273,224,49,Africa,17,1361.43
74d355f7d44f4317b6fe4ef25a7ec5cc,326,280,46,North America,21,1907.48
74d4554438184eacbf0d28a98f2cb3ff,364,334,30,Africa,26,2355.47
74d8cbba7a2d440fb6d0ad7a04588f66,246,214,32,Oceania,19,1026.42
74db976989684a398f08664c32f6530b,188,136,52,Africa,18,1729.43
74e0cfeda7d943bf8a4d884e5af01b6e,140,87,53,Oceania,22,962.78
74e1130df6a14720a6db3232ed2a4b11,208,171,37,Africa,22,1654.77
74e1dd63b18f481da80f359dfd67899c,215,196,19,South America,12,1383.83
74e34480df6f471eae574c0bade0e319,207,177,30,Africa,21,1429.04
74e3a38797594be6a880b5a40154c488,321,287,34,Oceania,21,2047.84
74e3fd64bba3486088ff45bdc87248d5,132,86,46,South America,20,353.61
74e4b75d7b9e41ad967f6b12d6c10a8e,321,298,23,Europe,18,2364.15
74e5f2dd1b434b15be4fe407243613be,249,200,49,South America,21,1931.18
74e65afa6f9a4197a07e43754fd7253d,222,198,24,Asia,17,1663.6
74e6e0c4f1b446599312a1a08c1aafa8,364,325,39,Europe,24,2404.93
74e8523d56034b9a8dc9a2e0a3004d3b,248,191,57,Africa,23,784.44
74ea2602028f4f538deb52b65f72d060,92,44,48,Europe,17,434.08
74eb2295ca5942b1baad5ef85c575b58,175,151,24,Europe,26,1111.04
74eb4f16d5dc4eeeafa0ab44661765dc,360,314,46,South America,23,1297.59
74ed1957367c43648d16035eaf121ff1,226,183,43,Europe,21,1195.73
74ed71b223014d4eb498a12357884d75,154,111,43,Asia,24,1017.58
74ef14fbef6b41bba2c755f8a9fef672,240,225,15,North America,20,1764.33
74f27a2f9be94a0eaaaa4cc3ebcfb4c3,335,305,30,North America,21,3082.2
74f65f1c9946488bbaf14d4b482834ff,179,155,24,Africa,15,1214.99
74f6830ffb9747759292472ac9d3298d,87,35,52,Asia,18,253.77
74f86b90fead446bb34a324aa6878a6d,365,361,4,Oceania,20,2384.87
74f88dae6b254e27917a6965f064fec3,57,31,26,North America,17,370.4
74f8d08ccbd7414b9b4feb0f6406586a,46,8,38,Africa,16,276.31
74fae7c7b6f54c7c8acd293e074b6716,48,9,39,South America,19,262.81
74fb9ac518b54f7dbecead943de8bfd9,30,8,22,Africa,19,190.95
74fcb6bd7d7d46cfbbc92af4c5a0fd04,41,12,29,Oceania,21,380.77
74fcbb3c21bf4081922e6e72354aebae,345,305,40,North America,23,1885.92
74fe497797994efb9d5ef3808ba0df8f,294,245,49,Africa,25,1445.25
74ff89e3d7c54c3ea59ddb63403fe5c0,340,321,19,North America,20,2161.34
74ff919c9a214dcba13b4c67d4ddd6d5,174,143,31,Oceania,23,971.31
75015210777041edadbe6d842dbf6f6d,365,360,5,Africa,22,1524.24
750225a0c3994d83b3f3b55310da525a,325,298,27,Africa,21,2080.76
75024713ac524ed4af4a36459867ccf8,302,240,62,Europe,18,1033.84
7502707cc974496caff6a566890ae9be,337,305,32,Oceania,22,1744.27
75034fea21a949bf908c26bec2405677,256,217,39,Oceania,17,1597.45
75042c32863748f6afe5b54f9f32b5c2,351,320,31,Oceania,16,3008.56
75051e38f47f4351a107e7a1ac5e8cb3,249,213,36,Africa,24,2263.38
750542b5a6f143ea8abeaf16b3b0567d,136,108,28,South America,18,1112.21
7506b450dc1c4604bf73c8152332e853,288,236,52,Asia,19,1347.95
750c466353c0465db799b4a330400c5a,158,109,49,Europe,17,840.54
750c5db0e3e14219a39b4a8541a61d5d,363,355,8,Oceania,27,2575.28
750f3e9e317b4fb39f1d96868c9f2cef,102,63,39,Europe,17,963.44
750f8bb308a946faba60543d36aa9971,261,226,35,South America,19,1608.15
750fa14187e54ff397071205f809de1e,191,131,60,North America,18,1339.67
75102e7a6fb34e9986de5b33504803b6,131,109,22,Africa,23,680.89
75122cc348d64f51944810bd262fba08,149,103,46,South America,14,435.73
751334bb5f29438cae047dbaabf6f9d0,61,34,27,South America,21,488.39
751343214dcc4120a00fcbb4efec1062,72,29,43,North America,23,535.43
7517b6e4f99247c09ce76dd8494a88a3,187,131,56,Oceania,26,1102.9
751b65fdad2f4a5aae90bf94d27b31da,321,271,50,Africa,19,1074.56
751bebeae0444d04a4107c29dc958d49,307,274,33,Oceania,18,1711.83
751de1055be944bab95e97b89d788781,246,224,22,Europe,20,1414.49
751fefaa14484165bfdee143487a7262,246,226,20,South America,27,2163.04
7520b554aa524e01872be70e01984f15,335,288,47,Oceania,22,2528.09
7522f2bc304448edbc49766d7fa26551,338,285,53,Oceania,16,1650.92
7524a4d3d9064199b454144720b359e1,365,323,42,Europe,20,1661.33
7524d43568284da7b3790114ec844259,214,182,32,Asia,18,1465.68
7525713ac5a340c7ac0cd491636bcd21,279,239,40,South America,20,2050.47
7526ade1e7c5478f8d300370e62ba56b,142,130,12,North America,21,1111.25
752818716368413993cfeb31cbfd2bc8,122,93,29,South America,19,547.98
75299d280414427eb633c94efaa3ff2c,139,95,44,Europe,14,458.73
752bba7ec1bb4a958886a221ac35e754,86,49,37,Africa,20,462.97
752c30e25a9f43a197a037fc26c8c3b1,208,164,44,South America,24,1144.75
752ca14771f5471aa1602608c205e6db,219,161,58,Africa,17,1038
752d86a575064a7181f4d627fe910a29,305,257,48,North America,16,1576.73
752eb32db74e4b588790101c8e518d47,365,354,11,Europe,19,2782.74
752f397f8f584160bc6da6c28df26cb2,100,70,30,Oceania,21,572.75
752fd663030d45a8b33eeaa2eb76f4a2,316,285,31,South America,20,2632.46
7530ca0edd0d42ec99067cf6dbfeb203,249,200,49,North America,19,1284.93
753283687d2946b4886646d4fb90d229,47,2,45,Africa,18,396.64
75349e94349141cd9fcc8dd0947bb414,132,90,42,Asia,22,478.36
7534ffbaad6a446f9e2007ad45f7ff2c,162,123,39,Africa,17,681.11
753573d7a7aa43e89116f55a4511105b,279,225,54,North America,23,1528.32
75364538e38a43099035c9bded7aebe6,221,173,48,South America,24,1460.25
75364f1e28bb4f73bff9d079bf635e83,347,305,42,Africa,22,1525.29
753775ea9b4d4ae38a1e971a16441d51,365,356,9,North America,21,2322.29
7537a309545d4515aa16d50d8dcc8a42,217,167,50,Oceania,14,748.8
7539d2ad8e77454f9e8a33d87e4b9cc2,173,138,35,Europe,25,1014.6
753ddac33a234025a4e15052ff286c99,304,250,54,Europe,20,1438.07
753de96b697e449587fa6d0b17018890,281,246,35,Oceania,20,1776.45
753e9132fbba479a970942ac2e2bc9fc,285,244,41,Africa,22,1739.46
7540430b792e4060859b9d922cc74471,365,351,14,Asia,19,1614.32
7541b7c661e64250a0da3b30240daf1f,71,17,54,South America,20,322.13
754298cb43c6462d9122ccf0bdc9ed67,153,122,31,North America,21,1048.63
7543756746dd4463a2beebe45b0c1bc9,333,295,38,Africa,21,3480.45
75454e156c554d86afe6e216e825f840,365,355,10,Europe,19,1860.13
75460280d6314c43a5dea753cc6c26e8,95,45,50,Europe,24,646.14
754790a4da334efb808c58f9dbca03a2,89,41,48,South America,17,430.59
754a99b6298f44f4975fee7aaa2c42eb,139,92,47,Europe,21,554.09
754aa39d91864f538285daa95ae03aef,59,41,18,Africa,20,401.77
754ad7086f8841ab8531583c5666541c,75,41,34,Oceania,17,582.59
754bcedc539f4d5d907bdfa9f5ed5139,139,111,28,Europe,18,763.67
754d882256ff43018c7649c117696b9c,249,222,27,Europe,22,1431.26
754dbca7b7ac452f873c9c96248c665e,247,189,58,North America,23,1257.11
754e01b82dae403b8cf6882df0548746,129,99,30,North America,22,1026.19
754f07e8d1e74583bf52568421192de9,265,240,25,Europe,22,1697.15
7550c8fbd7cd45ec837bf9cc0457fa67,338,297,41,Europe,24,2010.07
7551f747c7fc48939097c6b989cd6dba,330,282,48,Europe,18,1535.09
7554a52ce47145c1ab078385bc6fc3a2,245,223,22,North America,15,1536.19
75587e5fa4ca409a8990e18ed2a48df8,363,342,21,Europe,17,3150.39
755882a485ca4c1f89fa98546f882fff,365,335,30,Asia,20,1768.47
7558d6ce7a8948e19d2e933a2eb22cf2,142,86,56,Oceania,26,966.99
7559077050e04603b2749bf59bb74fe1,305,278,27,Europe,24,2452.04
75596fa7011b4e7196f4fa4ebf83291d,177,153,24,South America,16,824.47
755a35473a0b43258f4414f397db80e3,365,338,27,Asia,18,2045.25
755b1b5eda594857b7bf0f468d6ede2b,120,88,32,South America,27,895.6
755b4536c97e4ad7a236b4a736a32b4c,109,72,37,Asia,25,418
755c178504e949e9817f0d60e37af333,114,61,53,Africa,18,538.75
755c1c9c8ed14ef5b6d88a03d63aecba,156,117,39,Oceania,18,922.26
755f0fba67854db1ad81aa2969a5f6e4,272,225,47,North America,21,1283.01
755f8f217d7441ea9ea1b2a4b4235a53,334,312,22,Europe,28,2875.1
7561eb2a83c8477385de235fc629af24,136,85,51,Asia,21,1082.45
75623c8a7cfc45c38ad2307b9ff36498,301,265,36,South America,22,2102.22
7565bc9bafe442cc8f24f81a094545a5,282,248,34,Africa,22,1672.45
756b669481da4c60861b2fc4f7d30f8f,308,257,51,South America,19,1099.39
756d0c0dee774342b9ce10da804d87e3,286,256,30,North America,25,2310.94
756e9970206a4adaa119d63e0fdf4045,146,133,13,Oceania,20,1294.69
75700ec0296447748f48c64ed86504a3,229,174,55,Oceania,17,1035.2
757189eea4754ce4a063efaa8f31da34,70,33,37,South America,21,513.99
757340a1f03f48628ae7eac02106e90c,364,343,21,Europe,18,1515.55
75749e6a52c146d1a50c39e4a0018efd,150,118,32,North America,23,1003.46
7576f96b1749488584428176291ea640,36,6,30,Africa,18,28.91
75794aac08764147a4ec2f92e9ad340e,365,348,17,South America,20,2242.33
757be2125b8148ec9a952a1a022b7a20,365,365,0,North America,17,2810.02
757c43a9105e4c03b9cf1c1faa855b9f,277,225,52,South America,20,1641.22
757cb64c2d804ce98acfbaf546369b95,211,182,29,South America,16,1114.62
757e8b607c674842a52ca64a500ba409,264,232,32,Asia,20,1928.44
757eb638735e4865aca6388841f6a16f,213,173,40,Europe,24,1421.77
7580ceacff3c4a189858c512dff2f76a,208,173,35,North America,19,1782.62
7581b1f5b8b24bbb98521a4b319c9581,53,8,45,North America,21,223.72
7583c2576f4749a1af3bf8631350ea5c,88,36,52,Africa,26,420.02
7585830ae25b4e7ba0d23ac25ef90e58,232,197,35,Africa,26,1487.84
758646bf14af42218605b8e1ca33e66a,221,169,52,Europe,18,1188.34
7587041ef20741e396570619858dff7c,69,19,50,North America,24,397.54
758714d2af9b483d804cfaf9172cc35c,130,80,50,North America,20,605.83
7588324401314898ab065436980785b2,115,69,46,Europe,18,750.87
7588c78478b940b1bd15dd362cdb4364,334,301,33,North America,16,2537.3
758a50824b5a4166baf047947625ed02,313,272,41,Asia,22,1989.53
758b99b30f474c33a9b315f126ababe4,131,92,39,Oceania,22,586.35
758ffdf62dc1434c89cb64b1440eed03,363,356,7,Oceania,24,1404.39
7592f9a45f6e4a58a4038d98e7ea044e,257,232,25,Africa,18,2133.08
75976edbd9de44b2839a434a6e8c10d2,285,255,30,Asia,23,1883.4
7597bfd33f064a26b43e02ca7b97fa11,217,186,31,North America,17,1494.26
75994c9926ff406dbd9a2bdd22957aef,36,17,19,Oceania,18,172.57
759aadb522d345b8ba15fcdab3980c38,135,90,45,Asia,22,958.96
759b96e582da401082b39927b00df305,147,121,26,Europe,18,1512.73
759bf3a1fc2d487580484e0eb56453ee,296,276,20,Africa,21,2441.61
759c0c2e2e204c89953ec4b015de97f7,269,215,54,Africa,22,1463.18
759c569fa27b4c2293166adf467458ab,330,278,52,Africa,26,1946.92
759cc0d61dcc40ad93f9b55b07b88c9d,137,110,27,Africa,22,1217.48
759ccf2c169841cfacad2b218d89f5ec,253,213,40,Europe,24,1656.95
759d3510cd1f4eedb8bd77d9318adf9d,318,290,28,Oceania,20,2523.22
759d7929b05047bbb3d69db6fd323952,127,73,54,Europe,17,699.15
759e742da1834131855ba67ddc64adc0,147,100,47,Asia,19,915.12
759ea59d55e0412ca9afd35ab09525a4,240,206,34,Asia,18,1692.35
759f1957a99043ee8727e43f89c9fb09,132,113,19,Oceania,17,666.53
75a05d6a328c4ac988d6485d75208749,47,19,28,Africa,24,328.94
75a17093306947b2bd615eacbae4c309,208,174,34,Asia,18,1111.77
75a297368c494c8ea6a98044dc2e553a,364,338,26,Asia,20,1955.74
75a2d68d58414a5baab649a483d9a2b1,308,285,23,Oceania,22,1891.61
75a3e96f16b7407689643d94c09b32f6,167,132,35,Europe,23,1418.14
75a5888c5b40424d91efcb246c45cf02,150,113,37,Europe,23,1070.58
75a9dcb1a0ee46eda90126f68d2daa9e,365,361,4,South America,23,1402.86
75ac31f47ca34bd08f4205b7a5494c3e,104,83,21,North America,22,745.55
75af2399a3954ccab817d088efa4f11b,132,86,46,Africa,28,516.84
75b6619c01fa49269390ed4113f7a06c,365,363,2,South America,21,1363.14
75b7ad8c79ec4aa8be971a7fa52e0c71,83,58,25,Asia,13,640.64
75b7e812b5ce4726a212350cf16d6f80,205,157,48,Africa,24,1047.39
75b93d24a9514a32a537f20dd5543bd9,219,162,57,South America,17,895.69
75b9446f766e4a038c54a0f944a92093,302,253,49,Africa,12,1432.09
75bf26a7ef0849229d4ed36db770e88f,329,297,32,Asia,20,2339.93
75bf5706b97b4e5c94c07a7e32b3b2ed,318,278,40,Asia,16,1926.12
75bf7c7215e747c1a400b0bdfa26e14d,186,140,46,North America,18,1154.6
75c033e996794df5b593ee67cc84acc2,56,8,48,Europe,15,259.43
75c061b2a4e84f20a8b463866a250d63,302,252,50,Europe,17,1176.4
75c07451d47146a6bc0e0dd7a76ed264,316,274,42,Oceania,21,2056.21
75c3cb47d2e949e7895cf5f904cb3290,107,83,24,Oceania,19,815
75c41f5bb2cd4ef397ae385afe18f24b,346,298,48,Asia,17,1382.11
75c50d6be2094e4b831bbe744509887a,104,51,53,Asia,16,420.99
75c5bd5b77fb478ca8d2b909e1e183e5,123,90,33,South America,21,1261.69
75c5e99a84494e1aad49c36286920bed,107,51,56,Oceania,18,664.94
75c628e474f341b4bf53a63afdc6e18f,116,83,33,South America,25,474.13
75c88a7038d149cc938b62748bfd12b8,365,348,17,North America,24,2512.28
75c941af08ab4f24a864c9c0e861dc8e,242,214,28,South America,14,1443.26
75ca4b7913f24a2caf44a2ddf2512a2d,296,253,43,Oceania,20,1913.28
75cbcab7054445e684f766e6c730df41,325,306,19,North America,23,1851.48
75ccd6c31f694b28a26a04ba9491e4eb,274,219,55,South America,22,1964.18
75cf75d37d994961b3e8243dd8be74f7,249,207,42,Asia,20,1706.71
75d17f058627442eb3d02b9ecb06621f,79,33,46,South America,20,204.88
75d24c73d07445b8bf8b0c4621fbcc6b,313,282,31,Africa,20,2178.03
75d34f41353b4f8c813b177217237cf8,249,222,27,North America,25,1933.04
75d3c4321d63493d9aa4d2ce2e4de418,364,311,53,Africa,20,2057.5
75d502cbe6ab4ef4aca83bc12e8baea3,260,209,51,North America,23,1285.43
75d5775c3d714d3f8ab27ac2a4c0b9c8,249,200,49,North America,16,1153.41
75d651fdc0bb4c598187b3b5394827e7,345,301,44,Asia,19,1929.82
75d6dd4b357d4d749b27cc8ac04e3337,137,116,21,Asia,18,1354.62
75da480af3cc4d678bf149448e639676,225,189,36,Europe,24,1505.55
75dcf2394d1448afae5579fa97ba1516,310,267,43,Oceania,14,1733.28
75e026e99a424080a995cc11c36c6943,67,20,47,North America,20,98.38
75e071d680d04a278530ec2e83259b10,97,75,22,Asia,18,475.62
75e2bc24478442b6ad27fa3331886c60,119,90,29,Africa,20,1129.26
75e3255a33e947b8a60066f9f1a7b9fc,320,292,28,Africa,21,2401.78
75e4e4a5d719440f8320f173791cfbca,316,286,30,Europe,17,2038.39
75e52f44811f40eda27335315d7598af,150,118,32,Oceania,22,1123.01
75ed0c38d93640a099f941987c2a8675,82,31,51,South America,26,387.56
75f5758c596144a9875de980b87c60e4,194,136,58,North America,22,681.82
75f6364131344464819c1bc31ff532c0,365,353,12,South America,19,3197.49
75f8d5aa5ad54a748bbd6ff9e393c2c1,112,68,44,Oceania,15,822.13
75fcc90146ef4e849e7daad7429850b6,219,181,38,North America,23,1512.37
76009e9854af4d19892b1212dabc0650,53,39,14,Asia,24,427.8
76022f9ff30f4b699bd54b9a1abd57aa,251,207,44,South America,25,1251.84
76032cb4ddec405a94df3eddf6e84715,111,91,20,Asia,26,742.62
7604a96acd3747a0a84f1a0246b15cc4,356,329,27,South America,19,2404.25
7607e2a1a1ab45e6956de2c0a430ccfe,230,184,46,South America,26,827.74
760926bdd0344c2fbe8c9faf01dfa124,60,11,49,North America,23,341.41
760b9742782542eea6b748520dc53d27,259,193,66,Africa,18,963.54
760ba6924bac4e80b37cd30fd8df9591,297,272,25,North America,20,2202.72
760d1785ea964b778bb5987c69e05fc5,210,160,50,Oceania,18,944.8
76146c48c950450ea5c37366d32a77f1,198,163,35,Asia,23,1076.65
76193936da7f4ca1a8edb86132782739,182,162,20,Asia,23,1660.53
761943f393514bd38a1ac984e549c557,263,214,49,Africa,20,1438.74
761a326ee3694bcd87b2510d655fd54d,200,160,40,Asia,22,1336.9
761bb325c2ed48efb409daca793255f7,49,3,46,Africa,21,418.38
761cceca49504c1a8c1744dc5aa73f25,229,202,27,North America,25,1719.27
761f9bcb488f40328d845612a28cba48,364,309,55,Europe,21,1063.58
76218f3390f44ddb87ec91b9b942695b,57,28,29,Oceania,19,440.04
76219f19b32f449c8225fc60712ef69c,176,144,32,South America,28,1491.32
76242b97d82c45138d2dc7c7339c6f68,342,292,50,Asia,16,1469.01
7624a47549374f4ba3a578bd186a468c,248,184,64,North America,20,1534.26
7624bd6004d34c00aebcdab011ffcb09,95,49,46,South America,21,391.95
76257847e4cf4ead98498223d0282514,308,257,51,North America,18,1989.45
7626a9dfafdd423ab7bf99f418b364f6,310,263,47,South America,23,1771.08
76274654fe634b84843ea05f94ac26d8,282,243,39,North America,18,2184.96
7627b17b645743d799099c3fa0defb1d,359,321,38,Oceania,22,3184.49
76286328aa40492780209b618871a036,344,297,47,South America,17,1904.18
762f269a75ea4a748656dda6383628d6,338,298,40,Europe,24,2390.61
76315429252a4350a195397a853ba081,291,253,38,North America,19,1533.1
7631c2fe010f407ba0677b779fc73bf7,279,237,42,Europe,24,1842.24
7632ad09198343be8a046b1dbe2b5830,77,47,30,Oceania,21,611.62
7634925bb4d94f83a5909f92138b843c,62,19,43,Africa,20,271.56
76361c462b5b4b4591305bbd5a6647d4,114,73,41,Africa,14,883.03
76363ed99abe4d38b40e3e4a865b8d00,145,103,42,South America,15,968.56
7636db5df7694a60a52881415a51d3f2,126,73,53,Oceania,17,767.32
7636de565a1e4c7db22c3b1a698249b0,45,13,32,Oceania,17,119.04
7637092efff34f8bbd5cb33c487da2ac,283,246,37,South America,18,2118.72
763796be0d7d46169b1cf2358b2525d7,215,185,30,Europe,23,1719.34
76384613f0914e94a2be2932cc9e5f31,181,160,21,Europe,19,1300.78
763add4f05b04e779c9b521f365a373b,225,182,43,Africa,19,1200.18
763dc522d899407da537684aee3756cc,123,100,23,Asia,19,1271.34
76410c8c2ed1434bab51c8dc16f64505,57,20,37,Asia,21,536.97
764187b7489542e9a9062d62091f223d,26,3,23,Asia,20,165.18
7642e056686941ce95e2a093b9a521ba,163,124,39,North America,16,1164.98
7643c1e5d09f4f26b88ca7aec4d18842,175,137,38,South America,14,1390.29
76457805553b4026a06b86258eaf413c,258,206,52,North America,20,1485.86
76460533d700429ebd81eb896e83930b,63,19,44,Oceania,20,348.61
7649ca308f5b433cb7948120607b7001,321,284,37,South America,19,1850.55
764c38caac384b92a1884d263941e560,123,98,25,Oceania,24,590.27
764e308aca944cc3a3861f5be50ff252,300,253,47,Europe,20,1729.8
7650e218053f4d10baf4327be16e5150,325,279,46,Europe,21,2136.58
76512a5c7eb142a28cebd0e5f559805a,345,297,48,Europe,21,1549.08
7651715d915047719fd724d426affe14,124,82,42,Asia,23,1005.59
76533e78cc41440ca018cc69193b4aae,54,14,40,Asia,24,552.92
7653cb3a7f7d42ab83a3e6124417c1b2,241,214,27,Europe,17,2195.8
7653e49c1686422eb0a353c53248d68e,356,313,43,Europe,23,1145.38
765483f8afbd4634813dd55a1ed4709b,223,187,36,Asia,24,1126.11
7654c4e532eb415fa8b2e6e0982ef75c,51,24,27,Asia,19,303.9
76551185e25047668498c1d001cc9a53,73,25,48,North America,22,170.83
76567de7362a45b5a0a6c0fd40506301,119,82,37,Europe,19,730.22
76571a7ad3314ab09e9ca854a47ace0d,29,5,24,Africa,20,73.91
7657c8b6fdea4440acd0bbde2d44b327,327,297,30,Africa,16,2787.71
76597b9323184b13a51738174f877118,203,171,32,North America,17,1499.74
7659ef453ea04411b1732a69f48df642,231,191,40,South America,17,1992.1
765d360810ab43dcbf8b918ad4321dea,86,58,28,North America,18,927.4
765f3b3d02fb484db949f4d944346505,251,202,49,Asia,19,1296.15
765f7e95b3354d0589067e2d6ece83a1,255,221,34,South America,22,1759.18
765f8b4cefe44c3d9b5c7821d2ee45b4,78,54,24,Oceania,18,868
7660bd5ada8d45a9b77ff5e135306614,284,235,49,South America,19,1539.03
76623c7f066841c18f8ef743c1e3880d,42,15,27,Asia,21,433.57
76628182efb4404296b4de78c654c4f3,220,171,49,Africa,25,1725.28
7662dbcf5f974cbc84855ec15903d692,355,332,23,Africa,23,2086.24
7667091533064f40acc8dc0045907327,54,28,26,Europe,23,501.65
7667160911644bc5866ddee7dec72ca9,304,263,41,Europe,18,2084.43
766a4b525a7c41f492de67a65a4d4333,229,193,36,Oceania,25,1434.01
766ab30eebd0464187b95952aa37a47d,156,124,32,Oceania,25,882.17
766ac4308bf64f23a73d63956897b174,66,31,35,South America,22,381.47
766aff8580a543e587ae6f3a3fce260c,278,253,25,Asia,24,2178
766b454278634c6f84e0efc393ba7474,256,237,19,Asia,22,1899.81
766b710720c5406592c6e41fdac92f84,102,74,28,North America,20,1092.12
766d20384c48471bb62a512081e03c1f,223,180,43,Europe,21,869.09
766f0b7df9fb45878b272c9440dc4cc1,193,150,43,North America,18,1001.7
7670c268663641b0a4d912983d5c0045,324,275,49,Africa,19,898.35
76720c1b156b412f923d11dc56d1fb1f,89,49,40,Africa,20,423.37
767383c5c2f04ccb9480d2f8728815a1,312,290,22,Africa,25,2463.66
7673ba89b54e464c8b96d27e527f0b4f,312,279,33,North America,23,1870.94
7673c17bb2cd402f8848e5fc3b9eef48,334,294,40,Europe,22,1446.38
767403bb24814785b07b9916837fb363,19,2,17,Africa,22,149.91
767424bf246c4faea24cf76342b84fd6,259,234,25,North America,15,1665.44
76742c15f7a94d9daf6c3626e7b6b30f,77,38,39,Europe,20,447.32
7675a06c3c67419f878287a3b01da42d,262,208,54,Europe,25,1312.8
76775151a58e465995d9c6d9cfe543cd,322,274,48,Oceania,22,1555.82
767aa1b342204bb798bd9c9d21dd68e1,70,23,47,Oceania,21,66.65
767c45ee38334292a10f012308acdb97,89,57,32,Oceania,19,434.39
76856dac84f0491da5a6b828a3d767a2,84,46,38,Europe,22,623.35
7686196b0ed2431b9942a24eb0959e7e,216,204,12,South America,20,2148.43
7687b5f783d14479bf30ed23a2f16773,55,24,31,North America,24,673.28
768a0995ce8c4e3cb2e3b0cfa7a11f57,364,354,10,Asia,20,2135.3
768a186dec3343dabff0254ed4dd2b9c,98,56,42,South America,21,742.98
768c0ce6b1584800940943769a900f16,53,38,15,North America,22,463.77
768deddbe34a4eb292b241e138bd2e54,286,264,22,South America,22,2013.05
768ed2d7ad034f3ebe9a4ecf161f447f,274,248,26,Asia,15,1347.2
768fe67e08fc4b7e9e6aae5ffeaf2f54,101,47,54,Africa,22,194.43
7690005c5629497db5f9d2e7066f626d,142,106,36,Europe,21,825.68
7691104eae0b465792ad7b142242ceb1,364,343,21,Europe,21,2621.22
7691e939de964067bf4cac0b27355429,71,13,58,Africa,16,411.91
7693ef6a6a244517a9b8fb8d9e9cbde7,365,325,40,Asia,19,1678.83
769618049bbb4e5e9c82178a7449b002,185,156,29,South America,26,1269.18
7696275e08c74e42aaf53e200fbd9aaa,183,161,22,South America,22,1524.7
769719e399f64a74b055b093e5deba8f,348,308,40,Asia,21,2302.89
769af959b58848719509bcfdfa498b9e,149,99,50,Africa,25,830
769be2b99a6c4d28afba606c6f9815fe,197,144,53,Oceania,22,578.92
769dd93893a244f7952b49495c3ebd34,156,110,46,Asia,22,1002.98
769efa55547b474db44cb16999c33ed5,108,73,35,South America,26,867.9
76a0465d952c4f92ae7fdc8d5c48444d,287,260,27,North America,17,1582.23
76a097cd7b664f2782952ad38655bca4,338,294,44,Oceania,21,1735.5
76a59c57560140c1995045226f54ead2,210,161,49,South America,17,1152.33
76a7da7be9934d7497e90914537ff9ed,327,278,49,Asia,19,1572.5
76a852a190f243dbb6141777c8695324,272,231,41,Oceania,15,1448.57
76a93aa2a75742a6b9188da97563f988,123,71,52,Africa,19,557.23
76aa190493254b26b58fa9830369458b,138,100,38,Asia,17,1123.41
76b25b5bf2794399be32f7c0b29526be,331,273,58,Africa,20,2393.36
76b56d7913eb48d3b00f4e1d91af29a3,235,210,25,Europe,19,1859.5
76b60aecb14441c9b51cd01b6e460e4d,358,334,24,Oceania,18,3031.45
76bc966231be40048c7f8d2f9aa1a137,259,234,25,North America,23,1591.6
76c0200e37554b38af08d3e3114ead4d,173,149,24,Asia,21,1190.1
76c045cb636e442b86cca9546d3e02b2,344,291,53,North America,24,1890.31
76c11a2dc03945fb985df8aae1ffdcbd,274,231,43,Oceania,17,1118.84
76c14541051f4177b8930f6c32e169d5,70,41,29,Oceania,16,423.38
76c396a2c52748a68d0a3219b506b25d,326,279,47,Europe,23,725.32
76c6720c4f92455c860757b6e5b07e64,364,352,12,Oceania,22,2664.03
76c710fa47cc4b54b3b9fa0a4a02609e,136,97,39,Europe,21,742.81
76c82be76b854a3f8a70ad578a762378,64,21,43,Africa,18,318.45
76cb78b6d1d84168ae97158509539f6d,365,345,20,Oceania,23,1657.02
76cf1c5431334fafbe3e6032694fffcc,275,240,35,Europe,26,1747.83
76cf9b82a3784b9393fc9dbcb14140a3,295,248,47,Europe,20,1171.14
76d045cba61e4295ba11566545f270d8,68,11,57,Africa,18,668.61
76d186f1618749aaaf5d026a34ae5ef3,74,48,26,South America,24,655.18
76d3801a727b46a6aaadd48265305c04,354,313,41,Asia,16,1831.85
76d404a3118648a5bb1d887409f311ea,189,146,43,Africa,18,915.11
76d50987e76245e4b1947ec852ea1ba4,66,22,44,South America,18,708.57
76d658df22df48188a9af53bd798292a,324,299,25,South America,22,2370.65
76d6cb1791324ab9bf958d1e74da8efa,358,310,48,Oceania,18,1465.46
76d7a312f05942fbb5aa0861cd3eb91f,128,98,30,North America,23,1030.82
76d7d62628af4facaa9de7a54e4af7f0,210,181,29,Oceania,18,1613.76
76d8e5b53a8749d7992e6940d7a8cc62,361,306,55,Africa,20,1472.7
76db856041cc4125aa3a9bb7cd9c4deb,364,310,54,Asia,26,1020.4
76dcd31e93524aefb4c23dd52fe05f41,257,218,39,Europe,16,1734.66
76de118a214947449d9487d100c4a214,65,27,38,Oceania,22,681.47
76e267ecc6a54730961b514f8ce95674,323,304,19,Africa,20,3027.54
76e92e7ce82e4d8daf98fe592f2fac07,362,338,24,Asia,18,2093.93
76ea6a4817334c9298b9c4df49be131c,121,78,43,Europe,25,568.53
76eb73a61dec4135af9c600c2a51ba30,209,181,28,Asia,17,1770.6
76ec7953d4f94a28ae3088f71ee5004f,303,280,23,Europe,26,2387.77
76edac312dc24dd99e3c4ba520f62cb8,365,310,55,Africa,21,1895.08
76edbe6c1d914e8db7f18564fc5a8f1c,211,162,49,Europe,21,1172.32
76eec2403fbc4042a30ac47cf54f185d,364,362,2,South America,18,1773.16
76ef884ca7fd4f3fb214c851caf14442,170,141,29,Oceania,22,1411.02
76ef8a0ae85a4479be6845fe1e2cb5a8,281,233,48,South America,17,1607.77
76f2cd9e683a4884a6a3970ec3097328,285,236,49,Asia,22,1509.35
76f63a2448d443b1b5d07bf0ec514885,359,334,25,Oceania,23,2357.52
76f76e92fa7543469531fe4ba8f73b4b,48,16,32,Africa,18,642.49
76f835f4c93e435da9f9c0a5fe3fbc09,273,231,42,Oceania,21,1180.15
76f920b33eca405e8198d72c1f261b57,169,139,30,North America,21,1551.6
76f9cb398cf747e0a574bf5fcc9a4549,263,214,49,Africa,21,1158.52
76f9d0fb8f0e4e8d8a377ca3d02ece95,264,218,46,Oceania,22,2020.49
76faf8c42b5a4886acb35fef9cddff00,360,316,44,North America,20,1736.7
76fb392d404f4efb96e6874d9e0191f0,306,259,47,South America,20,1377.8
76fce90e404747ecb7055de28e8119f0,365,356,9,Oceania,19,2040.87
76fe17cc6b56409f83d33d97753363b3,280,233,47,South America,18,1577.12
7700b56558f1497ea3e938479e0a3c9e,201,161,40,North America,16,871.87
7700c669780a4d3a9bcbea5ca08226dc,322,295,27,North America,21,2808.16
7701f72d14824b41ab6d5328a7705481,150,111,39,Europe,14,866.48
7702491c9e5249a28926339d6e3b411b,219,170,49,Africa,23,853.09
77026346b5f746158f91b584e5728426,365,356,9,Asia,19,1904.58
770459ae429842ef8b310238c80bd758,267,213,54,South America,21,1105.63
770660ddbc144976ab9efc2a2740ca26,31,7,24,Africa,22,188.17
77068be4cba741ccb57b6acbb3eaffc2,67,25,42,South America,23,465.17
7708803c572049c8aeeaf6173e2dc591,80,46,34,Africa,21,575.15
7708fd9cfe5a4744b877636e296fc6e6,136,99,37,Africa,15,674.12
77099912611d496283eba7df38d057ec,314,290,24,Oceania,20,1627.33
770b5ff3e20048349d0dc9e04bc9e04e,218,170,48,Europe,22,1003.97
770b6bee484443a281c4680f97fb7919,56,34,22,Africa,20,288.32
770dc93f8c694e849cf9620913bf6a38,182,143,39,Europe,22,1332.61
770f51d0f1d048fe9058727264782dc1,147,100,47,Europe,17,904.24
7710bdbdaea94679a99ba89338b7b9a7,211,182,29,Asia,17,1189.55
77114858f2a94afeae6d1412f9665d43,201,175,26,South America,24,1436.25
771214e8f8fb4affb80b2e1cb349dd3a,104,65,39,North America,21,726.38
7712f8a5bba943979d1f41090e5f4740,329,276,53,South America,21,1836.25
7715430efafd4e248b3931d1539e9780,364,323,41,Africa,16,1656.85
7715fac2efbe4a92a739a4f0828479bc,92,40,52,Europe,19,587.88
771c2ba1221a4396980082c3a7e169e3,42,2,40,South America,21,266.65
771c3888fe2a49459855ef4267038dae,332,306,26,Europe,21,2426.24
771dad21946a46e4a4742aaca0eed112,264,212,52,Europe,22,2351.96
77208b0169c544388ca15049bed01f27,307,243,64,South America,21,1692.5
7722c3ec18264323a374b2316d8a916d,238,189,49,North America,23,1370.58
77236b95f632411091197aafbae13dc8,29,10,19,Oceania,22,224.46
77239706a58d47a183711ec02fd694d0,119,65,54,Oceania,19,585.86
7725816fd9de49b9a8fb42064e867913,84,35,49,Europe,19,351.62
77262c02e49c48a68223a0d2e708601c,212,161,51,Europe,25,874.93
7727db9cb0904491921dbfe602507105,362,351,11,South America,21,2707.4
7728dde2c4b04f638398629ab4f3637f,187,138,49,South America,21,1029.28
77291228fb68470a8a93fe95bd1701e7,330,286,44,South America,14,2404.89
772927aa5f2d4ff3ab5442e39a576e0a,105,54,51,South America,22,436.41
77311deb21a042c38e489b3d822076c1,184,141,43,South America,17,1420.88
77312f1a55a4484ab23ecb3653f2a267,144,117,27,Europe,22,885.86
77319984c42f46f3bafb61cd611fe67f,308,277,31,Africa,26,2301.61
77345136bef04af69f7cabc8d56b0c42,299,263,36,Asia,21,1673.59
77345cf13e37473c92af53668dc19a3a,71,39,32,Africa,21,592.16
7735dd1ed268476abf02d6456f384b23,144,102,42,Oceania,20,452
7735e314d22a4d43ab67448fc83bc3c2,86,37,49,South America,20,768.38
7736248a98044a2981f9353b7115aebd,127,81,46,South America,21,548.13
773789f58b28499883b40fc47b9b3d8b,59,25,34,Africa,20,249.77
7738d32ac4cc4a4da7500542e441795f,94,57,37,Africa,22,1095.95
773dc0cc07df40d491af05550f6cf445,363,326,37,North America,18,2916.68
773e033fc64641ea93687b0c124fbb57,95,55,40,South America,19,309.77
773e34dc7618469583bb6b6343ebb026,116,103,13,Africa,22,1113.52
7741b9573d0248f2adddcfda64b1d903,362,333,29,North America,21,2191.96
77430e0a70c8468bbfd7ee826a5354f3,364,340,24,Asia,17,1625.85
774315b8ad61490ea00ea93d1031caad,112,83,29,North America,18,1287.61
7744a147980f47c996a7869155bc2e50,338,301,37,North America,20,1320.1
77479708c5034e9b8ab01beceb1ab91e,344,304,40,South America,20,1779.38
7748f91792b74b49b19a487ff27e0749,205,163,42,Africa,21,891.22
774a816f15664ad8809db19206e22b8a,226,173,53,Asia,21,1121.49
774aedd0d143496a88e9e3f8d37ff2c6,306,258,48,Asia,19,1483.27
774da7b986f8436387058993eaeed7a1,278,229,49,North America,20,1618.62
774ebe5401504c0f915f5654f03b3b0b,308,259,49,Europe,18,2009.99
774f0a3d8d77473ea6c8bb16ba176915,246,200,46,Africa,22,1243.43
774f6ba4f5a547ba87626cb6fcd46a22,147,103,44,Oceania,23,1037.2
7751ac1ee18248c7874baf0872d9a451,189,139,50,South America,14,1215.52
77543eab8a9549f199d759de3ee8fe39,76,31,45,South America,21,632.35
7759831641b047678542bc19fff4731c,289,253,36,Oceania,24,1775.22
775a9acef6bc452a94f76ea1cf435503,66,33,33,Asia,29,447.13
775ab70a23444c99ba3cc5211db137e1,365,334,31,South America,20,2525.14
775c43ac5edc4d5497ffd72a0dcdf37b,349,306,43,North America,21,2059.9
775da94afd0844b79e74021e4ac01733,182,161,21,Asia,20,767.73
7760a5cf9f644424987611b0ef0f2a77,365,353,12,North America,24,2642.34
7762c7a54dff41aeb6dd8afeaed6c1b2,297,257,40,South America,18,2344.19
7762ece49a3d4bd8b805fcbbb470c179,72,19,53,South America,23,375.29
77633c10041f43a9a20a1dc50fb346ee,257,235,22,Africa,22,2179.33
7764c7e0890b435fb7bc283ea07306f0,295,260,35,Asia,23,2171.61
77655d529e5d4ba7874d8111b7bc35fe,224,174,50,Africa,20,1010.01
77669145fdef44649b40af52e16798bf,320,281,39,Europe,20,2797.81
7766e32b66dd47b6b468d1ae25a82586,202,161,41,Oceania,22,877.6
77672021e9504de0a0d3d57281fceccf,166,114,52,South America,18,553.45
7769706763f5417b8c897ebc019a9d3d,99,53,46,South America,20,302.09
776d97db428a41a3ad519e7f02ed4cd5,142,115,27,Africa,20,979.71
776e4ab6ef4546d8b0e7b6f87f03891f,69,13,56,South America,18,259.51
776f0382fcf44d76b230d2ff409682c6,69,32,37,Africa,22,586.72
776ff697b46849ec84458a31fadd1b57,71,52,19,Africa,18,412.88
77759751a7bd49679be0165ac146b37d,318,291,27,Africa,20,2963.15
777999f77ad144a8912b0f86f81edb78,241,195,46,Oceania,21,1357.76
7779c818ac2f4346972e33f7f1386c82,365,342,23,Oceania,17,2976.06
777b1dc500bb4dadb9526d53894f928e,285,235,50,Oceania,21,1430.09
777b88c378b2455fbe6129b13b17cecf,318,268,50,North America,21,1695.01
777d1da231a1454f8f2d8d93a3e37743,110,71,39,Oceania,21,372.57
7781479c7dbd4f49af82003648885f17,118,76,42,South America,18,822.95
7783ac86dee54443800bedaf6f2f9895,298,247,51,North America,24,1375.41
77877f8940b946da98ed33fa825da072,237,201,36,Asia,17,1198.16
7787b0b97e594558a1a7cd3ce1c57a30,231,181,50,Oceania,21,1568.07
778811ff70724e3f95d2c3d05512d7fa,126,86,40,Africa,23,929.32
7789a8a19b984a7b995f170c946ed0ab,185,134,51,Asia,18,845.15
778baf7435be4c6d90dcfb449ad32610,365,356,9,Asia,17,1882.12
778bba363d0a4917994373f4d8bf3edb,89,41,48,Oceania,18,289.12
778cba24fbc241b6bbed2fdfaac3a98b,364,342,22,Asia,19,2893.39
778deafd6b5945e98c29e73f317294b8,317,302,15,North America,24,1715.27
778f18d0f13445a3b1c84bdcd2132253,171,147,24,Africa,22,1183.44
779094bebf8941ac9b6d4b62978099c3,126,107,19,North America,23,1209.02
77909af51a0b46998ace78ff612badf1,103,76,27,South America,15,786.31
779163cb20144803a01ec9ddd5715a67,109,56,53,South America,20,521.93
779169b9527a4749bee836b1f5e65995,191,141,50,North America,25,901.51
779323face28405bbf5f38e3fac68436,121,99,22,South America,21,632.21
779464aa7d1848d9b9e9d596d1877c1a,116,80,36,Oceania,20,679.74
77967412ef3e463ba545bfe7e84a2dde,109,87,22,South America,22,846.24
779775adb906410b83a5f9b23bb6fb77,63,28,35,South America,21,240.55
77977b50ab0948acaf1235b57f8533bd,139,103,36,North America,19,743.75
7797d5f8a96c4936a4d5bc9c670350b0,269,234,35,Oceania,20,1982.87
77982594d1ab43738f89e986fab44b1d,191,138,53,Oceania,19,1099.91
77991ef0e07a43dda9bdc23f9e6a4faf,148,126,22,South America,25,1323.04
779a4ab12940487eaed87a32d6a28c3d,45,7,38,Africa,17,456.95
779bf13b4f614455b95048661865b45c,339,299,40,South America,16,2145.71
779c5e1791ed4fc28cdd759af3f36925,218,161,57,Africa,20,1307.83
779d54dacc82420a8df7aef92425f34b,237,206,31,Oceania,19,2231.25
77a0ec6f7a4e41a2a9132db8817838eb,85,58,27,Europe,25,845.78
77a12450d06141328fc909efabf1f031,89,41,48,Asia,23,250.15
77a1ca91c78d418a8ed6e5343c6037d1,274,220,54,Europe,14,1562.63
77a23b0c102c4288b1aa0515b8fe6f25,365,317,48,Oceania,13,1726.36
77a31c86cc054a1ebed9f72280f13353,181,131,50,Africa,19,903.35
77a48247c3c44a4aa03b0604ab913ac6,224,174,50,Europe,17,1201.99
77a595e375374aef986a3812cf4ea2f6,96,40,56,Oceania,18,469.31
77a5b2961d304805a78eee4e29b6d940,46,26,20,Europe,15,856.05
77a7478cd4e6452c811a2e8b639d6a17,326,276,50,Europe,20,1426.41
77a8ba510c0547ac94df9a46d0d0d741,277,256,21,Oceania,19,2588.75
77a8d6bcc3ea4fdd8d6f6c93a0df6540,270,217,53,North America,20,1401.11
77b17d3031994a7d93f39adaea136b1f,265,224,41,Europe,23,1553.88
77b1d764bc1e4ae9ba6cd07533094af1,173,141,32,Africa,23,1322.89
77b3449f9b184c0ebbd24d9f4d6d6c76,364,349,15,Oceania,30,2479.48
77b3c55321e04a9fb26860b29abea508,196,165,31,Oceania,20,1561.09
77b5959bfd8445a9ba8e4f2fceae447d,304,281,23,Europe,17,2379.01
77b636a9db3c485b8209f2049c6481ce,136,121,15,South America,19,993.9
77b88d3457fe4b3cad1352a652db9308,360,332,28,Europe,18,2393.14
77b91de976ff4845924d7f9f908d2915,211,169,42,Europe,23,1333.67
77ba0a60735b443ebacf62b50a95e792,275,250,25,North America,21,1393.74
77ba855ce72a405eabc0c18043bad4a6,62,24,38,Asia,16,390.88
77bbc16452124cdc81a911cab1bd4128,137,91,46,Africa,19,809.58
77c0a17411934aadb0cf1e17782f65a9,276,234,42,Asia,26,1325.68
77c12154795e4b5a992b95a05035ef8c,253,217,36,South America,24,2005.41
77c207e56b104523a7ae34a70303b519,64,38,26,South America,23,449.15
77c4277a469a40a4a903298c660795d1,115,90,25,South America,14,1250.28
77c470d2e2704b3d9deca22c0adbd1bf,234,178,56,Oceania,20,701.9
77c6fd4910e249a896f5eb492fb33e59,365,327,38,Europe,19,2536.11
77c72e02e84c4162ae0a73cd31a093a5,359,304,55,Europe,19,1737.94
77c870970a3f41cdb519abaa35829ff5,283,237,46,Europe,18,1631.72
77ca224d1dc4404a921151f556a4085a,18,3,15,North America,21,144.58
77ca4aaabdb449c0b8d9600f449e18b9,365,330,35,North America,23,1703.4
77cb9302cac34ded929182985610eb8a,63,27,36,Oceania,17,563.98
77ccf290be654b4b8240f2f2d1c41933,65,17,48,Africa,23,336.84
77ccfd0325bf401797f97e395349d82f,110,84,26,Oceania,17,583.71
77cd9647888d4f3aa5886932d2f67857,290,245,45,Asia,18,1903.75
77cfefd77cf449a0b0d80e1cae863d41,363,313,50,South America,17,2134.28
77d0444fd4f145cea157c2bb344f4eb2,181,137,44,Africa,23,842.86
77d20edc9c8845cba833a59fe30b0d3d,363,328,35,Africa,16,2395.11
77d2b8033f124fc78ffd651eb6c079ba,329,282,47,Oceania,21,1945.07
77d53cec596743d3afc2e2020c73f8e6,155,122,33,North America,21,1079.93
77d55b59aef541d79878cfc1e5a82f4f,187,141,46,Asia,22,1401.71
77d55c1bcc5544ccbf83e018b3c4c38f,359,316,43,Asia,19,2505.27
77d6c61d92a042428b20ede478f0df8d,255,230,25,Europe,18,2138.69
77d6d5e989de42e998bc112997e338db,177,140,37,Oceania,14,1104.6
77d6dca6552f43c685bed3b933d608d1,73,53,20,South America,19,800.8
77daddd8404647c3819b2b83d7fc9499,363,334,29,Asia,16,2066.16
77dc6d59dccc4969a3deb41a41fae747,135,107,28,Oceania,22,776.07
77e087618f76411cafa8d901c277ce14,202,175,27,Africa,19,1127.04
77f350fc7fc64e4d9574384154855dca,267,238,29,North America,24,1701.64
77f459a1b992465a887a2720a8f61ddc,133,110,23,South America,18,1098.5
77f7553b324a401e8eed7866f1a0fcfc,191,156,35,South America,18,1429.68
77f755b23592454e91406d209a4f82da,217,174,43,South America,18,1274.7
77fa4f7b19224467b47f90e39b7461bc,285,246,39,Europe,20,1792.28
77faf75a4e27491aad79291f5af356d1,353,323,30,North America,23,3184.24
77fcf4133940444faf38ef45d4b3299f,338,313,25,Africa,24,2230.68
77fd4b9278bc4d49bf4215c793ee17eb,273,247,26,North America,23,2674.47
78000d00d5bc48f4bd4c1f9be8f83c3b,207,177,30,North America,10,1546.48
7801ff2432264f54bdeb35774aa2df9b,189,171,18,Africa,25,1135.86
780302bde315496e9b70ccf7a74921d1,316,286,30,Asia,22,2193.73
78033782c9a14cafb13eaddc10816c05,249,216,33,North America,25,1537.63
780524b3c0cc4726bfdc113c16e7eeed,75,60,15,Asia,17,577.79
7805871ded4646a4844d06f16c94ae14,114,64,50,Europe,18,689.16
7806f9491b504d2ca6a6fc31d33ab905,352,330,22,Asia,21,1731.84
7807100f8a31460e9885f143b1221e43,108,65,43,South America,23,501.12
78072d6ce9594465b8b7075a6fef323a,195,146,49,North America,20,1093.88
7808a62c85174ad6ab52fa128741753e,245,192,53,Europe,20,1584.03
780909cce9f4414693836743d35872f1,255,234,21,Africa,19,1857.71
780a23aa9f0240f0a7f3bf3ab5abc25f,37,8,29,South America,18,224.09
780accda3ec9472194494a1b2bc2cdc8,265,216,49,Africa,18,1033.29
780ae1e575294ee8855538c96fc0f1cb,255,230,25,North America,18,1965.03
780cd6b70c964fc7b53318ada6bdae5c,49,17,32,Europe,21,163.32
7811aca4c21f478883f2516de8ce2281,365,360,5,Oceania,25,1763.71
78125c909e9441e4b5c96277f732a7a2,342,293,49,Africa,18,1575.29
7813179cc62441dea86d2081b49b0bf6,355,295,60,Africa,20,1440.45
7814907e08e84fe6ada1bead2515a537,164,126,38,Oceania,28,1267.67
7814fe93ac36408e8ee1f2139c2f823f,250,225,25,Asia,15,2183.74
78151c7996334a8e88cf0e49ec896e6a,46,21,25,Oceania,20,176.86
7816b981cc5442fba1e1111ff92852aa,281,228,53,North America,18,1173.61
78177bdfde4f41f58858bca46a94a120,101,76,25,North America,15,445.8
7817e65702ca4ec084aa525c4318c1d7,354,335,19,Africa,23,3765.03
7818c327cb4a43ab9694b04b3334c504,238,218,20,South America,16,2406.42
781a66c4dc3b41a194f80ce8647c13da,293,261,32,Asia,23,1949.72
781ae023cb104b29ad8676e309806f1f,125,97,28,Europe,19,1029.84
781b8b8917664edf83a50a922ea484ba,363,356,7,Asia,21,2600.73
781ce731cea643e0933fa50c13901a3f,162,111,51,Oceania,18,1169.75
781d7b0aae0e474eaf74029812158a2b,158,123,35,North America,16,403.11
781de374e1274bc1b782f9039054d4fc,214,176,38,Africa,16,1234.48
781e485ce9124b95be5b42bc9afae84b,153,102,51,Oceania,18,530.95
781f7466a15a41ab9546e34d4bd2e776,311,269,42,South America,19,1710.34
78202d1b7e7946dc9d9958f669f88bd0,362,319,43,Europe,20,2917.66
782321dbab3e4de3bde3037739e36ac4,116,83,33,Asia,18,825.13
78272abc605e4582b92747ca86225252,339,310,29,Oceania,23,2555.27
782b496bbf2f4c4ca20f9f2c1b006f7b,105,75,30,Asia,20,1086.23
782b9c3812204415b48b87ab2395c3a5,237,215,22,South America,21,1971.86
782e47893fe244bfbda9a048b12d15fb,306,272,34,North America,20,2474.83
782ee7342acf4e8cb916914aa16216b5,304,271,33,Oceania,20,2069.74
782f4c2e2641465bb48ae439f7d0a79f,103,54,49,Asia,20,401.02
782fc369b5b44f2c9514cf2d422b3abb,49,20,29,Africa,15,199.15
783185053ebe4ab4a1ec7853ea2b156f,199,172,27,Africa,25,1634.82
7831dd21e38e4f05a7799459fef4dc27,153,118,35,South America,19,1290.13
78334301579341fb8f6bd02f6e65ee5f,117,71,46,Oceania,18,865.84
78349d290957469ebc36f9ca93564389,277,252,25,Oceania,17,1846.11
783538d7a6a7480d9366807e7c1c3c54,215,188,27,Asia,21,1483.58
7836ea9c12bd4323bfaf346696914caa,151,92,59,South America,23,540.83
7837560be108482380df30eab39c72a8,287,247,40,North America,21,1913.03
7837bea35db84683bf27ee25c055b1d9,178,152,26,South America,22,1699.31
78381c7813d04e8c861663ce6e522905,325,282,43,Oceania,21,1282.27
78387f99cf82401484540e5eed172e16,314,292,22,Europe,23,2428.41
7838e5f36b084e6fbbfa820d77b203de,359,318,41,Africa,15,1875.46
783c70ebe2cc4742926469e553ba097b,188,129,59,North America,17,1005.6
783c9c682dc2437cb602e793e33a6aee,299,260,39,Africa,22,1820.9
783d40d56c5846dfb14305183ecf4036,194,170,24,Oceania,21,1469.52
783d9c3b0ea648cbbd01cf5007510bb4,278,252,26,Africa,11,2069.33
783fced431814a8fa00426cc910f50f3,308,277,31,North America,20,2676.7
784278f2e79547d8b009607a18a782e0,308,265,43,Europe,28,2218.17
7843afd9758d4fc89fe1d0d3223145c6,118,71,47,Europe,21,416.14
78465b42059f4befb0c3afb56c3708b2,37,6,31,Oceania,12,204.94
78481514ec3d4f21962982febe314bcb,119,99,20,Europe,19,949.38
784d8d6819fb42d0abc71c67331c9878,72,34,38,Europe,20,335.59
784d92ea16c7460281198384b04c6a65,188,165,23,Oceania,15,1603.07
785177f80f5e41278ed9b848d1031a9d,365,318,47,North America,24,2073.15
785207442ddd4ca28a34d123f266f0de,92,43,49,South America,15,425.32
785216c856784c40a29d5ddc64cede32,223,174,49,North America,22,849.32
78535b88a686440399091f407ac88a1c,62,20,42,Europe,17,205.89
78561d38bf364f4da6eab578cf503038,234,192,42,Asia,23,1865.26
785700738d3d407a9237dd1c14fa5622,149,99,50,Asia,22,508.25
785740671833404cb985185c5e862b8a,271,243,28,Asia,21,1835.44
7857a9626f8048179574b8405e6a291c,237,220,17,South America,24,2051.12
7857b93725de4d5aaaa045dc136a497a,123,87,36,Africa,20,699.33
78588908367e4220bba4de7ba7750638,219,193,26,Oceania,20,1357.77
785903d54d6c40b5980a1f11f359598d,361,355,6,Europe,27,1718.31
785abdc685204aabb13e9f5b060cc20b,128,74,54,Asia,21,746.25
785c7bbe2dbf496fb7a4a90460be7b7f,111,58,53,South America,15,152.7
785d3c7ce2fe45d8abf8e436aa024831,365,358,7,North America,16,2379.34
785d527320314ff59da6152a72df6d59,331,274,57,North America,24,2252.65
785e834409e24555b34726b73c6d2f84,225,189,36,North America,23,1752.14
786003ddf201417090ac9af9176710d4,162,113,49,Europe,17,741.39
78608512c5a1455589766a3e695bf0b5,217,186,31,North America,19,1163.28
786510ce4a5b4aac901a984f32c889ae,187,137,50,North America,22,1161.23
786572a030e74b738090fe0a322b6bff,352,295,57,South America,21,1488.53
78665b4bdf424f98b8deb1e6653e713c,365,335,30,Oceania,17,2887.2
78689c847558442a9646ea811dcd342f,326,289,37,South America,21,1361.14
7869747ebea6482680f8c5dbc45581ab,294,244,50,South America,19,1377.99
7869d4b041764809b03f27d8852b9334,252,220,32,South America,19,1622.41
786c65198abd4256b46cbfeee5cc1bfd,305,284,21,Asia,18,2417.28
786df6e7945e436fa9d1872630cd3b7b,316,272,44,Africa,16,2189.27
78715d6b43a14277aae04149b7ae4bf3,97,57,40,Africa,25,973.56
7872c7d754094a58bd0afeb712df4c92,73,22,51,Europe,21,513.95
78730674907c4cf3bc742215c5c8dedf,128,97,31,South America,21,1127.7
7873601e265148b49230750e56381d37,70,36,34,South America,22,437.22
78738351b74c4b34a63d1cea7a172796,158,109,49,North America,21,357.81
7874e1e83adb4af696411d4f96e1199d,89,44,45,Oceania,21,578.06
7878c05d79cf4eb5b09a11422bcd6e0b,203,166,37,Europe,25,1272.43
78791aca849b462eae620715d8d408aa,73,49,24,Africa,23,806.16
787ab352ebb54cf0aab8763e702b8e0c,125,72,53,Europe,20,450.49
787b0b03de574cb19840a2b10e49bade,168,135,33,Africa,19,836.5
787d29fa28a94c77944bf98ece8ead13,34,1,33,Oceania,21,146.68
788752bca3ee4bfa9ca48eb36df46408,362,353,9,Europe,19,2705.22
788c0fb8bb0a4d62b6046c8b152b12b0,195,158,37,Europe,21,1334.48
78905791a3a94c91be1a9e397047c77b,277,229,48,Asia,22,1429.3
7893f06d6cf14447a81b4133dd14326b,318,269,49,Asia,17,1574.32
7894fd0790a049c2b1269aa2842c8b5e,52,25,27,Europe,16,144.92
7898a95218394927af604fba7049abfa,69,35,34,Europe,18,741.98
789eab1ff03d46c2a835c4973c27ad3c,315,291,24,South America,23,1895.75
78a1ff91b8734f8cba3464f04b254075,186,152,34,Asia,25,1110.52
78a23d5412ed4b3592522336f32f10e9,167,128,39,Oceania,18,1193.13
78a2750180d64874af2ab3f308c4e1f3,141,109,32,Africa,20,1114.6
78a30ce8af134c078d60c26a60131280,276,237,39,Africa,23,1371.28
78a408be62ee4efdaf53f199402b890f,272,215,57,South America,22,1530.63
78a5836e026d4ccd9f0f2f4d3646bb70,309,272,37,Oceania,18,2020.07
78a5e548968445898efcae6c2730b285,277,238,39,Asia,18,2073.48
78a62a9253c4428ebb923ce7e4cbb5e7,175,138,37,Oceania,19,1052.38
78a6b8f69c98477fbf1fa1e556781936,28,1,27,Africa,23,88.23
78a75e7e96674765b80c6ad02dc4b50d,154,127,27,South America,16,1300.56
78aa17c1fc2e4a258ba824b0861137e2,108,76,32,Europe,20,893.78
78ad2b325be649f7bfd73b5802a437f0,43,10,33,North America,17,314.44
78afd7cd56b043a9b3f22942f4a2f98c,365,328,37,Africa,25,1499.67
78b61bc6d32c428aba574f8f50be967d,314,289,25,Asia,21,2525.02
78b644f309be4de682ba48366089171b,175,116,59,South America,23,473.49
78b7eea887aa4bed8e26657f76d7be20,176,125,51,Asia,18,817.92
78b904ee2be74ff7a2dfe0ae6cc0bfdd,359,328,31,Asia,16,3984.38
78bb6327b325438da58f8884c8f0be4f,31,9,22,South America,22,101.36
78bb983689b941289dbc2f845cfd4e67,297,266,31,Oceania,25,2169.31
78bbaa21bec94528ae0d3eac2eae090c,143,120,23,South America,18,876.32
78beea31121e4f7ca7eecb97ff019073,199,158,41,North America,14,1506
78bfa76dd17242fcbd77090ccd7d5580,147,111,36,South America,21,740.96
78c05fccf11349ff8c418cb381d7a8ca,154,113,41,Oceania,24,1339.88
78c2cdb422ed416fa045a1d5537f7b1c,286,256,30,South America,16,2346.12
78c2f85907a3485e9b1075823412ac7d,49,8,41,Asia,20,316
78c316ec3f6c4d2985291f9cc1743888,340,306,34,Europe,19,2308.38
78c3bd90f76c42249414bae9ea21e897,195,155,40,Europe,20,1255.79
78c3cf303b364f31be48962badfdbe79,365,356,9,Europe,13,1823.62
78c4bf7c0d614573a54179c1cc03a5d6,165,121,44,Africa,21,1138.21
78c5a92291f1482bb2bceb26731bc321,203,167,36,South America,18,1202.99
78c6478d573a496986518554e6aed9a8,289,267,22,Asia,24,1933.56
78c72d5326dc4291956a477b8657068a,45,3,42,Asia,17,119.48
78c7ce5a49f84702b841b7caf2cba31e,198,154,44,South America,20,1198.58
78c7d90d9a224ded9ab0bb1afb22b4b7,141,126,15,Africa,13,883.52
78ca00b83f544a82966ddb635ba5ee71,338,295,43,Oceania,19,2310.29
78ca6835f3c542029489027c29c8d0ae,204,165,39,Africa,18,1312.81
78cb10fef7cf43d0bf456963fd8809c9,203,184,19,Europe,16,1353.49
78cb872c0094420dbdaaed9b6e1cc491,166,149,17,Oceania,17,1314.11
78cc92f6954a4d8e90829276bba5181d,149,103,46,Oceania,21,532.26
78cd6271ff394893bb58c00044fec340,74,33,41,Africa,23,393.46
78ce1add7ce84a9a838740ef680c9bed,154,101,53,North America,19,657.48
78d115dc8f0f4d8c89021434637b79dc,168,153,15,Asia,16,1424.48
78d41765f2ca42caae8bd9d6801166c4,248,221,27,South America,20,2154.06
78d8561065c6431eb96d04eaa0df45fc,65,43,22,North America,25,659.34
78d8780d1a0343afae6aa078c63c08f2,280,244,36,Asia,19,1794.49
78dbd3313a4c4474b175a2a6bf3d5bb2,90,44,46,Europe,22,666.44
78dd58fa07954b038c9434fb326104cb,109,70,39,South America,20,784.58
78de9f1ef94642f7b1ad3dd4013b028c,101,68,33,South America,20,451.41
78df24f87d234d809334386ef455e7c9,271,234,37,Europe,22,2212.86
78e13fcd8f714a18b60542fd354bd8fc,268,219,49,South America,31,1627.77
78e3d4f180f544f9aea71f7c0acc1e3f,349,329,20,Europe,21,2395.58
78e44fd433ba473f987d5627a576d4db,320,294,26,South America,17,2812.91
78e78011fb0048deb4f8f25e173c6f72,349,323,26,North America,21,2703.56
78e7b0649b4e41589c2290c7ca95ae51,80,23,57,Africa,23,453.89
78eb533bea814ea095bbbd7a8c5955ac,171,152,19,Oceania,22,1404.04
78ed4070e8fb482d883beaac6765b1c5,193,150,43,Oceania,27,1100.68
78f0e3e46d004252b2c3bd0604e8842c,276,231,45,Asia,19,1560.31
78f1856973164bfeb4019bc6a1f8ca9d,23,12,11,Oceania,21,224.61
78f67ec0169245f98d900c3edeee3778,277,227,50,Europe,17,1483.72
78f7480864a84ea88dadebb925f0e2f5,297,267,30,Oceania,21,2754.09
78f797924ef84101aa28e341bed9fa52,119,81,38,Africa,18,1184.87
78fe28f92884439ca1e4b2322597f3c7,109,71,38,Asia,20,949.88
79032a2a54b540c2b6ad4b29df285e42,140,117,23,Asia,19,513.61
790661db80be41a1867760ecf86d2dfc,145,100,45,Africa,19,934.28
7906a6f69c9f4096b1bac95431ad4f3c,227,203,24,Oceania,18,2261.07
7909f6b6f998493faa57217e241cab0e,106,49,57,Asia,14,623.14
790aab0a6db14e45ac7b07f39075b7db,176,150,26,South America,19,881.82
790d73b63e1241469a2b1dff787ddd8f,139,95,44,North America,22,562.53
790f8254308447dcbeee9a410023804d,167,146,21,Europe,27,1705.26
791145e69d3b441783831496bab88c27,155,111,44,South America,20,1067.03
7911560ec177424cbdc482abb09b7c60,365,324,41,Africa,19,1993.86
7911927f00cd47d6923f83023dfdbaa4,365,346,19,Oceania,25,2581.81
7911d88cb3bb43f896da58ddb72791c8,135,95,40,North America,19,478.89
79129cef83ed4d5a969389a99af5ee42,363,328,35,South America,15,2292.44
79139154a4d043229163fcf01ab0ab3e,175,137,38,South America,18,694.57
7913c123d14248cc8fa143d941ae606b,145,124,21,South America,22,1404.67
791bfc495bb640eaaac2283c38b0e666,110,73,37,South America,19,1008.49
791c3cb3b9404c22915db1785208b800,353,327,26,North America,19,2396.78
791c954594824286a5e1135c53f6b855,272,241,31,Africa,22,1828.43
791e4e12e62841ceb386b1916f962453,359,308,51,Africa,22,1456.27
792180e2d9344d889826ff0ac77541a5,215,189,26,Oceania,22,1443.51
79221bc5fdd44a3195bc61e76321324a,72,17,55,South America,21,700.65
79229a9abbe8404e986e1c93d1b8422b,118,83,35,North America,21,644.37
79236a4d870e440fae7ab28164f5c703,346,313,33,Africa,14,3063.82
7923f2f4186a4538bf2fcae0f7ac396b,251,223,28,South America,24,2160.93
79256f7f16d34be4ab3717e873cd9995,172,154,18,South America,18,1308.3
7925b4720bd348dc87ff0c8014d73aa2,29,8,21,Europe,18,186.77
792a189b9e4545cfa86e1db3e00f157b,346,299,47,Oceania,20,2392.76
792d1d81e5484d61b6a4469626ac2faa,238,219,19,South America,22,1866.38
792f1339d194437285412c59a232f804,364,360,4,North America,22,2202.92
7930a5abadbf47b6b616b0c1f923dad0,180,155,25,Europe,24,2068.72
7931b48df7b44225a3ec4a1d237a8ffa,365,364,1,Asia,16,2049.58
79336aa8e9764cbb9a2eaa48c65b9dd8,174,148,26,Oceania,19,1351.22
7936709ec4074912912d0cd8e26fd93d,69,18,51,Oceania,19,259.48
793695d95af34a77a432ba20e57d3594,111,65,46,North America,16,353.63
793704e3b502457489049f80e7baabf0,85,52,33,North America,22,673.62
7937eda58b25478980ef13a922c96666,211,182,29,North America,25,1383.67
79386ffc74a94c0eb2dbf7a4775bac71,204,163,41,Oceania,20,827.59
7938c57053584982b9997604048c8bf8,41,4,37,Asia,23,407.77
7939b852417249e985034517ea0029cc,365,365,0,Europe,20,2068.56
793b9b46b8c0470688abf698bb9bbf63,109,61,48,South America,20,441.7
793bccc4344f4073b0223ee1854bb6e8,168,134,34,Asia,19,891.99
793de1e5f18147b18625f5ae192eac77,210,155,55,Europe,17,962.05
793f6e28ce9548e39175856d292725e3,365,359,6,Africa,19,2750.6
79402f47bd624b258deaf75fbf21f8f7,154,131,23,Africa,20,1326.7
7940e38f9e694d8b9ffc5a00dcd9dafe,148,89,59,Oceania,14,269.99
79415af78685433dba1a12401b840768,140,108,32,Europe,23,972.31
79419359d9b94254bebf0de89640c197,236,176,60,Europe,20,1148.1
79421d67051746a8953d2468d9cfbe79,59,26,33,Asia,18,496.64
794321eea39b47d2aed7d9912cb60833,88,60,28,Europe,19,705.49
79446f2e9a504529b124c523d57570f5,126,82,44,South America,23,405.95
79472749dde7485d8cc0ee5b9733a2b5,365,346,19,Africa,16,1325.93
7948a4c19ae3474e9aa373783b1c9b4f,64,42,22,Africa,21,241.48
794a43db6ce84964ab51c95f9375f972,311,292,19,North America,18,2964.27
794dfd6320b54aecb163b4b8efaddf7c,217,162,55,South America,19,1273.17
794f414e1c404f899bd5c88b9cd6246e,288,260,28,Oceania,21,2226.21
794ff2962f884e9eb23cdc01f84c2ec1,276,229,47,Asia,20,1247.91
795088f2311f44ceb2cd7ad13efed113,296,258,38,North America,20,1504.42
7952fd4a02c34008befe6004017a71d3,307,278,29,Europe,17,2379.16
79551cf723b1499d9efffded56be515c,282,244,38,Africa,19,1772.53
79561b3ccc424196a8eb0af864998519,304,285,19,Oceania,16,2366.94
79596c2f105642ddb4a2ffa7e3f6bfb1,213,170,43,Asia,24,573.93
795983024d5d4f3e8a31f808bd0c857c,336,310,26,North America,16,2649.01
795a33d883854391ae3145359032e993,334,292,42,Asia,17,1682.79
795a8af6fb63447fb80f0719e2efe0eb,191,134,57,Oceania,19,1402.08
795bf50b5d89432eaa56e209aa809f16,151,100,51,North America,16,734.84
795c6610ea104d1594fceec72ebe0d3a,72,30,42,South America,19,373.76
79601d9350214355a9de10ab1775cf94,327,287,40,South America,19,2310.86
79602e9e1b4341b0ad3114e48ecc4989,219,189,30,South America,21,1235.65
7964d9956ef842a88bbbbb4f748ac3ca,355,315,40,Asia,21,2816.48
79659e529d5e447491444162c9e8346a,192,140,52,Europe,26,869.2
796c2b3ddfea42f9a35fd16c88cef5bf,167,124,43,South America,22,940.51
796e7e0440c249d4b79afcd1ab93297c,94,67,27,South America,24,344.49
796fc0ff33784ea8bfc30ba81e795c11,26,3,23,Asia,25,407.04
796ff4e0994c45c184fe11bad67b0583,140,100,40,North America,18,1046.59
7970b13bb27e42de9bab31f0b3c14112,85,67,18,North America,17,565.56
79768cf605b0446586665d7bb85faffd,104,60,44,North America,21,297.61
797b5f559eb449c89ab5da995c62729b,290,237,53,South America,18,1712.65
797b9278cec7494e9122cdb40da22051,210,177,33,South America,18,1370.63
797bc415e4694823b44fe278d8e34113,313,263,50,Asia,22,1927.43
797cee6708a3463894fe6e2165af9618,146,124,22,Europe,20,760.29
797e26276c7645ae9d96257906435609,323,291,32,Asia,18,2141.22
797ed88bad0e4c77927897d83e80310c,219,177,42,Asia,24,1036.9
797f97a0ae964f5793c6c392a0f7a266,47,2,45,Asia,18,323.17
797fa5061c95473db38a5e76c416deec,362,354,8,South America,22,1792.23
79803ff483f9441cb40e9ad2fe841646,358,327,31,North America,27,2122.41
7980424e81ca4868a3dbb4dc9d22e46f,202,149,53,Europe,21,1161.68
79806cb2c5f6498fb53636500e83c6df,350,326,24,Africa,20,2121.88
79817123ac7b4ee2b1497f0d47ae4567,191,160,31,Europe,20,1263.34
7982ce56e671411b81607d167a01b7a2,278,262,16,Oceania,19,1757.58
79837e8595c54bd9ad5e4c8d71e27fed,283,254,29,Oceania,16,1534.65
798552aeb2754ba1b60442d63af42190,189,162,27,Europe,18,1139.21
79859b5c8f5a40e48a375f7c24f812db,148,106,42,North America,17,983.3
7985efeeec344ff9b3d8258f10cb93c2,163,105,58,Africa,19,672.02
7986c07f2cba4816911655f70a1aa745,357,334,23,Oceania,24,2436.99
798a1587804e4989902a1bedf166c4e5,361,312,49,North America,18,1588.72
798c82e5991443e9b6b94b90f8f80e50,69,19,50,North America,19,58.76
798e1436a3d44cce90f237ad176ca697,240,218,22,South America,16,2203.44
798e187a78a44bd7b84ea736194bffe8,118,61,57,Oceania,20,677.55
798e5794fd7141cb9e3dfd226e481071,212,154,58,South America,15,1143.57
799198fb71d14b3abbb50300a60b951b,201,155,46,Africa,19,811.77
79926c56625543cc98a36a7a78527d3a,365,352,13,Asia,17,1519.98
7992a8e0715f4881b005a79aef46e22b,127,71,56,Africa,18,752.14
7992d818b1a7456fa8bedd5f4552a964,296,241,55,Africa,23,907.05
799407d9a7e545d1b5a8306c61d49744,41,22,19,Africa,20,433.41
799435273c324aafbce5fec502e6adab,358,337,21,Africa,16,1797.41
79989162b67a444b9114dc862b0527a6,163,113,50,North America,14,671.44
799b13efcb2e468e8164ba8ab8ddcd3d,363,336,27,Africa,23,2427.22
799be063e8c2424994cb66fc13da99ec,190,152,38,South America,17,1286.11
799d8b14e73549a69ba69b0e89e7647c,72,26,46,North America,20,616.72
799effdbfdd8448ebf4a7417a581aff2,133,113,20,Asia,20,1181.03
79a041bb7f5045878337aac9304e4569,170,146,24,Oceania,19,1050.67
79a13190a1f448d3a5038dc8ca799731,256,234,22,Europe,25,2601.98
79a5a3775a194d5eb89cbb2251f54646,364,321,43,South America,22,2417.58
79ac84ab34be4df58ac57c517b7659e5,264,208,56,North America,20,1143.76
79ad4f00101849739a89d0145a0f80c9,88,42,46,North America,18,413.13
79ae65da71324e7e892c315f26890f30,217,166,51,North America,19,904.4
79b06ef3f88d4716b4d4f3204b6df86f,252,207,45,Asia,15,1010.61
79b0da61ec4b4e7186d11291613b4a5f,182,154,28,North America,19,1725.8
79b0ea7d26c24be687705d56d4190ea4,197,168,29,Africa,23,1027.09
79b0eee7e1144f37ba74a0f34f5992d5,137,113,24,South America,23,731.96
79b16a0bd89841cab7675351dbc51216,327,278,49,Africa,13,2059.61
79b1ce71c0bd4bc8926b3e158714bb56,34,14,20,Africa,21,201.19
79b2e58551a14d9f92f5a51f76b4e93c,308,278,30,North America,18,2433.92
79b3d09221034555a20c562503c3ef52,357,339,18,North America,21,2759.68
79b59db2213f4e22b9513adc6117d817,79,46,33,Africa,21,436.2
79b80fc20560425db3f8b31b46855483,43,23,20,Europe,28,245.69
79bb1c2c698d43d2b6c31a781fd31b6a,196,149,47,Africa,16,986.36
79bd3c17d5704dd6940438a9a8c1a153,244,189,55,Africa,18,1275.21
79bdf6d9747f4b049038541717b7df9b,305,265,40,Europe,21,2024.46
79be8e24cfa64bc1a77c272442c561fe,195,139,56,Asia,23,921.69
79bfa54cc2264b7f83eb80d25125b353,120,81,39,South America,22,753.55
79c31d1c0caa4562a592beeae8b549ce,362,315,47,Europe,17,2759.12
79c49523aec744d6b98fbdb6a8e4d93f,365,333,32,North America,23,1849.12
79c8883260c642c48a55a72b04edac87,318,292,26,North America,16,1711.2
79c910128157488bad188d3b167fc669,339,301,38,Oceania,25,2143.97
79ca7a37b35241aaa461cb4f765ffae3,330,277,53,Africa,20,1876.59
79cc3004e1bf4e128a7f035ab54466ef,344,298,46,Europe,20,1500.79
79cce311b1ac4b9db86e944e2ff4ed31,205,156,49,Asia,19,1541.59
79cf47d59e8049d291272f1c183d1779,156,107,49,Asia,24,1055.31
79cfa04141d14f3b806c1e43343aaa61,225,199,26,Europe,26,1620.49
79d21d4da137454282a6724ed2784656,275,230,45,Asia,21,1947.05
79d2910585a04aa4b20d0b023506c295,185,139,46,North America,19,1148.98
79d2a8cc6b644af89533c3094cae4f94,294,273,21,Africa,17,2735.63
79d2f9e92eb847809405ac4660a24de1,364,355,9,Asia,18,3049.37
79d40a2b956344e593cb8f94e915c189,365,361,4,Europe,14,1774.88
79d5d0b7cd944fa1963fe1001e3061e4,339,304,35,Asia,16,2495.44
79d60f5def134c6b9bf655d20bb8049b,98,51,47,Asia,18,309.32
79d674051a674dc8b757ce816dbed5fa,315,288,27,North America,18,2620.74
79daffdf758d4d92acdd432e88b7d03a,200,164,36,Africa,20,1384.83
79db88a66c6b463f94fc5c55a158ad49,191,141,50,Oceania,23,1108.14
79dbd66e12124a008771284f59d63ab8,215,180,35,Oceania,24,1823.74
79dcc4b03d514f8b820fd453cd82cc92,364,359,5,Africa,18,2614.53
79decfa2cfa94b76876530a5520a8e33,311,278,33,Europe,19,2461.41
79e218d0a76e43f5a297163aa370aad7,363,304,59,North America,18,1490.83
79e5a6dce48f467ba82f702530b0d797,365,342,23,Africa,18,2015.34
79e7fdad38834eb0a070661d83971423,95,56,39,South America,22,430.44
79e90718076a42869881f9eedf2f09dd,289,245,44,South America,23,1647.13
79e9ef6b14e04504ae70bb3567234516,333,299,34,North America,23,2034.88
79eafef0044a46619e6b90fa09d54e9f,194,138,56,Oceania,27,828.02
79ebad5ffe994cb18d7564200db18395,83,45,38,Asia,22,552.44
79ecc0f6b9f845f3811120bc380b3bf0,118,101,17,Africa,26,1164.22
79edf1b324134da689da17e519949b32,223,195,28,Africa,19,1595.89
79ef4b08c67a4156aeef83933538a9c3,20,5,15,Asia,24,210.86
79ef60e786304b2da588eeae1d76c869,344,312,32,Africa,23,2169.25
79f4a8c74c6f40fb9e91e9336b161e82,224,174,50,South America,21,1086.99
79f7f89ac56f45f29edd86dd2c1a12b6,296,246,50,North America,16,1843.39
79f83ba923e547e5b5a8e3fc4b0f1159,232,216,16,North America,18,1698.8
79fa346d36a64efca31f1ff64c0cbf68,341,319,22,Oceania,19,3190.84
79fc8f6ff74a48a283e457f574e01fe1,250,194,56,Oceania,17,1035.22
79fc96edd41946a19e808f5423031c65,154,113,41,North America,20,1140.18
79ff7acdbf844597b44c6afdf6b27828,217,167,50,North America,20,802.56
7a0148e61e844370abfed58d2ab68327,51,16,35,North America,16,365.73
7a031deb21d04393b121adf6e713bf13,272,247,25,South America,23,1630.67
7a038eb829794b1fbe4261fe84647ef0,233,196,37,Asia,22,1527.61
7a03de506a45432589872cb697c6d57b,142,100,42,Africa,16,600.73
7a04a1deda4347969017294cf73cd4ed,95,68,27,North America,19,882.71
7a0678186d5c4bb58df7382a78d493a7,363,326,37,South America,20,2430.35
7a0731e05a514a21bea95b097dac91ed,127,73,54,Asia,23,596.94
7a074c315ff84fb58d2a8eea2be65693,98,42,56,Asia,20,264.18
7a07bb527bc54c42976491ef01a43316,365,333,32,Africa,19,2346.57
7a08baf8b74546baa5389a2a95832b8c,361,359,2,North America,20,2499.3
7a09033d3c6248fd852b905b4e5afcc6,98,46,52,Africa,18,512.82
7a09307b17ed4112a29545d515a54bd2,181,151,30,Oceania,17,1203.6
7a09823cb65644c2a06bd33b09be1cb9,61,42,19,Africa,21,470.74
7a0a42064a464cf0b8393e64f8d34281,365,334,31,North America,24,2820.13
7a0a483eb0344c7c99f27a8abc4f960d,364,325,39,South America,29,3057.1
7a0c4b6fdd4646319ce027783bdbaab3,70,28,42,South America,20,518.45
7a0ca412b2244813bddf7dbbf23160ab,307,266,41,Oceania,18,1620.46
7a0fc83520ce4a2588c2e7df962bfc00,359,320,39,Oceania,20,2203.97
7a12a9470d5745ba99e8dd03dd45d7ba,365,344,21,South America,19,2874.16
7a13d4188fc54815a14f31d798a147ef,89,31,58,Asia,23,474.1
7a147970cd804d7b8997b92eda005fb6,340,316,24,Europe,16,2847.52
7a19c8284bfa4c4eae61f4947ca732bb,365,334,31,Africa,18,2400.04
7a1a1722d4a845c089bb6ceea4cde751,276,255,21,Asia,25,1552.69
7a1a43f040b14e1bbcad6d884b4e0145,277,236,41,Europe,16,2362.33
7a1a64b1201143b7b4f4ef7ca39d998c,249,231,18,North America,28,1876.01
7a1ab4e6ec834cfda4b22a4a76bc4246,188,157,31,Oceania,20,1529.96
7a1b6fc35302486c9e0e61a61d94d641,249,206,43,South America,24,1158.05
7a1be178ba414a1da495065d91f06cfc,150,122,28,Europe,18,676.51
7a1c28a0194f4d909aa9b204629816cc,342,322,20,Europe,25,2926.83
7a247b543be74fd0b86ba8b8bdc02aea,365,343,22,North America,19,2957.66
7a25d65997d54a2fbe68bc2068f3bff2,241,188,53,Africa,21,802.87
7a2798dddb364ce19022f02f36c1dbb4,242,201,41,South America,20,1790.83
7a27ef4bbffc47e4895f048b5e9ffd19,207,174,33,Oceania,22,1543.42
7a2bfef1f5a5451fba2b1d50a7bbaa15,45,1,44,South America,22,389.22
7a2d98501e974e60a168a2575e6069f2,330,295,35,North America,22,2062.18
7a30a60e7f0e427b9806718a5794a979,365,319,46,Asia,18,1297.9
7a33acf9af1c4c55949897f9f281797d,247,191,56,Africa,13,1314.72
7a34768a533c4dd1ba5970f63c2727c6,319,289,30,South America,20,1930.69
7a3a4807e269432d8e60a5a60c0110d5,280,259,21,Europe,23,1985.81
7a3a5fbc2d044333a92caddd12b9da6e,350,318,32,Asia,15,3288.92
7a3a781927144582ac37133e376b8523,341,322,19,Oceania,23,2660.09
7a3bc9e4ad834f199101aeb018afe751,95,74,21,South America,19,898.7
7a3e4cafdf6449f89d15d3207954bab3,147,97,50,Asia,27,336.06
7a4070452a604766bef11c6d0260721f,365,347,18,Europe,15,2284.52
7a44073e8f4243e184bb04491e680bfc,365,363,2,Oceania,23,2252.35
7a44499d3b5949e5952fb34cdc62b0b3,365,351,14,Asia,21,2263.01
7a458ea327e341018e654ccb3b62ab6a,178,146,32,Africa,16,1324.03
7a4737fe4a2445c19fb8b1d7f170122a,220,189,31,Africa,22,1592.75
7a4987d29f6d4c75bab483f1575e902e,102,52,50,Asia,17,787.66
7a4cbe18a3414aaab2c6850833916082,324,289,35,Africa,19,1701.72
7a5108709497474a806cd6c3b2e75735,357,307,50,Europe,21,1622.82
7a52225201be47199e95e7bb09438305,269,252,17,Asia,17,1903.22
7a5376f4d9a44a089d25df4c80667ca0,258,214,44,Oceania,23,1622.17
7a54fac2f055472fa1886c3927d997b6,269,237,32,Europe,19,2313.96
7a55fd8f24504bee9ef4d024824aa7ee,284,226,58,South America,20,1284.91
7a56770998dc4454aba1fa47ca12cc38,324,279,45,Oceania,19,1355.02
7a57729ff1bb4ecbb1cd37ab4f8f9dfb,293,266,27,North America,16,2271.19
7a591449939e4d89b2698da3e641660b,237,191,46,Asia,15,861.1
7a5951fe300d47c7a4e04d3102c60256,164,111,53,Africa,18,1523.75
7a5a57e57d5a4b7d93eb72ea6ec30c49,249,221,28,Europe,19,2128.59
7a5b161ab2194641880a3fc059c2c465,253,221,32,Oceania,27,1518.88
7a5b39e1592d48a0bef100a19e43fe82,347,288,59,South America,23,1541.69
7a5f6bbfe6b6422eac1a8d651dd71a43,95,52,43,Europe,22,668.02
7a618c4f63e94a8e9c01e404d8194e0f,269,251,18,South America,18,2347.06
7a61b0ebe4cb4bef90fb99351819b790,228,207,21,Asia,18,2011.25
7a6537b3803f494782db5957df55284e,339,292,47,Oceania,26,1481.51
7a663dac830b4e73a605b05735acb885,178,148,30,South America,24,1464.6
7a6720d343c7407d93b67c9d6c077e16,87,42,45,Africa,15,662.49
7a67915b9edd4d7d870cd2ec92437a3c,248,202,46,Oceania,19,2041.78
7a693845c768449a968b10eec6860e17,157,115,42,Asia,23,877.22
7a6a17293a294c78839824bc4ea451d3,298,258,40,Africa,20,1852.12
7a6a22839a77499e934ff8054061de53,351,319,32,Oceania,16,2215.04
7a6b42f73bc04848a0fff7f2a3b119f4,87,36,51,Asia,19,481.41
7a6ef8efdd1641c6a065b4e7912904fa,53,6,47,Europe,16,218.76
7a709d839d5d4b77a981b7e29bee15ab,336,310,26,Europe,15,2681.08
7a71a84d3ff54b02b4b730e5d77c2901,365,323,42,Asia,17,1825.49
7a7231ec4e3743c183a9a488148cc7ab,172,134,38,Asia,16,1549.48
7a73906c72aa4847892cd7f35c81e956,94,53,41,North America,21,849.01
7a73a1eeb95f4e63a195c6516ec512cd,267,234,33,South America,15,1787.67
7a73a592c52446dd9c5bcc32ca15c874,365,331,34,South America,18,2533.25
7a7671aadd5746c7bcdf1dae1ff108d3,365,360,5,Africa,19,2576.21
7a76c78c73cb41e78f815778faac45e2,52,20,32,Asia,19,401.22
7a771154f41846d79187cd27ee397306,365,356,9,Asia,14,2431.44
7a77ab50146c473482c878bc593b81bd,316,280,36,Oceania,17,1871.41
7a77bf8291d54d6e83d0df7f828f1bce,79,49,30,Africa,16,565.87
7a77c8bb1a1149ea95b206b9ece7138d,287,256,31,Oceania,22,2680.83
7a78745b5f7e428c878783450f3280b4,197,170,27,Africa,27,1724.12
7a78e7d3de3a4f548c40f9454dffcb6d,116,92,24,Africa,27,701.05
7a79761e53494fae8b4aeb96f47e8742,47,22,25,South America,23,457.98
7a7b81aa2a4e4c39b1065989d67fb48d,229,204,25,Asia,19,1060.55
7a7be75158924248b4e13fc6a47e3c3c,365,338,27,North America,19,2414.49
7a7d3b52dfd64679a217f8a863035c69,365,327,38,North America,19,1766.1
7a7e090cb7bf4bb5acc1312af7255f52,46,15,31,Africa,20,463.54
7a7edc5259b24405982b666a3946e26f,213,189,24,South America,19,1397.51
7a7f48689b094ca6ab2cb2b4930ebc8f,207,167,40,Asia,20,1081.3
7a80b4a193bd4d82b082bba392a723a9,364,358,6,South America,18,2221.4
7a8657c8206643d6b30553d4d6cb21f5,137,91,46,North America,17,917.43
7a8a19e4a3954aba9e278ea8713bee12,329,304,25,North America,25,2700.71
7a8f3e4414d743e2959b7e611ededff3,178,145,33,Asia,15,1024.31
7a9259825bfd49ea90af72aae3f92847,49,18,31,Oceania,24,219.2
7a9806f9cba94c4aa4552e86b7a82ca1,217,190,27,Asia,18,1745.97
7a989d97326e4b58aaa8f9958392a7bf,365,336,29,Europe,19,2095.97
7a99c0f96a614c63806f1fe03f1b561e,82,56,26,South America,24,622.17
7a99ee8184d3430b9dccb64a7256efdc,184,155,29,Asia,23,1364.46
7a9bdac163b843cf88e9fc8d1209fa9b,237,181,56,North America,25,469.91
7a9c97c4db924a839cf0e3332aa9b67d,365,321,44,Oceania,17,2068.76
7a9d08639cdd484883941749e5ce7a9b,365,339,26,Africa,24,2308.02
7a9d3aad42cf42b4aaaf8da690f2838a,151,121,30,North America,23,839.59
7aa3ca34fff14b2f933242d3c5a804f6,33,3,30,Europe,21,70.11
7aa448190e0c4198802b09768a3b4cb1,364,360,4,Asia,21,2585.03
7aa52509f0de4a0995803d75731889a5,49,17,32,Oceania,18,442.73
7aa5fb9044c84b25ae77a347d6a61868,199,161,38,Oceania,19,1353.98
7aa9d2ab79a641cb8bfd3dfb3f269473,78,48,30,Oceania,18,821.3
7aadf02efee94d0683667165ad43cc19,320,282,38,Asia,22,2038.89
7aaf7f7848654fdb99f83dd8d0c6cd44,230,213,17,Asia,25,2022.14
7ab0f083a032466aa3f86ff1c5f54534,226,200,26,Asia,13,1594.24
7ab122e9bd284342b1030fbca8a594f0,256,213,43,Oceania,17,1508.62
7ab1400193034e08a8a9b311dc047876,122,89,33,North America,20,1103.63
7ab1fc113e0a4f1284de84c538ab627a,287,270,17,Oceania,20,2346.03
7ab2287bd8274df6be2b252ec090c42b,122,76,46,Europe,20,563.68
7ab41952d81442878c96684859517c2f,125,83,42,Asia,20,937.74
7ab5e6bd1f2647daaa9815ba402181b8,358,331,27,Africa,19,2744.12
7ab63ad889d94f3882023e4c0f399005,120,65,55,South America,16,575.03
7ab72bd08e554c5ea2c82202745a8c68,246,209,37,Africa,23,2057.61
7ab761ddb9974b76ba0e40f324f48e00,98,69,29,Europe,23,478.54
7ab8b5a772354ee6b59477a2964b3f72,58,10,48,Europe,22,154.49
7ab927d2e023482f8e19503a1c6a0fde,230,205,25,Asia,19,1680.01
7aba0b907df34e4083a2a1e9457781ad,154,117,37,Africa,17,916.65
7abb36bb263f4bdeba83662788a5ea40,161,125,36,Asia,20,1241.37
7abc2d58bdf2487b8f652137333be423,352,333,19,Asia,18,3540.84
7abe763047974e639d482636dde8a33c,280,248,32,North America,22,2532.91
7ac26a63ed9744faa8e3bcc9fa844ff5,164,134,30,Asia,20,1337.87
7ac3551544734a97b32125c5a6dce5d3,63,16,47,Europe,24,317.39
7ac4751fa3d849619bf8fed1b2360fe6,272,224,48,South America,17,1354.54
7ac559281e8348caba1e6c8dc65d903f,318,295,23,Oceania,18,2768.76
7ac5a56a7e5d45e5bdafc056a8e226fa,95,45,50,Africa,27,590.31
7ac5a9944cf6474c815c6eb79da4d52e,180,129,51,Europe,19,1037.24
7ac6ef7c0a39431d94f75ee669d8ef66,101,73,28,South America,16,769.42
7ac9606326854e63b88df27f6dd13181,254,218,36,Africa,17,1351.69
7ac9ef7e871242669831a06557e1fcfe,102,91,11,Oceania,18,634.94
7acbb00cf71e4077b21f05eeb46eb307,365,328,37,Europe,20,1586.19
7acbd452b4a04bfc8bfdf00b10a841df,193,168,25,Asia,16,1697.16
7acd868c3ccf41108bc20cdf4fe88627,46,15,31,South America,17,366.81
7acd8ee7f4f84b4291a4d8063c246ced,352,326,26,South America,10,2148.02
7acda67239f641aca118963c2d7739ee,326,272,54,South America,20,1455.78
7ace1ce049d24c53a6d75077eb75de84,274,242,32,Asia,24,1820.41
7ace862085454313816ed7159271858e,340,310,30,Oceania,19,2285.8
7ad207f4cfc24b41891ab7c8394002cb,178,151,27,North America,17,1647.55
7ad2e2ac5a5c494eb21610b64a2bbb4e,84,31,53,Europe,22,485.16
7ad487f2d0a047a69390e6c9837c9acb,97,73,24,Africa,21,1042.26
7ad7322e437c474d8eb5e992915219c4,365,355,10,Africa,25,2644.29
7ada633640a34034b84ee6e24cbb5f17,91,65,26,North America,20,364.86
7adabcea931d4094a62b18afcb16af7e,256,213,43,Africa,21,1598.63
7adad3b627bc40a68e4edb446b9c2c00,150,91,59,Africa,16,426.25
7adc834b784d43409b5f3f1e326e61aa,276,255,21,Oceania,17,2430.9
7adc932ad7254391971b58c87925ddff,363,315,48,North America,27,2132.25
7adcac261afb406db62b4fecd16ed498,266,224,42,Oceania,16,1195.3
7add168f8cdf4a05995ecc3ac4ed6fa5,40,8,32,Europe,20,224.18
7add25acb4c8480892e86860a31bbf90,365,336,29,North America,24,2350.02
7add2acb0386473e8e62b27f0e2f33c9,130,105,25,South America,15,476.93
7adef570a91c47c4b04b87bef693c960,108,77,31,Europe,18,698.17
7adf0ca5d2b8434b9059277b021987e1,189,142,47,Asia,17,1180.98
7adf84bffa6a47f5a7ad6b5111ad3a4b,210,165,45,Asia,23,1278.31
7ae1f72c9a55448a8d6ab737912c2254,175,126,49,Asia,16,712.97
7ae2bfa8c6974f3d9b0449e3cade6c3b,364,337,27,Oceania,23,1663.48
7ae375063a3f4ac38fd9cf6ea2e547c4,131,76,55,Africa,20,576.63
7ae3ad7236a249a7b91643ce239ec54f,146,103,43,Europe,19,818.1
7ae3ec94a42c41be9b804b0b40bdb964,237,195,42,North America,18,1508.2
7ae60ed66cb243468234ac3c763d9937,359,328,31,Asia,16,3123
7ae77541d3554bd8b6dfdcde95bc594e,237,187,50,North America,22,851.62
7aeb14f023a644fbb07106361916273d,306,267,39,South America,16,2156.38
7aeedc7b95234b9480a9498e6432ed72,141,98,43,South America,16,740.98
7aefce857e334fdebc0d5f3cc16b459e,191,150,41,Africa,19,1204.4
7af0e04dba7a4719aa2741728d3eefb9,365,358,7,Europe,19,2264.81
7af2a90d27354e56875d94562ee13066,333,282,51,Asia,23,1760.56
7af3c2b87d0a4af1be1f22f39c0c8358,227,203,24,Asia,19,1709.1
7af6c5a9f9d043be959bb470eac4f2cc,307,284,23,South America,20,2257.52
7afb01611aee4b2cb9deaae850a23803,73,37,36,South America,20,492.07
7afc261aa51d434495a49305a5eeab9c,347,318,29,Africa,16,2473.95
7afd068d21904905b34431241867a7eb,65,19,46,South America,24,271.33
7afed2aa253645f5a21f26c5ebe66b27,320,291,29,Asia,17,1850.53
7b03ce2550c34912a8ca71d687bcac64,315,268,47,North America,21,1688.04
7b0906fdfef347d389211c012374e344,268,225,43,South America,20,2170.54
7b0a0141b6154ed8a046f49b8610b95a,136,91,45,North America,13,889.43
7b0aa91002f2424ba5b4ccb43eb12694,52,25,27,North America,18,473.48
7b0c85b3c4d9422f99962b6b065dea9f,266,214,52,Europe,29,1066.03
7b0d32ce6f86413bb95635bf3e71d087,208,188,20,Asia,17,1959.5
7b0fdd8741c84d85a138632d85cabeee,102,76,26,Europe,20,1121.5
7b102600dfa84727b2d302821c2712cf,182,130,52,North America,18,552.73
7b12c61a2cef4ef1b35e4c78b4480cf0,177,135,42,Europe,18,1024.7
7b151df26d2a40eaa2e47b609564194f,305,275,30,North America,24,2232.03
7b19811820334c04ae1f591abdb1fa1c,111,72,39,Asia,19,1086.09
7b19ac31af2849e0b1708d59ca51b0e2,186,158,28,North America,22,1297.55
7b1a32ae386445b1bcf42674cb6eff6b,314,292,22,South America,23,2538.55
7b1d53e5341945b8a1e06b88becb4652,113,62,51,North America,24,465.76
7b1e0d0892804703a9e5363b43f89154,363,315,48,Oceania,18,1324.53
7b1ee3b2dad94632b6e3a07d393633b6,264,238,26,Asia,17,2689.43
7b1efaf7d41f4df2967e5e85051bc293,250,225,25,Europe,16,1930.32
7b205178791342d9b6e4fc74f4406f57,186,143,43,Asia,19,1055.84
7b20b6b3fa2e4f7da20b2be7baa8a679,135,106,29,South America,21,851.26
7b2560316add461bb78fae1868159380,161,128,33,Asia,16,965.47
7b28b57502d14ddab36946031d50ecea,364,351,13,Africa,23,2565.06
7b295c0eb56d47359bf5b31e92057e31,180,131,49,Africa,22,765.61
7b2ec07f6cb94049a1ee2ae9096a9d4c,246,213,33,Asia,22,1584.5
7b30939e9d22471f98019af21538ae12,170,121,49,Europe,27,755.71
7b30d5a9052b4ea5821d72ca1a3aa03d,364,324,40,South America,26,1809.29
7b32ea63c69646ceb0910749429b01be,170,132,38,Africa,21,729.8
7b348220942640fa9f62d0ecdb010faa,239,200,39,North America,23,1688.03
7b3748284dab4098af6932f46f283537,258,235,23,North America,20,1685.28
7b3780cf7c314f07a9c9f7762a4b3ae3,187,141,46,North America,14,1142.1
7b381e74ea9f486c9c4e12dda01d2069,326,306,20,North America,21,2461.84
7b390ed147a64bc599bd1319af84a4f2,51,29,22,Asia,21,118.43
7b392bbc4b0f4ec5af081737f45b4277,183,167,16,North America,20,1286.39
7b3b7263075c416f82feec253cbda77e,196,166,30,South America,21,1656.9
7b3cdbee21964f39b1bb544455ac8b59,41,21,20,Oceania,21,157.77
7b432de6cd0e4daa966d772e3b6ac972,73,23,50,Africa,18,266.47
7b4397f83b584b4faf53318f116d5266,363,344,19,Oceania,20,2013.09
7b43dbba59344e068805cc72c5b40ad0,188,147,41,Asia,26,1450.18
7b4517656c76433bbaf95daef395957b,365,333,32,Oceania,20,1776.69
7b4596d651184e35b0fafe3a27cda2b8,127,90,37,Asia,21,1251.73
7b4606ccf12144309620ae80f3eb27cf,364,357,7,South America,25,3004.86
7b462ee4d16c47f9ac2b657cdbf4760b,341,304,37,Asia,19,2182.22
7b4630d8d31740b4813b423163cd1ced,214,160,54,Asia,16,1217.97
7b480edac7574c4db2fc3aaee7f5704d,221,196,25,South America,19,1582.78
7b49eca090f64c04aa64cd9376dc5759,176,132,44,Africa,24,735.26
7b4a2fb4cead482c94e8e699f0cf7096,162,126,36,South America,24,1252.59
7b4a714ac1a841bdb91a800f52ae863c,75,37,38,Asia,23,912.74
7b4b330efc5547cf83035dbc1cf5d772,236,199,37,Europe,24,1492.12
7b4cfaa933004b708cfd5b384b95982e,365,357,8,North America,23,2089.83
7b517ecc19e141f8b63a93d953637f8b,116,88,28,North America,19,597.42
7b5228e2cf2a4a368da41de977d2eeb8,300,252,48,Asia,23,1767.88
7b52b020a20740668afdc13ff6a3378d,347,291,56,North America,25,2137.05
7b52d55733d1485887d0a8101635c3e0,235,184,51,North America,17,1333.77
7b57217df23f43b9a8067bad6cea26ea,197,157,40,Africa,22,1418.19
7b5b61d7dcf24b57bff1b91e9b645f42,62,30,32,Africa,21,49.86
7b5fb7f390e64ee3bb9db8a78df89661,335,297,38,South America,19,2763.61
7b61e570d723498ba1d9a43675bf1162,308,267,41,Oceania,24,2017.02
7b620afd67ff4df2a95425b5955930ac,171,136,35,Oceania,19,1843.65
7b653ecd63344277a186a434545681f5,335,305,30,Asia,18,2443.99
7b67733db3fe4c3293c3306574fb3bf4,162,124,38,North America,19,1174.8
7b680e4b88564b87a564aa31987a168d,94,41,53,North America,20,569.1
7b6a82c9d75d4ca1b046921aa5994e77,73,28,45,Oceania,21,519.9
7b6c61cf2ded436288e85abe3af88bf3,110,60,50,Europe,14,366.42
7b70ed372bda4ebfaa027ec97e563b57,334,300,34,South America,17,2005.82
7b72b9d897f64fefbf7f086b51551d88,223,197,26,South America,19,1462.73
7b72ff5fe0db43c693204543799b75a7,221,182,39,North America,20,1353.91
7b74380aad294a1293ce3aadd0cbb281,350,312,38,Africa,19,2519.55
7b75b5fb1bcb433cb025a0e7e8ab34ed,338,311,27,Asia,17,2515.63
7b779bc5495c41b0a7a7bde0b49f028f,99,63,36,North America,21,467.34
7b77f1cae08a45209fb6ee5cf6d2e801,110,84,26,Asia,24,685.21
7b7bc6ef586e4bfdb2d49ee3dea7a602,337,293,44,Asia,20,1880.23
7b7c573b83c94f4695ec335a8019194a,186,147,39,North America,16,1121.88
7b7d55e7fbe84fadbd29083d7997365c,219,202,17,South America,21,2394.9
7b7eaf5b827a408aae66876cb6829222,341,301,40,Asia,17,1413.52
7b7f01a39f2b47b99706e0478ffbfbb3,198,170,28,Europe,11,1473.45
7b7fc974a3f143edad9a2f34f86a561b,112,73,39,South America,17,663.09
7b805149fcba4145baa143985acb06be,103,96,7,Africa,25,589.45
7b80f63f4699426181db21bea43e87b4,265,226,39,South America,19,1863.57
7b80f774431d4968941b1c2ae5370cc2,265,225,40,Europe,22,1831.25
7b84a93a99504e42879347cf63b0f35f,90,50,40,Oceania,22,771.35
7b85839fd52e4e0ca87bfbd8ee3a7625,358,316,42,Asia,22,2333.72
7b86409c474b4b2a82b35c308fb1f92d,365,324,41,Oceania,22,1302.82
7b8a993a113f48f192f71f65c7120f12,324,282,42,North America,19,2151.42
7b8c40b9a6cb473291fc45c338bda441,363,345,18,Africa,19,1571.24
7b8c7218e043408ca49ef901ec4f08fc,73,36,37,Asia,24,175.04
7b8d56a85c144a3fb759f8da408c1f3f,228,198,30,Asia,14,1921.57
7b90f1120d2d4b8fa92f63a9a84061bd,97,58,39,Oceania,20,800.71
7b91d35af65547d1b712507d9ad88f59,294,244,50,Oceania,19,1586.94
7b93cce8b2764d6981c92d61d489a231,254,199,55,Europe,19,1057.96
7b94052e45f247c98ab053bbf5024066,145,116,29,South America,23,1188.69
7b977dde7f82483b8031e1745343db5c,253,217,36,Africa,22,1455.06
7b97953edbb4425098ebe6bac20455c5,254,239,15,Asia,26,1688.3
7b9d427bf9414389a5ff81a4762b364f,93,38,55,Africa,22,608.4
7b9f3af42ee44e419cdbd3e3c19ec02f,148,122,26,Africa,21,1020.32
7b9f77e273d74a3185f135402f3a9589,157,117,40,North America,23,800
7ba44b7d5ec74b73affcf6b4c2950f2a,100,69,31,Asia,23,678.8
7ba94cd571154178be2454c95cb604ec,365,344,21,Europe,22,2038.22
7baa7d03265341459648d834f7973ba4,155,136,19,Asia,21,837.55
7bab2f7be4a44ae1ae263da052666e58,263,233,30,North America,21,1773.42
7bab68367c274ffc9797c41999e271b3,126,104,22,Africa,15,1193.76
7bad085a31c14c8aa3c8eeed117a27db,364,326,38,South America,16,1164.68
7bad905d97164b3a86a49de1ba4d0cbc,191,150,41,Oceania,18,1236.19
7bafce8e17784c2da0c4baf31e8d48f3,195,151,44,Asia,19,1156.54
7bb177ad30d34880a7a5a75973ab8be9,310,272,38,Europe,15,2069.61
7bb22922b1c947f3969514d909d54d39,318,288,30,Oceania,22,2469.37
7bb3f6f6323d4e949ab0c203d9e950ee,205,175,30,Africa,21,1541.21
7bb51d1ac22d4769a669b7e856ca825d,165,145,20,Africa,21,1245.4
7bb58d5bbf414eb282236c09750e443b,350,300,50,Oceania,19,2206.44
7bb5c4685ece4648b86677c8c20db1b2,78,38,40,North America,18,584.52
7bb718a58f814e4cbcc2ee9dea8b6118,214,191,23,Oceania,17,1619.99
7bb7226ffab34c2fb841494c1041c35b,66,29,37,Oceania,19,761.05
7bb971a2d29649ebaa836bb34493cfc5,120,73,47,Europe,19,451.28
7bb9db78fd2645e480129682c63bfcb8,335,281,54,Europe,22,1463.45
7bbbe1feabbc425c9d95c2e0e70b81a1,106,61,45,North America,23,691.77
7bbbeb8d18964adb945029e6c101364a,351,305,46,South America,16,1749.8
7bbc410d78f64a5bac0e2f25b551df2c,201,169,32,Europe,17,1963.94
7bbccc22203940ec926c400d21d05ea1,344,319,25,North America,25,2205.27
7bbf9f45058e49399c6a053934f248f6,244,186,58,Europe,20,1013.12
7bc00fb3b8d044518305297f5b035530,239,192,47,Oceania,19,1029.71
7bc0703af4cf4b21a2e52edb539ae06f,107,70,37,Africa,23,652.5
7bc1bec66f744c73a8835639f4053de6,212,177,35,Europe,16,1176.97
7bc1f1ccef424304a2a34b45ca8e7103,219,202,17,North America,20,1603.65
7bc3714b82b44637bcd384e837425bae,226,175,51,South America,22,813.72
7bc695a853e94d74b963a54e6ab66644,218,193,25,Europe,18,1925.67
7bc6a0bb3f50418db1e3e0c0e3c3bd3d,91,47,44,North America,19,651.21
7bc78a799a4449a7897eec7b97785a29,94,69,25,Europe,15,718.62
7bc83e44c48547e3b545b769b66ccbcd,233,188,45,Oceania,19,1624.13
7bca81fb93344dda9a54568d799f66da,337,283,54,Asia,27,1561.13
7bcaed14158c4e4e96c82ecb9edbc95a,337,286,51,South America,15,1719.16
7bcb82fce2164307b168a4abe3b75c3c,98,49,49,Oceania,21,245.26
7bcf4af802f1407bbff1f82b9b190f1d,95,67,28,Oceania,15,888.23
7bd35305694848a2b2f4673f1f60b5b7,342,304,38,North America,24,1494.95
7bd3e520ccf7409a88ad32c7c2a26b5e,364,325,39,Africa,20,2206.27
7bd448d12e304a88b61c7c90f8c2ca18,361,310,51,North America,27,1439.77
7bd4606fd68f47aaa098314ddc3d8047,182,157,25,Africa,25,1147.93
7bd670d88e354051aabe1912a89f2296,34,10,24,Asia,16,518.23
7bd6fc7ba65b4337bfef799f80dca61a,287,240,47,South America,28,2172.85
7bd7024ee0b64176b805a672288ca958,102,55,47,North America,17,452.25
7bd801ed616a44d09adf1ce0f02ea915,340,313,27,Africa,19,2579.93
7bd9f8497104450f9d4c7ca6d6ae8101,267,226,41,Africa,19,1589.68
7bdb4d0bae9d4913bb88b5e1bdb617fc,95,75,20,Africa,16,911.54
7bde4a96466c4b898947f29bfc60fb2d,74,41,33,North America,23,264.69
7be1c65b203741cdbc9311a41ba46f4a,198,160,38,North America,19,1138.74
7be3d1d6a1ab4f178a2d023bbb565ee7,365,344,21,Oceania,19,2582.68
7be3eee763214c4dba465bbf13a79baf,168,134,34,South America,14,1058.19
7be53ee7e08541518640e4bad9240cae,96,59,37,Oceania,22,516.59
7be8edac62034f4fa650dc785292f6e0,47,7,40,Africa,18,339.73
7be99f98c762406f98e58d2c4cccec56,263,215,48,Oceania,21,950.16
7bea12eb1e734c07a5763cf85c687bb4,183,148,35,North America,26,1353.84
7bea8a674c1940598ea3284ab7e79251,42,18,24,Oceania,18,148.32
7beaacf30cc5448a9bf79aea3beb142f,363,350,13,Europe,24,2636.72
7beb489d05714558b9b0bcc664740214,44,2,42,North America,19,317.99
7becd3d05d304ad982d8dfe43fcb0e10,334,294,40,North America,21,1755.44
7bed040f912c47d996882c22c78b07c3,365,342,23,Oceania,20,1195.82
7bee0173b9bc4498a6712c18587df43b,97,54,43,Africa,15,718.15
7bef484a3e3c4166ab02a36ee32081a5,323,298,25,North America,17,2014.5
7bef8a45c216404d803ab61d00ca80a2,195,166,29,Europe,18,1639.61
7bf0b4b41e554fb2969ab89fe7adc9af,199,165,34,Oceania,24,1350.4
7bf0e1fb72df4eecbe5bc88038818dba,90,61,29,Asia,22,699.31
7bf27287c79946e9b516438ff621bf5c,310,260,50,Africa,20,1849.2
7bf4e3ba30444b03a983553870ac1229,341,319,22,Africa,23,2022.74
7bf4e6a95bb74305a0feaded8ec0d320,267,218,49,Africa,24,1394.71
7bf5296efe344e69a2594a4d80a961d3,143,89,54,North America,20,822.39
7bf74433235141bda967a645149b1494,217,183,34,Europe,14,1716.87
7bf78f7ec19e430a951fa73e1102e95c,363,342,21,South America,19,2516.79
7bf9472bba6f4f8fa3eb70f012641c84,250,211,39,Africa,22,1628.46
7bf9c87164d243dea2c40128d3c1cdb0,326,295,31,North America,19,1766.11
7bf9d98eba4d46aab434885f8d8deb40,315,280,35,Europe,20,2306.84
7bfc5a00d64b43b2a8a2319be907ba08,256,223,33,Europe,25,2205.14
7bfd969ba3f2424c93228af3aaf188e1,363,327,36,South America,22,2503.4
7bfda8d2e5104412b38e3b204b222f0c,362,348,14,Oceania,17,2278.54
7bfdddfde4134f55aa6067a00ab750ea,55,37,18,Europe,24,439.61
7bfe123f51fc4c019e6f0bec6644a703,322,274,48,Europe,19,1988.57
7bfe2c866ce74afa948ca74dc00166e2,79,53,26,Asia,16,501.81
7bfe45fe04064422a2f50145a40f5611,220,175,45,North America,21,1020.67
7bfe4907bae547fba3ff0aea40ca6b44,121,68,53,South America,20,532.56
7c0024aff9a348aeb22482f004c8a7cd,335,302,33,Africa,23,2305.35
7c006eea20834aaf969206e630ef4f8a,361,309,52,Europe,23,1636.22
7c01dcf0a43f482bb8eadf08024a8c50,123,96,27,North America,22,974.62
7c02445926d54d4db1bcf52d97c43ef9,363,363,0,Africa,25,2020.83
7c02abff7beb4c9f953988b36d7f1375,269,226,43,South America,25,1086.44
7c033749cb8349ce913f1edf443be9e9,280,259,21,South America,21,2320.69
7c0384b9750c41318d8872384acf9fac,160,121,39,Europe,19,893.31
7c08021b0fbc49b9a15615b18bf47056,239,185,54,Europe,20,1476.05
7c09545e317e453d9a61bd4f6f7721e9,58,21,37,North America,21,247.57
7c0a13a9f63a495aa37a5da530482c72,356,306,50,North America,20,2395.88
7c0b69626fbc4d0d80a47220000c66f2,78,41,37,Africa,25,398.9
7c0cc5c3555543a684e488e372ad81fd,253,214,39,North America,19,1788.04
7c11b1301a3c480983e795371b0be41d,329,288,41,Oceania,16,1095
7c1325729fb747ecb3655afdd4abaabc,364,336,28,Asia,20,2176.55
7c13b18bcb4d47caaf5475c1d1d3f19a,342,303,39,Africa,18,2181.55
7c15c24b7fe34d2f8bee839a88f1384a,149,118,31,Oceania,19,953.01
7c16392c8319458292fac4d984155494,229,210,19,Asia,20,1750.19
7c163f6265a24dfcb434a911f3e9e0f6,264,245,19,Africa,17,2090.4
7c181ba56cb74d21ab062acb4a1776f6,186,158,28,Asia,16,1628.87
7c18c2ba18bc41e6ad92117205903f0d,81,56,25,Oceania,23,667.32
7c19efa4badc44e9a92ec9d16d866dcf,97,50,47,South America,18,492.34
7c19f502ef224152a09af8acec6a6a96,344,316,28,Africa,19,2994.46
7c1cb598d22b4404b57578e997699c79,116,81,35,South America,20,725.23
7c1cddac71374877976853be1e4a0686,271,233,38,Asia,14,1695.93
7c1d6b6a583b4968b0c914754e116255,103,54,49,South America,24,491.83
7c1e7b72be2148af91db6e19976e3c27,361,337,24,Oceania,20,3292.3
7c1ebf698d1343719893ce508b57f872,365,354,11,Africa,22,2638.69
7c21d38165b04037adaef10bdc25a1c1,170,113,57,North America,21,1010.37
7c2322414fed4f94ac04fe9f1109d13f,119,64,55,Oceania,23,864.45
7c23626790ff43c9896674a729d7ce53,207,181,26,North America,27,1991.03
7c2457a2e63d43a982a6ab3117888ab9,139,119,20,Asia,21,947.05
7c256e1a0c364fc08e0c239839297d3a,175,145,30,Africa,15,816.71
7c26d22ae2ef4b9a818da00f7a27af8d,232,183,49,Europe,18,1320.41
7c27f2f952624ac1b3050b7bf2966826,59,37,22,North America,16,393.2
7c283f71c50c4a2b994eead5af5a2a09,74,29,45,Africa,22,345.92
7c29d6dbdf7d4c36980d79092e811a36,66,25,41,Oceania,17,457.3
7c2d3504998f483381733dc35bee1f68,216,187,29,South America,19,2163.53
7c2e4995ff7c4f4393fbec44a9909e3d,151,131,20,Oceania,19,955.19
7c2eb8f664e64150bb508cfec5904cba,77,48,29,South America,24,560.14
7c304befbe084f13860ebeed5030632b,360,318,42,Asia,23,1785.2
7c33a1bd051f4cc48cfb2a02acaa3a94,364,351,13,Europe,16,1393.79
7c3c06736ce64797b451e011e0336919,283,233,50,South America,20,1187.83
7c3e6477d3514a689103338c48e2837d,171,138,33,North America,23,960.28
7c3f2c62c8724810a78c048a6f13cc80,282,241,41,Oceania,20,2362.36
7c4067dc1a4745d2b93804a5f2f74329,179,142,37,South America,25,1629.07
7c4080adab2c4d17a8633abc552d13d5,179,133,46,North America,16,713.69
7c40d7f100e04938845e3c884e7891f1,187,149,38,North America,21,1279.28
7c420771c58d48249590319cea0ed061,60,32,28,Asia,18,363.97
7c4264770d13435096a69ed0872cef01,240,223,17,Africa,15,1781.09
7c43c1188f834b2ea0eb8b21757cb6e0,185,140,45,North America,22,1496.79
7c43ecd892bc4c009bc04b4886eabce2,365,351,14,Europe,17,2097.08
7c44944c2ad041678a36a0e1cb4715b1,277,248,29,Asia,22,1960.82
7c44bb3b5edb44b1bab4a6a54e4eaa82,223,194,29,Europe,14,2196.26
7c45416a3861469ea3b89c558ea89b29,89,67,22,Oceania,16,1000.52
7c47f3c2f7074739b783472e4737f6f8,359,322,37,Oceania,20,3114.04
7c488887238c4eb292ab8d5dd8995dc2,249,203,46,Oceania,27,1300.57
7c4cb73851d4427d8b96b1e624c2812f,250,213,37,Asia,19,1559.91
7c4de95ba360420abc85f6479f346c72,149,128,21,Europe,20,1403.69
7c4e07a9da3d45a99461cf1cb75a6529,307,267,40,Africa,24,1206.71
7c4f5485058c4f28b60e8bfdeddf41d7,363,337,26,Africa,23,2504.39
7c51c57fd014433981312d3eaf6b767e,68,18,50,Asia,22,137.52
7c524855d5944dcca3f6f32f97540d04,134,94,40,North America,24,1057.23
7c527f436c614729951431aa12d265ec,206,160,46,Africa,20,885.65
7c52e6a36acf49cdbfb11cebb881938e,96,47,49,South America,15,392.78
7c52fc44beaa4c9dbcb2f464aa17cc53,363,315,48,Europe,22,2692.73
7c56ad23dc17413e94bc748d5d490c1e,44,22,22,Europe,17,435.93
7c57a2bb160243d7816f6c83e687532c,131,101,30,North America,24,771.53
7c5b23cd4a404c818bcfab71cfa6bf11,344,300,44,Europe,21,1481.56
7c5eb1b7fa9340b4aa7fb5fd959652cf,93,53,40,Africa,22,1157.52
7c5f819899b2470e9747ba525e394b12,257,207,50,South America,13,1046.53
7c5fecaf4d9744408ec99ce31d9140e2,337,294,43,North America,22,2244.67
7c63d8c310a84612a2ef5242147494c1,199,163,36,Africa,21,1501.73
7c656a9986334d279ca69739f1bdfb35,206,178,28,Asia,23,1359.61
7c65ce1ac37346faa5033bce281396cf,195,153,42,North America,16,612.43
7c65cf4c430f488c8cc347d87c0480ca,364,352,12,Oceania,18,2982.84
7c679ae389f840d7b04983632ac5a397,59,2,57,North America,22,253.66
7c682764c6f1469c82eda7cf55aa1725,327,276,51,South America,26,1468.21
7c68c75c8ce34408b877af0fa9eb1b94,364,340,24,South America,20,2769.44
7c696bdd40874668a716725d981573f6,365,359,6,North America,15,2418.54
7c69b40deca9463d9d92189db90f5fb8,184,170,14,Europe,20,1278.53
7c6a404833624bd0af3a3ca7b540c2a2,176,125,51,Oceania,20,1246.89
7c6c343de8854de9a60f2ce72f0564cf,210,162,48,Africa,18,1303.68
7c6d2c34d0024bc2b58b2a33cf3ad26d,89,45,44,Oceania,23,271.82
7c6d59be47e84bdd94773170e3c2abea,363,353,10,Europe,19,1541.2
7c6d6c04d4914d28866ffb3c4bc4818b,272,253,19,Europe,16,1601.19
7c70fd39f3934428ab051652c64840af,257,209,48,Europe,19,882.5
7c73910915b4465d9b014e22f90c860c,238,214,24,Asia,24,1310.32
7c769fef1e474806b299a83ec1a1430e,141,100,41,Europe,22,955.64
7c7afb8eff184c7298fc09f47e25331c,161,118,43,Europe,22,705.6
7c7b4fd6df294618a07f8beb1e766c07,81,58,23,Asia,18,646.49
7c7be3629bac4aa0b6afddd9936a830c,271,235,36,Oceania,23,1478.03
7c7cbea0e0434210aa1c453752837c3f,177,123,54,Europe,21,1081.75
7c7df7e6d90d430c98883df6cc99b998,143,122,21,Asia,17,1160.89
7c8000a7c9bf4e1892fc57550e920f5c,66,21,45,Africa,23,573.04
7c81e42b32d84609ba3b4e8f9caab7a5,199,162,37,Oceania,22,871.46
7c82132aab5a4c0082807e77e0162a38,328,272,56,Oceania,16,1553.2
7c82331a382848e29d20695abf1e9775,100,40,60,Europe,17,607.27
7c8274dfe56b436b8744918d9bffc933,361,353,8,Asia,20,2412.01
7c8298df136a494bbc00bc3ffd7e8ab4,88,56,32,Africa,19,815.61
7c881e1e1b394e53a1582907bc0af032,132,94,38,Africa,24,684.28
7c8834ad7f7d48cbb6cb2cf23083f54c,68,15,53,South America,19,313.32
7c8d93b97738480f9e4eda3a208a5da9,194,152,42,Africa,18,1332.2
7c8f8950a36240c997a519131be3b149,319,270,49,Oceania,20,1380.42
7c902c72f65c4326a5c7636003d435ef,206,168,38,North America,23,1602.91
7c918fe8594e4b6cb235adccc61103d4,333,290,43,South America,19,1546.52
7c91c8cf76d042588d26cf2b86d54f36,365,365,0,Asia,21,3011.72
7c92941b86964e5782d90afd86fd5a18,209,184,25,Asia,22,1093.59
7c92f95d6b634ef8802dca6eb68803fe,359,323,36,South America,20,2527.84
7c932146f7874863b445e9a87e0c65da,58,34,24,North America,14,804.28
7c9508ccaaa24ecda8d23510679bbf7c,139,83,56,Oceania,17,795.54
7c9628a5e8bb4a468923bd098843fe1a,346,315,31,South America,23,2295.28
7c963c01cbd64e6898d9907ce8e22aff,74,33,41,Asia,18,516.11
7c9896ae44da45a58d436bfccfcb6cee,146,109,37,North America,17,1186.1
7c9abbb835f147d599d98cd9e7370d0e,342,307,35,North America,19,1918.99
7c9b8397037c4d42aa368f4fc3bcf233,350,310,40,Asia,24,1515.61
7c9d08303d5b415495ed3d8b290b427c,338,298,40,North America,20,2311.42
7c9e53b4fe6745549534a4748eeb8656,190,137,53,Africa,17,718.88
7ca203c997814a90bdce6b98886d5712,247,217,30,North America,20,2051.84
7ca3720408af43069053753129e33b69,361,328,33,North America,14,2364.8
7ca50b0f5acf4d939865dc6db557686e,78,41,37,North America,18,451.07
7ca634fbfb9f4911b9699d45c95cfec0,276,229,47,Oceania,23,1359.56
7ca707986d8e41669330a1ab3e39b6c2,326,278,48,Asia,17,1327.64
7ca89270fd764f93800e7c55584d7771,361,341,20,Asia,19,1726.35
7ca8c47abaae4ed18f11f000975ef422,364,364,0,North America,25,2099.5
7ca8cbe5c296465683629d6ec028764e,39,3,36,Oceania,20,308.31
7cac594883754a76a2d858a8b42f8e7a,199,179,20,South America,21,1946.77
7cacdaf1b1d44fab9ddc284a3ab9bee0,188,165,23,Asia,20,1521.81
7cae4a06e7444a94b145d0097da27525,363,356,7,Europe,27,2269.74
7cb09a2263b54d96b7a96f3581f6ded2,327,278,49,Europe,20,1813.29
7cb10ebb2d254ee3ab1c52cbc739737d,269,247,22,Europe,17,2634.74
7cb2ad4138b742599d8fa4888e25a3da,162,123,39,North America,18,1389.44
7cb3a1000fed498fb2a38ad46f9a2044,124,88,36,Europe,23,1300.13
7cb3f27206a54f96bd950785fa452ae2,284,256,28,Europe,19,2295.93
7cb57ae49670470f8c4b930afc5b99f2,242,201,41,South America,22,1502.44
7cb68d775c454fc780c10da1aeaf161a,74,47,27,Oceania,19,664.51
7cb6d2f089c9484180c55da35a5ab83e,217,192,25,Asia,16,998.08
7cb7eccacbd0455fbc2c2e825951c34a,356,319,37,Africa,22,2034.8
7cb83a532a86458d8fb5765fa0e8cb06,80,53,27,Asia,28,356.25
7cb8cc2d85fb4415a7a9d2cfbfd0f091,85,32,53,North America,22,558.74
7cbb4b8f10c84ce69d86739b4c3f774b,56,19,37,Asia,20,512.92
7cbc1ebd93f74a5eb2d4418449a68a69,324,294,30,South America,21,1983.24
7cbf7f1f68e446c0a54744a6584dedd0,277,245,32,Europe,14,1516.82
7cc02fbb712b48488a3256ed596d6615,365,356,9,South America,23,2800.34
7cc0cbdb64a24e1fac0be8d74e77ed1a,55,38,17,Asia,19,384.21
7cc42163a00a4518b516c1c791f9faa8,87,33,54,South America,16,427.29
7cc4643b489b42cba99895cddc10beb0,316,277,39,Asia,22,2112.97
7cc656d94bf04ebd88d91e48a6347aa0,305,252,53,Europe,19,1184.49
7cc6792cbc434ecdbefaf9a009e24c5a,199,146,53,Africa,22,1004.71
7cc69f2d99314861804b337dc156e1ba,364,346,18,North America,13,2718.17
7cc8341e71ac490e9dfcd8b7878561f7,55,23,32,North America,24,449.07
7ccb0c2b64ec4b71afff4df19abd0d52,282,255,27,Asia,18,2163.31
7ccbb03969df4677abcbab7f5e61e289,216,176,40,North America,22,734.16
7cce93346b82447b84a5e83d834beab0,112,89,23,South America,22,1154.59
7ccf0f009e5146e2bfedde77f538ba92,194,137,57,South America,17,570.73
7ccfed82afb345deb3751bfd7030c878,85,28,57,North America,26,400.36
7cd09d92393749aeb3ca52e78c4a4714,363,333,30,Africa,19,2765.04
7cd38219d490437d8a4afcb2bcc7302a,155,137,18,Africa,20,766.84
7cd498d07b0e417c84db7841a6573f0d,208,172,36,South America,15,1537.1
7cd608bfd4c94d259c00f84c44da7130,57,37,20,Africa,21,640.38
7cd7e97d0b794b7e970288b972f2d91b,338,297,41,South America,21,2298.78
7cd8170ca4354e97b7a64a14696f884d,103,71,32,South America,25,848.98
7cd8502c06e844838b1318c69e0dd600,192,158,34,North America,17,1137.93
7cda7226a9554e4d811a31a745b99910,159,120,39,Asia,18,1047.76
7ce0892b413d411699e201acf95eefca,145,97,48,Africa,19,380.54
7ce1f76756bb423d9e0dd2bb81d81ffc,358,331,27,Europe,22,3275.27
7ce22446cb5d4fa79a09b59dd0ca41c8,302,274,28,Europe,16,2566.78
7ce2a4f53cbb47cab33e40e6f1ab4e52,277,257,20,Asia,20,1964.26
7ce3fa9f29ca439c8f9be7eb223736dd,226,197,29,South America,24,2105.01
7ce4cc150ec84bb98d887d3d5f1b854a,145,96,49,North America,15,477.07
7ce673f00b944d59a0853110ab65a14b,92,46,46,Asia,28,300.31
7ce81eb46c264f258bf4c91cbf118d0b,100,48,52,Europe,26,567.53
7cea30bf58924cdaab3257530a9e600c,272,249,23,Europe,14,1811.99
7cee96b20a5e46cdbdcbf81847135f1e,128,101,27,Africa,18,1133.61
7ceefda091144dec816e11e2469f5cbe,162,108,54,Oceania,18,1003.64
7cf0e2615e814e32b73f4b5157b69873,363,342,21,South America,18,2318.99
7cf27ab8f4f3431882db1f85ff73d8e2,297,261,36,Asia,18,2241.96
7cf3f3ed79934256ab9c2aa6a44199d4,365,321,44,Europe,19,1658.58
7cf627afaff4432d90f0385820ddd8da,189,160,29,Africa,23,1552.92
7cf6fa3409544ddf8e200eb3777ec706,348,318,30,Oceania,21,3186.61
7cf77c63bb2d40418daa24deffff5a39,364,322,42,South America,18,2208.73
7cf89966aa674422848c6df30422273f,284,232,52,South America,19,1613.22
7cfc6677987b4b6e88d653bc835d205f,92,57,35,North America,23,328.62
7cfea39c639442ed902c2ded31e98a15,362,359,3,Oceania,22,2871.54
7cff1f7b3805422ea78974a0790f8b36,116,89,27,Oceania,22,785.73
7d0035ee52fd4961ac507b62c263d53d,266,232,34,North America,19,2158.55
7d006a424f8a4df3bdcfc04544d1d624,173,143,30,Oceania,18,1725.85
7d00e74560a447c6afe1412ed735a9aa,365,358,7,Africa,18,2126.01
7d017c465e9b4a80b00c445c806441cd,345,312,33,Asia,22,2307.95
7d01e32638a740d39adc389b99192967,74,19,55,South America,26,239.42
7d02d72b2ba045e68a34809f9a020e3b,175,150,25,Asia,25,1390.84
7d03269c5eb64f71bf13069017abe450,364,339,25,Oceania,16,2583.77
7d085abd2dc54b6898203596f11be1b3,58,15,43,Africa,14,318.81
7d09962a1a6847b3bfed090859cb5a77,260,209,51,Europe,16,1251.88
7d09af999d51498fb2df6aed7ec25fe2,256,230,26,South America,24,1672.2
7d09fbba40284dd7bb45fbe97ca68557,161,137,24,Africa,20,769.94
7d0c6292b47b41179ffc852f064cefad,125,88,37,North America,16,690.55
7d111ba5d4184261a12f7762bbb7bbb0,90,46,44,Asia,21,492.98
7d121abc63b64a088faea7fbc4bcdea5,87,51,36,South America,21,585.8
7d12ef58e8c3488fa68bd333143ae6d7,83,37,46,North America,25,503.59
7d13392d57cf414b87d1ec6c2aa4ebf9,311,272,39,Asia,19,2023.93
7d163a9cff6d4f6ba8e8c04b21a5b250,127,74,53,Africa,18,557.77
7d175231fa68468ba85c83beeb3e481c,226,194,32,Oceania,25,1172.68
7d18999dad95481ab4a29d6a23b48682,269,237,32,Asia,15,1668.78
7d1949a83db04e08a4985cdb89e470a2,333,277,56,Europe,30,2190.39
7d1aecd6bf114cbe96b06f48761a20a0,75,59,16,Europe,20,884.62
7d1eda01c6164de5b8bdb4d109d75d8d,143,118,25,South America,19,877.76
7d22870a6b424ce2bba8e7e2f4851f99,297,277,20,Asia,21,2307.56
7d250f99e3fd4aa88844ac4e56d7f9de,136,92,44,Africa,23,599.71
7d2590255de648b89043db0ad96af790,333,309,24,Europe,15,1851.9
7d25ea8a790144a7901c237ecf9f3dbf,107,76,31,North America,17,1036.11
7d2625b1e1cd483a92c52ad97a0b0c99,78,27,51,South America,17,649.91
7d263571a01445638fcfed1a52249158,199,162,37,South America,22,1796.84
7d266f9ab0e64340bb2f2f508f7e0cef,355,306,49,South America,19,1485.32
7d26b4af87f14510a74f5015c62da4fb,365,363,2,Oceania,18,3104.65
7d2b7465cbb14cee8dbe30e2e72ebc09,192,170,22,Asia,19,1707
7d2ff5e82e6b4d09af25d4be84634889,88,52,36,Oceania,20,587.74
7d310fbd085b4cd59eb705f1b987c1b2,160,116,44,South America,16,1250.63
7d3267d812244a5784ae40339ae7b690,82,40,42,Europe,19,409.57
7d32dcd13ae8413790e3d883a5217fa2,365,351,14,Europe,23,1716.36
7d332e1c77e14f65b9f37e224451a4b8,83,58,25,Africa,19,445.14
7d349b57873e431b91e10868eac441e3,265,228,37,North America,22,1079.12
7d36f69787644bd5b001596f1d82d772,365,362,3,South America,23,2971.08
7d3811d3b22444d1b795ed6eceb0b0dd,347,296,51,South America,16,1543.74
7d38815e7f954877a028247d1b56fcb6,103,58,45,North America,25,347.65
7d3a4c1bb2d8477aa0ecfe31aaa2d4c8,54,16,38,Asia,23,290.75
7d3d9c78a2ea458d9ca95e40c141f740,188,159,29,Asia,20,1662.92
7d3f6e137e5b4790ab4f4572c9a418a1,340,307,33,South America,16,1669.56
7d4022aa76844467a7ae637f700d6a03,289,258,31,Africa,27,2208.36
7d428284a5dd4c17ae1e7c4ea4b45d53,255,231,24,North America,26,2575.66
7d43ae1e1ea540dabe52f19d89fb2d6f,364,353,11,Africa,24,2824.83
7d441ca5c0f24a9f9cc58c5557b7f86b,210,194,16,Oceania,24,1714.77
7d449fee39ad45e4a5edbe11603ccc4a,156,133,23,Asia,22,1562.12
7d4539e903d1492ca7df308465d9aaca,323,288,35,North America,21,2474.53
7d46daa7942f4752b952528072200162,351,299,52,Africa,20,1868.37
7d477736479846eca9e24f521e0841ea,109,58,51,Asia,22,683.12
7d478be2470848128e337d2ecafcf7f5,275,244,31,South America,18,1700.34
7d488c3a52cd4067881b2c7b8924bf32,203,179,24,Europe,15,2385.17
7d488f6824e14277be7dcffe73641bd4,330,285,45,Europe,26,2383.7
7d49b67dd65f4b83bcdcaeb80ee3e46f,288,253,35,Asia,16,1707.33
7d4a2281abef4b04b5cb63afaed57384,58,26,32,Europe,20,338.95
7d4a2e2ed23649748ee2ed9ec599db6b,216,167,49,South America,18,1354.64
7d4b071c75564993bf110727a48b05a2,258,228,30,Asia,19,1928.89
7d4c2bd8d11b4ec09c414459796a61ce,43,31,12,South America,21,503.76
7d4caf0cf97f47afb1e69f37e66aee97,110,95,15,South America,29,1169.26
7d4d69b7659842e5baca907461cd60b0,357,305,52,Asia,21,2080.67
7d4ee06417744a9caf21b0e9127779fc,231,195,36,South America,16,1628.8
7d4f4d7837a44ba491b2e60198a50108,246,181,65,Oceania,19,1379.1
7d507a5012744aba92ea49eec92ff63d,251,222,29,Europe,21,1227.34
7d5083fe0eea471db8502f08a3045842,147,105,42,Africa,18,551.62
7d50ab02204646559c85aea2abc5bf59,239,201,38,Oceania,24,1927.91
7d521cb4cb8d4fdea0d450a3b3f94ee0,352,314,38,Oceania,27,1880.99
7d53a81e80c74136b7d2b86ceeacddbc,88,51,37,Oceania,22,412.52
7d54533aae9a40408b50dca2e4a37956,182,129,53,Asia,16,822.61
7d54db5aa4b54582b6d13cdb82a783b5,328,287,41,South America,20,1638.41
7d5549101c4c42c8ae4580494f7b03c3,46,2,44,Asia,19,191.68
7d5707e04aa14a05987de1759edf7f3c,280,248,32,Europe,14,2121.66
7d57957a8fd541f0be9b4cde51f8b7c3,233,180,53,Asia,21,1327.26
7d57e0b0644d4bbea85fb3ca767255f1,136,90,46,Asia,20,513.7
7d58a352121f4dbc9ae3296de5dc299b,66,38,28,Asia,14,755.57
7d5a828e628c4bb5bcad53da17bb261b,99,51,48,South America,21,594.1
7d5c1170492c4e5287a2390d1e2623ab,189,151,38,North America,18,1116.46
7d62108d9ab143aca7507798eab6c9a3,40,21,19,South America,20,298.3
7d625cfe5f6247ff9d1978df5f8ec336,331,284,47,South America,16,1840.32
7d62f6daac604de7acf09efb416bdef6,219,167,52,Europe,16,1035.12
7d63610aaa6f43b9a5dbe4c838434c75,233,183,50,North America,20,976.17
7d64c48bcc834d87afa5a4c5df887eb3,178,139,39,Asia,16,1089.78
7d6739bde4a54d3198c85db017aa668a,65,36,29,Africa,18,764.15
7d67714a042741348b56f9239ec6426c,182,151,31,Europe,21,996.84
7d67ae0b9738466d9574a4c53b78d3e0,80,53,27,South America,16,584.55
7d680ff8501044f4bafe50f49648a990,364,318,46,Asia,21,1123.63
7d6c3928e37547baac08d2ef93f6d247,115,64,51,Europe,19,748.3
7d6dd6f0ef384980a673e12d47cb3394,277,253,24,Oceania,14,2437.49
7d6eeefa22654e2c95d16dec767a5473,65,38,27,Africa,22,268.29
7d6fbbff6439460dbcd9dc377ea426d7,73,30,43,Europe,19,569.99
7d72ea22185c4e518d07ec769eaebe64,363,356,7,South America,23,1770.93
7d762f246f86488189f42fed0bee5f1d,63,27,36,Europe,20,229.75
7d793601667a412189d7f7cf97a5bf8d,326,296,30,Africa,18,1791.49
7d79e663e1c64080adbdc2410d5cf2ae,180,153,27,North America,17,978.07
7d7a08f45cae4cfcac36a1cf815b35cd,293,265,28,South America,20,2409.6
7d7d96acfde04434a063667b325ddbf5,364,340,24,Asia,20,2010.59
7d7e96aebadf4d1ba3c8bd1f41c3bc14,360,332,28,North America,18,1929.67
7d7ffb48e54d469bb6422469e9da8850,118,91,27,South America,26,1201.51
7d81328b42594ba4899f99e02515f208,365,335,30,South America,17,2407.12
7d81c7369f0949ca9d0eb3fcc3aaea41,82,48,34,South America,19,443.52
7d81f4a00f494bf2bde6b9af991fc910,95,41,54,Africa,16,701.12
7d83a8e4cc044bd28052e5eb81350a87,365,346,19,Africa,18,2843.72
7d83cae31662426f8c72f92e15004577,359,307,52,Africa,18,2255.31
7d84d3f9d7614e26a3170b8b1a29e1c5,333,307,26,South America,23,3595.92
7d8d0e19b4274b53aa01ec96e4727278,268,234,34,Europe,18,1888.48
7d8d7b3cfc1e4ccc8626b2ca18c70448,95,52,43,Oceania,22,940.4
7d90acb3f4144360baf3de9690e574f9,166,134,32,Europe,16,1288.06
7d93c2afc826406aba4d8609cd703b4b,164,132,32,Europe,21,1344.07
7d9ac0913bae495a8dbcc4f315f66ff5,126,110,16,Europe,19,1039.91
7d9bc19f937d495b8716a4298c5d39ac,365,364,1,North America,24,2735.49
7d9c552255b44dcf905eb46c90720809,180,151,29,Africa,25,1617.32
7d9d7e82888149aa994d1eedf0154033,305,289,16,South America,18,2964.5
7da13448eb8d415cb03b3522372c7e25,156,119,37,South America,25,1239.36
7da176f9f9594247acee324ea3328756,365,347,18,Asia,17,3249.59
7da44cdd44b845a886e4a3814e481f02,365,337,28,Asia,19,1726.89
7da55df62861442fa3f701f594425282,71,24,47,South America,16,744
7da740349fde46ba8cb7340e9c116b01,240,190,50,Europe,17,1299.88
7da7ff36681448dab4572d45e13400ff,102,66,36,North America,20,419.3
7dac271475b1481fad623e2e913543d5,162,139,23,Asia,25,1528.58
7dad4a4c2c014c18872ec46e52ac717c,365,345,20,South America,20,2572.88
7daf2d75464b49fb87c2be73940feaaf,128,92,36,North America,24,1086.54
7db05f2b550d4f1a81ea0a240ea79871,324,279,45,Africa,19,1892.31
7db2b9923e8a46ed89d4f40fd9d9ce96,365,341,24,Asia,22,2521.95
7db3f41e76c14cd38e49b444321689ed,215,175,40,Asia,12,983.68
7db6fbc3f6d14112bc192770240702ff,62,34,28,Asia,20,625.84
7db787bdc6da430a988cfbbd9c25e747,227,191,36,Oceania,19,1184.69
7db87603856f4342a240fe844c0e92b6,336,297,39,Oceania,20,1505.61
7db8f8b3995a4468bccb08073b40672c,174,123,51,Oceania,21,715.49
7dbfa5df05a646e49b7e08cee03556e9,98,52,46,Europe,15,695.98
7dc0504343134b9da7e70825108d6ea7,201,169,32,South America,27,1246.6
7dc07abeba154d9790a2601f347e1f9a,365,338,27,North America,22,2265.22
7dc0e26696e948589d5ea5e9d3de3a30,263,236,27,Africa,22,2042.52
7dc10bf89ee740a39d700827ce7b2107,160,136,24,Europe,24,1461.61
7dc208ff5d254643afaf0987eed22663,88,57,31,Oceania,20,473.36
7dc2c0ed6a684be6821cbf8bd1f13412,224,171,53,Europe,18,953.44
7dc38c14d247473fbd089525ff2a7ab9,365,360,5,Europe,18,2734.79
7dc3a60b214645a393f8dc1e5e8b4676,347,324,23,South America,21,2934.85
7dc42d701c70410e9679cebebf0d5f50,325,273,52,North America,21,1194.86
7dc455ac79c141a486f4952c8a0569e6,102,52,50,Africa,18,501.15
7dc6aa647202460fa74bdeb428093e0a,279,257,22,South America,18,2534.73
7dc750f01aca4e938f98ee8eff44cef1,313,280,33,Oceania,22,2858.95
7dc96229102547d08154e4e9780c8d56,32,8,24,Africa,24,342
7dcba06d18134b5199ec101bf73acc3b,363,337,26,Europe,26,2657.9
7dcbbf1fcbdb48f5b83cc6ba324416b5,344,311,33,North America,17,2619.81
7dced70133ec4389b8cd72dc4f7fae19,348,294,54,Africa,22,1624.01
7dd03d590f53413b9042626377969c55,244,213,31,Oceania,22,1752.81
7dd22eb1f9104adbb956b8d7feb6694e,157,138,19,Oceania,20,1602.68
7dd4579989114b8d9891db25d57898f9,221,187,34,Africa,22,1179.81
7dd5579d620b4e659944589e47211e9a,230,183,47,North America,19,784.37
7dd81f4e069c4246825f571551a62487,323,276,47,Europe,16,1493.34
7dd8bdf25a934f059e30d244e76d7e8c,287,259,28,Asia,19,1648.3
7dd91030ce8b44618b6ecb5a25b282ff,359,336,23,North America,20,2035.4
7dda31612de84ea3aad2a13f80d4d196,137,101,36,Africa,17,779.75
7ddafb6deee942b7853b720ac6791122,257,212,45,South America,19,868.71
7ddb4986ccad41af8eb3808387bc95c7,221,183,38,Europe,18,2048.7
7ddd32f44dbb4bf7b72c250136540dfc,237,186,51,Europe,19,1446.44
7dde690d4d5740cbb7815038f79c3633,350,292,58,Oceania,16,2203.5
7ddeab5abfc84944ae642b96ff7ad512,269,233,36,Europe,26,1548.71
7ddf6b41735c40de962e053d5231515c,122,88,34,Africa,16,852.57
7de03980d76f47d69cc3e9c263330c68,363,344,19,Oceania,19,2381.05
7de37f8b8a3e4defa34e109858240320,192,168,24,Asia,20,1461.13
7de4ee99fedc4fb4b193d7dbb0a5e205,306,273,33,Africa,17,1689.36
7de7ec64fb724d6c91c108edf342a0cb,365,352,13,Oceania,16,2273.72
7de8d80aefe944679dc118b640ea3b2c,57,39,18,South America,17,259.46
7de99aa0a3f740a290c8fd4929db57f9,158,130,28,Oceania,23,1126.7
7de9ee0a322a45efb2ec3da3917b828d,364,362,2,Africa,19,3052.72
7deaf868d30c430789d2763f622b583f,156,101,55,Asia,20,759.17
7dec4ea1306a40c697d253b12822c522,114,88,26,Oceania,22,776.01
7dee41657f2d44a3bd003b47aee257c2,365,317,48,South America,25,1539.47
7deef1f1689e400495969f4826b79cad,79,32,47,Asia,25,318.79
7defbe6a444d46c2bf26c77156aabe5a,214,193,21,South America,19,1296.27
7defcdd584e941ef9a2cbbd4f1d83236,88,59,29,South America,24,715.78
7df05e32d7224d4b97e73db691db0185,38,20,18,North America,19,287.27
7df1686bc4aa4af79ec5d038fb6ff831,256,210,46,North America,20,1461.73
7df1756bc9074a23a067d392c853072b,73,23,50,Asia,17,621.31
7df249ff58124b2f9e56abe9dd64988d,55,40,15,Asia,21,559.33
7df39743d52545f3b87e9d0f8c3394e6,364,349,15,Europe,22,2431.36
7df3b291ff944f0fa6eda24e2edfe36c,344,302,42,Oceania,20,2023.78
7df503b91cbe47fd90478e2e71883cf2,215,181,34,North America,21,1485.08
7df5a9d4b6ff454694c396d6c20ffee5,294,248,46,South America,18,1482.7
7df77cd8f2884d199945fc513a2e6cdf,95,57,38,North America,22,405.44
7df806e94fb94becb62a0be2d14363ec,122,73,49,Asia,23,698.52
7dfafa51290d44b09a8f0f4fe03c8d8a,67,39,28,North America,22,420.82
7dfbe1d92e92438db41753673957cbb6,127,104,23,Africa,18,780.3
7dfe72f4b158455aba7a6e30538b2895,196,172,24,South America,18,1496.14
7dffecf4ae3d4f2587de92cd4a273a5f,365,363,2,Africa,19,2662.61
7e039e2fd095445699e11d0b14621bc8,310,282,28,Oceania,19,2300.65
7e04975b11824af5b1e8de1f12d1303e,145,106,39,Oceania,25,1061.37
7e063e47882c4831a0f37fe157a2783e,169,122,47,Europe,20,1124.31
7e09efd67e0c446395d630ad1c489fd2,93,56,37,Africa,24,682.96
7e0bb2c680ab4758a3e2f3d14df8022a,267,236,31,South America,19,2047.75
7e0ceb4dfc81488aac25da4cd0db4fff,247,216,31,Europe,20,1453.96
7e0d88264b1b41f88ecc8a113882d492,300,266,34,Oceania,18,1937.92
7e0da01bb58d4d0ba87ed2f32e42440a,229,177,52,Europe,18,1182.43
7e119b9b0ae748d488057f6fd30064f6,95,61,34,Oceania,21,900.39
7e124d4f73574a78ba5e8d789ce6d767,290,257,33,Africa,22,1439.33
7e134d56272840cca770fa4f19f2b473,102,65,37,Africa,19,319.3
7e151ca1d5de47c59d2e1b1ed9f7da0e,260,211,49,South America,13,1501.86
7e153168825f4bcda1c952a5fe30d96d,99,60,39,North America,21,931.04
7e15ded2f8944933a0986e5d4fd0c617,174,124,50,North America,22,1159.83
7e1820df2f9a49288859593a5f1c7721,320,274,46,Africa,22,2178.36
7e1b986f5c1d465c9e89b05e4fb68a43,135,105,30,Asia,21,838.95
7e1d4b3845fb4250ba2930e99535d399,149,100,49,Oceania,16,872.89
7e1e9d5873704fc4ba7c7e3f906af26f,365,316,49,South America,23,1897.04
7e1f96426db94dcfa0cba8f14c59be37,77,45,32,Oceania,22,430.4
7e1faa9850f345c5844fe282cfbf6076,169,138,31,Asia,20,492.38
7e1fbbff7c824e3c923d99763555f8f3,364,359,5,Africa,23,2936.58
7e224008456c43a497712c9dc67c7359,202,154,48,Africa,22,1639.7
7e22c3e68c994fd69cef05a72edf40a2,365,333,32,Asia,14,1716.39
7e239534de3e4afaad413fa44fe3f2dc,79,32,47,North America,19,467.44
7e2511a8c6cf45289cc4db8345b7b53e,157,127,30,South America,20,1301.5
7e2511f618ce4c82bbab2a56f74a54a1,320,296,24,South America,15,1938.1
7e26444c3d6e4a9d9ea9ab55d25fb802,288,256,32,South America,28,1767.99
7e26743b36a5499ea17d96b62536ba40,223,188,35,South America,18,1943.55
7e269f4382af49cfb058f0da2c62c1c5,290,264,26,Africa,16,2725.8
7e2ba89fe749490b8d9d4b552ddc467d,253,218,35,Europe,16,1929.9
7e2d4b4377c64a81a68fab27d57984f0,295,272,23,South America,20,2386.56
7e2ef255664d4dcfaaccd912d370f236,211,167,44,South America,16,1306.59
7e30d38fcc33498e8cc87cd6b9cbd8af,154,105,49,Europe,22,842.58
7e30fdd8d2b947f394e152fcbd2e5140,166,139,27,North America,21,790.38
7e3143ada2474fa1b9094c1ce23cfef9,321,298,23,Europe,21,2396.28
7e3301d8048c44819c10a72bdcba92ab,172,122,50,Oceania,17,515.69
7e3a8b34b1af46da80c9185daf5db8d8,32,1,31,Europe,20,337.37
7e3c0e9d802b4d64835e4ab10a8f60fd,203,164,39,North America,21,1532.21
7e3cc2ab764b4025a20626a206d107ac,161,128,33,South America,19,1578.59
7e3e249372bd4dbb8d90b073ba82ec0b,364,331,33,Africa,17,1406.06
7e419da1ca2749fe966e4136c5078118,340,303,37,Oceania,21,1511.1
7e4264d2c5da42dfbedd8190ce71441d,172,113,59,South America,21,677.3
7e43055dbf434e66b310fc95f8034dd5,112,69,43,South America,20,935.95
7e43af1f3d8644cab1f4eb2e6b4ea0d0,365,364,1,Asia,17,1560.8
7e483d2178e445399785b275b7d48144,78,41,37,North America,18,391.45
7e4867e7c3224a8db7c7c1bba2350895,126,78,48,Asia,21,820.35
7e4b717920294ce596760034c128f933,357,333,24,Oceania,15,3076.82
7e4c2bb565934fbf942a981c8750f64f,141,94,47,Oceania,18,549.67
7e4d333361724520af1551bab1297675,121,93,28,Africa,23,586.99
7e4f7a1e7c8e41e982e392bfae65eac4,320,273,47,Asia,20,1873.79
7e5200b9d3a54553971953d0856aefe4,259,205,54,Oceania,21,1059.93
7e5b1a99669542c0b0d5780fa078ba27,71,21,50,North America,21,503.3
7e5c700d9be34cc3960ec555c6241081,261,210,51,South America,20,927.31
7e5c801196ee4276bbe92ee470295435,88,29,59,North America,22,526.86
7e5f1c6abca2455ea69e38068e24574c,174,140,34,Europe,18,1309.41
7e61c506b48049949628db30209c747e,204,153,51,North America,22,771.28
7e62d3a900a44b32af4d86baa30680da,233,211,22,South America,21,1695.31
7e68a21aeaa640eda83d8fd12c4f5576,50,9,41,Africa,18,104.65
7e6b9408a6884b49ac70b749e22d43e6,186,133,53,North America,21,930.9
7e6e3830b35c43ef90f1fdfc9e4f2e09,343,302,41,Oceania,17,1860.24
7e6fc8e9115f48cab5046aed6e586c43,240,206,34,Oceania,20,1875.02
7e70d41a90fc47e2abb34298ea6654b2,167,136,31,Africa,22,1188.99
7e70dc46afd04c57821c2294d4fef43e,365,360,5,North America,21,2619.61
7e72b87d80544000903db6a373347b08,72,48,24,Africa,20,370.21
7e75ad74fb68433dbb7b00ecc8a637f2,365,348,17,Europe,22,1869.37
7e77522ac3544117a8313f4acd37f4cb,254,209,45,South America,22,1605.21
7e79980f2bc44f098f526faa383e91f2,205,151,54,Oceania,23,1157.37
7e7b80104a06494a92f6a2d8d7e2effe,242,191,51,Oceania,19,2149.97
7e7c89d6267343f4b4fed7b29cd82892,179,140,39,Europe,24,1177.18
7e7ccf5f1ecb45dda4c47465f01d4a66,315,299,16,Asia,16,2314.21
7e7cfef298b54393a1f63cc121fc4f8d,302,250,52,Asia,17,2180.03
7e7d2e98929e4386b4600f6d943419d5,106,71,35,Europe,19,660.94
7e7f2681379a4711bc5896e67d46f849,365,341,24,Asia,17,2142.3
7e7f7ace75724a8f9bc1041048340923,185,147,38,Asia,20,1726.75
7e81c447b230455aa315186f8be1d516,228,181,47,Africa,22,1032.91
7e8321fd4c354e149b357ff7ef9dfe6a,68,28,40,Oceania,18,291.49
7e83d38e94884393b03d8b8e4e62a401,39,11,28,South America,18,442.35
7e84c240860c4e808260683217468fe1,80,33,47,Asia,12,349.35
7e869512f89649c1acac31c7e353b7c3,365,331,34,Oceania,22,2951.99
7e8aa4a459184ae8a3a4c395b3875914,166,144,22,Europe,18,1546.8
7e8be023b5c94737977a567f86c4f397,253,201,52,Asia,19,886.76
7e8e74e93c024aa1b01ea665d8fa1340,267,213,54,Oceania,20,1342.36
7e9489ffc9544700976cad76c3588dad,120,81,39,South America,19,969.48
7e94d5c8e59e4ad2bf1a456317b5443e,242,194,48,Oceania,21,919.74
7e956e0461954157bb45da21fe649b7c,218,185,33,South America,22,1240.03
7e9666441f5b4e1ab68d7e6d1b7a36ea,303,260,43,Asia,20,1775.86
7e977f65013544f4ae40c6ea09baadb8,151,119,32,Africa,21,813.25
7e978a6a7940497f85039f21b2fb1760,279,261,18,Europe,20,2362.35
7e98441a0c5841d9b6a7d69938d0716d,47,21,26,South America,14,489.16
7e989816d83a451897ef433011be7353,355,333,22,South America,25,2735.23
7e98ffcee4ef448bbee74b941955d626,123,76,47,North America,18,663.3
7e9b2ef141134ba1a99995cd74db59ac,331,290,41,South America,19,1696.14
7e9d26c3cebb42238f4e39c1a48ea5eb,87,60,27,South America,26,666.65
7e9d355927584a92beb37c84ee592b22,248,197,51,Africa,20,999.1
7e9ddbb1eeab421eaf4cf23e8dd0e32e,71,18,53,South America,17,545.67
7ea3af81789e4fc9b794f5d5251c3af9,51,15,36,North America,18,221.95
7ea5192bd14e4027ac6385c2e2324e0f,144,106,38,North America,20,773.56
7ea546938e1c41f4a4ee3d6c3b4a0aac,365,329,36,North America,17,2659.09
7ea5c1fed2b84caca1b705e254bed394,167,126,41,Europe,16,1186.49
7ea6db5f9a984a06a582f7ad7d157a12,60,3,57,Europe,23,505.57
7ea7a1ff023c4d14bd25326dae65f55c,364,338,26,Oceania,21,2815.92
7ea8e9d20b604b71a36b8b3ea10d1eae,209,171,38,South America,23,1002.11
7ea9b0a9b9604a6bbc597fa4e98ca9fa,303,275,28,Oceania,18,2651.44
7eab6c5171cb4edca393e56a54ab934d,42,25,17,Africa,18,180.73
7eac3e77e4ee4ac0a5212c8709e22dee,174,136,38,Asia,26,973.85
7eaea1ba226749c6ac69c4c90474e09b,130,79,51,Europe,15,367.34
7eaf06ad27d14785bbfaf8318b265c45,331,290,41,North America,24,2147.39
7eaf1c2596e54b2ca744a5b2e7623147,199,162,37,South America,20,1436.48
7eafadade14b48ff8369fe6017f51018,350,304,46,Asia,21,2426.49
7eb0b1100116488fa724a3a33c40b553,196,169,27,Asia,19,1826.05
7eb410be557f4153b11506d5a42176d6,82,36,46,Asia,16,149.78
7eb41b17b3474fb292b9c1c2fb872e54,344,310,34,South America,20,2194.92
7eb436acae6b405abe0db0650c45a138,129,108,21,Oceania,22,1383.69
7eb4dbaca0fa4872818d88c7524bb457,209,176,33,Europe,15,1458.37
7eb59534b2a249a9b54ff04601ed4810,267,240,27,Asia,19,2102.13
7eb5b1f81b6149e3a8097b620dc28239,52,18,34,Europe,17,267.69
7eb603f555ae4dd98f311834aef8b39e,345,300,45,Oceania,19,1833.7
7eb8aa24dd654015ac47dfb2245400c3,109,59,50,Oceania,18,746.42
7ebcab556be8408a876fb987feae6cf6,255,236,19,South America,13,1285.71
7ebcbcab0c0641fd957e85f317d4697b,122,96,26,South America,24,1519.62
7ebe7188470043f9aa405ed955234b2c,311,292,19,South America,27,2278.81
7ebf702330ee4c1a9444f9dcd0bacc20,322,279,43,Oceania,26,954.6
7ec0295c34bd40bd8b4f4f94fa0fd4d5,136,108,28,Europe,16,1095.4
7ec3d0c7b4654459962d0916a91335a2,84,29,55,Oceania,28,358.47
7ec3d711320f444abf8a5f1dc7155e7b,285,250,35,Africa,22,1877.05
7ec4432eea01495db032fdf3ddae0bbb,336,297,39,Europe,20,2095.51
7ec7bf0d1b164e9e99baec9b4fc5a4a1,174,128,46,North America,23,592.6
7ec95cba628747bab07cf4b21c72029a,215,175,40,Africa,27,1297.71
7ec9f11ca3d5416f9bc4c22b6297d7ba,107,83,24,South America,18,729.52
7ecb489563e94304a27ba7debb5b8a99,192,147,45,Africa,18,1182.98
7ecc0684d4564feeaa03a5d6215eaf9c,203,176,27,North America,27,1374.61
7ecd2444954046629858c0d30f2423f5,287,251,36,Africa,18,2188.51
7ecee43732ab468e8928d6be0cd98883,84,58,26,Africa,16,607.98
7ecef51ab9d84e2ba5c30aef1b6886b9,88,55,33,Europe,17,695.65
7ecf0fd6ff494bd5ad8928694ac29636,356,326,30,North America,26,2509.13
7ecf6760ab194d4a86d6bd387470b574,157,109,48,South America,21,696.38
7ecffbe6dc134f30bb03f44bb9936d8a,292,253,39,Africa,20,2288.34
7ed0e837e11b41d6be2f9f6986518c6a,314,299,15,Oceania,23,2073.56
7ed1025dae26486ab5a8f0e4f7b37b46,107,85,22,Asia,25,1033.8
7ed13df080594697bc6ac8aeb17f79b2,259,223,36,Oceania,19,1591.91
7ed1549b32804f208159b40449f56108,264,217,47,Africa,19,1607.4
7ed1a6524b914927810d2cb2337d1560,333,304,29,Asia,19,1598.14
7ed53706aefd4d829c0139d9d13baeff,174,128,46,Asia,24,626.21
7ed7b340bcd8417aa50dbb9e88760dd6,268,228,40,North America,17,1369.65
7edb6896dc9f4357a90bbee2e2e525d7,263,224,39,Africa,19,1096.07
7edc69bbdc284585afddbfdb5d7d3fb3,118,73,45,Asia,21,344.66
7edcc196cdc649698a145aeed3a42735,219,185,34,Oceania,20,1718.88
7edd6e58a616447c9d99b47d9574b8b4,307,256,51,South America,19,1681.15
7ede798ea1e14cf79047f4292ac8246f,116,87,29,South America,20,1137.87
7edefff0ca1f4763a561837b0198dcbc,347,322,25,North America,19,3497.87
7ee1e7ff0e31432792e010fef8c72be9,113,83,30,Africa,18,925.01
7ee23ab783fd47ae92bbda0873c0b87d,60,36,24,Asia,20,575.36
7ee3c47a07f24764ace48092a13c6074,184,140,44,Asia,17,1189.47
7ee3c621c10a4707ae1fdf7aaa9b1b02,327,298,29,North America,18,2636.18
7ee5c40e7c80411381cc5ec780b98d7b,316,292,24,North America,18,2351.86
7ee5dc297399401c9782b8f6023494ab,105,58,47,Oceania,22,471.25
7ee65683f8ad4c24a65b7821e4304036,338,307,31,Oceania,16,2708.75
7ee7664c096e4c71bbcece426c43b1ed,323,294,29,Europe,20,2811.62
7eeaa95cf1d546d8bca162ea942738b9,365,343,22,Africa,20,1443.53
7eeb616778424766bbb9a9e62191232d,158,118,40,South America,15,1004.05
7eeb7dbdf4aa48cab6e4ed6341465164,267,245,22,North America,18,2320.92
7eef28be9dfa43d4881eda91174c77ea,117,91,26,Africa,20,600.75
7ef0eab9c1de4b3c8b3b334576a2cfa3,251,225,26,Oceania,20,2124.04
7ef1aad810bd414882770d029d136a3e,151,104,47,South America,16,1197.76
7ef29b00f5b2408cb6134b5a86034e34,166,159,7,Europe,21,1269.73
7ef31353bfd1432aa3a977a2f87b1b69,335,286,49,Asia,19,1354.39
7ef391d1e6df46d1a80489fa31cf3c68,332,302,30,South America,20,2297.83
7ef57a742f474fc59b13f353a17b0b53,356,317,39,Oceania,18,2697.55
7ef7bc1cb8ce4159a020cd44e18a893f,39,1,38,Africa,23,285.34
7ef8aeb5989341a1b0c764647099833d,235,190,45,Africa,22,1766.44
7ef9d7940654479c90e0783aadf022dd,323,305,18,Asia,19,2560.6
7efa3f3a26364f6fa979af6a41f75063,323,280,43,Oceania,19,2695.43
7efd1585364f4bf4a7c1ce6f6d51dde8,56,12,44,Africa,16,104.05
7efe6e80e00b483f80b05c8cb47ba497,246,194,52,Oceania,16,1155.55
7f035d6daa494275b72eeda0c975692c,154,121,33,Asia,18,800.3
7f03d03f65c04734b654c7e5a78f18ab,324,275,49,South America,19,1089.4
7f066fdb33cf4629bbee87619451b6f6,287,251,36,Asia,18,1417.88
7f09b5bb93a042e39c4b3c99e5f25c76,97,69,28,South America,18,277.28
7f0a6b0ec7cf439db6416a3ecd260f3e,255,209,46,Europe,22,910.98
7f0b6998824249abb167d45c83a608b9,102,41,61,North America,17,388.47
7f0e3471b0614ee09d71240208b314b4,365,333,32,North America,20,2811.85
7f0f8d4d80cc44fc9c9794081a6516f9,234,183,51,Africa,20,1027.75
7f14e57ec18b4786b7c0aa0f360b278f,317,263,54,Europe,22,1035.93
7f15d182377e4a1ebcb7e3e3fd9e5bc5,365,354,11,South America,19,2605.51
7f172574d5c449c7aba933110c6789a8,346,319,27,Africa,21,2373.82
7f19aa8060a542c7992736c14be6772e,250,229,21,Europe,20,2095.06
7f1ad1a31a0448129849cb853532d5a3,155,121,34,Oceania,24,953.46
7f1e3cb40071491fbc37998b8a3de576,96,73,23,Africa,21,783.48
7f1e7d9b504c4756aab082b6ce19b15d,335,301,34,North America,17,2101.77
7f23179ac3ee4ee09fa9b54bef4fca7e,102,71,31,Asia,20,457.58
7f24e3ffaa85423bb9174fbbab001d1f,361,330,31,North America,16,2572.14
7f25af9c5cae4afc8c05184b88af7a37,143,94,49,Europe,17,690.69
7f26200f3fe7459784a9a2d13bb93455,138,114,24,Asia,20,648.06
7f28a787c9db4d2d883f591b81c585fc,359,317,42,North America,19,2136.75
7f2a138d6ec34445b1f6a156eac189bd,66,33,33,Asia,19,368.72
7f2ce466e76648abad544834e6127299,160,109,51,Asia,20,1060.5
7f2e4c992d9d4ff5ae4c46d4be57e4f1,343,296,47,Africa,22,1515.25
7f2f3b6f481c46f2a0d2a2bd955936f9,358,319,39,South America,22,2111.14
7f2f4637f79c4a5f8bb857c442218a1f,65,42,23,Europe,21,440.12
7f33c277c5bf487da145e7ecbb5df4f4,63,38,25,South America,21,622.28
7f3608cefc0c496a88a5b7a0870fde88,58,30,28,South America,21,408.12
7f3609919f7b44cc89f43aabcaadcb75,199,162,37,Asia,21,1327.99
7f361945598f41a58398463bd4874b26,257,225,32,Asia,23,1765.25
7f3650eefda04fc19db5d66022e0dc53,294,274,20,North America,23,2471.94
7f36cc11529a4b1281c6f7461f6a67c8,138,100,38,Europe,26,769.55
7f3849be4dcf45039b094e7377e490b1,314,263,51,Europe,18,2000.13
7f3933ec74664332a09bdcee45e78fdd,213,176,37,Africa,15,1141.26
7f3e0200dfba40698bb8680949196953,290,251,39,Asia,16,1908.5
7f3fa6ac354a46d4b3a99c9dd318306a,170,117,53,Asia,14,1018.28
7f402db1a8ef4ea188367517ddec195c,322,289,33,Africa,20,1961.48
7f414cb2f2c24b51ac60494b3127a930,363,343,20,Africa,19,2591.07
7f435f99f7314c97a880d95e1ca5aef1,304,265,39,Oceania,19,2663.09
7f439c78886b475e94541293af727bc8,254,223,31,Oceania,24,1623.99
7f43ebd4d82b49eca4dd07ef7216b6b1,354,319,35,Africa,21,1607.77
7f440d93f2df4db2865929473ab0ac3e,117,96,21,Africa,22,1051.18
7f446f19f68a463c9f059df7851d7e53,247,210,37,North America,16,2143.31
7f4478dbf5744a36b96144b19212e16f,320,277,43,Europe,18,2106.09
7f448709cf1c44be9a6ae79e6c4a7669,363,355,8,Europe,17,3541.53
7f44c65b023c49938d25fa9305470a37,338,310,28,Asia,19,1874.48
7f452e5494ca4822a5f8e3c3ea9d8f9f,340,298,42,Asia,15,1559.83
7f462ad12f704132acaa12065d159ebf,257,238,19,North America,24,2457.03
7f490e86302b47f6aa99db1a5b6adb02,54,19,35,Europe,20,261.36
7f4997fb353a44a9b68ce9ee9fba7759,103,51,52,Europe,21,429.58
7f4a261eaa9d49879e5268b2900d9371,312,266,46,Oceania,21,2022.25
7f4a4346ebf4462da8366514a4c880d1,302,253,49,Oceania,20,1265.57
7f4b38104bd64ab5a015469eb23c41e6,328,285,43,South America,20,2117.6
7f4b5d3a2a404af88aa5c2cae69cfe32,98,48,50,South America,16,226.74
7f4b9a1377d4479c9ee01e6a85f6fcd4,232,206,26,South America,25,2057.77
7f4d87c3670045d5906148e6a356be68,321,290,31,South America,23,2105.3
7f4dea08cf5341268035e51baf095876,273,238,35,Oceania,21,1466.77
7f4ed043407d4ef8abff671a37740a0b,106,81,25,Europe,18,494.28
7f5120a7735d4fecad343647f67c646b,244,190,54,North America,18,1113.2
7f53b643aaf84d0fae3ea79dd714af30,256,205,51,South America,20,1013.49
7f55869bfd6b45cdaff8e57864c1c394,141,113,28,Africa,23,833.8
7f5617b1a139402b998a17938bd9d2ad,324,304,20,Africa,21,2676.75
7f56459fcfb1414d8a93a55481a6770f,186,151,35,Africa,21,1206.84
7f5773e1c4944623bf458c64c3c4156d,64,15,49,North America,23,638.81
7f591f9a66664dc6906e1dc2bfb7541d,30,1,29,North America,20,132.49
7f5f4e95dd4647bb8b170a7bd671ee79,333,305,28,Europe,21,2611.74
7f5f658d137841f897227f61fae536cc,89,31,58,Oceania,22,494.52
7f62ed35059a4fa6b56819c77fec7448,190,151,39,Asia,22,1319.92
7f62fe01d2e3451ebadb3d63ff49d02c,358,336,22,North America,19,2523.27
7f6561f5779c449ba8916af1ac30ae0f,365,345,20,Africa,21,1984.74
7f671ad1a8414276a58047fddb7a704d,52,1,51,Africa,19,488.62
7f6759ef5cdc41d2af628877a0f13edf,315,286,29,North America,18,2424.02
7f6a9146793243509c7bee8b51d53fd7,306,263,43,Europe,17,2131.14
7f6c0c889ca24da095c32aeb8189eb01,237,217,20,South America,14,1111.87
7f6c473e42ad4b1e87b90be9453c1e48,105,82,23,North America,18,725.64
7f6eb0d127aa4782b1d7b380b470506e,223,185,38,Europe,22,1667.72
7f738b8ff9c7437fbaaa2619db0c345c,241,202,39,Europe,20,1841.55
7f755ff63a73442cba70ee8bb714de8e,322,287,35,South America,21,2323.08
7f763f0a203a4977927f3f2e7af01d12,142,102,40,Oceania,14,757.06
7f7887bd0d8b43b285d884522e59703a,339,292,47,North America,20,1541.2
7f78f5a954ae4b2c80caa125f0812cc5,326,291,35,Europe,20,2294
7f812ce194ce42f99a1d07e220d314ab,172,134,38,South America,24,1411.21
7f843219c02340a8bb47c881b31b69e4,250,197,53,Oceania,23,913.23
7f851ced04364a99bc9289fe862c5ccf,78,35,43,Europe,18,1051.81
7f86db7b25df4459a210d63572c7098c,365,327,38,Africa,20,1500.59
7f8a02a9717a4b33ae15c38dd967609f,126,104,22,Europe,21,986.05
7f8ab39cf22141a38e16e54ab7de48bf,321,294,27,Europe,15,3001.48
7f8aca7ac9ec4c4a9778c48203118cff,97,75,22,Europe,25,982.67
7f8d4444c6564a638bbe6f6f5879d51d,224,182,42,North America,15,1142.03
7f8fc0c1c041486485a1d0b51dc21eab,286,267,19,Asia,17,1793.15
7f90aa03e2324d169c6d434ec3cc425d,48,20,28,Europe,15,214.43
7f90bd5e9f6a4b549025d3357e3a775a,247,225,22,Africa,24,1936.42
7f93848cbf654dd486dae9d649a468ef,313,283,30,Africa,23,2380.68
7f944d4dabfb4ff5872235f0979c8a79,182,138,44,Oceania,20,1110
7f9554d03d054881aa0bf8edd9375b1b,280,245,35,Asia,15,1773.68
7f959630aa134b9c9794617a3f3c2700,363,359,4,Oceania,25,2529.28
7f95ae58fa30431b9251d7caa40f562a,101,73,28,Europe,20,796.07
7f985537c134420b9d8255a65c7ba25a,60,30,30,Africa,19,745.64
7f993359365d4fab82796cb62355acdf,149,125,24,Africa,19,1219.71
7f9a3d1f55df41e3a3b3090bdce776d2,365,323,42,Asia,19,1477.6
7f9d82d375804c7c8ad3baeae63e85e1,245,200,45,Africa,21,1012.24
7fa0ec1f20a743998dad0d5169e2c776,257,233,24,Asia,19,1941.76
7fa34e4d265f4435805f23521c4568ee,204,172,32,North America,19,1370.81
7fa4740024ba47b5a023569e51f18c85,58,39,19,North America,22,533.61
7fa5a62bd96a407283e749bc3116da21,239,191,48,North America,12,1299.26
7fa71f370f7c4c3385f45ed8e9f1a50a,230,190,40,North America,17,1822.65
7fa84e53e7e54971975991df45f71dd2,162,117,45,South America,18,867.37
7fa990dc473b4dc7b500cb484d9e7dbd,142,94,48,North America,22,592.04
7faa13ec3b9949ffa45fba7823a9d0a7,189,131,58,Africa,19,1288.96
7faa200e27644d6fb6a8ef188525b0a8,203,157,46,North America,23,1399.67
7fac4f4a6e27491ebb3979bea5dadbad,247,221,26,South America,19,1521.38
7fafbe48bfed4561af87f0ece89c00bd,365,340,25,Europe,22,2581.87
7faffc43576c4c82a73ce30655f5d0d8,205,165,40,Oceania,19,704.87
7fb00ea6321045d9b0c5e5e5523f02a4,68,43,25,Europe,24,457.93
7fb0a2c179c54ab88e8d4e39c4661be4,65,18,47,Europe,20,300.25
7fb0c811275b4767b6ab875d3d7cd526,53,2,51,Asia,22,212.3
7fb2a4fa6ec54ff1a4ae53ceaeccf43a,82,32,50,Oceania,22,374.35
7fb4408efc104490b6a9f664dfca6892,284,261,23,Oceania,22,1690.42
7fb7bc4f3d2f467b8da7923cb0aa1d91,362,357,5,North America,20,2165.33
7fb8001f7535406fade95478d157daaf,74,50,24,South America,24,647.69
7fb91dd692a34ae3809ee0f080c20864,53,7,46,Oceania,21,227.33
7fb996c9e6724cd09399673216f5fa19,323,298,25,Oceania,17,2267.99
7fb9c1e4445343e984cd0a430d55fea5,303,280,23,North America,23,2524.49
7fbbc0f17ce946aeb4ca7dc2b78c0046,261,235,26,South America,26,2281.13
7fbd336e48a7445f93fcf525bfc55d81,364,349,15,Asia,20,2768.47
7fbd4a38d0e54863b89997070c181d25,268,219,49,South America,19,1865.14
7fc04bd72efd40279260822d8751c291,240,212,28,North America,21,1894.6
7fc3e0aa5aac4a25913b037c27239573,68,38,30,North America,18,535.42
7fc4c9029630498ca7d148a6b3c25352,316,299,17,Asia,17,3102.71
7fc5278853ff4926a046d0b9c3918c9e,365,356,9,South America,20,2496.44
7fc7897710a84d7992547c0b5ac991c0,310,252,58,South America,20,1319.79
7fcb7b343b0042559e25ed8d92b4ae56,197,170,27,Europe,17,1753.6
7fcb96824baa4f76b627f984b6b1b7c6,362,332,30,Europe,16,1613.93
7fd029ca3def4adda939b32c3f9c4d23,177,121,56,Europe,24,972.18
7fd34ecf5d9a43bab55c95136c406406,226,201,25,Europe,18,1835.9
7fd36640f173406fa28b07ddc20da59a,196,160,36,Oceania,20,1248.67
7fd3ed8bcde14ed3be8fde8ccfcfca1b,342,295,47,Oceania,28,1574.55
7fd75474694b446eb5fb91a4b646eebe,256,213,43,Asia,19,1156
7fd9a8e8873c481ba60ac5216ce7ed1f,81,29,52,North America,24,294.93
7fd9e335467a4ad39c426c7e4c50354d,214,161,53,North America,19,932.68
7fda36ec41114317adad02775190b21a,125,79,46,South America,19,641.11
7fda690d2a2e4077aef23ea86dff3283,292,260,32,North America,20,2792.09
7fda7ad40b2f4f47b726ecd4448b4af2,365,360,5,Europe,22,2045.03
7fdcc1d6e02c47d4a27b836575bd8610,286,260,26,Europe,22,2147.84
7fdcf079358d46ae9334584839ced67a,130,103,27,Africa,21,999.75
7fde6281474e40a98ddc99c131715b71,114,58,56,Oceania,25,911.88
7fdf2a22e32f4af7a933b363b58b8338,78,32,46,Africa,19,399.33
7fdf62e1a4a94fe5b0a41a72bc8ab3a5,283,229,54,Africa,16,1530.64
7fdf98ea3098442487067eefe0908e8f,120,94,26,South America,17,1036.25
7fe0fc4e9579414b9cea451bc4eac7ea,43,9,34,North America,23,568.78
7fe117eb116f4d56a7bcef5f86ff1ed5,216,179,37,Europe,26,1596.16
7fe1b4a2330c4974832ca025c716050d,135,110,25,South America,16,672.6
7fe203937b224f8a9d65812fd0d55f9f,132,107,25,Europe,17,932.18
7fe2bd46b4794680b12c899937a90c91,337,295,42,North America,22,2128.06
7fe4c9d1ac69492f868a15b952bd8fb5,107,81,26,Asia,18,755.82
7fe53a00129e4c30bb026b96d3f59465,331,293,38,Asia,14,1628.52
7fe65a55e37d4506ad55fc53fcb12c0f,344,313,31,Asia,21,2638.78
7fe743012b8e4114a7e43d1c8285e102,292,275,17,North America,24,2412.27
7fe8143eee524644ab054c9eca1d2987,112,79,33,South America,19,525.98
7fe8fea0f9844a74bb774f530b5a3c42,210,183,27,South America,16,1454.01
7fef752ac0024b09a3c48b565cd1216b,63,27,36,Africa,24,535.25
7ff673c302964cf391660b83f214f114,102,88,14,Oceania,24,1039.16
7ff7ca38c1434fd68fad0c883ca35ff1,317,290,27,Asia,16,2241.41
7ffb20d441ab4f2eba2600ed7dbb9922,181,151,30,Asia,22,1147.37
8002e28d9fe943be8c9f6d1c8288dfbf,70,29,41,Africa,19,502.96
8004efc423c44fcc8e1cb334d22bade3,264,226,38,Asia,25,2135.5
80058f881f18489f91eef4a3a48f7fd1,80,29,51,Africa,23,390.44
8007181f8300489096710f54f2edb893,137,110,27,Asia,21,893.63
800748c733cf46489ebb358656f3f204,123,89,34,North America,20,956.1
8008ebd7478347aabcde0cfd002db5c0,83,47,36,Africa,26,546.29
800df08c60404c12b31fd70fda2e186c,131,90,41,North America,25,889.48
800e104526c84edebbbd320256d2b7c5,300,279,21,Oceania,20,2619.26
80118c94161840cc93a1757c1ab98f23,146,107,39,South America,21,769.53
8012ada7855445c78981acad0fefa285,58,8,50,Oceania,16,139.39
801417f7a88e4c659d10031ed63df8cf,291,245,46,Oceania,20,1691.18
80156375dcb34461b837319e84ed2766,313,280,33,Africa,22,2958.41
8018a6d82c044499a868cb24b26286cc,235,204,31,Europe,22,1679.28
8019965f1d3d404e918ee29c2bc1318b,210,186,24,Asia,22,1788.54
8019bbad3b7b42d7a0abebcc8faa1e37,55,30,25,Africa,17,442.91
801ab84dfa224a19ae62bd82b9f1abfb,358,324,34,Africa,21,2381.19
801b464bc8c14ca693bfe5be4fd26062,250,223,27,Europe,19,1377.84
801bd59625fb42dc990b36d8084a6572,137,107,30,North America,19,1062.2
801d7e242d24485db19ecad63fcfea7e,320,289,31,South America,19,1878.43
801ed62651164d6788dfd51fdd1e60b7,47,2,45,South America,16,347.59
801f595e50fa41adb4c7bbba419419e5,110,78,32,Europe,16,879.36
80217453014f4cb7823595245d9e5712,110,83,27,Oceania,22,724.66
80230fbe532844eb9772026df3cc1509,153,113,40,Europe,15,1241.38
8024eaa890364f308e1b0158e7f19c08,225,177,48,Europe,21,937.88
80261a34f53049dbbfff636098d2ef8c,117,69,48,Africa,21,872.29
80281853078f4ee8951a9691af7cb47f,71,30,41,Asia,19,395.09
802c5cf4ce20484ca912eae32a8080a7,285,260,25,Asia,20,1943.33
802c89b66c8d4a3dba9a3a44776b6c8d,350,320,30,Asia,15,2641.3
802f4e6f97a34673b2d8d88c418c28f8,364,335,29,Oceania,20,3095.48
8030117330894c4e99c6fcdacfebeeb5,364,356,8,Asia,22,1796.79
8032a717ca1a4cebaa65f5b37cb78dc9,365,342,23,North America,18,1797.87
8033e7bd0b5449c08e86bb9879b097f2,168,139,29,Africa,18,1423.07
80343bc46b824880bfe16e0fa9c94ce1,189,167,22,Africa,20,1486.25
80349b8ede324dbbb5bd00426ed51d94,61,29,32,North America,19,505.35
803782ccdd1249e489aa9444f0ff01b6,81,64,17,Oceania,14,479.02
8037acf150ba497d9512a580e01554cd,326,307,19,North America,18,2527.91
803adb2a0142436fb1dc6220072fa56d,159,143,16,North America,16,1418.33
803cc783050648eba3b581994f17753e,274,242,32,Oceania,22,2394.7
8041c35387704cbea3b43fb1f619f655,341,293,48,Africa,20,1776.73
8043af92a6d44d2aaa73e20f0b3a5c5a,327,308,19,Oceania,18,2307.83
804667d04bbb4f02a973eef8343293b0,312,286,26,Asia,21,2533.21
8047b4aa7211418799370725ae119f89,303,288,15,Africa,18,2338.26
804ec547cd77495db16e7c83092aca3f,365,311,54,Africa,21,1747.17
804f7f5cc5004c8fb6c2adc8115a4579,138,97,41,Asia,22,913.52
804fabc7bf3342c6b1d6e34b60dd13f9,316,298,18,South America,17,2092.56
8050696aacd74769824814f03e72ac79,227,189,38,Oceania,17,1469.13
80515c3ae9ac4c15a2cedf13bddcd536,72,29,43,South America,18,328.74
8053625f190f4115866c3a644f0ac5be,46,4,42,Africa,21,124.33
80562b06926147338313d71f86992e10,97,64,33,Europe,25,604.7
8056a969f61b47988ff8058cf60a36f0,78,29,49,Oceania,18,205.68
805a4efa78054ad6b4559826c353c330,72,32,40,Europe,14,452.24
805baa36b01842099746f9488600a180,304,277,27,Asia,16,2426.58
805bf84ea346419a8e0cb5a87861e06c,69,39,30,North America,22,663.61
805e5921497e4d5490b490b41d1f2a90,283,251,32,North America,22,2243.23
805eee59aa0449f1a2907a9d3ce6c5a5,138,95,43,Africa,21,909.94
805f3ab6a56147a592f6243033d41e5e,365,321,44,Europe,21,2001.74
80614f7edc024a869b11a364dd275e71,198,163,35,Africa,19,1191.67
8063a343345e4e13854e76b81718d15e,90,38,52,Africa,20,501.86
80640adc89414e2f9cae6ae8818c559e,200,157,43,North America,21,802.41
80671a7e87c24132a66371da42d8e621,102,57,45,Asia,15,654.48
8068f7de844441279ca9d96b27abbc35,279,255,24,Oceania,18,1788.64
806a0634a8554ce88372b0b1d3e98597,182,139,43,Oceania,19,1252.19
806a0cf86b9d47c292519aff1c2d7fbf,365,345,20,North America,19,2813.23
80712888de4041759dc76890c1e33a9f,73,14,59,North America,18,681.77
80720db30c724644accb4722ae9d5542,351,314,37,South America,16,1991.08
80746fcf4497444a843c5c1e36ddc3b0,146,117,29,Oceania,21,1413.91
8074dc743d374d33b2e3b88d8c906154,188,157,31,South America,21,1895.7
8075e0a63c08412e816dc7ca54f85e14,67,32,35,Europe,17,477.1
8075e1a80aa54f6a9843c59920b90607,355,342,13,Africa,19,2691.78
80764614e2f34c2fa2a587cdead2412a,364,364,0,South America,22,2948.54
807835562bfd469eae723696c4ab0090,252,204,48,Europe,15,1518.65
8078ab461e694549b652a388e5c18822,116,88,28,North America,18,1050.59
8079caaf429c4525bff730ba0343489a,220,198,22,Oceania,22,1698.69
807afc6ae03546158f09c7d10977b74a,139,112,27,North America,17,1172.49
807b5adad3ca49898e0ae35bce4b4ac2,171,124,47,Asia,24,1396.78
807ee8a0bbdd4bd1999e36281a2aefbf,193,165,28,Africa,19,1479.31
807f37ab58184256b0a011e68bf62eb9,152,123,29,Africa,20,697.68
8080b48a6a584be5b017cc78c40c342e,333,293,40,Oceania,21,2448.91
808402389e394950af45d71f82f33f45,234,186,48,Africa,24,1302.02
8084117efbb841f1a588b7d368d0833e,310,272,38,Asia,19,1863.04
8085c66e638a47c6bb316c372adf2fa3,216,191,25,Europe,17,1698.29
80874dae2b994dc18b51bcb369dc0fd5,147,96,51,Europe,13,666.5
808a6b2808c44b70ba5ddd5b92106d0f,134,98,36,Asia,14,722.87
808af38691f74f748e43be3c40fee3a4,320,269,51,North America,19,1875.13
808fc17ab9c2473a9ca6affdfe35219f,45,6,39,South America,18,725.33
8091b842040a463c992a556a5c1d060b,171,147,24,Europe,20,1041.4
8092871350a142b38ec4679f0b3c6485,208,163,45,Oceania,21,919.39
8093cba2773f4096ae2e2f069ca29902,308,276,32,Europe,19,2386.55
8093e7200bf6415492cbfe281b67cf11,230,185,45,South America,21,1355.34
80950534e9aa447d8254139fc1d26783,293,277,16,Europe,21,2585.63
809586f471a2419e945b0cba61ff3d7b,120,67,53,North America,16,370.49
809858420e424db5b6e89553e7303df7,365,355,10,South America,18,2289.04
809a1f2da6d946ffb7ff4f162c30ec0d,364,337,27,Oceania,16,2238.15
809d53504e4643e6b667d32e9c1bf837,290,245,45,Africa,19,1341.71
809e181b306e49ac808f5f4a5364f0b6,189,143,46,Oceania,19,961.81
80a0d5cd92374d48a20c61eaa77acbef,365,323,42,Oceania,17,1906.28
80a48c0f5b8a4a1cab8d6e6c3225c3b0,364,364,0,Europe,19,2417.27
80a5957ffceb49da9aa7a47c388da4cb,134,113,21,Europe,18,1366.6
80a6cac64d3344488da463c5d6c3c054,112,82,30,South America,13,977.76
80a7213044d14cf58d38684fdcdf30b3,130,84,46,Oceania,24,278.29
80a8b5e9edd545a38f052d80f47845e8,81,34,47,South America,17,318.6
80a951087cdf4b5ab1e8ac50c0001ed1,321,292,29,Europe,22,2460.08
80ab64401a4447c2ab0b85d5698a0d9e,48,4,44,Africa,20,385.22
80afb103064b4cda9ba860808936914d,160,121,39,Africa,18,386.13
80b24f4d8f3e4447b0f9a177c9172479,232,184,48,Africa,20,1395.49
80b31859b7e143008a28b438d25ec91c,150,94,56,Africa,24,701.78
80b339005f5941238d5c0605fdb2228d,278,244,34,Europe,28,1591.45
80b38ababdf24f70ab43945b3ecfca2f,324,271,53,Asia,23,1360.14
80b546793aa44766b74b278ad1325271,82,46,36,North America,19,629.19
80b637c1041a4b25977180e7397ebc52,149,113,36,Africa,24,908.69
80b97718a83e4c9da6ad3c9243313774,99,59,40,South America,18,638.59
80bbcbbb991d429ba792cfb1832a8dfa,298,260,38,South America,16,2246.06
80c1dce070374a64be359dc6e71bb99f,40,10,30,Oceania,18,243.31
80c3436ab0ea45c9ae0b83b08daffa03,216,181,35,Oceania,21,1321.03
80c360882cdd49e082aae2673160e60d,261,209,52,Europe,21,857.55
80c50684c5944c4b973d784f178ad27b,365,363,2,North America,19,2117.56
80c6ccffd6c3482f83006e9c1a88385b,332,282,50,North America,20,1916.95
80c76a4cd0de4736a1887f8ab0fcffe0,362,346,16,Europe,20,2173.71
80c80eacbbfd4c17a772bd75e06c29b0,188,134,54,Asia,22,1454.84
80c8d7db134f4445b1b4f64f2f9d4c39,145,107,38,South America,20,849.68
80c90480697f4ceeb407b195699d9557,291,268,23,South America,19,1619.12
80cc88eabb274e4981382d851c5ece5a,184,143,41,South America,23,1507.89
80ceb401acd8477bb1fc7809ecca9828,215,185,30,North America,17,2026.74
80cf9c3a92d74fa8adfc2002d3b923b6,46,11,35,Asia,20,298.83
80d1a72fca994e0cbf3cdeb61a8d4f41,349,304,45,Africa,24,1413.81
80d1c3b783e84fb3875f5ddbd2266631,95,50,45,Europe,25,355.65
80d4b3469a184813a4a0b3b729caec9c,349,330,19,Oceania,17,2196.12
80d5554082784c048b27321337e52a74,193,153,40,Asia,24,1718.24
80d5f3f858904e379415ef12d138526b,59,20,39,Oceania,18,182.05
80d687f3c2a349a5b33cbc8d09c3a829,116,86,30,South America,17,1338.32
80d79a14cd2841c4a5d914c2f180945c,119,91,28,Europe,17,1513.96
80d7a8cead0d4c4892b69a1160f554d0,211,157,54,Asia,17,1238.16
80d80c4919134c13bc4fc124e35445f2,114,74,40,South America,23,857.37
80d855fcf61c485181e413e87a242e01,94,56,38,Oceania,22,803.32
80d97b5498de49b39da90218380593f6,174,121,53,Europe,22,1148.17
80d9e640c1aa471fb84f1c87e2e04bf4,71,21,50,North America,22,538.71
80da4b3ca7b54a1088073a82bf6443f1,334,290,44,Asia,23,2207.78
80dccc1d4b8841f593af8001466d780c,256,229,27,Asia,17,1760.1
80dd53b9a4994fcc9f67ec0816327609,365,325,40,Europe,17,2441.97
80ddadc96bcf4803921b9a1e5df86754,319,276,43,North America,18,1586.72
80ddedff7b404f7b99d3a54bddb1ed56,92,62,30,Europe,21,403.04
80de1cabc30649328f0a98228e7fef36,268,244,24,Europe,23,2488.43
80df1ed0f41647c1a45e77ec623bd8e8,298,254,44,Oceania,23,1248.7
80e274bd748c419ba8b7e8dbc5a9f22b,238,199,39,South America,24,1537.75
80e8154e9fcc46d29a23b44d8a865930,22,1,21,North America,21,166.84
80e91090068d4ef99e6e4d54ea0e5fcb,120,83,37,Oceania,21,475.9
80ea536b24834532bf9666ddb0d6ce71,239,212,27,Europe,20,2727.54
80ea778b1f114eb585f955878b3355ca,130,82,48,Europe,22,700.84
80eaa5be549844eaaa7d68fde60d7c5a,169,135,34,Africa,23,1084.99
80eabd07eced4e9bbf26ed3b2494dbf8,365,349,16,Asia,19,1552.03
80ec2ad15d724ebf950e3f3faa3c77e1,62,17,45,North America,16,613.98
80ecccfbbda34683a838a95c5eb94bb9,181,162,19,Africa,17,1281
80edeea0637541f29a873c333196bcc1,189,143,46,Europe,22,790.8
80eee6e5b4574e399a49e71310e1f017,364,318,46,Asia,19,1953.34
80ef650fbfb84d21812ee0a0dc1c5dc9,332,298,34,Africa,21,2445.07
80efbe20419f4bd48ce58c2f25617df1,243,220,23,Oceania,24,1680.37
80f0b82d877d4413ad73e4967587c788,365,346,19,Europe,22,3022.73
80f241d48e0943d8b2f03faefab72020,215,185,30,South America,25,1853.21
80f2731a34334ea4acae02d836ef43ac,191,167,24,Oceania,22,1378.72
80f3819724e646d08bf6263d9af46235,310,289,21,Oceania,23,2718.09
80f394955e77494c93740674b78d4f90,58,11,47,Africa,20,416.55
80f5034394184b7888d133496c40b776,365,359,6,Africa,21,1822.15
80f74054854b41a1989fdb3dd971b865,76,50,26,North America,18,548.04
80f760e2755c4a1e9f4291c27233aa18,207,182,25,North America,17,2385.72
80faccfc4e45448eae924e142ae0fe54,301,267,34,Europe,24,2043.39
80fd0a8648af4506a0d966d2a2ea913b,309,278,31,Africa,22,2151.51
80fd45320a24441f9bea0dc263400429,365,355,10,South America,16,2244.47
80fd50852f6c4d3fad70885c264ccd8e,364,319,45,Asia,17,1641.67
80fd5a8e770b4ce78a92b2f777ef1b24,74,46,28,North America,17,638.21
80ffde4fbded48f8bb0ff9ae638b4ed2,112,65,47,Africa,21,208.76
81015ffc9a13430796724bc1231bc08f,225,189,36,Africa,21,2059.9
81029f12622c4d07b308c1dd25825e99,132,94,38,Oceania,17,1174.2
8102b3fb6c524cd19cf487aa8b0d0f7f,365,330,35,North America,18,2905.93
8104ac669bb4415c8ae58b06d604c546,220,164,56,Oceania,19,1204.63
810507a8e60b40f79371b876b52a774a,228,205,23,Europe,20,1543.97
8106b203b615448b865c645c275d9697,267,218,49,Europe,18,1815.12
8107b2eae6074ccdb832457cee445782,134,89,45,Africa,17,1013.86
810abba46d8b4661b00da18974aadb7b,80,30,50,Europe,19,125.59
810c1386275244c086d77eb2e98bee9c,197,170,27,North America,19,1334.39
810c6951fc5b428f86ec97d5155571ff,170,131,39,Europe,25,1385.19
8111049206114692a64a99d3e60835cf,254,203,51,Europe,19,1273.97
811238f4d2e44a968042cf635a531fb4,356,327,29,Africa,18,3026.23
8114f891b88740f892067d2709fdf557,362,330,32,North America,22,1741.47
8115c86d65424b17a13349f97dfd201d,177,150,27,Africa,14,1590.43
8115ee505a6e414e84228b32c58117d7,364,323,41,North America,21,2773.55
8119c1b7b2c64c31a171bd508cd05d16,299,268,31,Africa,19,1831.22
811bea40121547ea8a92123368a8cac5,301,277,24,Africa,19,2259.97
811c4bfe767e43c38e9e1f736d30c3d2,328,285,43,Oceania,21,2663.49
811cdcfe56794c0b9411f12befd1907b,262,239,23,Europe,20,1737.09
811f6fe73ba440e394c572705e5f64c0,179,130,49,North America,18,932.86
811f747004c64e39b1f2b4a01506ccb6,59,20,39,Africa,17,182.59
8120503ab46f4d82bc22f056dbde7be2,251,230,21,Europe,20,1561.72
81208eccb75f437cafed98aa5b277a8f,72,36,36,South America,18,273.35
8120e7cb054445d59f4a565540b94353,357,331,26,South America,25,2833.22
812271109812454291ef3c553bc0d8c3,347,327,20,Africa,21,2905.99
812334fac24f42e29d3fc7e442d26451,286,252,34,Oceania,17,2172.67
812bac7937434e9b9e8108c5e3b78e53,173,148,25,North America,21,1226.44
812bfe6d0af64215baa0ccca7ce9a049,311,260,51,Oceania,14,1661.99
812d115563554dc4a27c751c2be16876,167,133,34,Africa,20,1783.69
812fb13ff7bd4081adaec820edce30a4,326,292,34,Asia,14,1364.12
813163130ce44cb5aaf0f9c290c4f21b,234,214,20,Europe,19,2030.56
8131738adf564981b15b5f8ea654d879,276,250,26,North America,18,1848.04
8133f215920b463f99904775040769b2,326,275,51,Oceania,19,2261.05
813699228865444abbf0ab4379c5cbb2,259,226,33,Africa,20,1762.59
8138d7c417cd447f81366a480009bb21,77,43,34,Asia,19,359.97
813af739431f4556813ff05ce815f912,76,52,24,Europe,18,669.77
813b60f86a1e4695ababf1e5f7b6b88a,106,61,45,Europe,23,592.48
813d26bb5f2243f6baecfdb3e545461a,84,51,33,Europe,22,723.73
813d6a333d1d43218632a41fe48d691a,362,341,21,Asia,18,2431.69
81403d8be5af4d2e8c9d5af835c841c3,45,24,21,North America,18,530.07
8140d7487d61416fbee21d4d9f8bcbb6,124,76,48,Oceania,18,834.06
81418b60399f41dba5f96e7491388d54,361,352,9,Oceania,21,2814.76
814217fc40ad45a8be05df3407cddd25,141,108,33,Asia,22,1249.46
81424ce409c54b7e9e534058fafb136e,365,343,22,South America,23,2405.93
8142df63c2a44b29ae8777dd5696d5b3,365,317,48,Oceania,22,2426.66
81439bcbab6b48debf8b0a41522f63f0,121,69,52,Europe,15,589.39
81459f4c61b242a7bbf39c848d8d5998,90,72,18,Africa,20,643.93
8149522ecc094f26bb7bdb70aae9129b,195,152,43,Asia,20,1296.51
814a406ad66f4cb885889faeb0226798,218,184,34,South America,21,1121.57
814b3c5b7f0047c2bba740e3d306c9e7,239,218,21,Europe,15,1326.15
814cfb450b7a4477b62e22faceea7f09,140,102,38,South America,23,1020.07
814e5adf8ab04006a0ebcbcaf4b2b75d,298,246,52,South America,20,1452.46
814f611a18fd4f22b17406ea61900ef1,245,229,16,South America,23,2382.32
81507800d5bf4ce39fe33c8876b92cf2,364,321,43,Oceania,20,2258.77
8151d752196047bc8996a2efe51adf03,131,92,39,South America,24,1198.88
815233bec378494b925db3540a0e7ae5,365,357,8,Africa,18,2965.26
815457ca30ea4a14a7284308b8eb8219,163,112,51,Europe,26,765.75
8154f448de6a4197bc6d489aa3ed7a72,271,239,32,Asia,24,2013.29
815529ffa76f4ee291eb6e0158ff0b95,302,266,36,Africa,17,2284.96
8156b8202b3b4dba9c4c3f77a1a6232f,169,139,30,Oceania,12,1205.47
81571756c6444bad900a6a61e62bc5ce,47,4,43,Europe,19,296.48
8158c887cd4440f5add6c8f8212c4a9b,76,31,45,South America,17,619.13
815b8d121e584889b55fcd6d2139008c,365,332,33,Asia,20,2442.03
816145e9456b4566ace453c77682715a,305,264,41,Africa,21,1695.83
8161fd9a2664435489d040ebafe3daaa,62,10,52,Africa,22,183.19
8162e493e68b4af4a2bfa675e13b0b8b,322,294,28,Oceania,14,2536.96
81632d6a4d6649f09ec6ab3a5ba57d4b,319,290,29,Asia,20,1762.36
81659621cf684e7fba2ad5e606849ca5,364,330,34,Oceania,23,2623.67
8165d3f9855a4006944993fbb0838e2d,311,261,50,Africa,16,2136.01
8166f0a5ada74c64a072b23276ac1f6f,333,285,48,Asia,21,1668.96
81670c8756b243b281910b78b069ea65,303,282,21,Africa,15,1947.89
81675bfa85444ea184e4f281f472ab65,365,339,26,Europe,14,2662.9
8167af71484a4cb3a9695ca47dc471ba,364,334,30,Oceania,24,1846.44
81680a540af24d33b754e221868f7b83,130,81,49,Asia,23,763.47
81694fdb7c644b6c8643a711e5c925ce,87,41,46,South America,26,514.42
816965d20e254a81b83522b8e9ac2894,333,294,39,South America,20,2543.91
816e993ff76145118bdb6a59713a4a52,288,267,21,Oceania,20,2361.89
816fc795e6b04988a1715141bcd49d4b,350,313,37,Africa,22,2574.33
817203a66bea4debb001b689b2d3755d,182,130,52,North America,17,971.2
81720935fec348b0abd9a7df6035e77a,263,231,32,South America,18,2199.49
81776b3d3dd040a9a155d46a4d7204bd,58,11,47,North America,19,319.94
8177a4453b4b48cc9bb433da63cadc6a,244,197,47,South America,21,1623.39
8178678ea08945efa7f7fe6bfef245f5,48,12,36,South America,22,60.96
817af0cf163d43988aa4be71af371ea5,84,65,19,Asia,15,672.47
817b61f17ac649d9adaa82b7ea16e513,104,52,52,Europe,19,513.95
817bdb4e6e3f4f0caecf4b8bbcccc9bb,180,154,26,North America,21,1482.36
817e8e052df745d89ab6570bbf7d5a8e,118,79,39,Africa,19,760.87
817ffbcca28540a1951fe15f11173998,216,171,45,Oceania,16,1325.61
8181b334953f4e0a8dd504570d383073,342,308,34,South America,23,2591.18
8183a2ea80f54810849e86cbe8a465f3,110,75,35,Europe,24,784.09
8184546e1b044077a24edabca59ebaf8,363,345,18,Oceania,21,2383.16
81888d6b5457458e86888d00e759d3a7,252,210,42,Asia,19,1988.02
81896fb56c7548fa9588eeebd94d9628,162,126,36,South America,22,1416.7
818a42f4ef524e088fdefc1f1b11244a,358,315,43,Oceania,20,2829.48
818ca52b35c54868ad128d22ce32fb17,205,177,28,Oceania,18,2099.46
818d31c66bfe481282ea3731b3cb4c62,263,225,38,Asia,21,1638.73
818d530fed424780b8679993d7b002b3,358,335,23,South America,18,3339.07
818f0f92dc2f4a989bc118d8f086252c,307,261,46,Oceania,19,1494.84
8190dd595fa44162a777c8cba5d87f29,105,55,50,Oceania,22,841.58
81913ce4417c4c3cbd070c1b032f0de9,364,330,34,South America,16,2562.03
8197dd5bf5a94894b5dee148961bc087,177,140,37,North America,25,875.59
8199bb5485de47618a37265ba7fd03cb,208,180,28,North America,22,1131.61
819dac28567d4910bf815bd13ee92770,234,185,49,Oceania,21,1604.49
819e6b1c384f462380b0be6ca7344566,141,114,27,North America,23,593.52
819e830ce281437d93289adba00a4bc9,106,65,41,North America,18,407.64
819f52d0603f4963a3f6d23b08618230,232,188,44,Africa,23,1425.9
819fbe67cb6649ffa1aec466242a7f94,240,206,34,Oceania,20,1466.75
819ffc39656947e38f9483d38cc8bc34,52,26,26,North America,20,478.04
81a161dc4f4b47fb9fb6d2fa77d3c029,74,32,42,South America,20,594.79
81a1df7ffff5491f88fb41de2b500fef,253,226,27,Asia,22,1637.94
81a34aec33f345d0835943552a5f641c,281,261,20,Asia,17,2538.44
81a37a09cc43424199e2ebea9732f378,128,77,51,Asia,21,619.15
81a4c5f3aea342e4b972f568689553dd,37,2,35,Europe,19,280.64
81a4dd10d49a422799fa693d6f3dbb6a,235,193,42,Europe,18,1154.31
81a66a468bc64dd1a6e038620bb39c32,318,266,52,South America,19,2005.17
81a7bf3edac248319723027d4da4480c,365,359,6,Asia,19,2450.22
81aa3b02548a473faac81f0bb61947e6,359,316,43,Africa,16,1713.38
81aa852d47ff4fc1baebe2a7b5b0650c,341,307,34,South America,25,2793.74
81aa90589e1c46fcbfc8dcee3733532c,329,307,22,North America,21,3075.84
81aadb817be947589491499760b0b46a,241,185,56,Asia,19,1413.94
81abfe62226a4c49a64cdae07150f946,365,353,12,South America,21,2423.48
81afd8e1077f4600adced52ba58fa99b,306,258,48,Europe,22,1842.84
81b06d0ad9d745b4ac0e24f9a8467e74,267,236,31,Asia,22,1660.37
81b12d22d54141739cd11ab9118077d7,346,300,46,North America,15,1685.77
81b42276ac7c472ab8f4cad68430e7a7,189,156,33,Europe,26,1095.72
81b5e0e1a2ea4a63bdbef0227f0f99ae,307,268,39,Africa,22,1984.99
81b72c0a953a44cea130ebe108d28329,341,283,58,North America,27,1830.49
81ba22efb3544a59bfec7e25d14b375a,128,88,40,Africa,23,697.25
81bb285229a24b04b9f31e28a59ce204,200,174,26,Oceania,16,1253.45
81be981435f143c6a5aa0e3d35800571,364,326,38,Europe,22,2109.85
81be9b6fe7154c5399fad9bf0e597ef5,257,224,33,South America,17,1478.52
81c33a85ec10426a9ba2cdc3c55c575f,286,237,49,Oceania,23,1305.04
81c36435977d4fa6b6a4085fda350d8a,294,263,31,Europe,18,1737.92
81c6209caad6431eb50fe026a9aabd2e,112,74,38,Africa,20,571.86
81c75f06dc7c48be9b1a8190bb8cadae,364,350,14,North America,26,3259.97
81c8499704574664a5a479c975e3793f,365,340,25,Africa,16,1980.56
81cadf314198412cbb2e833c47c59918,127,80,47,Africa,20,831.7
81cd8d7389934e2fad35cb697ea71216,44,23,21,Oceania,22,319.67
81ce2c5452294919a5efd0951fc9e5f2,76,41,35,Asia,23,585.3
81cef7cf53704df39682b5011aa6f97f,142,98,44,Europe,22,773.21
81d0eb0ecc094357a48007eaf119291b,183,130,53,Asia,18,1002.13
81d315c03f7043539992b3c50458c46a,271,216,55,South America,23,1338.45
81d3ff29923f49f5b3e54c477844ea2f,251,230,21,Oceania,20,2249.7
81d5cc0a388848bfb38cf07bce299fd6,147,117,30,North America,25,1113.02
81d80ff02be545b39af30452673d4894,45,5,40,Africa,21,323.66
81d81087bd504a77855b56834eaa834b,333,297,36,South America,20,2332.73
81d9ddfd178b4ef197a1ed31a6da7def,350,295,55,Asia,24,1718.46
81d9e9dcef2b4dfc94a5b3e77b4cb256,133,84,49,Asia,18,275.75
81da12acd0344bfdb7fbf787879190fd,245,202,43,Europe,18,1628.98
81dd8f0532474d4f94d8c2ce56c4d398,232,189,43,South America,18,783.85
81dfee9a6d704838b45dd2b44f023359,81,42,39,Africa,21,574.87
81e3c310ecaa495f88bb658a38e98dca,121,70,51,Asia,14,514.21
81e4a9e96fbe45df8cccd0022e44c1c1,284,260,24,South America,22,1905.25
81e4d07e4fdc41deabc25a108e2eb070,120,98,22,Asia,25,865.73
81e71fa5085e42e7a57baf5f94cf1438,115,89,26,South America,22,731.5
81e7df8f89aa40dbba4a7760af51f586,365,350,15,South America,26,2183.36
81e80123bc1941a097b4823f29b17900,126,70,56,Asia,18,624.51
81e80d238cbf44d7ab616c86177d3c5d,171,146,25,South America,22,971.21
81e8fc94e19546589e75df32552ac229,291,261,30,Asia,26,1017.73
81e9343edcc2490994cfe97b70f842df,39,26,13,Asia,20,253.34
81eb37d808a84f3eac4e2320b9e8029a,320,296,24,Asia,22,2642.75
81edbe9fb00c45a1a189d07d7edd184b,362,327,35,Asia,16,2728.91
81ee6dca2aba4561a97160ce0d9c0500,252,206,46,Oceania,21,1330.48
81eee4702c0e4517a7d1895899e38f66,160,135,25,Europe,21,1280.19
81ef2419d9de47659c7002610d1baae1,115,83,32,South America,14,672.48
81f2c55186b849a383f55db7825dd84a,262,218,44,Oceania,23,2230.99
81f3666f496f43c0bb0696a8499eb997,37,5,32,North America,22,229.59
81f39396e0df43d49eb4629e7ba71c2e,365,337,28,Africa,20,2247.85
81fae0cb26024e87aff916a3ad2065bc,353,345,8,North America,20,2004.93
81fbc4e629934ef8a2cd4534f961f1f6,137,107,30,Europe,20,813.82
81fc4a0452284874a6e1946fad0d1fc8,132,114,18,North America,22,1454.49
81fcaf0c9e79458ba7243da98887c59c,141,88,53,Africa,20,876.95
81fd1988b07f4db5a724594576f1b9a1,164,130,34,Asia,17,849.34
81fe2d1778c34a68997cf09a5ad26720,362,319,43,Asia,17,1789.6
82005d5b45d84450a1bc5c367d99e4e1,134,86,48,North America,24,515.19
82008916c1e744fea361ddd89dc6749d,277,239,38,Asia,20,922.62
820152959eb9497c98e8378e4d60f4b8,214,186,28,Africa,20,1712.04
8201534fe2ec49b083ba87996f6c2180,161,140,21,North America,19,1225.3
82023830839846d0bc97871093acf352,226,187,39,Oceania,20,1028.25
82071274f31a43669fe3fe0deafb592c,101,71,30,Asia,16,585.9
8207e0287e074656b78c0451dba1ae5f,235,199,36,South America,20,1621.3
82094f92fd3b4b3f8ff03925f7300ef7,298,247,51,South America,22,1882.65
820e849ff68f491f80b4e70bf098e430,160,124,36,South America,18,1114
820ec0717b9d48fa94f6cc156f2e8948,267,209,58,Asia,16,919.39
8212f890e0de4f8f872843c3469ca119,48,2,46,Africa,13,533.8
821416ba11e945f6b2e45b65d4124004,41,4,37,Europe,21,442.69
8214eeefb4a542e6903f963899774552,186,154,32,South America,18,1208.67
82161a2a676c456eb1f3ec0b5ecee3ee,169,134,35,North America,25,1055.37
82167c3add024c309c37d02f78f9a8ce,201,173,28,South America,21,1358.62
82182aa245d547b7a8af542eb1f7a0ae,364,358,6,Europe,21,2208.5
821976ed18a64da19606c1556d698a1b,234,206,28,North America,20,2207.27
82198b6a7573467d9c6431a3b5f345fa,365,320,45,North America,19,1716.67
821c16f1b0bb4650a1246d1b2f68a0cf,365,325,40,Europe,19,1674.03
821c98f98a9c48fca1346be3ba3815fe,48,1,47,South America,16,87.43
821da8be726148508b5204797792b392,166,149,17,Oceania,13,1109.45
821dd053b5c8441589b28b16c301bd69,173,149,24,Africa,21,1153.25
821fca6f7344465c93a68b50c4aa959c,53,15,38,Asia,16,298.07
82203be90a99475cb8f056e805974b0a,155,113,42,Europe,15,1144.21
82206d9a0bcc4b71886db72e9f79f4fd,51,6,45,South America,20,145.05
8225b7a7dfc1463481a56fdd3e4b1e75,218,194,24,Africa,16,1722.93
82269ef96b0742d0a1f5de35fef4c640,182,137,45,Africa,21,1048.5
8226d7a87fb843069a24a561c5c3b570,191,152,39,Asia,21,1368.62
8228e141b44d4d96b46b8041e65c8447,68,28,40,Asia,23,355.23
82299dea02e043c5be37776d64a9aa62,175,146,29,North America,14,921.47
8229d174663c471e9839c18998dbc8e9,198,171,27,Asia,21,1548.8
822a1fa02a12449ebacd7ef3acc9273c,331,297,34,Asia,23,2414.78
822b035e4d5644ddac15f911f0bcf91e,41,6,35,Africa,25,189.36
822d8a5a27314c4294f121b47e713723,99,44,55,North America,22,615.32
822f2a72622049f2b6c63a8bf32710cd,44,5,39,South America,16,40.27
822ff56ce98b4d018c209a3fa152228b,115,67,48,Oceania,14,706.29
82314eb319a24038aba6f853d70425c3,114,70,44,Africa,20,621.95
82316d0761974693af0f13325b468c98,172,145,27,North America,12,1150.11
8233d3cf8918467ab117225fd344f333,289,263,26,South America,20,1973.14
82369addf4544caa9fd9e3715e174889,351,294,57,Asia,20,1258.28
8238169250eb442ba549cda881040121,289,273,16,South America,22,2961.68
82388914c2fd44acb985be19d248ffe0,352,339,13,Europe,15,2841.09
823ecf71f29c4c86b52b1bd92cea1805,265,237,28,Africa,25,1524.3
823f50c145974a5da95ca60bcab823c7,171,122,49,South America,13,910.36
8241fe0289844c5da93502ff712cabb4,71,30,41,Africa,21,187.97
82432ca0d3ad4f6a8a3be67515943484,32,11,21,Oceania,21,174.05
824404b33b804e1585e953d687ff0f55,335,317,18,Africa,18,2287.68
82480b3686a94a8d9e74c1bc39a6a287,103,57,46,Oceania,26,514.07
8249893e810747e1aac1bc70b7fca404,365,322,43,Europe,24,2013.88
824d16a8e3984fec82794908818f6a22,267,233,34,Oceania,20,2156.47
824d75ad6b6647278bfe5c6a7bcb8d85,358,317,41,Asia,14,3189.74
824e3e35aacb4a0eb0db755d37533198,58,37,21,Africa,18,463.71
82512dfcdde342bfbaa94e7eefd9354c,242,218,24,Oceania,15,1952.02
82538e8438ec45d98a8c1aa10316968b,131,113,18,Asia,20,797.11
8253e25d05e340aa926156b59fcdd435,24,4,20,South America,17,370.78
8255424bc82e4546945721500de235a8,67,52,15,South America,19,596.3
825595c88da84f9a9557361d99587fb0,182,136,46,North America,18,866.74
825b2e1b25d4497987ba05b1c68f7c4c,202,151,51,Asia,21,929.93
825c6b9dabcc49caac3ec2e6e8ad5c6a,187,141,46,Africa,21,1019.07
825d6bc95a1a4cbc95f5a484e69a95ba,339,290,49,South America,18,1616.77
825da3f9f645449f8b559133908575b3,210,182,28,North America,18,1635.89
825da82078414de895ff39b4e0097d91,336,278,58,Africa,20,1889.89
825fa7aafd7b41bc9c1476b723cfb8a9,264,214,50,South America,17,1464.46
826057e6921340eda6bbee3e44dfc74d,122,68,54,Oceania,20,373.91
82684991a75d4b44adbf6514296fc44d,227,201,26,Oceania,19,1372.22
826a578a2f174a6eb6020bb0528f73b0,338,321,17,South America,17,1908.2
826a9c5235b7482e9bff449aec3478c5,311,293,18,Asia,23,2864.06
826b01f398644613a11a1edb75e20cbf,132,88,44,Oceania,18,1034.54
826cf7e3dcdc4f738dfa62b22f3be6f6,305,252,53,Africa,16,1692.79
826db4c837f84c21b9b5257abdec0d79,72,18,54,Oceania,19,611.39
826fba0f3db94532a536582031fa580b,118,85,33,North America,20,636.01
8271665a565d4d6a823ac83b89e570f5,310,283,27,South America,19,2896.34
8272812ee3dd4928b6597d9e469bd327,365,347,18,Asia,14,2526.35
827622901e614e02b5ab44fdd26bf565,324,286,38,Asia,23,2015.39
8277e3a1e9fb43759070d8feed499d32,365,358,7,North America,19,2868.1
8278dcddcbe54249b132745b099a03d8,54,3,51,Europe,11,233.67
827abef83f634fa5997d99ae76cf4730,363,334,29,Europe,21,1983.08
827ad21894fd4c03abd69d5af78b605e,127,94,33,Africa,22,735.35
827e3e89ee694faf8fe110db82c81535,357,299,58,South America,12,1289.09
827ea176a15449b18b9088467e526b6f,188,157,31,Europe,19,1218.53
827fd255a23146a5a21b7d4f96095d80,297,259,38,South America,17,1761.2
8281c4dfa0da4c4284f7a42f650aca2f,187,162,25,Africa,20,1363.49
8283b3bc559843b08a8039a9e6703d67,298,249,49,Africa,20,1398.63
828493ea346846be90148238805bbdf8,227,175,52,Asia,22,1047.61
8284b2e89bc3484b86ad2b8e2e6011ad,123,71,52,Oceania,18,648.17
82855d95cfbb4cc0a0ff0672ca9946e2,240,206,34,Oceania,19,1884.34
82859511eb98474f913329982f67dcf8,287,239,48,Africa,20,1419.71
8288113f557640d49de31205e6bd11e3,365,360,5,North America,18,2623.1
828874fbe2ff4c84974f5930111478a2,166,130,36,South America,22,1375.01
82888fe9248d4ac7908d6b061da689e3,365,332,33,Europe,23,2539.04
8288b1b249184bc69f5dabc5eb92f239,339,295,44,Oceania,15,1962.08
828a8e9514e842c697ad7da69644aad6,226,188,38,Europe,18,1151.51
828e2d16449e4ae79aa8f1fa9843e1ac,62,29,33,Oceania,16,523.57
828ec22b5a8c4419bde3310edd8097fe,83,48,35,Oceania,20,440.43
828f2058ef44480380c781f651ba46f8,156,113,43,Oceania,22,1160.96
82910ef2918442b5bc12f27625dba6e4,87,52,35,Europe,27,611.72
82948a27b1bb4998a51b2353857cf333,323,265,58,Asia,16,1679.6
82955faa7ef443c5bce4fa87ad8524e6,183,159,24,North America,22,1168.83
82965911d29e43378306bcbba9f6e1ac,116,74,42,North America,16,627.08
82967c9d42f74a18b1fc32da3bc2e8a1,214,167,47,Europe,22,1545.07
8296bb3741d0480f8362b2ca7dc3fbd9,364,363,1,South America,18,2649.19
82998a6e8ecc4a8f9a2c068002f47db8,90,47,43,Asia,22,643.3
8299b123ade64cbbad9ed04eb08718c6,175,134,41,North America,21,1605.47
829aa529a85349dcb9d104357bc8793a,273,224,49,Oceania,20,1523.76
829b8c637f7b4c82a70ddbdc096bbb74,197,172,25,Africa,13,1498.25
829bde40ccaa4fa0bfefb482ace8f743,82,47,35,Africa,15,450.11
829d989e7649412cba5f8ddf6ccb60e3,59,35,24,North America,21,439.91
829e12f9644349a987ea83149b6b4e67,352,300,52,South America,17,1973.73
829e638b0f124d939d3f09c1f5b838bb,364,348,16,North America,22,1760.36
829f7a70b5714ad983599d42cf22b65b,52,10,42,North America,19,216.48
82a03246f36d474cb4d112bdf7ec3105,53,6,47,Africa,17,520.02
82a0a2a880b349efbc48732e48a4f0dc,298,252,46,Oceania,16,992
82a11d5532dd4ff39b8df55b18de1bf1,40,25,15,North America,22,374.91
82a275f6c18b4d329529a5ea141f4f10,170,115,55,North America,19,1193.12
82a2d41fa441406a83ffc24070013314,361,312,49,Africa,18,1637.74
82a38ea56f994c06b04b67251e60a7af,91,37,54,South America,17,474.58
82a6d995ce08420bafe897d93a3e25bf,156,134,22,Asia,17,1286.58
82a7f5cd67134aac9dd9159ca49ed482,263,245,18,Asia,17,1934.78
82a877aadcc840e1a1747a949f186262,119,83,36,Europe,14,503.71
82a88e27aef74e508c93004cc8ab262e,116,88,28,Europe,22,909.15
82a8f13a5fbf4410b4441d74872c0729,365,332,33,Asia,18,2648.43
82a97a149975432b9cf92e19e85905b0,162,133,29,Africa,18,1383.47
82ae0aa027ba4504b1b54b25678e075f,39,23,16,Africa,17,356.14
82ae99728d4540f49b0c09c390791828,124,91,33,Oceania,13,895.47
82afcb0288c24770a9a84b071b91b9d4,265,236,29,Oceania,20,2283.48
82b205b13ab247f2b74bdaa516b36ce3,353,325,28,South America,21,2350.64
82b257e752244576b75f542d5bcff3de,336,289,47,Europe,22,1967.14
82b2daa1c2d847b0ac3efcc0129a06f8,180,145,35,Oceania,19,1052.17
82b31402d8744ad5b7cb465eeaead35a,228,198,30,Africa,20,1713.11
82b3a3c85b4d45ea9d600d068344fa73,350,311,39,Europe,15,2282.62
82b533feccdd4d6d84203c19137c30da,166,136,30,Oceania,17,1105.47
82b5bf151cc4436ea1eb7482240db909,83,38,45,North America,19,343.72
82b6393f03af4e58b35d73cb46dbf16a,153,112,41,Europe,18,1352.31
82b720074a02469c96422e2930961cec,312,282,30,South America,17,1890.69
82b8c40fae0f432baa5980a7ccc9197a,139,101,38,Oceania,15,1551.41
82b9d925bca34118b077546232a1966b,365,355,10,Oceania,23,3033.7
82bd8cb9479b486f9fe3cc509e21549c,202,170,32,Oceania,25,1458.2
82c237ffb1ac4c37b78a57e21cb1bbd7,343,306,37,North America,15,2288.42
82c2a71073034f2aa56e2feb1712ffd5,345,311,34,Africa,20,2301.86
82c3e8d7fac34d69880b87f197ae9318,314,261,53,North America,13,2629.9
82c4e8e5b3bf4e8c8bc0999889120b7a,78,52,26,Africa,19,714.09
82c74a4de93e47f4adc5e4b48898d7a1,57,21,36,Europe,21,469.94
82cab2351023410cb09569ea7e9a5d31,26,3,23,North America,24,142.21
82cc0f46508b49ad87b4126cf7473e03,110,82,28,North America,16,628.38
82cd7ba06fd8484ab1828c8acab55b1c,182,131,51,Africa,20,1181.28
82cf19058f9c4dbea5020a23724f2fef,160,130,30,Oceania,24,1223.13
82d0dd5f89a043de9f9cda6a34bd122b,365,365,0,Oceania,16,2894.92
82d18f2a60334237843749c48fefdc78,59,20,39,Europe,20,533.46
82d2cd1ef7fd4a3bbd4cc6d4727b19f0,180,139,41,South America,14,978.94
82d400d9fa24410c95d91f11117fc172,65,15,50,North America,24,425.99
82d4317e28ae4e3fbca11d6bba413321,149,124,25,Europe,18,1572.73
82d6f8a941e24129b5a57fa41f3dc6fc,81,51,30,North America,27,670.43
82d71692b4484948bf9f3f858d05e0c7,115,88,27,Europe,20,872.06
82d8b7a8eeb6411fbf73112f2db81ef0,140,92,48,North America,23,1076.96
82da2f52973e4fd6a988856c358d2409,163,112,51,North America,16,866.22
82ddce2f70d04f2980b2dd0a9a6b3ebb,166,124,42,Asia,20,931.8
82de5cdcf52d4ee9be71cd13a907c564,60,32,28,Africa,23,303.45
82e0cc1f795e4b1e9d35371e28e1f8d4,101,53,48,Oceania,19,260.64
82e4dfb155514a3f8a787eb343f6b620,360,314,46,Africa,19,2246.87
82e7d6b5955a4382992348c8855fecf9,329,283,46,North America,20,1638.76
82e985d719c8494795598c9306f62603,365,365,0,South America,21,1628.65
82e9fb64021549e3863d3aebd4d4a03f,256,232,24,Europe,23,1367.72
82ea85436ec94db3ab9bd8299376d19b,346,297,49,Oceania,20,1965.5
82ead05c95e64789b63773809215ff29,345,302,43,Asia,22,2473.57
82ed55ccbe764d7a8f3a84317b267125,72,55,17,Europe,14,916.83
82edb5c740a44443bb16744fd8dc96cb,365,363,2,Oceania,24,3342.89
82edd686b4ad4ecc9b391e2c1acf2a6d,159,135,24,Africa,20,1143.54
82ee67bd06374848a2708921c0c86f41,286,253,33,Europe,27,1894.21
82ef11d11f514093af050961c808eecd,360,359,1,Oceania,11,2071.93
82f08d4a5e8f4a70a84a5e597a6ac1f8,123,84,39,Africa,15,1119.86
82f183296f3742cb9bef3f04a091b2fd,118,70,48,North America,23,430.45
82f274b095524779a22f89de82dd3093,318,287,31,Africa,21,2004.11
82f533a7f39241aea3e1b984623bc444,220,164,56,Africa,21,1582.75
82f5d21c51ee4671b54762b9ce378676,363,349,14,Asia,24,2762.28
82f905e29fe1427b93dcc52a5d777136,243,214,29,Oceania,22,2104.55
82fcdd1b430b48fbbb18929024bc22e5,144,91,53,Asia,22,809.34
82ff2e4798f34917b1ec01eb89b40521,68,18,50,North America,19,297.87
8301b3e37c2b49bdbd1cdc26624159f1,305,272,33,Europe,20,3145.65
8301f8a0f165497ca2e26fab1c1a876b,157,141,16,Africa,22,1327.95
83031296b4da47a5add836505c328bab,234,205,29,South America,23,1221.91
8304662fa986496db4d14f91097fe475,365,363,2,Oceania,17,2779.09
830afbec7a2f48bb97a2cfdbc56c55b8,315,290,25,Europe,21,2496.51
830b42d1d4fa48869df65b97b0421466,173,144,29,Asia,18,1118.2
830dfa5567af4d8da3624448a05b9529,365,363,2,North America,19,2060.79
830f688155a54a43939584fde71d5e28,118,91,27,Europe,24,591.57
83121e466dda435dad852215a823f56e,237,206,31,Europe,18,1910.6
83125aab8c1c4144bcb4a337ce23a8a6,81,33,48,Africa,19,500.58
8312c7477fb84384a79a1378d13aa570,124,105,19,South America,19,1172.19
83169ca43bcb4eeda40079534d9f2826,134,105,29,North America,20,1241.22
8317706865d44a97befd780159fa1ac5,192,163,29,Europe,18,1091.6
831987bb644d45cba6634b74821c1046,364,359,5,Europe,17,1650.14
8319cf7915a14b10ae37b181dc828bf8,102,77,25,Asia,18,505.22
831c6553b8de447194cd69d10e0e2eca,315,273,42,South America,15,1994.49
831c8bf4fe7c4f22862a4745198188a7,324,291,33,Europe,23,2216.69
831edde3801d4664b13e5adc45fefcac,238,213,25,South America,18,1577.63
832106dcbd904019aa5dceb97d2565e7,219,199,20,Africa,22,1651.79
8323855d6da6443fbe4eb72d2fbb6277,114,74,40,North America,20,452.45
83244e0765304a78ad866629245efd93,146,110,36,North America,18,779.91
832633909f8a4ddf8c76d67b3e66449e,363,332,31,South America,15,2534.26
8327ce357c654200a091a28a255062f5,176,151,25,Asia,20,1489.09
83281e6a326e4f0b9e826f31ad9cdd5e,64,32,32,Africa,17,594.29
83282c72fb6e4574b168c66620d1b201,365,338,27,North America,24,2195.99
832c0465fdff4aa59801c434f08b9ae3,234,194,40,Africa,25,1246.14
832ca725082a4754867b615f1c41d44a,113,92,21,North America,16,1028.08
83310601ded44eba90ed6738c980ebca,309,278,31,South America,20,2384.29
833363c83e954e9ab9ee7ce971f941f0,138,109,29,Europe,19,1075.91
83358063552c4745b4db4ddaf3b64238,123,89,34,North America,20,844.48
8336dc06a59e4efc8151fa8524690f2e,365,337,28,North America,20,1981.44
83370bf05d364272894cd435413c3f6b,240,213,27,Africa,20,2018.99
833748074c2046389c0306e7d073151e,127,85,42,Africa,21,600.93
83383b3b0ab141ca92f538072f322393,78,30,48,North America,22,270
833a56dd814c463bb1a5a58f7a5e7377,287,256,31,North America,25,2343.73
833ac7eda07347058829bfcf7e1985c4,123,102,21,Europe,18,1122.56
833c45cef6cf4b6f9271256ee890b52e,352,335,17,Europe,17,2980.63
833cfbae7ef8481988d556e23815f90d,228,171,57,Asia,24,1217.3
833ee99af4b3482a9dba54f4f9050a77,364,342,22,Europe,20,3109.55
83400bc0cccd490b9417280461a3d006,291,247,44,Africa,19,1551.69
8341a5ca07b84a94a3b9ec9ae20fa54a,111,86,25,Europe,24,1039.65
83434eee53e14f4b881924af21a54b2a,359,325,34,Oceania,22,2721.06
834474baa2da47699559d63e6e2f5872,50,3,47,South America,15,308.25
83457271887d4351ba6fdcf82c41dca1,285,267,18,Africa,24,2817.98
8346ff7c370949b9946df3732e6e5515,66,12,54,Oceania,17,166.84
83476c7f502744039bbaa6f7647b9a77,337,300,37,South America,17,3028.59
834968b707b248debde239e894e59dc7,239,214,25,Asia,19,1499.09
834a5a2948504d1fb7c44e8ff10dc08e,163,125,38,Europe,20,1235.35
834ad9e8622043b084a72a59f4090ae5,365,323,42,Oceania,22,2254.93
834d9e8ea1da4b798991f8d3eb8a4af3,260,211,49,North America,16,1261.14
834f03f3400047b6ad4c04e674a93af0,62,33,29,Africa,21,709.78
83505f124dc84fd68ac53aca0fb7a516,343,308,35,South America,23,1613.98
8352a6cc32f242059425ed9b05eb0921,352,300,52,South America,24,1564.52
83549d4da02549f1a93ead92e14b970d,365,343,22,North America,20,2681.82
83558d79eef64bb69c1434de72fab681,243,191,52,South America,18,1203.14
83582fc30986421fb4dec1bb9b2e82b7,153,131,22,South America,15,1193.42
835846056e9e4b8cbd43c871457a04b5,31,10,21,South America,24,106.63
83598a4a2ebb42aebacf464e1734c769,177,135,42,Europe,20,1154.76
835b676954be4ba48f163280f74f1efb,261,240,21,North America,21,2055.8
835b8a3db9a94914b61a8a5b7d1304d6,39,25,14,Asia,18,84.87
835bbb173d384134839e2874ae88476a,365,340,25,South America,21,1840.74
835cd9bb2763404b9a84cad3a7329d32,215,176,39,South America,23,1222.24
836053b890544f18b58e741876d2deec,263,214,49,Asia,15,1459.71
8360ce5b968b46cfa5c00931828258a8,364,338,26,South America,22,2599.96
83611dbba4084b949fe1c08b079542e9,243,213,30,South America,16,1527.73
8362052cca8742349d10cf41e4bc9726,71,24,47,Oceania,26,700.93
8362f5ac22af4bb8b0cfce3ffaa6a363,169,130,39,Oceania,20,927.45
8367b5b7dd7e40bfacf47d5e571666db,212,190,22,North America,22,1406.33
8368a2edc7da40c9b477f96f3bed9571,123,73,50,Europe,19,720.9
8369bc2d2ccd4725b7b3202d1aa81bf6,333,299,34,Africa,15,1882.89
836a7b7e3d9e445c9abe9f4d7a281d6c,132,81,51,Europe,16,744.17
836b45fce4e54838aa9224d02b3f3fe8,121,83,38,South America,22,1110.38
836b6208382e48caabcecdb6c44676f4,333,275,58,Asia,24,1653.43
836bc52f5ce245c38b8391b5e7e5223b,64,28,36,North America,22,178.86
837441e110aa4fda85f63499ebee27e4,362,358,4,Asia,19,1896.85
83751a0ae1f541c4b797c0989cbb338d,259,219,40,Oceania,22,2911.08
83752160af564159a2d159d728df6bda,362,312,50,South America,23,1886.83
8377136e766c4278bf3cb301dfa561e6,362,342,20,North America,18,2173.69
83795cb984984e218e8c70a43aef50b2,308,268,40,Europe,21,2194.52
837d12a45a964aca8df09bd88b0c2d1a,26,4,22,Asia,23,272.69
837ed91785f940f9914e878d43356f7b,301,262,39,South America,19,2046.92
83803eff1e074501b22edcd2a6315359,44,19,25,South America,17,535.19
838122ad84424edfbcddd879dc5b8943,102,62,40,Europe,16,519.81
83823b48b86245168d36c282a3b99839,88,55,33,Oceania,15,400.69
838329e5c2ae4401bfa59ece65291bec,116,79,37,Asia,24,856.67
8383c24a602f46de951160ad3a8c9e93,323,272,51,Oceania,17,1573.39
838472b8fff9423d8514cbe727d05ab8,332,298,34,Europe,20,2411.65
8386232437f545ad828068f514837388,190,136,54,Africa,19,1020.83
8387507baa8b4176896a28e5eee1310a,232,202,30,Europe,15,1657.1
8389864099474118b06c1c000dc58d8c,76,41,35,North America,26,893.15
8389b71de72140babb6e1802d180ece3,190,156,34,North America,15,1077.56
838b96d1a179414c9053f177998fae92,81,37,44,Europe,18,172.52
838ce0b488d14d5f8435a6ee0589ec67,341,326,15,Asia,19,2922.85
838cfcf9b1a847fdbfbe873dc832a5a6,177,152,25,South America,22,1633.04
838e7f4943ca451990c29a1b42a84454,189,152,37,Oceania,23,1488.81
838f790dd10a4891a51a76d29dab7ef5,362,344,18,Oceania,18,2678.37
838f95ba85364f8888c94b6fa59d6ef1,114,92,22,South America,15,670.88
838fc135513543628ad6ea128fc2302d,235,212,23,South America,21,1836.37
838fca13b36443c5aa6c5e243777d8b9,64,45,19,Europe,14,238.22
83908a6bd6664132887ca9974900421e,166,130,36,North America,20,1143.04
8391272ec0894fabaa222e7537ed22bb,310,284,26,South America,21,2488.87
839157f3c43a4769977b083402a84b49,44,11,33,Oceania,23,259.15
839302946b494f00bab2212bfc9e05c5,363,305,58,North America,21,1913.83
83931a278be644b0aa9842782c681942,91,72,19,South America,19,1105.72
8393f6a2ec39459c94d82e816d584aa5,349,319,30,Asia,16,2824.44
83943dff0e3d41eb99fa2e6ed40dd594,120,76,44,Africa,17,631.61
839579bde0584c5dae54d04459c5c18b,322,295,27,Europe,24,2345.06
839589a315c94291a9e2f0edcdaea7a5,139,109,30,Europe,16,957.27
8395df23cf5c4a768c84fdf3c99ae24c,326,304,22,Oceania,21,2537.81
8395f49b8634435a9c7eecb8b4942290,365,364,1,Oceania,20,2924.19
83973d692cbe4f6b8e7cb9c398a40556,257,234,23,Europe,19,1874.17
83979eb074734494968ad8745521e708,115,71,44,North America,24,717.5
839a27300e114c518129a63236867e8a,365,351,14,Asia,19,2099.13
839b95161db44409a3d8c57f04289928,344,316,28,Asia,22,2567.48
839b9d6dd6684b7bab38b989ae549779,59,26,33,South America,21,279.38
839bf375de7f44bcab1ae5c0bfd3fd79,254,228,26,North America,17,2092.35
839c16dc31f64c9aba964b8ffa8eab72,173,128,45,Asia,18,915.73
839d72189d1d4e3a94a12f3b137a143d,54,33,21,Asia,20,300.08
839e82971b0f419588a259f9a315472e,293,268,25,North America,22,2369.19
83a0be46b5fc44528cefdf23e3514743,168,135,33,Asia,17,1176.79
83a35611d7d14524a15a560f9477fe7b,311,259,52,Asia,18,1270.1
83a4ff979c5c4861b46c2fc85f9b16d9,302,276,26,Oceania,22,2021.76
83a59656ab4044469b6da702f72c2783,364,356,8,South America,23,2151.03
83a87e0085344ce498756143a1a37181,295,242,53,Oceania,21,1222.81
83ab05a4520a4022acef5ffc50575e3e,57,27,30,North America,17,384.85
83ac0bce9d974c1cbbcd4ec704cd0afb,227,181,46,Asia,17,1309.17
83b2e8e98104474aa234f6269967efde,359,339,20,Europe,18,3622.75
83b32650a5ac49698a5a69c202d804de,362,361,1,Europe,18,2363.2
83b41eb0b6da4a0282d2f4cdd4307e62,204,150,54,Europe,23,1004.7
83b5401c93504306aa9752a070fcc50f,186,160,26,North America,17,1325.8
83b6dfff24c34b16bdf61355392920ff,365,337,28,Asia,27,2003.91
83b84bd037274c68b05c0727eac60850,44,11,33,South America,20,380.01
83ba4b4250694a52a26c3572b4c1feb8,227,170,57,Europe,25,824.95
83bc89d4e824444dba2e98313249f964,192,142,50,Europe,18,1361.6
83bc9ea2d11d4922ab67b10abf96ab9f,176,128,48,Africa,19,629.83
83bf032fc3c9410bb93da6230f971f7a,233,199,34,Oceania,24,1730.86
83c5b543c11e4b489a72e4f8674f468d,76,38,38,Asia,17,433.62
83c7179b1bed4779873667553bcefda7,153,121,32,Europe,19,850.53
83c7419b465642aab18348d631909d6b,211,167,44,North America,26,1531.74
83c86bd0577948ddae75a587e1da23dd,329,278,51,Africa,17,2232.68
83cb41144fe5497c83656c79baec952f,314,264,50,Oceania,21,1572.18
83cc9a6b955d445d8ea4befd8fe60c51,190,170,20,Asia,17,1567.56
83cf054b29a14f218c8d78e5c74c535a,336,281,55,Europe,23,1693.78
83d0f249a1f94217aff1d637c4590065,250,226,24,South America,19,1351.61
83d49f17c2f24d2eb4f5c4ae1eea933b,365,318,47,Africa,23,1407.45
83d6458a9e684db6a1a016b6f6ff771b,130,93,37,South America,16,930.9
83d7056a7a004c7d820786fcaba6b777,87,46,41,South America,17,505.67
83d9aaf09e284177bb85db9ae3a26ae2,183,146,37,Europe,26,1210.15
83db04e57e6148c0b9fad8852e2b3694,122,69,53,Asia,19,790.67
83dce4d8f16247d89d49cccfebf827ed,201,152,49,Oceania,19,961.94
83e13cee7c704e5283ab82e32359e7a0,173,137,36,Europe,22,750.7
83e2871fbfda4c31a577cfb8d0cfc416,333,305,28,Oceania,19,2062.95
83e3ad892cda4060add98ad81da281fb,332,289,43,Europe,18,1353.15
83e3bc070cb94709be5f5486c54ba8ed,365,363,2,North America,22,3023.81
83e5d4a3b8db4d2789c5d4d1dc370adb,326,303,23,South America,24,2482.99
83e72809dee14cc4ae42b2c4aa570343,56,36,20,Asia,19,305.43
83e9646886dc48369b7c6be28a20ef62,161,111,50,Europe,22,1046.99
83e9ab98cbb644d881b6d3d377eabd21,245,216,29,Africa,27,1771.52
83ea47a0af694872875012958607b8c7,365,322,43,Europe,23,2457.61
83edcf6aa2924bae992a304a762d1b46,239,204,35,South America,18,1738.82
83ee71c470ec44e5ad57a4a82ac33fda,223,202,21,Oceania,18,984.6
83f1d8d9bdd44becb2afa0398e638f39,323,287,36,Asia,21,1797.43
83f30d37aa904440a09100aa3c41c030,72,38,34,North America,23,635.41
83f487eda56045c3b2e967ca2e7b93ea,51,3,48,Asia,19,257.59
83f58df225d8494cb4bf13605a9aa69a,34,11,23,North America,21,153.54
83f6b8fab01f4bedabbadb5e0ef2f7be,348,328,20,North America,19,2326.37
83fa36c68e6a4c759c1c9c3c7cde3ba8,100,50,50,Europe,20,531.63
83fae6d151ee4289896ba6687b04fc8c,170,139,31,South America,23,1276.69
83fbf66b0d254a2898efc4b0067e8ce7,49,26,23,Europe,17,530.76
83fc577e6b8c480ba5ccd797e989a205,124,86,38,North America,15,685.05
8401cf1dfca849ae820335c18d6dac53,365,336,29,North America,17,2096.38
84037409dab4479ea1e8935190c64b7a,364,343,21,Europe,12,1688.66
8404c07a7375437781959480adeb38bb,245,205,40,Oceania,24,1553.45
8406af23243f44b5b8b8f97ee13a36e7,289,253,36,South America,20,2184.06
8408d17f3fe7467ebfebf83a3ba657d6,175,142,33,Africa,18,1377.39
84090a24c6eb4de2a3265ba5f9c9f12c,60,46,14,Oceania,16,437.86
840bb9d03d694654bcdc501d55a3b3cf,190,145,45,Europe,18,1023.31
840c0c6a1e134526a8494602af391c5d,110,69,41,South America,24,521.37
840c685099ac4010bd6a702e6387736e,70,26,44,South America,18,523.21
840d1da8a3df4056979aad226d2207da,53,3,50,North America,21,331.29
840f02d1a33e4b748ee837c7eccc4182,329,280,49,Asia,19,1466.78
840f151c43ce4b8ea312a8052940d093,239,207,32,North America,20,2059.14
8410eb1a37544f1689194381a3cc75ad,120,73,47,Oceania,21,697.64
84120380bc2a442e8bdef9ed4bb74b00,234,192,42,South America,23,1606.46
8415a9c2825148c3957a08eea07d3671,320,266,54,North America,16,1720.01
8417300d34644b4681b77e5e097418ff,259,230,29,Oceania,17,2167.31
841964f3ca91422488038c0137f5a6bd,98,50,48,Europe,17,380.66
841989895b274c9ba77de972cb5544a5,104,82,22,Asia,17,908.46
841bc62cb6ad4a5f9de9bff76d7b8a5a,89,54,35,Oceania,19,397.03
841c2151e0ad437da8269c29bf24aac1,251,226,25,North America,19,2517.78
841ed5fb490b496b8ad58bf849259973,336,312,24,North America,18,2786.53
84206b8c69c44ebbbcd053c962c4545e,364,350,14,Asia,17,1789.92
8420c125e9414ea78e9284e7da09983c,243,191,52,Africa,18,1141.56
8421fd6d0a4d42d09a7c69e6d733ea7c,161,131,30,South America,17,1045.14
84231515a3504fc5aea0a480b5411276,195,171,24,North America,21,1647.84
8423365572684bf7b4d86e498ff8e2e5,214,160,54,Europe,22,1474.74
8423ebe67a2040df83ff457aa83083bf,235,207,28,Oceania,21,1461.67
84252bd1a20c46fda52b2c9ec1e939bb,363,328,35,Asia,20,2309.33
84257cf81e6e4a75ad47b199bdf8654e,52,24,28,North America,13,307.93
8425d396a3ac474dad34353603d69114,262,232,30,North America,25,1430.36
8428929bf26349a594d1c746147555ef,365,344,21,Africa,21,2337.77
8428bd5ba5f4433bb28dd627d2cf1752,118,80,38,Asia,27,1045.63
8428c51874f2430ba81ca159eb65575e,131,110,21,Africa,22,706.79
84294c3882564a1cb100a52b40661703,223,188,35,North America,20,1884.59
842bd8b9198e4c87bef948c1943ec335,46,3,43,South America,20,224.75
842c05b3aca84fa1803eb71b80dac36b,267,212,55,Asia,19,1213.6
842d420c96a94a02b51280d4f1cf4274,239,181,58,Africa,20,1204.99
842d5aa99e2e488a900f0ccf0723943a,254,222,32,Asia,20,1847.41
842d9e3077a64082ad64faf66224b606,248,213,35,Asia,14,1719.56
842e05a1f236473d88c85ec24bd1fcae,150,107,43,Oceania,21,830.68
843057130eec4c8c96a9b9c21f0131b2,214,170,44,North America,21,671.1
8430e596fafc4beab54b9c345842edc7,227,176,51,Africa,24,963.18
84319aa99ceb480dbf6ef690a19d2625,294,260,34,Oceania,20,2373.48
84319e8046e145c096c2b1b513abe2d0,213,162,51,South America,18,662.72
8432403c38244a46bc3520a74b611581,130,86,44,Oceania,25,1128.78
84324a15588b4ce286179997d06b4840,365,338,27,Africa,18,3006.94
843573e829a447ddbb2c6dbd22483568,106,71,35,South America,20,1042.87
843a3bb26d3f435d8c83d624dbb7df9f,359,313,46,North America,20,1661.13
843acb7c11e64cd5ad971305303b6e2f,364,337,27,Europe,21,2525.21
843ccd62cd064f768e168a61bb4b1554,268,233,35,Oceania,14,1546.72
843e5e7349234afd8955510a0b448921,139,92,47,South America,18,582.86
843e963806ed4e889e75189a6fdefa06,86,38,48,South America,20,931.83
84439eae18ae4a9ea317c31f5a604d3e,163,136,27,South America,18,865.42
8444dcb8fa6f4afbbbf3beda06d385da,60,18,42,Asia,20,181.35
8449003c0a3c417e8e863d549e7b7cf2,264,214,50,Asia,18,1333.49
8449851d9239486e88679ae1fcc68f74,124,102,22,Oceania,21,930.8
8449e97571e64e58a0c05e1b6d2d2fa2,129,74,55,North America,22,613.14
844a9f84daf04a1eb10731b48ed2fa72,285,247,38,North America,26,2002.22
844acf99e0de443a9adfbd6a4c899def,293,260,33,Asia,21,2191.67
844ba2788f5f451a9bb208d8762f7255,290,269,21,Asia,23,2332.19
844bd0f2b9874374a29a33d15bf50d7f,209,157,52,Asia,20,972.76
844f4bdb4c294cd5bb9a492f9cb2c0bd,365,317,48,Africa,18,2272.17
845074eef83b414096507a2634e228e0,128,97,31,Oceania,24,881.18
8451b9342c864cccb04bb6351afd9cb9,59,7,52,Asia,19,321.87
8452fba157274d4b99677f80ce9ff661,237,221,16,North America,21,2421.43
8453b09091c54afbb85589607c1ba420,109,85,24,Europe,23,1005.51
84540d9e48834de79f238fd7cdfffecb,365,353,12,Europe,26,2636.29
845f7b344e2841809cef463c73826271,277,235,42,Europe,22,1549.13
84624228c9eb46dcb99673868078a558,363,344,19,Europe,18,2421.73
8463b87e8e9f4ca6802e139d89ec9a33,341,322,19,South America,19,2711.38
84640253309d484580bec68b67890b0b,208,180,28,Asia,20,1439.78
84645a3d833a4797b386518d0346330d,84,59,25,Oceania,19,963.37
84651486b5df4762a691e84e6a924fe1,321,299,22,Asia,20,2257.66
8466c76027154c9c9e8bfed8c7a3d00e,283,242,41,Europe,21,1257.44
8468d93864c74e2eaa277eb40c46612e,349,317,32,Africa,25,2089.65
84693df387a4458f94dc5a2626afb6cb,288,243,45,Asia,22,1462.42
846a324e613b4c75a983bb91516541b9,312,290,22,Europe,21,1507.72
846b115007ac43818d9dc4fbd0a4c51f,217,185,32,Europe,16,1220.6
846cbb54d93943be92fe006f632214b0,365,346,19,South America,20,1975.1
846ef598ab724ae2b890489b2f07d52c,296,278,18,South America,24,1725.86
8476f6971539481699017df8077c6bdf,363,329,34,Asia,22,2290.82
8477ce0d8cae460d8b23d2b68da6a3a6,362,361,1,Africa,21,2353.56
847acacafc55457cb676797046ab676c,365,359,6,Oceania,21,1909.11
847b4e085e504160bec1c30d048c3a7e,350,322,28,Europe,18,2471.24
848753d80a194ec6bc070e90d8c149c0,306,256,50,Oceania,19,1413.98
848a1dc0c23c40bb8d909eb76effbe91,131,102,29,Asia,23,876.08
848b9ca243724bd9bfcea8f80373afa4,218,189,29,Asia,21,1943.73
848c19512c514d14b9e5150013dc478e,346,300,46,South America,22,1424.77
848d3412486e4ff4bba9fc124fc711db,355,327,28,Africa,19,2380.98
848dbfe63a834bdaa65d5414a8ebdcf7,216,179,37,Europe,22,1510.18
848e37d2fee7442ea1151cbd217f9ac3,257,207,50,South America,16,1408.04
848e5b9f8ebb4f9cad1b94024fd63aad,126,76,50,Oceania,18,807.36
848f4138cd1b40dd8d08ff185417c89b,220,170,50,South America,18,1223.34
8491aae7d28f4785bab1175eeeadaf89,199,152,47,Asia,22,860.95
84973af0a7ea4c0089aa74dabb6ec161,254,199,55,North America,15,1431.07
8497cc071e794dc2a6430d4045e61a49,365,323,42,South America,21,1412.63
84995f63d01841d188e1d52a7355649d,121,78,43,Oceania,20,863.93
849a249099124aa3bbf1e497eea73486,251,215,36,Europe,26,1900.23
849a698226ca4b3689307e4e05699458,364,341,23,North America,22,2335.98
849ac4150e454b06a70b3ec937f715b4,145,96,49,North America,12,672.96
849b5c88c6fe45088252008d79664a65,92,50,42,Africa,20,508.27
849b5efd8ff24f9f821b53babc3f559c,365,347,18,Europe,23,2125.95
849befc96ab84412818b44509c445915,300,271,29,North America,18,2258.97
849cd9cee1194664ad4079a2ca06db5e,212,164,48,Europe,25,827.98
849ee820e5b64f92bdee7fc1257b0b73,324,285,39,Africa,22,2168.72
849f04d55a9a45cbbb165aea80ec2480,120,78,42,South America,24,985.49
84a1f7e64e4a4d889924d312a8726d4f,287,238,49,North America,22,1105.8
84a5d17978d141898d12b0d6871d8b81,175,144,31,Asia,20,1104.04
84a7f9bbb67b4b1a98bc4c48c7ee2169,241,204,37,Oceania,20,1436.73
84aa9b5ba8e643789453207b5451a34a,364,338,26,Europe,22,2146
84acb8648e9e46458a4370bce399cbd5,289,252,37,North America,21,1796.75
84ad1ae46de64b19a73d100e1bec0d94,245,219,26,South America,19,1924.4
84af323b4788474aba88b90209d5fbae,277,252,25,Oceania,23,1632.52
84afc08740054f1c95ecdb974e3073f7,258,230,28,Asia,18,1635.49
84afec29df4f4763b7d8c7d10cfdf53b,217,193,24,South America,26,2297.03
84b2a075cba84b5889f3103141e93d2d,212,164,48,North America,16,662.63
84b2a55af7c54150bd8b9ad797cd56be,130,88,42,Africa,21,730.48
84b354eafb4140f9ab331eb11eb8f33a,360,310,50,South America,26,1843.96
84b58f4bc06645158e818c8ba45306f3,361,319,42,Asia,20,2448.47
84bb37cdecbd4abd83e04e3d93ecf3e2,151,107,44,South America,22,1065.2
84bb96a59b734500b8f0850bf4ec168b,47,12,35,Africa,18,417.65
84bc996e79b14685ac3f8246b5a9727a,322,285,37,Europe,20,1640.05
84bd89c167cb4d57b5a8eb8c29826faf,233,200,33,Europe,22,1731.37
84bdc917b32b442a86ac8a64c9930e33,364,362,2,North America,20,2656.87
84bf238831724c26a3703ee298920f5f,89,67,22,Oceania,22,442.11
84c255c6f2844c0b8e66d902ebdb3a9d,110,91,19,Asia,16,609.69
84c31e3cc113440588a201783cd8883a,111,83,28,South America,23,785.18
84c39c3a66284fee9624f785c88905c1,353,316,37,Europe,17,2110.65
84c3e9946a13474c9e0162b744de3b41,319,289,30,North America,18,2399.61
84c9d031e9514d1eb45857e137ea4994,363,345,18,Africa,15,2800.43
84cc6d082168445c9991241bc512f2e2,187,158,29,Asia,16,1539.57
84cd3e131b164b4797366e627fe3ec9a,245,215,30,Asia,16,1588.42
84cd44b0d74b42b5b2c29a8f5e94b069,331,293,38,Africa,21,1924.23
84ce9399630647a8916faed296ca9d66,200,167,33,South America,21,972.3
84cfccf481304047b40688f930e690bb,178,122,56,Africa,20,767.58
84d09d4f0241471386e1ca833157f3e7,91,58,33,North America,23,595.85
84d12ddb520d4305b23bcae21f1f5d49,225,198,27,Oceania,21,1460.05
84d1a6850eb445d987e3652aca9d9030,361,332,29,Europe,16,1229.64
84d21e20cc9b4ba8b73a7be0051e68a9,346,300,46,South America,15,1629.28
84d35bdccd384343b1fa390506b42b19,285,253,32,Asia,21,1240.37
84d501cbe6e4487cb1343e3984b8ff89,365,337,28,Europe,19,1799.84
84d5d8eb70954dcea12bc6b0d9d31e49,72,35,37,Europe,21,289.37
84d6380a16c44084af06272594475172,57,3,54,Europe,15,183.22
84d663314b2f4d60b73851c12ccd90f6,337,307,30,Europe,28,2268.52
84d6bc493abf46219332194f20d381b0,151,115,36,Oceania,18,1314.42
84d9c759465746c9962df5b51b2a7d93,212,159,53,South America,18,1186.72
84db41a9668447b5b92389c4c8e781af,143,112,31,North America,21,1013.48
84dba713a0cb485f8ba504af1aa04e15,258,219,39,Asia,16,978.96
84dcc3f0df06437a9ca80177d41e72bb,319,272,47,South America,17,1872.3
84e07615ee4c4eb492009f34a32c62fb,122,100,22,Oceania,17,886.66
84e0ebdf4d2447d5943c5610e29d834a,171,112,59,Oceania,22,928.29
84e122c22c9d406090a6fdadf7ac7623,97,50,47,Oceania,20,438.73
84e245915eca4be084d6b056eba863ec,69,32,37,North America,19,411.19
84e29de023ac4bedb99e0e2fe536db13,98,64,34,North America,21,372.71
84e42aa7de0f4a5a86512555c3c4a65a,364,347,17,North America,16,2775.16
84e47a72e0d24b379dfb42f5b72bde3e,365,330,35,South America,20,1969.57
84e67300cae0428583bfa971ab97f08a,205,177,28,Europe,22,1422
84e7703ce4804f4bb9dc94f49883a71f,348,325,23,South America,18,2149.12
84e7d1c32d044998b32faa77546b6e48,247,209,38,Asia,27,1403.85
84e97ab212074e67aa36668996ba4b4c,43,23,20,Oceania,21,325.83
84e990cb6d0f4fb8b0c4c49f3db887ff,364,346,18,Oceania,24,1820.72
84ea5517d9b84cd7b3ba9e82f84e6650,59,15,44,Oceania,23,446.78
84eb5a7f550d43648ec49ff1afaa468f,330,277,53,North America,19,1619.09
84ec7fb90a2b4a19826cca1ac0c9dfc9,351,340,11,Asia,17,2899.13
84ed4a27f3dc440697ab296458d8e8aa,331,294,37,Europe,19,2595.64
84ed96eee35146cfaa11c0d686faa51c,294,258,36,Asia,19,2194.77
84ef9323f40d4e9d9684fe4e0d04c067,259,232,27,South America,21,1979.97
84f015ec94834ad0a72b626254bb0ea9,109,80,29,Europe,19,786.13
84f05db67b2b4289b118369f0053fcbc,188,165,23,Asia,20,1547.04
84f344a25b2647cf9af49026239e288b,197,142,55,Europe,28,831.84
84f5e5a16f4f4f0d9e7b3c5b951c19e8,49,31,18,North America,20,291.26
84f71c102b334feb9f3d50ea7353b9fd,297,247,50,Europe,20,2301.35
84f82522d46940f8ae69861ddae2bf0c,103,52,51,Oceania,25,728.32
84f9f2acd8284448aeaf54d9291d9728,363,355,8,Oceania,23,2332.3
84fa7299e9e640b5b77823acca5d8db5,104,71,33,South America,9,1298.13
84fa9f710b944fcfbb25a77c074a7000,207,148,59,Asia,18,1143.02
850180081b5c4f33851f7951e1ba2313,143,106,37,South America,19,1171.22
85029ee0da7444beae1fa03c994bcad7,307,274,33,North America,21,2118.36
8503f880e74541ce976a35c0bf38775d,363,326,37,Europe,13,2191.54
850402f124884fa4911d6dec88a8207a,364,364,0,Europe,24,1436.98
85063edb56814efda0958cb4fe5d74e0,46,9,37,Europe,22,335.61
85076f51e50c4de587b8dcc4eddcc4cc,120,78,42,North America,23,512.38
850863e96971478dbb603bacb60d8e4a,235,185,50,Oceania,16,1416.51
850959b638074bcf9ca7c26f47d05900,312,292,20,Asia,20,2286.24
850978b5301a4db284cebd07ffd66504,205,173,32,South America,11,1497.04
850afc83d13541ceb860677673e0d289,109,59,50,Europe,19,656.63
850b2af552854475900a5a2dbc207f36,261,210,51,Africa,19,1114.82
850b6f6263624d368f22b4c15c16fb0e,236,210,26,Africa,14,1830.04
850c4c89af7b4a82a840f3ac04ffaeb7,190,164,26,Europe,23,967.5
850dfc2d25c54f9d9a809f1ab8dc3537,109,76,33,North America,24,1112.28
851515372d8c408296fb0cf8218155e7,136,93,43,Europe,18,1318.23
8518bfcda7954bc18a55b4c21d3c38d4,85,47,38,Europe,25,700.4
85193b7648f44a508b92c4f69752c83b,151,101,50,Oceania,16,341.14
851bb77055864f068f18808121733516,263,224,39,Europe,23,2210.3
85202bf27cb74ddcab50a9df53fa9c1e,186,170,16,Oceania,22,1154.78
85217fbddc834532822c63908ab8dc69,356,313,43,South America,20,2334.25
8521af2aec0e48b1b7b70b66adb43885,297,244,53,North America,19,1195.99
85223317c0bc4ec298746a1057fae729,179,157,22,Europe,20,1502.54
85247bea28674169878a41afc576b7b1,365,347,18,Africa,17,2982.44
852713ee33844fdab4506d1a5dd8fc88,80,19,61,Europe,21,309.54
8528f7a846ff431eb9148d34652a57d5,326,286,40,Europe,22,2078.86
8529decc002744dfac8fc141cce71c07,179,132,47,North America,19,803.85
852b5e17f8944f44b70395b31aa0a1f3,151,132,19,Oceania,22,1644.21
852bc4776cf74bc08849f44c18fb91de,51,16,35,South America,24,530.03
852f203699564b9b926e150a07ccb4cc,354,329,25,Europe,21,2800.37
852f58106ea6466abb3b789960874d42,184,160,24,Europe,20,2026.21
85305d8a9dcf478683f85dbd793be54d,184,153,31,Asia,27,1198.57
853064ae07b64dbdad80add3e649e764,49,14,35,North America,20,263.68
85324f4fc1554535b2ee44cfc2c73d98,146,96,50,Asia,21,837.88
85328063df6a4230adf5dc601498e365,131,102,29,North America,20,1113.48
85336f8a1db24dfdb33d5e84ab87e6f2,111,71,40,North America,26,663.15
8533eb9f96bd4eb9ae5b5f74ce9938b8,365,349,16,North America,23,3051.19
853526fd39e240a6b6d30b2e6b4ce95b,72,24,48,Oceania,23,137.51
85359481196643e986dc596aad5bb0a7,269,220,49,Africa,19,1594.09
8535c212b17a4a768aaafd7029e603e8,297,278,19,North America,24,2295.03
8536db47a8924a22b60df7a8cd9e2d70,302,245,57,Asia,22,1795.77
85372ffe0f284cb296b0ab81f52cf935,365,331,34,South America,19,2790.49
8538f0287b25471aac0c921acd3b92f8,315,269,46,Africa,20,1625.11
853ad9d5782846e9aaa257d0fa3ea851,43,19,24,Europe,18,566
853d48d2972447999d6a8f45e1fc3e1f,176,161,15,Oceania,17,1634.15
853e02a141dd46fca00302f6acf4ef62,218,167,51,Europe,18,1380.04
853f17d591aa41c3a7a7399711222bd9,190,143,47,Europe,25,1075.24
85406c86fb55447496fdd6c8d4f37464,107,68,39,Africa,21,1093.75
8540e8e0f4aa4688a723c70dd1fe8d98,122,74,48,Oceania,19,575.98
85410727e50646929e0d2616f2378fad,305,259,46,South America,23,1749.84
8545d683fc7141d6941a5c7a30326bd3,165,117,48,South America,20,909.52
85463e05d5044fb4985de332f26b7fd1,275,240,35,Africa,17,1534.82
8546d6ca9cea49478b62d88e17157cfc,93,65,28,Oceania,18,771.72
8548d59162b74b7884ce3731e0b026e4,242,221,21,Africa,19,2108.83
8548d7409c594d22851f118d0ae6fef3,49,8,41,Africa,17,271.8
854943028d8d490eb2a07181100402ae,340,294,46,Europe,22,1880.45
85528cbd8bc742b9a8347a4594a1e67c,129,92,37,North America,20,1342.67
8552b01a2d4a4202a7409daec04a5794,255,204,51,Asia,20,1800.56
8553b693281342d39000918efa4b5e75,154,113,41,Asia,16,1410.13
8554355298eb4dc4a9207db373b50fbf,201,170,31,Oceania,24,1522.77
855a8473b7844d7d96da58b2191e9c5d,108,83,25,Europe,20,500.55
855ae3aa7fa7418ba06ca13142c8099f,94,59,35,Oceania,20,626.48
855ded700d9f4958ab498177ef6b18b3,70,26,44,North America,20,383.71
855e247e6ab54521a898b6d5da85181d,200,169,31,South America,16,1481.21
8560ea47c5d64184a55f24f662f333bd,144,97,47,South America,22,707.89
8561d9008b6d4687a01dae9e9e1c3819,325,283,42,Asia,15,1622.65
8562a14373364f15a858652ccbde79e5,175,153,22,North America,20,1178.97
8562f291675544ba8d08fd08005d9c36,64,21,43,Oceania,18,596.16
856507fb2dab4d6080934826d512cde6,152,125,27,Asia,22,1106.74
8565dc1a86cb4b1fb5780f312404f7e3,223,177,46,South America,25,863.92
856674b351a94134bf5c77b83867bc35,140,108,32,Europe,18,1092.29
85669167cde741219e70103c687175e1,113,70,43,Africa,22,582.67
85674d2192a74b6eb4528a974cd8b6bd,73,27,46,Europe,23,284.36
8568a8fc12ac4387936113c70d185348,167,143,24,North America,23,1288.43
8569d106c7e447b8bf9418b9dc9fd04d,284,239,45,Africa,22,1889.01
856a58d2107f4ecfafd6a31f318bfa3f,103,79,24,Europe,20,1339.6
856aebf0002043ed81289d05023dd08e,166,138,28,North America,19,1194.05
856b51ce4c274e25a9f867c292252af5,360,340,20,Africa,20,2222.84
856db08927564bcb818f4d202443814c,181,138,43,North America,15,1030.65
856ddea132ea4dcda27f7ff40205590d,283,264,19,Oceania,20,2679.35
856e741e28de4ba09481df9c9c341a51,353,325,28,South America,24,2783.97
856ef3c4c5f042d1b1042ea3eb6d6432,347,291,56,Africa,18,1976.03
856f9c9f6fda4ca6bf173c941fe396e9,107,81,26,Asia,20,1076.51
8570121f2bdd4e54ab610ea85b82b5a8,149,104,45,Africa,16,890.09
857095a5060e4a548a851b2b9bc9c280,347,315,32,Europe,25,1934.35
8571376e7a8b476da87d2ed2e47f4170,86,58,28,Oceania,24,736
85717e7cd88041b28d9bfdfba1612530,72,51,21,Oceania,22,411.41
857294f1aa9e4dba9e2ad426851a6413,325,277,48,Oceania,21,1866.19
85740b5fc82443cb8710c89d2898b50d,313,264,49,North America,22,1428.6
8574dac2730743a7a45a386a0c2a9454,137,75,62,South America,17,612.2
8577af3c093041e8890ad0b4e64841b7,190,148,42,Asia,17,1598.98
857950b57eec457abdce1320623e9144,233,204,29,Europe,17,1147.93
857a0f82dd4c46ddab8700dbfaaf0cc1,59,4,55,Oceania,18,162.17
857a7c5d3cbb4b4c95bf7c4e25374c2e,161,115,46,Asia,21,1111.87
857bdf48c4e64e66b2f8e33fc10ac4ea,262,217,45,North America,25,1049.64
857c483f330344a68b4e4a82be911b3d,78,41,37,Asia,22,576.14
857e2e35c1b247a6b6a5d2ae554f2f24,224,188,36,Africa,20,1526.47
857f4dffb33040b89bdae0ef046f50e1,143,104,39,Africa,22,1130.21
85838818a47b4c3db6419fe3fe4970ff,344,314,30,North America,18,2196.84
85845f617e654f5d931ee25a6c5f43d2,195,161,34,South America,17,1320.21
858472052eb940bc95d65ae315098c31,275,224,51,Asia,26,916.51
8584736761334dc59543bfd241c27884,196,142,54,Oceania,22,871.57
8584b61336704840bc2220c67e040a2f,316,292,24,South America,20,2489.74
85888335a5d24dec81c3110dccd70548,58,24,34,South America,22,510.6
858b2be51b1847c68b8adb25c90d35a6,262,235,27,Africa,16,1763.99
858c1d97235e4ce2a311ebe27c1c52cf,365,345,20,Asia,20,3582.64
858e4a74d04e4aabb3fb6d11ead42c8d,353,331,22,Africa,23,2568.01
858f41638e524f5195b32cf3a689074b,363,362,1,Asia,15,3087.77
8591384b64b74a81be552e587ef0c7f3,142,97,45,Oceania,21,352.54
85922f1ad24e401680e18f4802f88f0d,52,27,25,South America,18,555.21
8593604d3ec44083b9133b33f29c10ec,22,5,17,Europe,17,102.37
8596d8139fd841b194c0d4d97701ad5a,365,350,15,North America,22,2474.22
85974664f8254627af502d5cb5f217c6,299,264,35,North America,18,1600.79
8597f3d9088c44f6b9bb14b1a6aca23c,137,91,46,South America,17,851.5
8599361572ce4d069ebd992b0f22a354,364,360,4,South America,17,2258.37
859a0c19ebf6462f86b68774a3f2fa67,355,307,48,Oceania,19,2070.64
859d112cfe6e43269126da5cc62a5ea3,62,14,48,Africa,26,440.67
859d2b2c695342c6a026b713494f03f9,364,330,34,Europe,18,1758.32
859f8e58e4824e74a020306686717aac,249,204,45,Asia,22,1782.35
85a0d9d6b25b41f5b56788a6c04f8866,37,6,31,North America,14,125.91
85a721fd93ce4b62978afb5a3663c81f,231,178,53,North America,22,870.51
85a863bf0f744bc799b0f863b12dd3f7,309,278,31,Europe,29,2024.74
85aa50555855400da2c4b62c0a0d2d9a,206,165,41,Asia,22,701.2
85aa94acc30546b0b83661e0b7f9c7b2,264,224,40,Europe,20,2155.72
85ad477e561246dcb6ce10bce1cf3a3d,365,332,33,Oceania,18,2090.01
85ad7db3cfef43e3885d166443732fb5,365,350,15,Oceania,13,2429.15
85af69aa9d854291a672216db9152ea6,298,262,36,South America,24,2435.03
85b1ddc844e3463c8396c76ea0677093,274,237,37,North America,20,2378.46
85b22d8967b44d18b057edbdedddeac1,266,251,15,Asia,20,1799.03
85b39f5c44744dbe904d11d48243fcd5,102,57,45,South America,20,878.99
85b4729aab8c4069a6779b09249baa97,51,22,29,Europe,20,337
85b4e2d3b39b47dba2e9c078026f91e0,96,57,39,Africa,22,717.31
85b8231253ed4129bc58f5bcf44ea8e6,363,360,3,North America,21,2470.59
85bbddc22a3d436f904810535d1a6b93,364,342,22,Europe,20,2506.74
85be6c3acfeb4bbfb47dbe1deabecd10,176,148,28,South America,15,1694.97
85bf86837846415a87e206b19d8821b8,241,205,36,Africa,21,1253.34
85c17247effa41eaa54ac05c8cb45038,301,252,49,Europe,18,2282.22
85c385e04e3e42b0b9a4eeeaba16a427,274,252,22,Africa,16,2094.52
85c5566a0c564c06b0d2a22d20e858d1,23,6,17,Asia,14,270.55
85c5b1b72c1c44068e2996c13796ab26,364,358,6,Asia,26,1418.87
85c64a2ad7b44e939a1fa7229b6fd8de,47,3,44,South America,15,235.76
85c8a25c24f441c89fbe483670818458,171,134,37,Europe,23,1392.48
85cab01ed9ef4bf38ec7a07046d245ba,214,162,52,Europe,16,848.82
85cac2430e724328b20fd66698dd4341,56,36,20,South America,20,466.59
85cbf0b397ee49e9afcc6303b0ffefa9,85,48,37,Europe,25,751.92
85cc8ecd2d994a638527d3ebdaa3ed00,89,56,33,Asia,21,462.61
85ccac9d363b43e8b85eda3e90c019d9,348,316,32,Asia,17,2351.67
85cce0ced7f64042ac82c3118d028c52,166,138,28,Europe,21,998.39
85cfae5547d54f5ea61a39235f024bd2,218,166,52,Oceania,16,1205.85
85d15f39670f4c608731d0d98a5e3415,363,355,8,North America,23,1146.97
85d505306cc7433cb153d5a4556d2784,53,6,47,Asia,29,506.71
85d5a2149bd549f8828c2eeda60f322e,231,182,49,North America,19,1222.52
85d88d4b09974af3a1f1abf602e5720d,317,281,36,Africa,21,1238.43
85da68727b9049efad4a542374e46c54,150,111,39,Africa,23,1205.47
85e03aace7fc40e8a0af5a96ecd7de4b,238,187,51,Asia,23,1286.27
85e307d9355b47258d8c76d626b24d09,123,102,21,South America,18,842.32
85e53465fca440e486331b74b0d5606b,143,126,17,Asia,19,930.92
85e76722d5c14ef6a1cb2844bb200987,236,188,48,South America,24,1504.12
85ea01849db94cac82329ee02dabeea6,186,143,43,Asia,22,731.24
85ebce5dca214b7a815aeb0903297fc5,216,179,37,Europe,20,1122.09
85ed814c60bf41c8b1cf6ca502ce46ce,189,143,46,Africa,16,1329.21
85ee439330e4478fb2d6977572dc1c5f,365,361,4,North America,20,3051.66
85eed1ead8bf4004a5651e4d3f299688,330,304,26,Europe,21,2512.27
85efc40e3c4b416f905ce3cbb552f1c3,241,210,31,Europe,18,1918.85
85f18ce1547e4a6491f9d8eaf07030cd,186,133,53,North America,25,831.64
85f24c61a9e34d789a7ca82649f40cf0,362,358,4,Africa,20,2837.42
85f25a2f014d4003b2b8a86b082390df,365,328,37,Europe,20,2099.65
85f409191b5d41b09fdf47d36c2c8bc2,181,120,61,Africa,20,1418.91
85f4790f22694c9284437c4529c9bb35,237,183,54,South America,22,517.39
85f6def0eca84c37bb2030f78a6b41c0,138,90,48,Oceania,18,405.66
85fa98e3c89b45f59aef9a1281e87d61,113,56,57,Oceania,19,622.67
85fae756e6f045b69cc8bcdea0793d4e,364,344,20,Africa,21,1753.12
85fc1f5a31db49808892cd2742a3cce9,264,239,25,South America,19,2345.56
85fe29a94d384695b748746e171adc10,94,54,40,Africa,18,637.3
86060e42af1043b3b2d7e9696374e8e7,360,304,56,South America,22,1558.45
8607aa26677a4dccacf737f3af1384cc,108,74,34,South America,22,619.85
8608a8df072b4b07a29ae1771d6da66f,365,324,41,Asia,20,1250.5
8608e00e444f4117a226bc71b2aba0d5,132,80,52,Asia,22,455.91
860a08b3be42439f8aefa84041d58817,351,303,48,Europe,23,1791.99
860b0bc492b94369a84bbe5ab210e0fb,227,177,50,South America,18,868.35
861204b19a4049de8571a7b6b80be563,279,224,55,Asia,22,1418.25
8613bdfcce6047deaaf280d2379e6268,276,229,47,Asia,23,1790.89
8613f3928b854fdb9071a0b8dddf0e5e,53,12,41,Africa,22,606.62
861453936a5f46a0aa227168735e54fe,156,121,35,Asia,14,811.9
8614e3b2e0784eeda8de9af2593470d2,327,291,36,Europe,26,3073.77
86152c7293b54da8b29f4a7f1d9fe110,116,68,48,Europe,24,677.31
8615657bcb3e4aa7beb8eb1005a6eb8d,365,365,0,Europe,26,1790.64
86162000c32b43a2b03c932499ccd9f1,240,219,21,North America,21,1658.9
86162c0ac0c544e2ae67e8dd9c6bfc6d,363,344,19,South America,20,2651.35
8618cd2507c84326b747c1f7ae2b5924,151,107,44,South America,23,1050.33
861cb50ef9e3436e85135c1585b132c2,363,325,38,Oceania,19,1577.8
861db4a47287420888da7b91674de3cf,136,100,36,Oceania,18,930.88
861ee74a828c49c58e91f12b03e0eb37,261,206,55,North America,22,1624.82
8620636efbd54c6cba86e6ecced06942,117,74,43,Africa,17,661.53
86211188a80c438eaa72ceaff756e0dc,162,109,53,South America,22,1006.03
8621b4692b204aedbc3c494a8c2c479c,359,337,22,South America,19,2408.03
862210cb59a1413288fb344efb97a60a,333,285,48,South America,19,1603.64
86238c45925a480ab749aab1cef058ce,365,365,0,Asia,23,1724.48
8624379b34a549b384ef1df96ffd408a,31,5,26,North America,19,148.55
8624959cc8224446a59e48b6653dc146,108,78,30,Oceania,25,927.53
862c4ce7c984436f8a5ef74c1095d4b2,270,213,57,Asia,20,1137.89
862cd23c221740a2ac04f183697561f5,339,308,31,Oceania,22,2603.39
862dc73835ff40549134c37a5a2de14d,287,260,27,Asia,14,1992.92
862eb4ed97ee453581a4d651ce23f167,61,22,39,Africa,20,543.08
862f1a7a97c64d92ba8ddf18dca6b60a,113,62,51,South America,16,726.99
862f6d1b8b234d758bac12cb1a582dcd,243,217,26,Africa,16,2264.36
863101bfad3f4cb88946617cb293a401,54,13,41,North America,15,490.23
86328320905040609e873c3baed34157,336,315,21,Africa,20,3146.33
86337016224d43d399c47c448301f9e5,321,290,31,Africa,19,2376.76
8633df28e9b3455ea8e1475f57ed9534,235,200,35,Asia,14,1722.2
8634b6884a184118bac62e7fd7a8024d,117,85,32,Oceania,20,390.28
8634c51e4f0a400fbba5471021b7d845,179,138,41,Europe,14,1135.57
86360a44735e460d9e15c799ad11a6c3,210,174,36,South America,18,1054.56
86370bc996a7431da03da2bbe242d5fa,259,220,39,Asia,24,1901.73
863a92672088452ebd473cd83211dd7a,235,203,32,Africa,16,968.54
863befc3f102428c95c095cfd565aa03,361,359,2,Europe,20,1759.23
863d0ea2af9a4ac080f5be46c5933a4c,265,209,56,South America,17,1677.24
863e0b7082334e15961c8e05945c896e,261,213,48,Oceania,20,1676.28
863f6564272941928897b7d8774815fd,141,108,33,Asia,19,721.91
863fd1870d1c41a8821e7760bdcec965,365,355,10,Africa,22,2765.59
86404132393d4b439be0fc66289f4849,206,155,51,North America,21,677.39
86427caaffb64e36882eb94d4f424159,365,358,7,North America,21,1798.34
86447ab9e8dc4e1b8793ebff90344562,79,47,32,North America,16,923.5
86473a152b004763a8832faf80355f7f,174,152,22,South America,20,1276.82
8647fc3bd4c44cb5b09c4c10b307a709,359,345,14,Oceania,18,1774.13
864ec0180138436e94802eaed25b96e7,336,315,21,Oceania,21,2041.16
8651be6e1a4f4dc7b22a4dcd7147dd93,258,218,40,North America,20,1628.99
865438ff38d5475da515530a51ae395a,225,175,50,Oceania,17,1013.96
86547a6725b745d5b15419a4e631c121,179,121,58,North America,21,1033.29
86557156701b41a285b1c9fafac6406e,122,75,47,Asia,19,689.61
86579b4d7f6a48eab7c5d37be057bb40,67,46,21,North America,18,649.75
8658751c23a34cefa3a5eff7c7a62acb,288,263,25,Asia,21,1856.37
865afc8634f2423f9727c4c9f62e3005,92,67,25,Africa,22,597.54
865ddba37f4d4ff582e57c2763e1596b,194,146,48,South America,23,1123.04
865e4afe4dfc42e49198758140a465dc,321,288,33,Oceania,18,2297.41
865ed6afaf5e409798815e3ad5f106a2,139,109,30,Asia,23,1236.14
8661daf16e724647bcb55ee7a5e766e8,357,319,38,Europe,20,2349.94
8661f946ab6649dabe42b3a702f8a6a9,297,270,27,Asia,17,2400.8
8663b9a8007f45aebcaccce0e7fd0129,357,302,55,Europe,16,1637.21
8663db21e3ea4371b7d3dd1d16cbda92,70,20,50,North America,19,394.69
866531c3c2f64194b091e3669016b9d3,364,338,26,North America,23,2801.55
866707b53d8840829bdd9f4742ee7ee3,365,327,38,Africa,20,1457.06
866744c06ca94ad2ac21c302ddf5972f,333,316,17,South America,23,2566.09
8667f1939e664d0c824d4399e5a2759c,291,240,51,Oceania,22,1212.08
86685cf95cf84b64a1b386791bcc5082,172,126,46,Asia,27,1590
86694daa9d6843c1a78d41a68c4069c1,272,251,21,Asia,15,1907.91
866aa71ed0644f11832f652e42fd56c7,133,87,46,Europe,19,685.41
866b13edf159457ca246cd661cd98c9f,68,41,27,Asia,25,131.28
866c627269cc493d87f6a18bc4e683b0,152,109,43,Oceania,29,1204.99
866cb389321f45ac9b8ff71c55470952,83,53,30,Africa,19,429.48
866e4c41d388464f8ff50331f9de4fd8,207,178,29,North America,22,1421.71
8670a41777454496b071e02763d0f4dc,305,270,35,South America,16,2240.69
86710bdeace24695880486a019b57b0f,326,311,15,Europe,19,2288.39
8671492f67e345eb9c80ce2bb1815a5d,184,128,56,Africa,17,938.41
8673143af92b453ab67c3307e59fcc09,67,38,29,North America,21,301.01
86742d2a247447bdbe47c4cdf36d12c8,297,260,37,Africa,23,2529.66
8674c431e3554275a09123817e6da55e,365,329,36,North America,19,2331.34
8674c78cbabd40a2b4c69bcecf7cf83b,306,260,46,Africa,11,1250.61
867fa65856174dd69ad32004ae97d2c6,363,363,0,South America,19,2153.47
86812262c78a45e4ac65615d1915a2ba,352,324,28,Africa,20,2363.74
8682f36342c74f8981b44ad7ea5d9646,145,125,20,Africa,20,1088.73
86837328eb964661bd724bd221cedf2c,159,117,42,Europe,18,758.69
8686eaf253c44ba899c94e6cb59385ec,269,253,16,Oceania,22,1967.2
8687507964ae451884ace0b40d2866dd,43,10,33,North America,19,356.66
868b1f831c764ac9bf679c666b37c9a2,316,277,39,Asia,17,2180.5
868b92037bce48a7b391cf2aaf55cfbe,52,18,34,Oceania,23,215.36
868bfa3667f04e6cb2437384a4a14d3c,306,273,33,South America,20,2148.28
868d3ba7fab144daa4b02e47337536a0,363,343,20,Europe,20,3649.33
868d61743dfa45f4a348267b8eb54a8d,363,343,20,Asia,22,2626.6
868dd17d163e4117b0e72c05c7078754,147,115,32,Africa,21,1225.82
868e683d08a04e9ba578584a0c28102f,134,94,40,North America,23,648.71
8693aba9dccd4411a27c78a8b7810847,252,220,32,South America,19,1855.11
86940db326e0442a8825155425f2c100,365,341,24,Africa,18,2227.54
86953f39d6f74b82818e9cb6ede2a021,154,116,38,South America,22,1402.22
8697f0b8cfab45f4bde246455bf228f8,254,214,40,South America,18,1890.35
86982faa8c1849c6ac6200ed7242ebe3,169,130,39,Europe,24,1146.8
869baf1bd606447fa61d642f99ff4a19,195,173,22,Africa,17,1496.88
869d12b03c004816ba58b9f17991e6c4,344,328,16,South America,22,2291.85
869d264b8ef149ae85b920fde6201bb5,351,299,52,North America,20,1661.73
869e4d3d8fa64d6c9254a3d578c6535e,361,347,14,Asia,23,2663.64
86a12334fd474f6a831d17f5100a24f0,205,178,27,South America,18,1226.62
86a573fa992c4193af740decaaff682e,281,251,30,Asia,17,1781.21
86a6065569ec44a9ad8953e09e0fb55d,137,101,36,North America,23,1411.67
86a6581de4784b599f0519470a788ec9,73,53,20,Oceania,26,633.99
86a70f67d99a461887c6d5a34d823bde,315,278,37,Oceania,22,2254.82
86a789691589435d9404797066d35c94,314,275,39,North America,17,2477.98
86aa32df4ee84794b872cd9be18472cd,277,255,22,Africa,25,2029.89
86aa3e46c2f743c38c26225b58eb964b,142,102,40,North America,16,983.16
86ac626978a3496d9ca5da06b2e99faf,53,17,36,Africa,20,326.11
86afcff6e4704c02ade493ab35e90eec,195,173,22,South America,20,1503.06
86b0613ca88b44e6814ca7444d9d8c58,362,343,19,Africa,20,1460.35
86b573ba79d44277b3854b6c67c03e23,70,22,48,Asia,23,341.97
86b85f1fe72a4f54887e934184ab5123,364,343,21,South America,18,1489.59
86bacba1a28f4d98b784618380588558,121,68,53,Africa,23,592.11
86bd828971e641a784fed9465050410c,300,252,48,North America,14,1865.74
86bd8334468d47b3b85db15cddd0f6db,340,311,29,Oceania,22,2406.44
86bda51e60d346dea8b64638542cd688,268,248,20,Europe,15,2228.24
86be98f5cc0442ef84a248f2066c4bf7,70,26,44,Europe,23,441.04
86c0610ba1934af89695509c7d0ac413,103,89,14,Europe,22,1190.11
86c1979d842a445dbf4bd7ddd46c688b,166,146,20,Asia,22,1069.85
86ca38cb6aee49bc8726277b0e5e7c1e,350,312,38,Oceania,23,1985.37
86cb1d3b04ae469eb453b08e36508edd,154,110,44,North America,17,723.28
86cbb84402b646e0bfe1d34e45492629,347,315,32,Asia,19,2221.06
86cbfe369b0747bfb2c254ba9583f038,278,218,60,North America,28,1550.04
86cd3d3b5bf241b3b33c9754db253cad,69,27,42,Africa,18,163.31
86cee4a0575741f3ae3e8aea1209ff3f,82,33,49,Europe,18,608.65
86d241058ffd47c0b8104a46e7452c24,196,160,36,South America,20,1257.89
86d3c160cb9e47c696ccc52668fd1c35,63,15,48,Oceania,24,226.71
86d6b34fc76c490a86e9aa35bdbc6735,237,191,46,Africa,20,1511.16
86d6c4190d3749d6bdb42620cca908ea,179,131,48,South America,17,640.03
86d80a5206ee43d6b15f2ad9e59fdaeb,170,126,44,Asia,15,1204.54
86d909d3e0994df996d73e5073917951,365,338,27,Asia,15,1368.21
86d9616286e2463bb743808ed780ee07,195,177,18,South America,24,1498.92
86d9e65fd40044e7a21d4d582dcae0a1,339,313,26,Oceania,26,2263.15
86da23b2d0c6467e90ae39534011ee07,335,289,46,Europe,24,2053.34
86db18725d5a48bfa103c727a6456ff8,175,116,59,Asia,14,1220.89
86dc6de3edae4621abe4656d4933a3fe,103,57,46,South America,23,714.56
86e39188146f49c8a2cedb7bfd8afa0c,60,11,49,Africa,18,345.31
86e70b578c6e4ad8a4548fd371657649,144,122,22,Europe,18,915.43
86e9f0e1a3e949918d2f917114f4297d,214,161,53,Oceania,20,845.52
86eb550e68784bdba8b7e5b0ec6c99af,335,294,41,North America,17,1225.2
86eb7bba52eb4e92942757c48c510b3d,315,285,30,South America,19,2591.74
86ede60f9e684ac78b81baca44eb897e,276,226,50,South America,20,1960.61
86eff8f67cbb4cd78e3be2da18cb71f8,187,138,49,Europe,22,777
86f01123510644b1aa043c7863936b16,285,256,29,North America,17,1477.98
86f09c70e89f4ea7a383eae7c4f94686,137,83,54,North America,19,547.34
86f0c2f3ebc5440cb2397712ab89e126,133,101,32,Asia,22,787.37
86f16e46c4164bc38e5d7243829d51e5,330,305,25,South America,21,2492.12
86f1a0b3ffdf45799a5f9aed7941e1fc,342,313,29,Asia,18,2122.94
86f53608472c44fea73716e990925864,84,57,27,Asia,26,794.99
86f66f71fdbc4a16b8e6c770d316afb8,160,106,54,South America,18,696.06
86f6b49e5f46431db3ad800662b9516c,117,58,59,Oceania,21,498.26
86f8346dfe8d4b0ea4030557c5cc52ee,75,30,45,Asia,22,176.69
86fa66f4d75c466698aa86b54d349b90,57,13,44,Africa,18,598.13
86fb9274aebf49ba95a3a59ae465ebb8,218,176,42,South America,22,863.08
86fc0b3f375c4affa5f7504139f89d40,338,277,61,Europe,18,1996.45
86fe5f14c4524ac5bda7ef3e7c6bd64c,321,288,33,Africa,21,2587.03
8701e8bc3d414b40bd808fc87e1c2111,123,88,35,Africa,21,317.08
8702ce03fce143808c89d7720bf13c71,222,178,44,North America,14,1345.55
87073aa667de48658c84795cf6b49549,234,183,51,Asia,16,720.66
8707e21a1eee48e788daf9d5335b40c2,188,140,48,Oceania,24,932.34
8707ecf0cb0d4d95a8b28d65b10ec92f,116,73,43,Africa,15,823.52
8707f9a5cf174b0a9ed208944f7086f8,43,19,24,Africa,22,9.91
870d90c6ad414abfbb8d2726536beca2,44,3,41,Africa,24,210.62
870efdef94ad45be9e52500b790ea4e6,330,290,40,Africa,21,2415.84
870f7c07bcc244cdb67c0a41607afb6f,362,357,5,North America,22,2877.24
8710edb08db24a258e51d3d3a4d26f1c,147,95,52,South America,19,805
8711a6bed50a4518934c82b177eebb04,99,69,30,South America,20,819.9
8713e418356146cf821e608c62590b43,365,322,43,South America,20,1709.01
8714648bf1654bd4a25da8465a7ebca8,195,165,30,Europe,23,1534.71
87193263d4374f4bb4222391381ac5b7,164,134,30,Oceania,21,1410.06
871a81f529df43eeb3a9e2bb013b2659,127,86,41,North America,18,528.37
871ad889aff146f09bf3959fb71648d7,108,54,54,North America,22,657.2
871b53477f804dbe9028835221f334c5,354,331,23,Asia,25,3000.68
871bc16d071c49e7bed85a727261e279,289,263,26,South America,14,1795.68
871c048fd6af4e298bf4cf00a4a974f2,60,36,24,Africa,17,473.53
871c678594d54305b987df6f42390f5c,342,296,46,South America,20,2384.9
871c6f5a44714930994dd67589d565b0,332,277,55,Oceania,22,1544.19
871c7fb4f8cd455f8d9b005cf2596c9b,245,207,38,South America,19,1148.16
871dc691d4b8488483022d5cc5eb5f8e,314,290,24,North America,24,2238.85
871e02c2817c49309598e2bc5acc597f,226,177,49,South America,19,1295.96
871e67f1c64f4ca8a49342ee897a3af0,156,113,43,Africa,24,480.21
871f88a98405415a851122f26f8fb2dd,356,328,28,Asia,20,2747.96
8721d49a89c84de1a168ad3d42dace5d,322,279,43,Africa,17,2291.58
8723171072294c608f03620989697555,364,353,11,North America,16,1929.75
8723cd31b78d4fe080fe230fe930f8e0,336,312,24,Oceania,25,2891.42
8723fd1edc544436aeecff1bd4745888,362,328,34,South America,20,1706.06
872497497f394aa98101b081c513c8d6,228,202,26,Africa,22,2452.55
87263ad0a5af42d1ba7d98e794a93b67,308,258,50,Africa,18,2324.88
87268d35a7c94edaa66e208a7a032780,182,142,40,Europe,20,1340.1
87271209fff9448f9753755ea87b1c71,358,318,40,North America,17,2916.08
87275416b3214cedb6772b33c4933c14,269,226,43,Africa,17,2626.13
8727b467532c48b49920fbcf8d16cb5e,285,260,25,Africa,20,2026.55
8727f1e8577b4c3cbc8729570bc60584,62,41,21,Asia,15,212.83
8728737feb2f491db91dd36ced40826d,348,313,35,Oceania,20,2401.98
872f3fd2895240628b60760731f482ed,62,50,12,Asia,18,393.05
8730fb117658480eadf35ca38ff746d0,176,143,33,South America,19,1056.62
8731db5da2b84bca99ed4d482e2f7f36,76,26,50,Asia,20,165.21
873a0cb6c86f4b038c097d5747ccf75b,341,297,44,Europe,24,2293.67
873a45c1c33c4483bd2f760057faa623,134,85,49,Oceania,18,776.49
873ad56b569248c681880ec868265b7e,333,293,40,Africa,19,2010.69
873c0bbf411f4bbaa52693fcbee6e993,362,345,17,Oceania,22,2542.84
873dcab2e8c449ecbf7f335e54091d68,125,84,41,Europe,19,922.57
873df849c0074e19a4b4b769937fbc40,119,65,54,Africa,19,813.65
874071946b75417e8654f136be1a8e20,205,172,33,Oceania,26,1733.33
8741bab76e434672ad6cd1eff77f9f1b,154,103,51,Africa,20,1066.04
874341a1fdf543779adfaf4876f11131,281,255,26,North America,19,1956.34
8743ac1bd2d8418481d879ff718192af,267,245,22,North America,24,2182.69
8748858e160c44babf853f9b00b505d3,212,174,38,Oceania,18,1315.39
874a7e3a3d18445d96fca4575a7d4175,231,181,50,Oceania,18,970.26
874b1bf144894acdbd598836f8162b9e,359,338,21,Europe,17,2912.06
874dcf95ecfc47b294b09f3578b31bbd,191,130,61,North America,16,860.03
874e2e86543a45ce8b688bf1898f1ff3,132,80,52,South America,21,483.24
874fe4ac5696425e84add9caded3f183,335,294,41,South America,29,2220.85
8750771ff3644266af9ad6f745990b4b,365,357,8,Oceania,18,2170.28
87526e5369b3425b8a9bc4f50be25b22,33,3,30,Europe,20,311.07
8754003714be495bab8296c43bcda0c8,64,10,54,North America,21,590.62
875511077c3644c091846349e4fde1ab,142,96,46,Asia,19,825.02
87570dcea0d649bdab4be9c55818fc6d,346,306,40,Asia,21,2657.75
87579bce9d7a46a09638b5281887e6cd,47,12,35,Africa,22,343.22
87592a4eb5094ce6ac3ff162b84ae566,58,29,29,North America,17,481.87
875973a40b34467b8f630cae01be7e8c,364,354,10,North America,19,3328.39
8759be090b854910ab7377cd35faf99c,327,299,28,Oceania,19,1718.27
875a2387235a4b02acab8c0b82af1e9d,140,87,53,South America,18,771.81
875bafcd729547fe8a7a40633c63ae1b,154,126,28,North America,19,1626.41
875be621e09640669b799e8bc706e6a2,321,271,50,Africa,24,1407.1
875d5a06cd04469dab804fdd1f917779,159,126,33,Africa,21,836.18
875dc5c6281e4169ae86d7ea8533daa5,133,118,15,South America,19,1191.78
875e4b573a034616a21840199c4d19ff,336,295,41,Asia,18,2636.67
87605264604f4f2fab91d4bb354b31fc,182,153,29,North America,19,1831.25
8762194bbcfc405ca01f31d7844c05ec,208,170,38,South America,17,1293.02
8762499e9b84430dbcfabd6151d2534d,283,239,44,North America,19,1668.67
8767a8d8b94f401d8c447e5be46a73c8,217,177,40,Africa,27,1574.25
876d50fec0e541ae91581b262f027047,128,73,55,Europe,20,694.86
876e778bc2804d84a767f1cd016c189a,280,250,30,Asia,18,2121.7
877004062a054e068e9d3c960b56520e,272,243,29,Oceania,19,1929.53
877212109fca4f29b84d707a65151c54,136,112,24,Africa,20,1318.66
87740c7398a041a2985c04405fb9aef1,308,253,55,Oceania,24,1804.46
87743325e9d6454fbbc944490ea02d2d,68,44,24,North America,23,742.28
8779671211a547559338c8d97cfdef53,323,278,45,North America,15,1602.97
877a4a4e5530451996cf5e278ff54085,297,277,20,North America,17,2038.39
877a9a2da1d843b7b4ca4990171099a0,340,290,50,North America,18,1346.07
877f559da00647089dc4b42c4023fdcf,182,136,46,South America,22,1348.95
878365f53d13412b8fcdae8330cb4639,94,55,39,South America,21,627.48
878423051d3a477f90db04d2893edeed,364,320,44,North America,17,1598.29
8787461e3eee48e693fee9318ea7fc1d,202,171,31,Oceania,19,1495.09
87880635f514428eb2ea4cce1fd31373,172,130,42,South America,19,999.83
878cac974e2842abb62644ee07fecc13,112,80,32,Africa,23,552.4
878fbf93bef541fd827650077f067595,356,326,30,Oceania,16,2547.1
8790f530bd9e4d858f364cb27ce5f21c,67,37,30,Oceania,20,281.93
87921f41e9714d2c80b66ef42f99b45a,235,206,29,Europe,17,1330.8
87929acde7c848bcb64b3c261f28a283,274,220,54,Europe,22,1154.73
8797f53c6ab64dfaa2104364e98ee24a,170,125,45,Africa,14,894.51
8798cce6ceda4671a3a55ef4d7255145,54,8,46,South America,14,279.03
8799c8fe09f04dd1b8bf22c0451c4287,181,148,33,Asia,26,1390.18
8799ef671be3491b87586b4757eb8272,365,332,33,Africa,20,2655.7
879dd1f025c945d789c9befb054103fb,54,6,48,Africa,18,145.44
87a115f995eb4e178c7de3cba84dc815,202,145,57,Europe,17,996.97
87a2b7a47baa4df9beae021ffda14dcc,158,117,41,Oceania,20,1108.9
87a2d3f87b3b4b419379f52b1bfc2b98,296,243,53,Africa,24,1929.59
87a2e7baeb844c4982c5d543d3b4b053,69,38,31,Africa,20,635.05
87a38d44866c48289220bc1aff8b7b30,365,352,13,North America,15,1665.02
87a39e97266c42d48ea6b8e9a6707dd8,213,169,44,Asia,21,1355.88
87a3d5a0269647adb4104038706d5821,331,290,41,Asia,21,2776.55
87a42d8a90cb458cbb5afcce540f4ad9,151,107,44,Europe,17,987.85
87a4e07f8f2a460b9cc35b6be317d129,319,285,34,Europe,18,2001.58
87a542f14a53444191b8df4e67f528b9,251,222,29,Africa,18,1746.47
87a64cc8e5dd4377b4711dc733b48dd1,276,238,38,South America,22,1428.94
87a69e4386f3464da52819da2ab75cec,301,278,23,Africa,22,2176.87
87a7c0a1c57c4d709787fff5628fb0b8,177,148,29,Europe,15,1321.71
87a852a0a417425597629b3ce9addf45,109,52,57,Europe,18,639.11
87ab2de11b3648d48f44d7fbb63e8a4b,324,280,44,South America,23,1364.39
87afec178010474fbb2c74ad1205abd4,289,260,29,Europe,20,2145.57
87b2d373596845e59ca64a4962f198c4,306,259,47,Africa,23,1946.73
87b5acbfb45c4f1baed3c9b0e9f03e0c,73,17,56,Africa,21,540.67
87b5e61a92564b32a2b835b98bb8a686,76,46,30,Oceania,19,465
87b5ef41e81b47f0962c12fa208941bb,364,335,29,Europe,19,2354.81
87b6409908fa4c879403a0ac15130950,365,333,32,North America,15,1999.58
87ba723c752b4d91b41eb92c1a33c7ba,144,99,45,South America,19,887.02
87bb2a1b86444d948c412c0aac01a025,228,179,49,South America,22,853.83
87bbb420b96440498d934e3643d297c0,356,306,50,North America,17,1674.61
87bd9fe2e0064c48aee951ae7715e875,266,216,50,South America,20,1280.5
87c005256aa54bc29da398b7efef7177,155,124,31,South America,17,1458.42
87c0acab8dd94daea8df813dec7e8f71,39,7,32,South America,24,216.1
87c205f7a17c46d8a8be5c168a16761e,100,52,48,Asia,20,371.38
87c58780f6d849c4a54365fb9a6544e1,171,139,32,North America,21,1042.16
87c5c538214942eeaf057be7b6df3136,276,217,59,Oceania,19,1439.47
87c67416431c4537a42ae928ac4b77f4,124,86,38,North America,22,547.15
87c7b577e0b344b6aa0ba5f8da44c1e5,107,76,31,Oceania,18,896.49
87c9261c569943d3b18411fd340b69b9,171,130,41,South America,23,1154.47
87d2316d707a4a8a8ccfa72ffc2d6c78,104,62,42,Africa,19,511.11
87d4c6cd37a84bb69cc2b3a3805502cb,348,330,18,Asia,23,2644.07
87d570705067410fa80fff96cbdf49fb,200,177,23,Asia,22,1666.7
87d5a59c58d4488a859dcaf3ac578c75,123,99,24,Africa,17,1256.26
87d5bbb4e86543a7a8f621760a8a5a08,315,258,57,Asia,23,2004.25
87d63f1b14984d718bee710883142372,224,200,24,Oceania,18,1262.52
87d78875efba4d938a57ea1857599e75,365,340,25,Europe,25,2694.19
87d8188a57ff4165ad32b1ec025f0c35,122,69,53,Europe,20,332.19
87d8b5fa0862426f9e6e9dcb0e9d4495,178,131,47,South America,18,690.98
87d924c1ad36433989ebbf696a4f0ad0,252,214,38,North America,22,2053.59
87dc3237049f4bebafea9003a706c5ec,184,161,23,Europe,19,1484.43
87dc57bf4b6a40908b88e9ed8b402ea1,239,203,36,Africa,21,1421.52
87df03074933495fbecc6e8cd0ec4809,364,313,51,Europe,17,1829.64
87df78d961f8424a90ba48a56fc1e6ce,248,196,52,Asia,20,1085.81
87e26b6f8bc7430f99b95cf3463da1a6,363,363,0,Oceania,21,1845.14
87e2773e729d46469f3dff3ebf1b0746,45,5,40,Oceania,21,316.05
87e4dd7b05854b30aa395e085e05f283,139,98,41,South America,21,869.48
87e62d5fccec4a8699466068739c665b,365,364,1,Asia,21,2768.18
87e729abf3fb4e8589056440d342e2b7,48,22,26,Africa,10,233.37
87e88c561f3d4925b8e03d4e3d4f1cd2,365,334,31,South America,14,2323.38
87eb1241754449b09f8e1da4a3b2bf56,227,180,47,Europe,22,1031.1
87ec43ceaf794ee7909dce83707cae1c,336,282,54,Oceania,13,1685.37
87efec401d5646508dcfd7de8c6ef62f,77,18,59,Oceania,16,656.26
87f114d500c042fdbbb39f1de3ff257b,43,19,24,Oceania,19,335.56
87f3c9bde9c54bc698098b76d331a7e2,214,172,42,Oceania,25,1602.53
87f468faede245a688df83b0c02192b9,46,12,34,South America,21,427
87f89d2f1d8847f48c2fdeab7dc1db9e,354,312,42,North America,18,1354.94
87f8ce0dfe864bc19b97d6471409cd9c,337,309,28,North America,16,2655.14
87f8fcf3660e4f519608db0d4bd941fe,172,132,40,Africa,17,1179.4
87fb7bf8389b4879b2bf01cad9ea35cd,85,58,27,South America,22,853.35
87fd7bd5e61445b6b119f9417dae669c,66,31,35,Africa,24,453.29
87fde0f1505f448ab1492b92720315d5,364,349,15,Oceania,24,2118.88
87fecbf487f5432b8d60d27a758df950,169,129,40,Europe,18,720.81
87ff6d473d28430692bc143c9882f01e,204,171,33,South America,19,1161.8
87ffa62afd514653a1219b79c5378bef,359,336,23,North America,19,1477.38
88003895f8b94a8892825259e1b86748,276,237,39,Asia,22,1517.83
88027ec982894df0acf2c6cc431b3493,280,244,36,Africa,26,1889.07
88058d1f41794c719f3e6805eeda9c26,114,72,42,Africa,16,651.27
88063a0d9ec84e5581892ef08e9df00a,277,232,45,Asia,18,1268.9
88093b8991d04aa2ab8d671d4c9ca003,169,117,52,Africa,20,880.66
880af5de33c243afbdffbb4ed4c9f11a,172,136,36,North America,25,1326.39
880c3b3b7c99454ebd31a320259672b1,105,56,49,Asia,20,776.68
880d1fdf524a40b4a751c609406a87c3,80,24,56,South America,19,655.72
880e198037b94b56ad846d4fdba825e9,98,53,45,Europe,14,148.53
8812e4401f4149ebbd21f3e7c27b53c2,364,318,46,Oceania,20,1778.31
881543b763584feb8dc8db39909298a4,321,263,58,Africa,23,1955.59
8816adab9e4348e6a0d04ed075db73b9,335,299,36,Asia,20,2447.1
8817fcca0c5948db9cb2598ee35f8f42,327,306,21,South America,22,2459.65
88188b1a19964f1895fb3f74741f2371,238,187,51,North America,22,881.4
881a0d02bdec42c6936eeb32be2e704b,186,135,51,Asia,26,746.42
881b28a2d497488a913402a4e257f419,97,86,11,North America,17,809.08
881b9f201939499a8d88b34a4de63a8a,202,167,35,Africa,22,1603.92
881cbb302d554433a7ae66dffc4007b5,67,35,32,Europe,18,723.91
881cc8ef589543c2b920d6fd25a68f5e,281,230,51,Asia,25,1319.53
881eafce4d9740e195a70efde41f3559,133,103,30,Africa,17,765.55
881f16c5a6c44e708cdf20afb405b58d,209,164,45,South America,20,898.22
8821a96fa46f4088925ada9d34e9f5fd,218,204,14,Asia,22,1330.25
8821b02ee2e64bba9898f16300f94717,164,125,39,Africa,16,966.31
88225f09340a492aaf7e8b3dd336dba6,194,153,41,South America,20,1635.07
8823c5f0ecb7454d9286e785e30643b5,98,41,57,Oceania,16,682.07
8827657db2a5457193561c8112478196,72,12,60,South America,19,488.93
882a2c32a1a544cc8bb29bbdc8f1ddaf,295,258,37,Asia,23,1957.45
882be74c6f164ff4aef8e8e8e271c3df,321,271,50,North America,24,1626.43
882d87e5d5d24a43abe657537d123094,36,9,27,Oceania,22,486.9
88314607bcfc405dba032774a3e71bcf,62,45,17,Europe,18,557.07
8831978307854110b3857b1e75177326,363,356,7,Oceania,22,1751.09
88344e3a97964581b3fed65a351a7999,181,154,27,Oceania,21,1718.48
883554a0485b45e2894c566802d86fe6,194,172,22,South America,21,1442.02
88376e685fcf4578ae125b544ce8b7d1,271,244,27,Asia,17,1886.24
8837988e552542f39cdab33f42a8f836,214,182,32,Asia,17,1642.69
883dc8faadb2427184117baad048828a,272,236,36,Asia,20,2029.35
883ebc431c0a46098e8d32adf71f4a3e,90,33,57,Europe,21,261.07
883ef9d3cd2c4eba99847c58a66341f2,365,345,20,Asia,20,1802.96
88479e1bbfbf4cc0af66d25fb50d449a,234,190,44,South America,25,1227.38
8848b081631e419797134d472415f293,345,306,39,Asia,20,2426.72
884a5b5960d14cffae2539d32ecd4322,57,21,36,Asia,15,445.33
884c8ac593f44119a991b6ca953dfe6e,187,157,30,Asia,19,1546.72
884d97e0f1e24af7863f4eae74456274,28,1,27,Africa,24,135.04
884db40c55ad46e98c69a1be567483e6,124,68,56,Oceania,16,638.79
88509b31651f494aa262b7b6f6eb2ecc,24,5,19,Europe,20,271.66
88511bc3dcaf41d9971a8f5b2e64c5fe,134,91,43,Asia,22,835.89
8852189cce844ee4a1a0312629b1d66a,284,265,19,Europe,16,2871.16
8853b496ec874d07b6c0d2f11bb778df,243,195,48,North America,20,890.95
885a26e267e941cba84ee81701f0c8bd,365,346,19,Asia,21,2989.55
885c4db219f0461f8a00e0cb79d32941,34,12,22,South America,21,372.43
8860763399fa44538035a2b505b1589d,155,110,45,North America,21,681.39
886367ca144d4c90aec50d4926e1ee37,278,232,46,Oceania,19,1532.98
88652ab4c9a142c18c938659704f2ad8,295,265,30,South America,18,1693.12
886b3df4cd8a497eadf58e89edc70153,26,3,23,North America,19,66.33
886c0987b89b40b7a1796a566d173d36,228,198,30,North America,21,1539.01
886c4fb55f754ff3aa6e6ad347cecde9,351,321,30,Oceania,20,2645.51
886d96a242824cd69161316cd23b1931,363,346,17,Oceania,17,2374
886e5556d58441a69d640c822757a7a7,102,47,55,Europe,18,418.13
886f1694297545b387b22dbbcdcabfee,301,275,26,Asia,23,2091.19
88700e1c5eb644279d3526898289e22a,362,308,54,Europe,23,1595.56
887023727b9b488f8fec6cebc099022d,82,34,48,North America,13,195.49
8872ed9a20fe4763b6d26ef36569818f,69,38,31,Europe,19,514.62
8874a7cbc7204d0a9ce3cd41f02c9ccf,335,309,26,South America,19,2492.85
887549cbdc1b44f99b965e209fdf05b9,72,33,39,Oceania,16,614.66
8877d786e6294c96aa819c560cd203c5,118,73,45,Asia,20,939.26
88796a185368464ca447add0883327b1,38,10,28,Oceania,22,409.38
887a2ef556df4f858bcfdbeedc239cfa,87,39,48,Europe,24,647.11
887af5a946414faf94b7c31265e808b1,180,128,52,Oceania,20,1341.67
887ba31ed25f4c56a1b569a705441a8a,100,72,28,Europe,21,500.45
887cbb1d66884d1ab1790317130630f3,117,87,30,South America,22,894.48
887dc80c1dd84f77a9159b78de32ee1d,311,272,39,Oceania,25,1817.67
887fc1ff26dd4ceab81561f26983011d,364,326,38,South America,14,2000.55
887fe4b7c98c4d638627e2ed3e9bf4d3,86,59,27,North America,19,465.34
8880f5a65ed14991ada1533e4e397507,127,71,56,North America,19,542.48
8881668ebd47471ebb13e6cb9893854b,60,14,46,Africa,21,309.54
888252fd08e14348bfd23b2127af5579,215,178,37,North America,20,1332.51
8882fbaa6571489faca919a1b0183d13,257,230,27,South America,19,1982.2
88841bd5c343405f83b5fff58833a816,209,174,35,Africa,18,1281.79
88849910f949464d8269aa0be3e45974,101,45,56,Oceania,23,474.71
8885b60b4ebe4caaa7eed0cbfdbd90a9,365,315,50,Africa,18,2198.69
88877f566ee64b4bbb2bc8d1af0873eb,362,361,1,Asia,20,2157.02
8887dc5dd6eb4f268261a784674325a8,198,155,43,Oceania,16,1500.91
8888d05154a6462aa3e89c4baba88691,293,243,50,Oceania,23,1426.63
88896fcb6c8b446ba2b18db95da1464e,339,288,51,North America,20,2565.66
8889fa22a70241adb802f5135afb066d,314,270,44,North America,20,1340.37
888b130940064405ae36bbe6572fd593,200,146,54,South America,24,843.01
888b1b90b5d748d780fb10a01b08f3ba,199,154,45,South America,18,1025.29
888b8ea1bcd24cd6922d0daa02dfcad9,289,258,31,Africa,18,2076.8
888daed944e9444d89dc7ea3b08f3816,116,65,51,North America,13,577.67
888e66b17fe3429e8ba900fc573bdc55,103,50,53,North America,17,694.29
888ee9548e424085beac79b1f378f8ec,180,134,46,North America,22,676.1
888fc6b741184e5c828f43169fdfa8d0,362,329,33,Asia,16,2244.19
8892b7b60e7a409c8431cb864127da5c,345,296,49,South America,20,1620.91
8892e2296fa1418f99dada0446dbc18b,221,183,38,North America,22,1833
8894637f002f4e7f9f1d7093ce89567a,122,96,26,South America,23,847.07
88946c45cbd0481eadb298a43af903f7,201,177,24,Oceania,22,1096.47
8895967c28c14b12ab7dd618b1ca0853,57,29,28,Europe,18,182.06
8899797893d0470f86cdcd461df5c0a5,183,146,37,Oceania,19,1013.73
889a6d4cc4c643d6b124f723ec70d245,303,255,48,Asia,24,1880.81
889a81fc6e424abc890f3a27db580d89,327,283,44,Africa,20,1225.32
889b0b8a82ef4544a37baa77ef4a3249,30,1,29,Africa,21,143.48
889be097a8cf4d79917243c89119f5b6,239,206,33,Africa,24,2399.79
889c08a1c7cc46a58506824b00ced4f7,68,28,40,Oceania,16,536.65
889fc44854ed4f64993ef507240b7ad5,192,169,23,Africa,25,1257.98
88a0a38b8c94495e822f2d82f25f53df,90,36,54,Africa,20,594.71
88a4f74e76a64232a523a4a78f620a25,291,241,50,Europe,20,1178.37
88a87c4e2fee4f24a8ec7499c5096eb9,80,62,18,Africa,27,549.32
88ab5b47d7d54c39be42576e708a5832,110,76,34,Asia,20,1054.71
88aef13cdfa34e0b9ca352125269b4c8,115,79,36,North America,19,728.41
88af97a014dd48bea73eeab91e72435f,354,303,51,Oceania,24,1373.84
88afff32770e4249b96387853e4b1bc8,248,201,47,Oceania,24,1391.02
88b37a9b917c4990a2e0d3792bc58d05,323,271,52,Oceania,23,1215.36
88b657161dce4b10b7bbfd0f6fa3460b,82,57,25,Africa,20,712.63
88b6e60eedd34b5586aef02477726899,85,36,49,South America,23,295.36
88b8725f16f94eda9ebe819ec657f664,282,238,44,North America,21,1204.11
88b8e16c0eb543f198fa7830bb17cf5c,133,89,44,Africa,17,693.8
88bb635b5696438e8ebb452aa3c91926,351,299,52,Asia,21,1683.43
88bc55e3d25e488fa0ab21ef852ca0e3,83,39,44,Oceania,21,305.3
88bc725405e34604bbdf1192aaef5da7,91,59,32,Europe,23,641.7
88bdb92fa8b84cbd9d5b598dcc95b21b,171,123,48,Europe,16,815.82
88bec8cf615b4e86a1fc6e1001f96cb6,221,182,39,North America,20,1285.43
88c09ef8696c4d34b4fa2573aa80801d,365,352,13,Europe,20,2578.99
88c0cce31b4141ddb81b9cb05cb4c6c8,65,47,18,North America,22,698.74
88c1559b0447468d85d29d28055675d9,364,345,19,South America,22,2693.54
88c2054360e8463c9edd33ca77001fdc,328,295,33,South America,24,2444.88
88c26b539f424a29b1a556f5c61d76e7,328,301,27,Oceania,20,2891.4
88c66b6e96094de59aca18d976e20682,148,112,36,Oceania,25,1292.69
88c6bc83f34a4316bfaad8b32f830e24,290,272,18,Asia,15,2468.03
88c795d853eb45679e6a2991ada69866,260,223,37,Europe,21,1380
88c7b8c5a8674f4ba557e69580a6a8ca,365,315,50,South America,20,1872.51
88cae9d0009e443a9f5dc6b9e18e34ff,152,113,39,Africa,22,1380.16
88cd472f37954d8c9557f80cd46a7671,213,171,42,North America,18,1454.89
88d09b257d2846d0a4aadfda5e91b2ee,310,268,42,Oceania,16,2435.88
88d3187016754eb3bae4966c45d9eac8,363,326,37,Oceania,23,1694.88
88d4b76dd691489d8802d9e6a3575b61,181,134,47,Oceania,15,1021.7
88d5b8dc72f04c3083ff793705067819,201,163,38,Asia,17,1819.13
88d692e8f82a4c3cb3f926948c810c79,178,152,26,North America,18,1056.64
88d6b453594f47c6978e6ba3ead533c9,136,87,49,North America,20,1018.9
88da2a8756cb4b3ebce3cf32c2e6a46f,364,329,35,Africa,26,2049.18
88dae5f6cb0646cfaa9d229190a2eecc,106,58,48,Asia,15,750.86
88daf1d1cf074f73a8e880c932c64633,365,333,32,Africa,21,2099.95
88daf96ab46a40249ba2619d0d13c4ad,228,179,49,Africa,23,1195.81
88dcd10a1bb847d58c029a3284504b0a,72,34,38,Oceania,18,845.06
88deb6f61d15453aa6cf83122cde4cc5,365,351,14,North America,20,3356.99
88def32bab3c48d5949ef0d7222d8561,313,262,51,Europe,16,1744.19
88e37fe1d0214f6b80da6c6aa8b93f52,161,143,18,Asia,19,1225.72
88e71b35b5364835bb9dbf65fa6440e6,361,353,8,Africa,21,2374.43
88e85682cbc848d1bc9c24efa4ca0285,235,191,44,Oceania,22,1222.01
88e9f5872c3649a392fad400011403c5,284,254,30,Oceania,20,2462.27
88ea768861c34bde8e076b8c94e23b7f,248,213,35,Asia,24,2018.79
88ebb65c28bf422c8a22a574f61c977b,240,194,46,Africa,19,1817.23
88ecd5c1a461483c84490d3a46700397,250,218,32,Asia,20,2434.98
88ed5124fc174e8d8de69ab22ee1a79d,278,252,26,North America,22,2248.54
88f155809a8342e6840384e8cc155ee6,363,363,0,Europe,24,2745.25
88f2e7cea96541768a3a0b56308c219b,52,30,22,North America,15,469.6
88f3d143a41544afb4915ccb5fae03bd,87,48,39,Asia,26,467.66
88f8f8b62a964d908ef41f67ab75acc0,214,181,33,Oceania,18,1342.53
88fa6bf5cbc24b35a5df02e190968f7f,115,94,21,North America,21,908.71
88faf27856244457853cb27f0c7242ae,143,110,33,Europe,21,1081.08
88ffc53eaa2e41bebab8a09de08d44ed,134,115,19,Europe,16,979.99
88ffed659495400aad6656f83a256907,324,288,36,North America,16,2075.85
89091dae31ba4f148584232a0456af99,227,170,57,Europe,18,1154.78
890ae9f580cc4aa798155a839cd9d95f,179,116,63,Oceania,20,628.86
890f58dda36e40f19068f28abad4acbf,361,306,55,Oceania,19,2084.57
890f79ccb37f4c86a1b56b620aa06835,57,35,22,North America,21,322.03
89119c30dbc04190a970442a019e3559,234,196,38,Africa,22,1294
8911d6a168d54917a73aba03b9a53702,325,304,21,Africa,23,2723.69
8912d3f06a394a548b6d95e9b1cb4d3b,344,292,52,South America,21,1915.86
8916d514de3946baa6ec9198bf47c0dc,249,223,26,Asia,19,1836
8918916abb9545209313f089a0b7f3e8,103,70,33,South America,23,700.91
89195f54234e4580bf3a1013ec2ca508,138,99,39,Oceania,15,1131.61
8919d77ff19e49468ef448f04db26d67,344,292,52,Europe,19,881.74
891a8200545a4ac1bf31ea459ec302ab,364,333,31,Africa,19,2332.34
891b339c138647ce8863ea88706f3141,33,7,26,Africa,20,380.56
891b8fcaf17a42e39ba705f81c8066b1,80,41,39,Oceania,20,247.63
891be8f062504699ae1e0950623fe5c5,362,330,32,North America,20,2653.21
891d429f48f54e02b04a0332ba17a76e,187,133,54,Europe,19,850.32
8920f5964cda4dce9408aabae7e68b69,113,94,19,Africa,22,826.38
8922e8d2358c4fd288975961efb39857,344,298,46,Asia,23,2526.08
89247481a7ac4d8988844ee625bd0554,116,73,43,Asia,17,573.39
89270574232d4addbeb44b912e4faef5,282,240,42,North America,18,1297.6
892729a506794cb7b98e502e8dd363ef,121,95,26,Oceania,22,1012.85
892d37a600a140ada4313f75e71eba29,140,83,57,Africa,18,407.76
892e1a002b514bf686e12ca399ab4deb,365,356,9,Africa,23,2306.47
892e32208ccd4ad19f9a08014e050926,175,125,50,Africa,17,962.02
892e9e667a3741f09d3b534ff5cb6fbb,344,299,45,Europe,17,1302.29
8930057e104742c09c729c6de3f428ba,277,250,27,North America,20,2319.3
893013d90d814c8ba8ec53da87376b10,59,12,47,North America,19,287.84
8930a7516ea340609db718b46465766a,167,124,43,South America,14,1128.85
8931054f55cb476ab8e9e43c4b596229,184,162,22,Africa,13,1056.7
893404f91e7648069dc9eb17b9b75d2b,248,200,48,Europe,19,1926.5
8934e49b4cee4e41b5a680e23e4bdd31,349,304,45,Oceania,25,1951.15
8935d1510bd44b4fb3324e4d7830448a,284,261,23,Africa,20,2145.09
893612f1b1e740cdb652c25ad734c333,109,71,38,Africa,20,436.45
89375fb528a64f028744d7a1e360bec7,287,245,42,North America,19,2167.88
8937b65a379443609fd3173e8bb7844b,199,167,32,Asia,21,1374.86
893be1fd44ca4655af67420dff392cbf,257,210,47,Africa,19,1093.43
893c931cfa9748a89cec09736b5e38d4,326,277,49,Asia,19,1363.75
893d8ba84cdb46c5a372fac94cdb114a,331,294,37,South America,22,2284.15
893ea2db83534307b93d1b2cf786e983,319,288,31,Asia,21,2888.39
893eac16266f4f7d94db56317dce0ad3,198,159,39,Africa,16,603.42
893f38cb6aa04c9985c33295e760960f,188,141,47,North America,25,575.73
893fa7f9645e447e89bb16120bb0f146,117,73,44,Oceania,23,835.93
894021eab8564a21bee68caede90ef74,149,111,38,Africa,21,1084.81
89441ad9dafa4310b86cc3dc2511b87e,276,239,37,Africa,21,1369.45
8945c80d82d44e85891f1d1a2a4c8734,303,265,38,South America,24,2253.14
8946682dbb8741aeb8d503eeac596900,365,363,2,Europe,17,1780.4
8946af9e2e1d407588d05b5f3ddb875d,358,303,55,Africa,22,2019.04
894b8dd989f84a97a2240b505610fdf7,90,37,53,Oceania,25,544.4
89509cb8159b41808fe5d37358b4ffd3,125,83,42,South America,21,578.46
8952c5d6503f4dacb3ac1c88bafd8291,259,202,57,Europe,28,1061.34
89588f0cca27478680f6bea024584127,128,81,47,South America,19,409.08
895c9df469dc461f86d5e145de516e28,238,198,40,North America,19,1458.31
895e3dd4287a4dac8abca325b359362c,267,243,24,Africa,15,2126.76
895eb3e6a6a5469c954e6ed2e1695ed9,157,135,22,South America,25,1179.98
895ec60e4118463eb2ad71b580716053,80,66,14,South America,22,583.43
895f206725754e0daa00d249a1da2bf0,151,100,51,Europe,17,746.69
895f49a4ec6a43dab1328439815c882e,168,144,24,South America,21,1409.81
89603112302e4415aad0a87dcafd0870,222,189,33,South America,18,1347.03
8963908301e64037a3ab655b13549cc3,327,283,44,North America,19,1764.57
8963b664d24347cc84688bd701a69b7a,88,44,44,South America,21,292.91
896783e11d7949ffa082f5aee74c5ada,93,45,48,South America,18,467.54
896822e353dd4c1483a7176dcdfc8805,327,296,31,Asia,16,1669.33
8969121381a742b29c920fa4f9d9e6ce,76,25,51,Oceania,20,336.74
896b0e39d3c04998b1a5089cc28d4415,241,214,27,Africa,18,1803.35
896bef03620546eeb1329fa884e81837,338,309,29,Oceania,27,2554.92
896e241f55134b07a24924b2977a06de,63,18,45,Oceania,18,534.18
896e87ed32c14229a2ad3f43d2c50a39,322,299,23,Europe,25,2197.93
897155ed57814091b59aeb0cf496a449,192,146,46,North America,18,641.61
8971c5a2a7824309a0505a88fc30bbc6,152,125,27,North America,23,1247.11
8973121ec1174c90973de16bfe744132,87,44,43,Europe,19,443.75
8974bd76ddc94d5594854427c25be9b2,319,282,37,Asia,17,2470.26
8974cf714b8149e3b8bd7041b71e7370,179,129,50,Africa,14,1153.53
897618f6e6e64ac4984f9e9bb9d5fc99,320,300,20,Oceania,16,2620.46
8978e6899964439b92455c623923bef5,209,162,47,Asia,19,1087.1
8979a9bfff1e482bb280443324ef6ed3,214,177,37,South America,23,1561.78
897aa8224d844705aeea687e4548e0ab,135,97,38,Asia,19,928.48
897b95dff3a24cb18856d753f8aa9752,30,13,17,Africa,20,347.22
897c1d057fcf4b06b60d11adbb7dd9d5,298,277,21,Africa,22,2562.01
897cf6f914994e68bfc52636df8a186f,365,334,31,Oceania,19,2914.9
897e103a42a244eb8586c486fb9b253c,199,170,29,Africa,21,1374.37
897f73e2d98449938a43abe7942caebd,105,51,54,Oceania,24,466.8
897fc6decba5449cb51be0b5bc9722fd,102,57,45,South America,16,489.14
897fdcdc33284e87952702fd23169f1a,360,317,43,Africa,23,1963.55
8980032b2261492aa85534dbd9e29559,226,175,51,Asia,17,1044.11
8980344cad4d41a4b437c695c0ada548,115,89,26,Asia,19,769.1
8983b80b757a48aa83b09dde4ea78bd5,286,253,33,Europe,19,1793.47
89840552be0a498ab086c152cfc74464,267,233,34,Europe,14,1435.62
89878d620bc54fc89807ab04d05cba1d,189,163,26,South America,20,1236.5
89882a73136d4ff9ad17b8e690d447ae,364,356,8,Asia,23,1939.49
898838b8e5ea46ff93aec70865974dda,42,18,24,Africa,23,240.32
898851edf0c44a7f9841902f9c7ab41b,95,59,36,Europe,16,1077.98
89885aa975eb470684d1ab83ce9812b0,239,187,52,South America,26,1574.33
8989a4b9271247c38f3808f496cb52a9,334,307,27,Asia,16,2279.18
898c42f5083b40e7a7024cf6d95bd866,59,32,27,Asia,18,286.7
898c804e6a154818a86a6da6cfeee647,129,76,53,North America,20,455.15
898c8fbdb7c444c3a7692b80149f38a9,162,105,57,Europe,22,908.01
898df07127ec49648628e27e3e61e33d,207,154,53,South America,22,1127.16
898e2f625c8a4cdcac5878d88c346428,148,136,12,Oceania,23,1263.77
898eaef98b164dfe9a2d30fb965414c8,191,167,24,Oceania,22,1723.75
899142fd935541ae83ec1fbc5cc7e0c5,161,105,56,Oceania,19,877.23
89922ff29d8a4d52806e4309737bbab1,347,305,42,Europe,15,2238.94
89927fbab5e840e0bdaa2b316b435a42,70,48,22,South America,12,631.47
8992bdfb212e45eb9f9799fcd50d7135,176,133,43,South America,17,703.85
8992f543d666413db450f4d1af622564,91,50,41,Oceania,21,480.47
899325e25f2d4268a57b4e9f1fd24546,313,287,26,Africa,15,2605.66
89945849cca44ba99c31a5b228029b4e,76,18,58,South America,15,562.39
8995004eb43b4ae1874b96d1b79751fe,128,84,44,Africa,28,764.35
8997419cad954cf89f85423995bbb003,217,185,32,Africa,16,1913.24
89980db041954084abf863c7205f548f,340,307,33,Europe,21,2429.38
8999aad892194cbc807832044611fd23,365,323,42,Europe,22,1758.13
899a471b3d19496cb75d8884aeaa66f7,365,323,42,Oceania,22,2233.69
899aa1bbab194481b29537c085bf1aa2,170,139,31,South America,27,914.84
899baafcb9db4c0c9b13cac141f9cc6b,317,265,52,North America,26,1888.69
899e2c64193a4f43be7f5d4851a17da4,298,277,21,Asia,24,2000.15
899f32523d894d98b2960a809fbd726a,364,362,2,Oceania,24,2390.11
899f60bc9db34803b796659ca09f7233,50,18,32,North America,21,537.34
899f6c3e31df417b94cfcc4f40ac862b,262,226,36,Asia,21,1980.17
899fa9f20b7c445286337b29e5085c95,55,8,47,Europe,22,437.49
89a03de04dac478390e08ab99394f806,145,129,16,Asia,18,1029.32
89a073681d0b4784873954b1eb8d07f3,198,159,39,Asia,24,1579.98
89a3b7d8d93b4ac98c1c0967a3956431,262,230,32,South America,14,1909.41
89a3c02bc00944a3b478ba9b4c437a0f,144,88,56,North America,15,871.34
89a4526caefa41cfba5cc8582803f6ee,302,261,41,North America,21,1841.76
89a4efcee8ed44ef9d7d3f63cec4de51,347,304,43,Oceania,27,2401.48
89a4f7e8aa0c46b6aa1c3efb8ce061b0,253,226,27,Oceania,14,1851.77
89a51ceb9ed046cf8cac1251d0a433d9,354,326,28,Asia,19,1527.7
89a784ab481f410284d775cc3058f81b,268,224,44,Africa,18,2027.08
89aa72f6716641c892720dfcbcd8155c,161,121,40,Europe,22,1751.72
89ad6ca92735442ab88b851966204525,135,97,38,Africa,18,486.23
89ae8c2aa36541e899174744e6a20184,67,12,55,Asia,26,306.49
89afbc17397f4741b45836e3c4ca8515,153,122,31,North America,19,1083.97
89b03a0bc3df46218ca996e2336e2d3e,95,49,46,Oceania,24,267.66
89b2257f07e74a9d8fb5e02a38694b45,112,88,24,Europe,24,936.46
89b245bd35304c85b22c6d17578273e1,225,205,20,North America,25,1725.62
89b67fe8235d48259df3549547243a87,363,334,29,North America,19,2984.59
89badd0b43614dd292620e63856d7274,348,328,20,Europe,17,2120.79
89bb57a5f69e424fb37cd64a52b5f394,92,52,40,Oceania,17,639.26
89bb66d90635471797fcffaae89a8648,42,18,24,Africa,15,321.25
89bd3aed379844c19d1ef0153399b8e6,334,291,43,Europe,22,1747.33
89c058b153bb4d59920c4f4e996633d8,282,245,37,South America,18,2215.79
89c10f44738547a6ad02c198f8764517,103,54,49,Oceania,20,406.84
89c1e7fae1334d02b5e8116fe8381a42,322,272,50,Africa,22,1419.17
89c2e0a8b8064c32b07fb4057ff7a958,134,95,39,Africa,19,894.57
89c33d17090e483fbf1a76ee69481210,72,18,54,Asia,19,290.5
89c665747ba04d1c904c4a948c302198,226,173,53,North America,23,971.14
89c691713acc4893befc3830b3453a5c,47,21,26,Asia,18,488.21
89c8eab41847444ba523993480ab19e1,42,3,39,North America,20,247.61
89c91c97c3374ddcb3ba94f0992f2e4a,150,113,37,Oceania,21,1133.94
89cad310653d42f4ba4d35fc7e548db7,340,316,24,Europe,22,2126.73
89ccc0467c3c42e9935a41cc5d849be3,159,109,50,South America,18,964.73
89ce4cea0cb74532a072316588f21ab3,66,16,50,Oceania,17,273.75
89d0e38f0005466bafdfaa1dcc95304c,125,90,35,South America,15,1024.73
89d2a365228140459f5ad39cc8b4b977,365,350,15,Asia,22,2432.31
89d3c718ff3242a1a43d5961770d4912,171,140,31,Asia,19,1316.94
89d503476e1141cd967c7ca8d7ef6e84,212,183,29,Europe,18,1598.99
89d8bd8e22bd40dba8a2bba13c23acdc,365,365,0,South America,16,2176.87
89d8bfc5c0ad494aa0ea1ef039f9f789,186,141,45,Asia,23,1151.94
89d8cdb765d44c22810703fa6eeec2a6,104,82,22,Africa,23,776.23
89d90684423c4bb0932842009e509497,140,98,42,North America,26,1103.29
89daf23fbfae4546aad886ec98e2ac05,276,242,34,Oceania,17,2331.78
89dbe0e085ab41b19e7c8158bb8f2cb1,333,289,44,South America,21,1761.73
89ddee2291bb47fb9e92cab92e1949f9,46,14,32,North America,26,388.45
89df92d0e1424319853d07b6a5071e8e,269,223,46,Europe,20,1951.85
89e02492e1d44bfebaaebbeaf8816b18,222,181,41,Africa,17,783.59
89e04b4f69e045baac4c5e982a963e2b,363,332,31,Asia,20,2732.54
89e1fd47439a4b3c8415032c8bdf417d,324,301,23,Oceania,19,2354.65
89e23b9c451f433f8f037836f5161fe7,330,279,51,Europe,20,1896.97
89e305d2e8464b5695814c1ecb26b76d,202,176,26,South America,21,1218.78
89e4739192c9440cad30a49be14c72c2,314,265,49,Oceania,24,1241.25
89e67f60732b4d6db30f957a555c1b5a,280,259,21,Africa,25,2101.57
89e6972ddc024a86adbb16566f1f587f,178,143,35,Africa,24,1000.65
89e9e6cd86d0470491336896de021b87,283,247,36,South America,24,1214.86
89ea8c48bbe642608a24a3e3fd51045a,265,217,48,Asia,20,1887.81
89eb35beb70c43a5a89344bd944ea10a,186,130,56,Africa,19,1122.61
89ec1657e36f452097d3eab0f68d4881,162,122,40,Oceania,20,1278.59
89ed0bf4d48242c6a3bb2d61f2a9d47f,218,195,23,Africa,23,1767.68
89ef6296a4b04948bd4e72164fbb2ed9,114,68,46,Oceania,23,462.06
89f559e096d948c28dc4231e19f7e2e8,256,212,44,South America,22,1447.24
89f6e39cc5cf4958a7483401e6a54d13,75,23,52,North America,20,376.63
89f7080156764b9487507cce19e79fda,93,58,35,South America,18,433.8
89f934d7be7d4c3ea782c303f556d26b,52,5,47,Oceania,24,188.67
89fa3d150cfc4c439c3d350df06294f0,282,247,35,Oceania,18,2260.12
89fb8f73d0e3483ca97472b7952ea7a8,115,92,23,North America,24,633.79
89fd12d875c04c85a9be6b2764df3ffc,84,58,26,Africa,24,832.1
89ff0874381d49c88143884a566b8777,292,261,31,Europe,19,2740.93
89ff4eb30f9d42fdb0c1a04bdaec9af1,216,172,44,Asia,23,873.44
8a010539a7c84c84b4f60270b80b2485,304,272,32,Asia,18,1589.77
8a042668aa024e48bf7369a323c9a012,75,49,26,Oceania,18,458.38
8a064af5cb1242868970bd0aa23400b2,209,171,38,Africa,23,1815.67
8a07be325ef3448981e803c4dc985309,363,334,29,Africa,14,1844.02
8a08d33727544bea8650906f37f97137,310,261,49,Africa,22,1477
8a08fba2b9a14427a68b5e62826e6180,43,8,35,South America,23,270.51
8a0945e8f47b45fb80b5b5bd1b50049b,175,128,47,Europe,25,1160.9
8a0bf3b3bec2417b92694aad198733d9,114,75,39,South America,17,1049.62
8a0c76f0199544468b793aec3a2e7cbf,315,282,33,Asia,18,2571.97
8a11c464f0bc478fa306da5b52da26a9,298,273,25,North America,15,1423.79
8a13e3ea693345a1a9d2a4263c3684fe,365,324,41,Africa,21,1596.14
8a171b229e8641349018d3833964291b,363,351,12,South America,19,3044.27
8a17b08845674c91a08886e521a67792,307,264,43,South America,20,1551.37
8a17d9e8e8404312a5ab4d9e58b21208,357,309,48,Africa,26,2603.63
8a18b2ae654d4829a1a09e27aed46299,143,97,46,Europe,19,706.46
8a18fa80013544fba7d47a478755d920,210,157,53,Asia,21,878.97
8a1a92f9f1074016b132fc4eade355fa,251,209,42,Europe,16,1931.01
8a1acf289e224a4698750ef1a4118b4f,86,63,23,North America,22,981.57
8a1c4c0e7be346c89d3e63d340a5fa15,122,87,35,Africa,14,635.33
8a1c9e14871c4689a7f64e788a1630f9,365,353,12,Oceania,21,2836.67
8a1e509b5bcf4a8da30bda9cddbf3594,274,229,45,Oceania,20,1922.51
8a21fade0d624253baba4f15d24a6007,81,30,51,Asia,17,150.94
8a220cb8f16e468691d147a70fc49aac,243,213,30,Asia,23,1986.48
8a231db96c044bcc968e64a6072ced87,204,162,42,Europe,16,1173.92
8a23ca2e2d3f4e7ea3d6202f1f5e92a6,83,48,35,South America,17,895.58
8a25891e89e44c67b17fde2298c16867,245,189,56,Africa,12,805.85
8a262fb608a44024a5738837ed2555dd,252,223,29,South America,20,2178.06
8a27ea9ea0ac4633b663de5577581598,145,91,54,North America,18,793.54
8a2833d6cf6e4db497b174f55d117d3d,62,38,24,Asia,23,555.96
8a2984e3ac16493f9ec07bfa7b2d940c,318,268,50,South America,19,1035.99
8a29ac45de7c464380dadcaca027f210,93,46,47,Europe,21,326.2
8a2ab75142ad406c983de1d3c7a8caa2,323,299,24,South America,18,2705.31
8a2b2987214d409b970ac8ac6618734a,125,93,32,Africa,24,982.2
8a2d514d478e4f96a1ce4fa92d75c81b,275,228,47,Asia,21,1336.45
8a2dcef0bf9e423d9a264f0857ca98b1,168,136,32,Europe,17,895.34
8a30d6bd36ec4f7ba6c068e04ee90dd5,364,356,8,South America,26,1785.03
8a31f57eee5a4c428248e210a06ab050,94,57,37,Asia,15,950.54
8a3287f7be94485bae680a4966f20bc5,362,307,55,North America,19,2272.82
8a338a099fba4f74830194af63c17e40,86,54,32,South America,16,453.53
8a367459582144dda0f64befbf092682,363,358,5,North America,16,2936.25
8a398c73b68749c5bcfc61a3bc20a7fc,237,192,45,South America,19,1732.88
8a3aaa21ea48485081ff0913dc55231c,76,53,23,Asia,19,268.44
8a3af965f04e4a258090a997748aa474,261,219,42,Oceania,20,1664.82
8a3c5307d2624b64b727c8cb364fab95,87,57,30,Asia,25,768.09
8a4111f3b4fa40b98dc2d0db6e5bd5c7,262,243,19,North America,19,2385.14
8a4252deec6244acaf0d0d59daf8e58f,129,107,22,North America,17,730.24
8a42bc05298b42ab84314ae83ead2530,185,161,24,Asia,18,996.35
8a43e413945048729c1c7e72fa1621b8,157,121,36,North America,21,1055.04
8a43fe94293e459fa92722b3f660bf8e,233,190,43,Africa,19,1027.02
8a44c370432c42dcb6497be97fb58850,243,219,24,South America,15,1544.7
8a4657d6255d42b4aeae8bc8bf723643,174,147,27,South America,15,1800.53
8a49ec9a33cf4d889ddfad45a043c423,177,139,38,Africa,23,902.07
8a4a59f6e21b44b694eff668754f377d,61,30,31,Oceania,17,437.01
8a4b473747ad4dd8add9a4dedf988655,174,150,24,North America,28,1199.38
8a4be2ee4ceb422e8d75630375f96b7d,197,144,53,Europe,20,1035.27
8a4c2e2f7e9444c6829040c1fc93b44d,314,268,46,North America,16,2584.55
8a4d296e367f4e029d25c35e4fffa0b1,251,203,48,South America,22,1295.31
8a4f4a7ad56447b7bcda7da367465c4a,360,318,42,Asia,19,1910.37
8a53a81d604e4d1e83818d3262bce094,255,237,18,Oceania,15,1831.48
8a575fd7a56a4e8d8439938cb2c3447d,150,125,25,South America,29,1781.86
8a5a13f87eb84599a3d9f7c7c31654db,268,252,16,North America,19,2388.54
8a5b69ace4794a7bbc4d07c9dd5cc433,166,148,18,Oceania,24,1894.6
8a5c2d10bbd54cb085f844b2be622e98,160,122,38,Europe,19,1616.25
8a5dc6a9372c4c5a944f6b94ed106892,101,80,21,Asia,22,696.23
8a5ddf1df6a54f8c91170b857b4e8c2e,70,37,33,Europe,18,623.19
8a621f53c7f04eac90bc87c908d122e6,363,359,4,Africa,21,3449.48
8a62bca39b5646c180574f36dec7abda,265,236,29,North America,23,2116.27
8a6306c593e34708978ff2d5c78a7e4a,322,268,54,Oceania,25,1530.39
8a64e414336f424cb76e2f741c966ffd,265,249,16,South America,21,2065.76
8a6a0fc74c0d45059a8357b6bf3cc7ea,94,64,30,South America,18,811.11
8a6bb1cb9de641cd98b19542046f8049,119,89,30,Oceania,22,1230.88
8a6f26e5212d4e1dbe82c98db353fe15,251,202,49,Europe,20,1406.1
8a6f8a65485044788d08cbab7afb88fd,104,58,46,Africa,23,406.76
8a76079c1a0b49d581a015e19c44fbc7,77,49,28,Oceania,15,588.58
8a76a54d784e4fd1b8d6c14cb5c8f6af,102,83,19,Africa,18,988.15
8a77f4a87ce64ff8a8d514681b47f7e2,210,158,52,Africa,24,1037.7
8a7a9411b8154e57aaf06ac507507c74,197,168,29,Africa,20,1607.42
8a7aaa585e544162bf9b807cae6587ab,51,5,46,Africa,16,359.15
8a7c6cb8271d4b0e97d355e88315e3d6,206,155,51,Europe,19,978.34
8a7c7a3c701d427fbba24bdaf61393de,110,74,36,South America,23,657.76
8a80ec8b42b0459986cd0221300983e2,189,131,58,Oceania,25,883.69
8a82ca6a8e704032a67648451b1318ff,253,201,52,North America,21,2014.54
8a82dbe318af43c49f77f530628e105b,60,29,31,North America,17,429.47
8a835c8b79154cd086a818beac4f8f97,365,325,40,South America,20,1381.79
8a842d31e40a49ed83c6d88f25ab5e0f,34,11,23,North America,17,227.89
8a8806bca3ce4d1fa349c7f8b345146a,97,51,46,Africa,15,501.89
8a88cd5d2e5b43b3b37177de4b18a6eb,261,209,52,Africa,21,1050.27
8a8be9e383e64cf88367e4e1f96da5b0,143,115,28,Europe,19,769.18
8a8d1464008544c78c1c58a2c7a3f4cf,232,179,53,South America,23,1139.53
8a8f0951b6864775884019bd56c37a19,328,306,22,South America,22,3214.72
8a9291e2c8c7486ba3bc01fb932ea4cb,61,37,24,Africa,22,506.76
8a92f0a7e6254f4a81622e96ed2ef40e,211,193,18,Asia,18,1875.58
8a947efc86234f6cb845573cbf3abd3e,188,133,55,South America,23,707.49
8a94c34573874e5ca0ef034b0c564b79,278,219,59,Europe,22,1242.48
8a94f25abe3142e6956d977d0f74fadc,262,223,39,Africa,20,1903.24
8a98a17c298146e9a0636e30a31a7626,335,295,40,North America,22,1392.99
8a9c2211ef934ede8a3bd447530e90d6,252,210,42,Europe,20,2124.44
8a9ce855deab4a9a917eb2b7148e2425,212,191,21,South America,17,1450
8a9e07f08be94a869e524415b00bb159,170,130,40,Europe,20,1030.11
8a9eb0d7378a4852a9f222045a6281bb,287,234,53,Africa,22,990.47
8a9fd2b4b74b4952b4cc9018f49eda8b,360,339,21,North America,20,2629.93
8aa097c58062441991a8b72943cf4870,248,222,26,Oceania,20,1588.77
8aa271da86984633b96b78080695f4f5,228,204,24,South America,22,1476.25
8aa34ba4476b42638849c9797937880e,364,357,7,North America,17,2487.53
8aa39225dc5245fab5e0bd80c655e43b,347,294,53,Oceania,19,1403.64
8aa4e00e56c648bb8929243fdfa60811,236,186,50,South America,26,1444.16
8aa6dfcb01f045b6ae2d9313b811ca74,319,286,33,Africa,23,2612.87
8aa77e4828004d96ac7571e1c0bfac07,300,266,34,North America,21,2388.98
8aa7b129046541f9b00f526234544d43,140,104,36,South America,21,1275.17
8aa9a198414144b9801e75dc85c6c803,333,297,36,North America,18,1534.86
8aaad7ac83b54787bd2b382833843287,364,321,43,Europe,17,1695.85
8aad31cee1b64321bc319ed879cb69fb,134,117,17,Asia,20,871.18
8aad8d71853944ddb3bd2934d8878ef7,32,7,25,North America,17,253.53
8aae0085026d426f9bae2ecd4a27faf6,189,165,24,Africa,25,1525.65
8ab21ae1376f49c782390ad14084f4dd,363,338,25,South America,18,2281.26
8ab27295f8724db5ba9e47b60fdd2835,194,141,53,Oceania,23,1075.9
8ab4afc5a8d0471ba184e1578c4f30ff,90,55,35,Oceania,20,566.5
8ab50070c5794fa0a6e76ef6a63a8664,275,236,39,North America,21,2094.29
8ab5636d5f644d0c8e8ee220ae778c04,355,305,50,Europe,22,1781.75
8ab626ccda3b45d8a062600acb58f869,290,265,25,Asia,24,1583.49
8ab6d20cc30b4e38af72cb1fac497abd,195,160,35,North America,14,1160.89
8abcb560c64e4921a5782a1d0ce8ce5e,114,79,35,Europe,18,962.04
8ac03928eb3e4116ad4292b282558568,346,323,23,Asia,21,2362.34
8ac12c3aa30f44b89387497f9482f878,171,131,40,Asia,22,937.83
8ac22bd9d3df4d0899961877f19adfa1,54,16,38,Asia,19,522.7
8ac49ec9b9574c04a37ad10e0ef55b00,106,61,45,Europe,17,772.6
8aca7ce866424404bf386487f3eac2f2,24,6,18,North America,18,102.24
8acb854d1be24c01802d948527818dab,322,294,28,Europe,27,2463.16
8acbcd59a0a44e25bc274b5dc3f3bf4a,101,53,48,North America,26,415.28
8acc541c43a6456dae8582f8c2e80ac9,188,160,28,Africa,22,1425.77
8ace7469bec04ea3b79ab18f9f6173a5,327,279,48,South America,20,1886.65
8acea6003a31406297882ac7b67e56f2,356,331,25,Africa,16,2854.42
8ad1f6b220eb4407a6ea4566f170ccd8,280,253,27,Oceania,23,2287.24
8ad21e7760724e42b1905bf334b7bf01,365,358,7,Africa,22,3356.29
8ad25507aeb64d8e822ebc02db542b26,269,225,44,Oceania,22,1805.34
8ad25f258f804b0caf883cee12e7bf78,177,128,49,Europe,25,928.96
8ad3ea1bd4f240759e3655589d98d626,363,338,25,North America,22,2419.01
8ad419f532c245a0944bfeb864694c1e,316,272,44,Asia,22,1433.05
8ad4361ded634f46aee97e5b43f107fa,246,219,27,Europe,22,2210.34
8ad490404657436fa6b9bf775e81bc58,220,178,42,Asia,15,1515.8
8ad707e92a804dffbbe9829f1ae8683a,57,23,34,Oceania,20,302.41
8ad7c92ba4e8492b9b858db8423f86f7,97,53,44,Africa,19,696.46
8ad8ce3dfc5841afa6234958e13ef63c,254,239,15,Africa,24,1910.06
8ada1eaf9e104f8da46d75080c3cc85b,334,305,29,South America,19,2152.16
8adac2f7a6604517b6b874d443e2cfde,213,186,27,North America,15,1374.64
8adb824418c8459b9e2e77ab8c155ab4,104,53,51,Africa,17,497.58
8adfad5c2d934a61bfba880ddaf23e4b,364,363,1,Europe,20,2347.43
8ae04e1319164bf1ae393db486c181f5,73,41,32,Asia,21,873.29
8ae0943140fa4eeb90a4f4209b6dcef7,69,26,43,North America,22,765.47
8ae10ce60854470ea8713962e1702c86,167,137,30,Oceania,18,872.5
8ae3e27d05b64e5a83249bd189a0a88d,222,189,33,Asia,21,1544.44
8ae3ec48ec2d43f2a306e41fd3be26ed,260,240,20,Europe,16,2312.95
8ae4c5b3afdb45548fa5cbb23fceea36,365,330,35,Africa,19,1929.18
8ae768c9fe494ce884369a0ce4e27347,143,89,54,Africa,18,899.05
8ae8f98f71824027bd29e5b1c6c7a8f6,179,148,31,North America,21,1325.29
8aee00a8da0a407ebc35c1b3d6e817b3,54,30,24,Asia,21,636.56
8aee34d4c0f040e89845d1f4119add50,149,106,43,Asia,25,283.8
8aeec7b792834a1c886eac59eca41fc0,255,209,46,Asia,22,1884.46
8aef3bed109046419166f415df3dbd7d,224,169,55,North America,22,880.35
8af13fd31bf743e48e9fce4b81e0f926,148,108,40,Oceania,23,791.06
8af1681eaf714ae9a1b2b119013de5f0,83,50,33,Africa,18,735.6
8af25bb5ce18493fa25435119ec4847c,279,246,33,Asia,22,2183.72
8af369ca40d74f359edc545a735a5ac8,95,59,36,Oceania,24,440.08
8af5266097e04e6c8be6251ae72c1ba7,147,106,41,North America,20,1287.27
8af6f68634b54d2087762968aa81964f,162,110,52,Africa,23,1083
8af73333093b44dc863d801e3b71011e,331,305,26,North America,23,2368.21
8af74155d3f04650a332d6c58001fca5,82,55,27,Oceania,25,535.56
8af81186d4df4a9a91cb45ceb4b91e6f,288,250,38,Oceania,21,2687.74
8af869db3a3f42089f816b35f6d532f6,102,52,50,Oceania,19,526.81
8af93652e09a4e01bdea423441d156d2,360,312,48,South America,18,1581.26
8af977f540884e3c929665dfde6a56c0,135,92,43,Europe,21,737.09
8af9b8421cbe4c7692246db02ab240a2,162,136,26,Africa,21,1342.32
8afc56e7033644339045c5038adddefa,238,192,46,Africa,20,1304.91
8afc913beb9f409a9a9940798bc17fad,329,288,41,Africa,15,1492.08
8aff506e773c40a6a68a92439df32413,216,168,48,Africa,22,1112.69
8b047bd628844446984b9d442015d009,88,49,39,Africa,21,565.43
8b048f2088ab452bb50cd78ff0fe2729,121,92,29,Africa,20,780.09
8b04a63430c8492ca675f9323caf3b57,168,108,60,Europe,18,742.89
8b050e95139a4e6aa58830107b335892,145,119,26,Africa,23,1151.48
8b0636aded444cf3b798a0e8f92e56ce,362,319,43,Oceania,22,1796.36
8b0b488974314cf3a87e255404601e81,238,206,32,Asia,27,1448.73
8b117cf6539d4feca379f78a026cd501,326,301,25,Asia,14,3486.69
8b124a55f5f04d93ae7741575ccdcdcf,110,78,32,Africa,24,703.71
8b128f0f8d264ee7962abcec29421093,196,157,39,Europe,21,1009.43
8b1293d65bf24aea94f8fce8c00a0c58,104,81,23,Oceania,18,768.14
8b1329d3d6744f2185ccb8c8d1c415ba,60,33,27,Africa,21,292.54
8b134386dabb4e00a7f1f419627fb2da,242,208,34,Oceania,21,1532.78
8b15b2af71c54e3c9c6e199845a036b4,362,313,49,Europe,21,1420.54
8b1728a712954344b935e7ae2abb2a1d,248,194,54,Africa,17,1389.19
8b17f8940e014b79b97b4a0250ca4465,306,246,60,North America,20,1748.93
8b18ded814c2405cbaa9af49f12b0fab,364,353,11,Asia,20,2401.05
8b1955cd307b434489237e03b299c980,79,42,37,Europe,19,358.61
8b195ec6d09c4bae8109939b04fc618e,296,249,47,Africa,18,1245.92
8b1a6f2b31da46eaa332e35784c68a0c,198,182,16,Oceania,24,1048.79
8b1ad0cf2cde42a1b444c0a7d9a55422,126,66,60,Europe,20,605.87
8b1c0e028d684f64904d26b3e4a28874,281,230,51,Europe,20,1033.56
8b1d8494cbdf476a86a023bb83293964,154,120,34,North America,21,1673.71
8b204bf662eb48dc872b8d142d23d9c8,323,269,54,Asia,22,1586.64
8b22b53c20ef4738ae4a3a2e25a72bb2,243,194,49,South America,18,1811.26
8b22ffcc1fcc42a194011a43f4791091,316,264,52,Europe,17,2064.54
8b233a2ee5cc45b2b9331137c715bfaa,69,16,53,Oceania,18,189.15
8b26c66aae1443a69c607aa0c22269b2,278,240,38,North America,18,2199.7
8b29854145754cb4adbee1bf2e09b04f,55,11,44,Africa,20,259.75
8b2e5ecd276a44f38d53296e27020b83,363,361,2,Europe,21,2007.05
8b2e7f30876343f589a90d36ad76560b,365,356,9,Oceania,22,2345.57
8b2f9b6b5f674cf68e6e4bcbb4afb01f,228,215,13,Oceania,21,1663.74
8b2fea59bb8d45dbbed93e541430063a,247,223,24,South America,22,1525.78
8b303d573ae44d53bba0cecf29a8e9e4,122,103,19,Asia,15,881.68
8b3222dc8e4e4b07b2baf94bab684d29,50,11,39,North America,18,135.84
8b32798f166043baaa5bb23301299e27,311,257,54,North America,16,1465.39
8b32fee5792a416ba85b6d4c3e4e8fbb,225,174,51,North America,21,1095
8b33aa040c7a422198d0cd1725ec3b6b,278,237,41,Asia,19,1516.75
8b34eb80cbe7429ca29ddd9e7cd7fece,278,242,36,Oceania,20,2116.89
8b382008807f47919ef1833480d6670d,218,192,26,Europe,21,1797.15
8b382a7127454428b08b4cde262e51eb,363,343,20,Africa,20,2206.16
8b392bba28ff4537baa988a28534f66f,298,266,32,Asia,15,1936.36
8b3a024e47a54defaa68b63276b12133,166,133,33,North America,18,1166.95
8b3aff8d661546889b0a6cbdac043740,209,165,44,Oceania,19,1236.62
8b3b1e0b5f95411a9e1f23bf6bf10b13,364,321,43,Africa,15,2211.01
8b3c2238c2ee41a4b7a8a9925a3e2a94,365,347,18,Oceania,15,2539.73
8b3c89e8f51843ce8908be4cbe595e12,159,129,30,Oceania,24,1358.42
8b3cc8f513df49f8a5bc6518257a3b34,333,309,24,Africa,23,2094.21
8b402972602a4babaf561f5977386563,209,184,25,Europe,22,1788.99
8b4039f8ac724a79b8d5af510ae3af0f,58,26,32,Africa,17,389.25
8b406edb3b1f48fc9907a89ef78ca86f,154,129,25,North America,16,844.73
8b482d11bc3340749d700016d91cac6e,53,31,22,North America,18,347.35
8b510ede5227424bad1ba94f03a34f08,365,350,15,Oceania,19,2164.86
8b511afd2df74da7918c3531eff5f0d9,362,340,22,Africa,23,2685.53
8b51760d90c7436cabb51a21cfb5a598,219,189,30,Africa,17,2131.76
8b529e7d985e4d6db4ae1e3a125051bd,72,48,24,Asia,20,584.16
8b53c4656317477eb47ba59af8cd71f9,365,331,34,Europe,16,2399.23
8b55c90e287841e3a8c649844c82f2d8,290,257,33,North America,22,3022.7
8b572e32ddf6487a9b5b201028413c67,246,192,54,Europe,24,1317.27
8b58485e00cc4bae858462381e559633,255,226,29,Oceania,21,1545.33
8b590ab2b5bb496eba9037fcd5060f7e,364,363,1,Europe,22,1885.21
8b594410b9e242238355ad47b4c7ae66,357,311,46,South America,13,1530.47
8b5cec4188874b048dffec4787b54499,265,212,53,South America,15,926.31
8b5fe333b2344a69a10100f9da7428c0,253,213,40,South America,20,1410.23
8b6081910c734c1bbd6e1f1440c20aa8,315,300,15,North America,18,3023.82
8b61877cdf954502b1dee1f9b35eca04,205,154,51,South America,23,1037.72
8b61c375a6814518af8eeb4341626317,222,196,26,Africa,21,1667.89
8b633bf8674f4269b91f60755231b962,84,41,43,South America,19,374.22
8b664fe3b6154b748002f3bab23a8816,300,247,53,North America,19,1059.52
8b667d9945be4ea5aa61718137c36a67,213,160,53,North America,18,967.82
8b68c6836c7143bf82e5d79bb93d5fd3,296,241,55,North America,23,1534.07
8b694ec3d26e4f079dd6a8d6856e96db,196,159,37,Oceania,22,1453.89
8b6d000a5dfa43a9a600da91ed6f1dd2,194,143,51,Europe,17,1039.42
8b6d2f41b9a54749a9de02782ade84f5,163,123,40,Asia,20,1254.94
8b6d85c9560841ab9aef73d983125857,63,8,55,Oceania,23,254.95
8b72b9bb51b54709bf8c470ccb78acec,296,254,42,Africa,16,1542.12
8b73b7839f674c9c82f48d3bf8b9e26e,365,337,28,Africa,17,2351.48
8b757e82255b4b4a900dbfdb4ddc438d,267,217,50,North America,20,1993.46
8b76e0721db340499819ad357d4f31c3,191,140,51,Africa,18,966.79
8b77dac1efc04f55921a70df587b6fc1,86,28,58,Africa,16,205.95
8b785da458c340488be794bdcd1eea87,358,317,41,Asia,14,1775.78
8b7decfab58c4aaea9c6190d155c9a0b,365,363,2,South America,19,2421.81
8b7f5aadd18447ce8cdbd0152778b5fb,365,359,6,Africa,20,2909.89
8b7f6e23d48d429aac421aea2669a19d,254,222,32,South America,20,1851.08
8b82a1e4f87d4edeac2cdf9678a8e6be,134,108,26,Europe,24,1266.17
8b83787740764cc49526c77ef87ccc87,228,200,28,South America,21,1727.32
8b8ac57cc75b4b18afa65c283c18e4e3,40,16,24,Oceania,21,205.73
8b8b195b1f864f62b7627f9b91945edc,365,331,34,Europe,16,1532.96
8b8c4d9e656c45e59f1a1565fe938c18,232,200,32,Oceania,19,1210.65
8b90f2dcbdba48228154dee332790511,276,238,38,Asia,22,2125.49
8b91a30aff8f4e478556e363f25d152d,308,269,39,Oceania,18,1179.54
8b9826a4ff694394a605f94f533bedef,280,250,30,South America,18,2113.02
8b9954dd24ed4a66a825d48c36551306,167,125,42,Asia,18,818.45
8b99e3a85c8d412b9fd4f75d2df37a62,364,338,26,Oceania,17,1883.72
8b9a433a6e564c4ca37b0cc3f49f33cc,201,178,23,North America,17,1198.1
8b9a5b605b2e4635a87411ec2c954ef4,217,184,33,Oceania,27,1168.92
8b9ab997778b4a63b185b34af43b3f17,158,132,26,Europe,17,1809.87
8b9bedc3dfd44e528aa305023f9934d6,362,343,19,North America,22,2662.76
8b9dc0e0c88b4e99815fb8315282951e,336,302,34,North America,22,2350
8b9ddf60a86d47148fa2ae45af6914e0,274,261,13,Europe,18,2137.72
8b9e0b9c276e40c49b1e8490bac3d44b,69,44,25,Oceania,24,730.76
8b9f22cfc78841ed8d0db3b9fe070485,365,364,1,Oceania,16,3133.52
8ba2a15b0fa84fa49573b2218f5cc99b,206,169,37,Asia,22,1272.99
8ba30160a8b04a6ab61cded8edc8c0b3,145,94,51,North America,19,464.22
8ba7da2145f94ee6969045db5275ee01,296,263,33,Asia,21,2164.47
8ba9ff6e49284f70b0aac6a87e5a604b,75,42,33,South America,22,497.68
8baa61d78cc446f9ad19064789a1200e,201,170,31,Africa,18,1742.2
8bb197461dae4249837ab5fbca558269,211,173,38,North America,15,2346.05
8bb26be64d744997aa7826390fad2f08,279,235,44,Africa,15,1645.75
8bb60449809844a4b665af501760a63c,186,175,11,Oceania,15,1447.71
8bb81259538043c9b19a89f6d7c2b3a5,310,287,23,Oceania,17,2180.19
8bb870001d594f6cbf996315d1905ed8,199,160,39,Europe,21,1525.93
8bbb2535673f488881f7592df2afbdb3,57,6,51,Europe,20,340.93
8bbd67123bc44372b1e778863a29d606,38,12,26,South America,18,192.07
8bc31c559a0f42e295cf5f04f30284d3,81,49,32,Asia,21,673.38
8bc93a2fe44b4836ac6cfe488381a546,224,180,44,South America,20,1630.33
8bca1a4015414165a8e7447a9f0f617f,187,147,40,North America,21,1316.02
8bca3da98aba485182ec85499b396c11,244,217,27,Oceania,15,2208.53
8bcfaf3baf534cbdae9096d0798278f3,255,220,35,North America,19,1145.48
8bd25c9299af49b695927de8152dedb9,308,258,50,Europe,19,1781.39
8bd3597338a3482fa95a6c11fbc9ed0f,276,254,22,North America,20,2519.43
8bd4eea8727e45ce951a923df0cfad09,165,113,52,Oceania,24,721.54
8bd5b9034c284921a024fb0a6e5a1fbd,45,16,29,South America,19,348.88
8bd78b67fd94443792a3323d96f19736,322,282,40,North America,19,2110.98
8bd8976f23af4a71bf35c35fc1197983,348,293,55,Europe,19,1795.49
8bdb4a6970d2456d8caf51bba7555e7f,168,132,36,South America,19,1510.91
8bdd888629194540a68fb972832a7f7d,359,323,36,South America,19,2542.51
8bde378bd0094486a97b78275aed2063,263,240,23,Africa,22,2457.06
8bde54fc816f4c4b94cb22413d83ceb1,116,53,63,Asia,18,653.6
8bdf63ee8d844497a5b999bb8073ec53,207,167,40,Africa,23,1489.08
8be0d33e087d432fa162e071f5b80a18,364,364,0,North America,22,2427.3
8be129f35f7447778d2d038aa9c2fa1b,50,16,34,South America,19,699.06
8be17459b76b427b964ad571cf8ebb7b,326,287,39,Africa,20,2659.27
8be2108e3d634e28a32c1dec601880a1,347,310,37,North America,8,2317.97
8be3681818ac4760a4dce9a1d3824177,108,61,47,North America,22,519.8
8be44e30ee3741e49edb6450f14440f9,86,40,46,Europe,20,729.52
8be85fa70f3b491fb501d20dd812a412,259,232,27,North America,22,2079.07
8bea8d83def845bf849ed09df64b5aeb,362,341,21,North America,19,2354.02
8beb2f4defec43b890e4b9fc72e46979,364,318,46,Africa,23,1933.03
8beb45fa3aeb49ad9fdc1dc8773d4487,293,245,48,Africa,20,1307.3
8beb73912c8c46728028366d0a6ebf82,167,120,47,Africa,16,1531.43
8bef8559de094f30b583c5eef48d548c,164,134,30,Africa,22,1216.39
8bf07de260e04fb394d6a68bc8421ac1,53,30,23,South America,20,345.38
8bf222246aa8412982d10ca858ff4360,209,168,41,Asia,20,1323.99
8bf2312a4a22420c92e91f8468d0ada1,314,261,53,Oceania,19,2421.02
8bf25e49b490455395f6858c3830218e,98,64,34,Africa,23,711.88
8bf368a4b7e6417ab88f2c38e1b34013,361,356,5,Asia,16,2847.8
8bf37a106af64864be2d3ce1674f4a08,89,57,32,Europe,23,481.65
8bf5b4cf6b7744c68f016a30083a2d21,296,259,37,Oceania,21,1758.4
8bf6935cf26d47438e28727f05469e02,253,220,33,South America,23,2519.45
8bf7978c4510400e8ea8d496f9be5dd5,198,152,46,North America,13,866.93
8bf8646352ff447dbf97722f6fb052ef,333,285,48,North America,17,1767.89
8bfb720dc6204aef8e3d1485a32f7e03,202,149,53,Europe,26,1035.18
8bfb8826526942b3833e1824da5cebed,356,327,29,Oceania,22,1609.32
8bfcbe2935a24d4fbce67a747650ca19,365,344,21,South America,26,2449.87
8bfd2065cebe493ab939cedd773e8a74,317,277,40,Oceania,19,2158.68
8bfd528ec4684474b573398f07b88cdb,350,299,51,Africa,20,1517.52
8c027b7d8f9f4ff3bd3f8a572d1c72eb,133,79,54,Europe,21,627.45
8c028566cc514fd682c599dde57f1d9e,211,175,36,Africa,27,1456.88
8c02d66a01584666a2301bc248f3d5fc,123,80,43,South America,18,857.29
8c02f8524ac14232bbb641fa19c798fb,81,46,35,North America,19,362.33
8c031d5941544a5b83a20155dc0b8c61,160,131,29,North America,19,1048.84
8c039413ffec49cdba534d717ed0475a,108,70,38,Europe,19,562.3
8c08d8f7c83a4cf0800acf6d161999dc,43,11,32,Europe,21,496.65
8c0b11010af74c4c8350082ff4756be7,220,194,26,North America,22,1225.12
8c0bd38f22c7475aa7cb77d7345b50e1,106,75,31,Asia,17,563.32
8c11513abee044839da66f09b4398211,275,239,36,Asia,20,1281.75
8c129a319c4a473db51854bead306441,104,69,35,Asia,28,761.82
8c12ee26ec5a4423beed93fef4545fb1,142,110,32,Asia,22,986.58
8c12f9e657104f9892fef7c966250139,318,296,22,Oceania,21,2476.8
8c16d9dd72aa4747955852fc2c0336a1,85,52,33,Oceania,23,563.21
8c185d60213b4a038f0ddbcb2bec1ddd,312,284,28,North America,24,3183.46
8c1f368051ba4837bcd1d719802a2c79,78,30,48,Oceania,18,387.57
8c1fde74808f4f09a4f38dad89f5cf92,284,253,31,North America,16,1989.09
8c2050e38a9d4347bff8321f73df1a07,244,216,28,Europe,17,1817.09
8c213e9d4efa491bab446db2e3996a33,310,286,24,Asia,18,1717.59
8c22475ea95f4ee990ec69d964ac8284,174,126,48,Oceania,23,1134.46
8c2252370d354c7faf83eaab21da6c52,76,60,16,Asia,19,423.44
8c23259f42224024af23133956d842d4,364,337,27,Asia,22,3686.12
8c24858b25d846518a0962746c31999c,183,161,22,Africa,22,1326.59
8c2536f70f0f4eddb96d4911f21ac536,362,350,12,Asia,22,1719.44
8c259df46fa94a80b1d00ecd2c395ed4,341,321,20,South America,18,2574.8
8c271afe1390411ba4fd28e62158e344,316,290,26,Oceania,23,2489.61
8c2746dc50d04f29b9ff006e84b28ef3,216,196,20,South America,18,1433.36
8c28d1d7e6684918bedc3748ae317cd8,38,4,34,North America,18,111.65
8c293dd98fe84c5a8563f5166d164fad,287,260,27,South America,17,2651.1
8c2aca616c5e4516b239e624a6d58e81,41,14,27,Oceania,10,361.17
8c2cf9a982f348ceaf7c8bc7c0422731,238,194,44,North America,19,1328.4
8c2d886791044559ad1efdfbc8139bfc,251,195,56,Oceania,20,1178.63
8c2e64da991f441fb895199bfcbf3914,118,98,20,North America,17,943.32
8c2ee51b28904d28bbe02e6a498f88d2,365,356,9,Africa,18,2844.25
8c2f02beb773443e89766f95838f65c6,246,223,23,South America,22,1626.3
8c3309ec3fe847058e4162144587b7c6,288,236,52,Africa,24,1406.3
8c33fc3d298b4652b486bfe07e174bc1,161,122,39,Europe,21,1242.78
8c347323c52e4e28a4daf83be38c7f16,306,257,49,North America,23,1152.01
8c34e4cd91204af3ab192b5db561e9a8,365,325,40,Europe,20,1385.35
8c3750b03e09496588eef000945aec43,365,356,9,South America,17,2667.53
8c388bd023e84663aa516beb8bd7e97c,364,330,34,North America,23,2176.42
8c3a142921164b3ab2cee295db7a70f4,51,12,39,South America,26,575.15
8c3c451eb9934e499425177acee93ef4,242,204,38,Africa,19,2169.04
8c3d0f01805a4d6d8495d119f695a8e6,63,37,26,Europe,18,793.13
8c3d7feb576146e78effc271811ab6a6,173,145,28,Oceania,21,804
8c3de954ae4e412c8c0bb9f4656a0282,301,250,51,South America,21,1483.49
8c431ba5e5f641f394fcc2318a9d5f27,362,322,40,Africa,21,2190.86
8c43e48f8df24211bec09069fa7d4352,365,364,1,Africa,21,2865.14
8c443f30e2f143edbccda1ed29f5f2e6,324,284,40,Africa,17,1890.05
8c444b4709104e55a66fff1ab8d7d606,112,70,42,North America,21,1258.71
8c44aaf7de7844bfb8418a090bedf7e1,161,130,31,Oceania,19,963.75
8c45f183fdeb4b879bab8adeeffb32c8,158,129,29,North America,21,996.96
8c461ca164134002a454f3a70e60e0a8,181,141,40,North America,15,1225.02
8c46d97f42704b52b710af4b88307c24,239,199,40,South America,15,1948.24
8c474f92f06d4877811d1998daf21d93,250,220,30,Europe,16,1954.85
8c476d948f404306882c6751d6912f86,68,16,52,Asia,25,273.2
8c481aa4afab4742bfccc6107618c120,169,134,35,Asia,20,1321.93
8c481fd83c344b849b36e2b8b0c5e4e6,139,105,34,South America,25,712.96
8c4ad2323a8740ed869b5e64490a5ee1,223,206,17,South America,20,1889.21
8c4b6f387b284c7e8b23f63d1f37312c,222,161,61,North America,23,1064.03
8c4cd81d24ea4c649e4e2bc5e07a5835,105,57,48,South America,17,434.05
8c4ea1704cfb4bbda9d5f16e147df806,365,350,15,Europe,28,2692.01
8c507833d8394a1a8cac81abf31c1df8,362,334,28,North America,20,2612.49
8c5354773a2142c5a41de979186e4e88,328,305,23,Europe,24,3182.58
8c5573ed825b439d99904bd36adb5ba4,116,84,32,South America,15,787.69
8c57b740f8cd4da1b503e08605abc6dd,232,178,54,Oceania,23,955.78
8c5916c1cf76404bb79a9b1007ca777f,280,247,33,Asia,18,2302.55
8c5a966da6e543d7a1b6d7ce7e3770b9,22,2,20,Oceania,26,215.07
8c5b07e4d2ae40dd93a8d9359c442d86,358,333,25,Oceania,22,1992.8
8c5b9ddbb7f24d4e8f8e1e6c0a98b9cd,263,243,20,North America,21,1415
8c5c8329ff2a4a2d98029eb3d486670b,37,8,29,North America,26,65.78
8c5db42b9c074349970c02f818f74fca,131,84,47,Europe,17,997.93
8c5e572e10204107a0e4b06ea3ec5569,84,55,29,Oceania,19,816.25
8c5f732f5a7c4f0dbff16be61187ff7b,112,53,59,Africa,22,622.11
8c60273118d1472a9d9bacdbdb4ea2ac,66,23,43,Africa,24,362.33
8c612e7855614613ac40d5363769d7f1,100,65,35,Asia,24,620.15
8c61465c07f042be8780653104265cef,156,115,41,South America,23,608.62
8c61f2efb7384fd286d1c779aea3dc42,318,274,44,Africa,15,2123.7
8c65083a17954f439e696b809aaeb226,274,252,22,Europe,23,2013.08
8c6647da6f5349ed90ded6df6ad1fa1d,60,11,49,Africa,21,538.79
8c679ee3d52542348f70daca95331220,75,54,21,Africa,21,484.28
8c68722c311e48419026332a15f1730a,153,111,42,North America,29,1158.34
8c68e165241e481a836da92095a19f08,246,183,63,Oceania,22,915.8
8c6ade0c6bf2451b862fd162f75c480f,198,143,55,North America,18,598.68
8c6b8f1fe68146768488ff516eb6c31e,73,39,34,South America,18,342.68
8c6bb2b12870459780d2df5af56bf7b7,71,48,23,Europe,19,325.41
8c6d088770f04b1aa0df435f031e652d,150,119,31,South America,21,1164.06
8c6f87854b464d10a693aef1c001c303,364,349,15,Asia,21,1633.74
8c70ebdfe0d840e8aae07978c18120f4,182,155,27,Europe,19,1534.31
8c71c7e026e2444297861b5c29a4a043,210,180,30,Asia,16,1597.95
8c71eb35ab244545999f3077cbe96cc5,248,197,51,Asia,25,1642.91
8c71f0426bc14a758d33c9cdbdb53ddc,136,107,29,Asia,22,1268
8c750b83e0de4107a304f7095b5f3a97,190,163,27,Oceania,23,1624.14
8c758fcb6e934acc9fac52e01f4aac56,154,98,56,Africa,22,589.88
8c7702401a7a490aa9cc5e533a4df96b,187,138,49,Oceania,18,398.4
8c786e84161d4538af6d1ca799cb2eb5,246,195,51,Oceania,17,1661.85
8c78b58d02be47b9a3b7a1d171351a1a,273,223,50,Asia,15,1526.5
8c79d69c5f0f48b8844467e8086ca3af,43,25,18,North America,20,167.52
8c7b0b60b8eb4914aef8baed00c58312,261,229,32,Oceania,19,1758.09
8c7ce6038f2b4888adf10508c2c5814c,41,16,25,South America,17,577.4
8c7d7008d36543a49eee1838cf208b20,178,158,20,North America,21,1455.75
8c7e7cef654043499f5e9446d3184a79,83,39,44,Europe,23,341.68
8c8413de738542b0aad08d74f370ded8,281,248,33,Oceania,19,1836.69
8c84a2262a4c4c80a3e1dc058bd1f945,50,23,27,Africa,23,379.19
8c8783274e744069b99556f5c7a89fc9,138,104,34,Oceania,17,921.86
8c8a343cdd264cc18f9fa480337420fb,363,359,4,Europe,18,2556.96
8c8d9266b3a847089d680e0a620d2286,330,289,41,Asia,19,2793.43
8c8d9751e3b14779997c176febf1fb75,77,44,33,North America,22,431.1
8c8f214a83ac4fa488bc2e926d474590,318,283,35,South America,23,1909.75
8c9211af3b6a47b0ae4a8f37c9c26370,362,352,10,Europe,19,1644.58
8c922370f022439ba0062fba855927a6,172,150,22,Oceania,19,1578.27
8c98e54ddc554fd286a9e7294077e498,365,338,27,Asia,18,2912.39
8c9acc4188dd41da98bf1663d2f069a1,99,70,29,Europe,22,679.71
8c9b271bd2bd44319360b66dc8bf5e5c,115,64,51,Europe,21,854.08
8c9d8b00894b4b7da8593518051a21a3,270,240,30,Africa,20,2244.04
8c9ee878e0be4e56920c0619d1097a8d,342,325,17,Europe,19,2974.71
8c9f1984d3a24e5a988f8ad87f6b022c,84,55,29,Africa,19,748.16
8ca1bfc3cdf0434d95262cfc93000e84,178,168,10,Africa,18,1711.72
8ca1d11a3908426d9e980273b44dfcf5,286,240,46,Oceania,23,1775.69
8ca3cde4d05749dba784e88cb2f1beea,280,246,34,South America,20,1987.12
8ca62329e7ca4f14a19f766417ce111d,198,172,26,South America,21,1291.11
8ca91a8b34ac43a08318748dee91c869,364,346,18,Oceania,22,2252.02
8caae71fd1f9447bbe0fa4ef26ad5e02,60,13,47,Europe,20,135.56
8cac646d0fac4c64b0e69ca0299ba4ac,53,13,40,Oceania,18,366.74
8cb21dfd9a0b4875acba7244a03a6122,71,26,45,South America,17,437.16
8cb26e24485342f19b4294a6fe7ffe4a,100,64,36,Asia,18,959.55
8cb3fc06805f44ccb1f10ec8b94af912,111,74,37,Europe,13,634.15
8cb45062adca4837966569f0c6a2ad31,178,133,45,Europe,21,1571.58
8cb4af3b3d4a45cfb4b06e79f7080291,205,175,30,South America,24,1371.91
8cb4d92f097345da932c810a3c93980f,226,197,29,Africa,20,2137.38
8cb57a50fb3c48cf8b3ea3127f1d8c97,276,224,52,South America,19,1884
8cbacd082ca740f398b984edd225cc43,260,232,28,Africa,19,2219.25
8cbbcd91912d418cb05b6f436198a357,291,245,46,North America,24,1764.26
8cbd1084e82f4e308484a16c435f9a90,79,30,49,Europe,20,485.2
8cbdae81a5cf45a4a286d9773768b82e,259,209,50,South America,22,921.39
8cc0c41d6c4c443f9c1edb7b6a3e67ac,258,231,27,North America,19,1740.49
8cc198cce0aa4b5d9eab80bb2dfd8930,76,29,47,Europe,14,228.88
8cc3037e21884d68a6e9f67d23741301,258,219,39,Europe,16,1806.5
8cc847940cdc4bfa9a9159825630e31d,114,87,27,Oceania,15,796.02
8cc90f66ed5f428d8d2855979b758cd4,60,14,46,North America,23,204.27
8ccb9be50d9046f09029e44ad1718dca,279,257,22,Africa,27,2607.66
8ccd6eebeab2497b95daf9270a022377,293,242,51,Oceania,18,1675.02
8ccea06ec9344b409f168733117707b9,211,194,17,Oceania,19,1480.79
8ccebb9309bf483abfc85c5213c2e54e,61,31,30,Europe,20,529.61
8ccf78561fcb4de2b95e0023caa0a971,66,21,45,Asia,18,621.56
8cd1054e14ef4070b8195cde736ee6e6,363,358,5,Asia,19,2350.93
8cd2c87c48064bf6b40aaf0713a3ffc9,341,307,34,Asia,22,1959.61
8cd314ccfbb34ed49c6f9e1f173d04e9,311,277,34,Oceania,19,1917.54
8cd3325dddd5413ba4b8907838d1a329,89,39,50,Africa,18,807.12
8cd4346daf46497eb31eef8183bbe14e,315,290,25,Europe,16,2624.48
8cd5af7a688044f4b8c29f2b43574cf4,328,313,15,Africa,25,2159.04
8cd868b4ac834f1099b9022250ae1272,87,39,48,North America,20,591.08
8cd8beee587c471f8f5a024b1769bf66,269,241,28,Asia,21,1747.12
8cdbec196b1e4ae2866f72fecd721951,328,282,46,South America,25,1803.62
8cde39a8a43643d6986429f72cb0e2b6,146,107,39,Europe,18,1031.93
8ce0a49c46ae4917ae571186fd382791,268,224,44,Oceania,24,1341.07
8ce14be7ab564fc38034edc79f25502d,365,338,27,North America,24,2861.53
8ce26aab932547cd8367d61c62d769ea,276,246,30,Oceania,21,2394.99
8ce3725499ec494b93423a50c0f2c13f,334,291,43,Oceania,22,3108.77
8ce3e9b467c14a47b4ace5f41964535e,94,51,43,Europe,19,552.57
8ce6d2ed30dc4481b0db4518d5a08901,69,26,43,North America,20,185.33
8ce9c9f1ab0f437989b9ce916b6e9aef,152,123,29,South America,19,854.26
8cea5655442441d19889b241104bc28c,84,47,37,Asia,19,208.06
8cea6ebfc0bb4f77bbe978503d29efa1,261,211,50,North America,23,1817.24
8cee4b5ffe714462bc2c76fb0965a375,365,332,33,Asia,20,2864.2
8cee9fe18070496a89bf5d4c54431b2b,98,73,25,Africa,14,766.81
8cef647f3e3443eda8f1c659e65b24e2,153,112,41,Europe,22,1000.38
8cef76459ada4628a438c4a2ab9a3570,162,137,25,Africa,23,992.66
8ceff91f1a2c4873bd58c0abbd8d0e02,84,31,53,Asia,24,355.06
8cf05e9cff064847a0d7b913ce9b4af2,278,257,21,North America,20,2573.57
8cf1b6ecdd404d8a80f142701c6419b1,61,25,36,North America,19,337.7
8cf1d806488a42d88e184886e79d3fba,185,145,40,Oceania,19,1592.03
8cf28378251e4d46a559136dc852769d,32,6,26,North America,20,138.43
8cf4a1da2a4c4934a83e54d5360ba551,362,327,35,North America,19,2977.74
8cf6038e79d246e9bfaacc73e5d28eb2,44,20,24,South America,17,188.43
8cf8fada207c4c9cae5053ba7b4f5e22,331,315,16,North America,17,2712.32
8cf9e8ea880f49cca5acc6e4a8bb4657,106,79,27,Asia,18,287.92
8cfa858d6cf142dfae55812c111947cd,214,157,57,Oceania,18,746.26
8cfb4071c28b4d0594e8e0d048c55056,71,32,39,North America,18,222.34
8cfc311d9127459cb14b59e3d716bd1a,154,107,47,Africa,23,861.27
8cfcf9c17d394eafb9b779975151e0ab,197,159,38,South America,18,1331.27
8cfd64faf91d4f70a626d822e04d19c9,123,75,48,Oceania,16,720.07
8cfdff03ce8b49298d63f49acf2b0a86,333,315,18,South America,18,2702.55
8d01d0ba59514bbf930b9915d5926910,354,305,49,Africa,21,1120.32
8d02bc6c43d6414dbf847aa522ca43f4,214,168,46,North America,24,1390.4
8d054083fdf44ac98feab9aa4c177a97,26,4,22,South America,19,104.7
8d0608e561054758849748eb46b2329b,198,175,23,North America,21,1228.98
8d073ea38fe24fd9bd64a2818d32ee92,57,7,50,Africa,21,438.04
8d094e240a8a43c0b2cad83ef8171dfe,364,364,0,Oceania,25,2262.48
8d0c29156d95480696888f330e1bdbcb,284,265,19,Oceania,16,1588.36
8d0e7cd7c66f441fbc3f423c2f5b084d,291,262,29,Europe,19,2084.98
8d0ff006b32c4e7aae6891e622425f5a,365,336,29,Asia,19,2882.46
8d105e5669c24510b32f6e8137daf5ae,117,64,53,North America,22,306.31
8d10a71564a64e9298ed901739855415,239,216,23,South America,14,1602.95
8d126fd1f01f4997830a889f9eb9e82d,61,23,38,Europe,18,136.65
8d1444ee74c4456e9ec563e40dc9c0b7,164,128,36,South America,17,1526.67
8d15634ae0914b2b86879d18b02704e1,255,227,28,Asia,19,1812.41
8d18f158ed614733b48d94bb505ad640,104,76,28,North America,15,1031.84
8d1bea8a4664473eb08b2d579725129e,197,164,33,South America,15,1112.35
8d1faecb63734fbcab5c0a60e4ef7787,328,302,26,Asia,15,2260.05
8d22df76866d43e0b07df0370cecc8bb,112,84,28,Africa,18,763.14
8d2a19b0e01143fb9a47bc477353721a,144,98,46,Asia,16,549.54
8d2a8d8c2aad474cb04ebb09c37563de,340,293,47,Europe,22,2214.34
8d2b8decb2704488a0397160e6e69350,127,86,41,Europe,21,876.54
8d2eab0f7ee64e4888e446b2338bcf19,209,173,36,Europe,20,1346.18
8d2eb34e54a7424282bf00573c2caa26,111,91,20,Asia,22,820.35
8d3219438f0e4e89bc0130891e1b2b47,50,19,31,Oceania,25,258.9
8d3467521fcf404491150dbd3d83aeee,344,290,54,Asia,20,1942.1
8d36f746a3d640fabba1c866f7f076fc,232,200,32,Oceania,22,2291.53
8d39621674964330800d84e8dba23caa,46,22,24,South America,25,192.05
8d3ad135bf60467eb14dd7b900ab8a4c,218,188,30,Oceania,22,1964.98
8d3b231f6c85451e9a472362e9132d81,296,277,19,Asia,22,2705.12
8d3be782cd5c46998887d65d03300c93,235,199,36,Asia,18,1987.16
8d3c84cf2614438ea9abf6e4e730e88c,132,86,46,Europe,23,370.88
8d3cf2f8f2704e239bc01f2440448135,325,307,18,Europe,14,1938.91
8d3e17d748ff4448a1f3fcf9c9e2ecd0,273,226,47,Europe,17,1960.09
8d3f4ce966804c049164dcc107b8ce69,90,47,43,South America,19,325.62
8d3fbd226c444cbc9e511921b6e8f55e,174,136,38,South America,21,1568
8d449cebe60a408b823ce06911f082cd,274,217,57,Asia,25,1717.14
8d4576febc1c43a1928e4606d34d1a6a,109,75,34,North America,19,615.81
8d4900408589407894e72c34d1e6df67,293,257,36,Africa,21,1994.45
8d4921d7788943259f6ce589c16c41e0,54,29,25,Europe,20,164.78
8d496a3c793e435091642de849a8166c,364,326,38,Africa,19,2541.82
8d50d1c49d24488d9a867d37bc2aa888,198,155,43,Africa,29,813.32
8d50e412a0854f7eb35635385efbeda9,364,343,21,Africa,19,2594.33
8d518404eaeb4e5abaf0b4f3a365a8f8,352,307,45,North America,21,1532.81
8d527818670b4276bb23d4da9fab5d9f,156,128,28,Europe,19,681.96
8d528769ddba4315aad9e820fd971ca3,73,27,46,Europe,22,119.61
8d53b4650ea64deeb4b175450b9d1b2d,363,354,9,South America,18,3211.99
8d553cc5b25546c0984e952e0ef03315,363,340,23,South America,18,2496.38
8d57dd7b6e2d4485b14b8bf146184f96,214,187,27,Oceania,25,1448.97
8d58aab73bec499fbc20316fb60d452a,30,5,25,Africa,19,254.48
8d5b232c5c6d4d8fb33e6d10383d9ee6,363,340,23,Europe,16,2789.88
8d5e58ff52e649c39ec2c9155daaec73,294,267,27,Africa,22,1619.42
8d61fc337e464adda8b843ff78eade87,119,96,23,Europe,18,466.61
8d621b18259f4f788d6f9a428c811e7a,158,133,25,South America,24,1028.39
8d64690137f94221ab01dbc94ed02b06,200,159,41,Asia,24,1262.49
8d656e4021f842a993471eb9008f65fa,188,134,54,North America,15,851.69
8d66b4b623ec4c3bb9fa28ddd21a7017,365,325,40,Africa,20,2388.68
8d68b62757f84901910f3adf4c5e6434,127,106,21,North America,26,713.28
8d693c67b000450d806f895aaba4a7c1,327,305,22,Europe,21,2636.18
8d6d685ef4ee406a801073ba650c2399,340,290,50,Oceania,20,1537.17
8d6f33d31acb451d8d088beee6da78ec,310,278,32,Europe,22,2021.99
8d714e7c6cdf4d39b3ffbf25a64b7bef,302,274,28,South America,16,3337.82
8d71aae85d6e4f06bc07bfa100718853,184,136,48,South America,19,1023.51
8d71c24a6b4e4582b4c209a67af1bc2d,208,186,22,South America,19,1899.66
8d723b345d344b2b8ed68b73e7a27838,365,340,25,Oceania,24,2516.62
8d72ae9176ab413e82ec2f98063ef5f9,197,168,29,Asia,19,1031.04
8d732ce696474b0687298c129f7116e8,135,107,28,South America,25,887
8d74fbbcfc384c859a8d4731e4b94814,345,321,24,South America,19,2764.5
8d767c46c60048b3be99ee1585d9bc4b,364,326,38,South America,23,1305.39
8d776d948b0e4eadae8dcd4ffd376a19,361,360,1,North America,16,2605.2
8d7880c0705b4f11a14f196603cd71d3,359,323,36,Oceania,22,2378.8
8d79304636e24cedaedd37db615d08a2,276,224,52,Oceania,22,1385.4
8d7bf867be0e4ad8978dec7a7b3b1012,104,73,31,Europe,25,651.34
8d7eaad521b24ce78ccf89d7a7aa946f,74,39,35,Oceania,21,640.78
8d7ffc92a5e84bc3b45a2c9f94284a60,293,267,26,Europe,15,1243.17
8d80175bd3fe4be69527094c73697673,73,26,47,Asia,28,300.72
8d835f31877e45a8b9459a384d4b59ff,311,263,48,North America,19,2610.1
8d84066c855742dcbafcc53da2b14c1f,322,286,36,Europe,21,2343.55
8d888025172845feb19bef7fc8ea0521,299,277,22,Asia,23,2502
8d8a5cd877ec464b845c909d1fc409b8,93,41,52,Oceania,24,356.91
8d8b7ee6427c4e7b9738f979c88cbc24,239,188,51,Africa,20,1489.88
8d8be66784e848608e3035476572af40,237,214,23,Africa,18,1604.6
8d8d8aea27ba41039b86d4986ec0c9fc,334,307,27,Asia,18,2404.06
8d8db1c834ea4c2da6938f90c982f920,362,328,34,Asia,19,2353.1
8d8e33352f3547fa81855a4a3d4b7421,125,110,15,Europe,24,1212.82
8d8e3841740d4d9dae1723efbcc97b36,188,146,42,South America,12,898.58
8d8e3aad792e4000a34fbac047e7f772,325,292,33,South America,23,2240.49
8d8f39bf7dc243c2aa5aa5bde10e2dba,254,211,43,Oceania,18,2016.6
8d8f542ae5b245f784f334197a309089,162,142,20,South America,15,1080.95
8d93e252ad2a420a833d73e4f220f699,242,214,28,Asia,19,2181.81
8d942813baf5436d855a9f300c9adf7b,227,176,51,Asia,22,1023.08
8d942ca570a34f43bca0a1b9b1d7d7fa,226,182,44,Africa,17,1569.52
8d945459c3c14c30af670ab35665400a,256,226,30,Europe,22,1901.42
8d9673c1f14e423785ccfa43f7d995b7,213,163,50,Oceania,22,1017.64
8d97871e8f804721952c8a54feda4be4,92,55,37,Europe,17,1021.17
8d97909a055c4038a37ba18a2062acbe,178,149,29,Europe,18,517.69
8d97c5dc29f843fa9e8e76f8d195a39e,264,216,48,Africa,19,1413.4
8d9923ab7ec942a59a6bdbb7aa5afaad,144,129,15,Asia,18,1706.01
8d9a96e4acb040b6b6c03c1f22ecafad,257,225,32,North America,15,2156.03
8d9da0b3bd564bdba82ffe5fdd7d1e70,361,331,30,Africa,20,2498.29
8d9dcb8ed984429a838c2967c3e10d37,365,343,22,Europe,18,2714.13
8d9ed236552d4767854f5fac3c88754e,336,277,59,Europe,20,820.44
8d9f64d81c794086b7ba9c0bf64b6eb8,175,143,32,North America,22,968.54
8da1dd8914994740afaac0ad62c4b4b1,140,105,35,South America,16,1100.8
8da435433c654a96bfd031cfe67bafda,358,341,17,Africa,24,2862.22
8da4c8c5f6064f77a7eda7aee61eb901,45,16,29,North America,17,126.23
8da51f91cab646148c72fdd8e8a098a2,124,83,41,Asia,19,1036.33
8da5df36be1244099b347f0202172750,320,290,30,Oceania,20,2155.72
8da80108a3ff4750890ce21e3fddbada,361,350,11,Oceania,16,2349.12
8da9702064204c03bd87170b11fae9ab,100,80,20,Europe,17,548.72
8daa071c5d4b42068ecff48955597d51,204,151,53,Oceania,15,856.5
8daaae4528774854ae2ce4ade5bcc561,134,102,32,Oceania,17,1359.81
8dae3c9f0e274ee391a1aee61c6337eb,324,277,47,Asia,18,1818.84
8db0b5dc728d4111999462a60f4ef4ca,173,145,28,Europe,18,820.7
8db0ee3f970e435a9796ff3a4af9f86c,150,125,25,Africa,18,802.29
8db35d554f644f63b3e62df08c56704b,149,98,51,Oceania,21,329.32
8db7ee7d171041e38cf3a25936b6ff13,271,229,42,Africa,21,1743.2
8db87c69532b4210af8ba14769946479,140,97,43,Oceania,22,845.01
8db92e9feb224cf8bcc651d9974b177d,318,267,51,Oceania,24,2002.83
8dbc05f8fb7d44d6a2f0c48b138e8a7d,60,36,24,North America,21,601.03
8dbe45d194b0479ba21b74d22d6b9a04,218,190,28,Africa,21,1967.73
8dbf9bd9039e4e0bb65fe8b3805f6f84,138,107,31,South America,19,1517.5
8dc019d1a4f9493fbb1c3f701082fe06,139,91,48,North America,18,479.88
8dc2768f85424ca9a04bff39d91196dd,66,36,30,Europe,18,697.08
8dc6fafd16374c25a3d62ce37935aaf0,232,208,24,Asia,19,1446.16
8dc99c4a92b04c1c8191666884fa508a,348,298,50,Asia,23,2041.88
8dca20572e154d6c9667cf8836557425,165,119,46,North America,21,640.16
8dcae70c6e36445d8ebabff9295bad99,349,312,37,Europe,26,2112.94
8dcb6e40883849e492b12751838c41dc,283,236,47,Oceania,28,1707.61
8dcc72a7399e41b194bbd47da09066c7,82,37,45,Asia,15,239.96
8dcc7ed1358c4d5d8fcf9259d10cc1b3,321,260,61,Europe,21,1775.39
8dce8b9bc66a445e9db2cc0c3945a4eb,42,10,32,North America,18,268.56
8dcf74c5dc3945cfbbe212c4321ec823,365,326,39,Oceania,23,1761.84
8dd582b2b59543b3962d13ecb8a0a12e,253,225,28,North America,18,2024.63
8dd675bd935b441ca5369c598aec647a,365,344,21,North America,22,1566.96
8dd76daf71f64d2ea8fd086f8825aa77,358,320,38,South America,16,2082.55
8dd7cb783bee4d6fa549f506230fdc84,316,290,26,South America,17,2738.58
8dd81fef1daf4cf0b330d8efa79214c3,71,50,21,South America,19,376.97
8ddc1b45a0824e07a90ff30e05cf5e02,312,265,47,North America,23,2302.54
8ddc928377604066a400e6999d84605f,216,175,41,South America,18,1173.37
8ddcf42b451048c1ba4dac99a8a59d19,83,30,53,Oceania,14,271.8
8ddde0904c1e4b85961dffa205c86554,285,245,40,North America,24,2406.79
8dde15a976fc4212ba7051b151a16ac7,191,152,39,Oceania,21,1345.74
8dde63eebc7946da9956945e65099ac0,44,6,38,North America,19,131.88
8ddf319dd4e845e5a89f3d5118b0e076,236,198,38,South America,18,1189.12
8ddfc7e061d44032b8ebe9632b2c51d3,131,111,20,Europe,19,1206.76
8de0bf484f86482f8de84a938e854ea7,64,40,24,South America,23,376.52
8de1b1c204d548e49331e24f1e026b6f,356,312,44,Asia,21,1539.62
8de1efb0dc0d4ca89203942be3c9ad2e,153,121,32,Europe,21,1228.75
8de504a737f3494e83b4f989b6cb4cae,167,115,52,Africa,21,809.18
8de56b22027b4112b773b7a334d373cb,219,175,44,South America,20,1281.45
8de69665436a41c683a51938aa4497a4,365,337,28,Oceania,24,1803.05
8de6ff72e71b41c68c0de2a811ae4d11,211,171,40,Asia,17,1282.38
8dea0b123c9341578b3fedcb88749300,352,306,46,Oceania,24,2935.85
8dea45feffa74ebdb76c98f26edf26ef,43,12,31,North America,22,474.49
8deb512b7e0443daa07e8d2623b17b76,79,56,23,Asia,20,786.91
8debd3bfbe604fff92bd8e2e449d1745,359,313,46,Oceania,17,2266.02
8defdbfaab4d4646bee056ce1a8c1c8b,167,117,50,Oceania,20,1207.62
8df5d30f2cec4dab871d2cd0ba3166d7,130,102,28,Europe,18,934.5
8df8894a05cc49569f76323b5f6c83fb,93,41,52,Asia,21,328.87
8df9db7239b645548e1aced98bb19671,365,350,15,North America,22,3114.33
8dfa0c59d71e4f1b8b55c19b862b84af,365,339,26,Europe,20,2270.46
8dfb662e25c447b4a85b61903044845f,309,260,49,North America,20,1345.68
8e0259719a864fb88e2ac077aa40569b,331,292,39,Asia,18,2688.07
8e0279d114354b5e825d41b85a202e46,365,364,1,Africa,22,1678.52
8e04aff0ea38415ca5bb09efda2c98a4,268,218,50,Africa,16,1060.73
8e04e6d709e84bcc887b4efa10c0175d,202,176,26,South America,21,1678.53
8e059f30cdb64658b0fd008865955712,75,50,25,North America,27,492.53
8e06cde6ff184a349a370b6d1855ae0e,81,26,55,Africa,22,470.75
8e06f8235354412caf4a25f749750e71,276,239,37,Africa,24,1538.61
8e07df2d8cbe4bbc9614fefbeec978bc,218,182,36,North America,13,1996.15
8e084d8f00f94210a135238ad048eec7,286,268,18,Europe,19,1689.22
8e0a425d46b84125b90318cb03a0b804,365,354,11,Africa,24,2263.42
8e0ae85fcaaf4145a97e0ca03bde639f,160,136,24,Africa,22,1389.07
8e0b8e6a8264499296b7bbd7a6b9aee2,123,96,27,Europe,20,699.07
8e0be1a81bfd4e5b81f28e760ae53a7a,335,293,42,Oceania,15,2152.34
8e0c282f459d481895cd81331d08c194,283,245,38,Oceania,13,2979
8e1437b09c004356a2e17e0b0acfa8ba,244,222,22,North America,20,1746.3
8e1733845e0a4db3b1479e9e5a4ab7da,364,351,13,South America,15,1634.65
8e17bc491fcc4fc9b07e5e5dac6cd5a8,216,177,39,South America,20,1583.7
8e1a7c40315641b7969b0a342605085a,127,88,39,Europe,23,566.27
8e2059a17679423c87ef749abeefcf75,89,64,25,Asia,15,305.78
8e220e7437864815ae50eb1d9c65c230,338,324,14,Oceania,19,3095.7
8e230799d2784f5abc44fa69f094670d,365,344,21,South America,21,3012.5
8e23dd60757043c7b58119b7bda2e79f,363,349,14,Asia,18,2936.53
8e25cc4a1c91474db636472348053ebd,365,349,16,Africa,15,1828.81
8e26201a0b71458b807f88011c971b03,151,97,54,South America,24,1254.86
8e26853e43a94d77940001df233174f6,101,73,28,Europe,24,758.83
8e26cd2bb2c14ee681f9e1d672418015,150,121,29,Africa,19,873.9
8e29415172fe4c61969d34b4b32f87a5,167,126,41,South America,14,1479.45
8e29582e58c44c8599ff50a134d7b631,341,316,25,Asia,17,2307.72
8e2a997838e0454d8f59f88991793295,202,172,30,Oceania,19,2714.7
8e2cdb7f14424dc988bcf594a548bf1b,139,113,26,Europe,22,925.66
8e2d4e26c0c248dab41fdd2cfd6ecb09,362,357,5,North America,18,2484.3
8e2d9649637145fdb1629a1aec0b8002,81,46,35,South America,18,591.82
8e2de3d295e44ab8a8ad763bb147e645,195,170,25,Africa,26,1158.05
8e2f8aea9e364ebba24497ccf1837b04,52,10,42,Asia,20,421.1
8e32655b64ad4d56a0cc8eb2339734cd,345,303,42,Oceania,20,1830.96
8e336203d03345a4adbc1222533a2aaa,315,279,36,Europe,24,2534.93
8e33c6cc14fb436895d7fb528f1747a1,245,198,47,Asia,24,1362.48
8e36aa70eefe46c8bae1f551c92f5a21,365,313,52,Oceania,14,1572.05
8e38e1c8dafc4bb3910213c275d27ea2,318,276,42,Europe,22,2365.11
8e39779407ff4770b3bcfaa9cb5af0d3,146,100,46,North America,21,623.11
8e3cba14822543b38e88d41921620ce1,190,133,57,Oceania,23,693.85
8e3d1f6247204e4cb983bf6b8b54c5c2,280,240,40,Oceania,13,2188.02
8e3dbca53b2d413ea2e4ab436d0eea5e,274,232,42,Oceania,22,1695.99
8e3dfc83770f469f996b6ad904e5d8e3,221,179,42,South America,20,1592.11
8e410f0a61e8443da1bb30ef81385a6b,231,214,17,Asia,19,1414.13
8e4157883832416cac11d752691e2539,168,126,42,North America,20,777.68
8e4495eed3cf446ba9a1b85fb57f89f0,365,333,32,Asia,16,2305.89
8e44f674ccb94113a351e66e94f4e109,319,268,51,Asia,20,1598.19
8e45cd9687e841d7a07bcfdeb425d7aa,344,299,45,Asia,21,1656.1
8e45d1ff23a648569830b5b6cceaf3d9,68,44,24,Asia,25,370.12
8e47a301f2b048608b25af44f50129d5,294,267,27,Oceania,19,2121.54
8e48d61082004d16b64652f979fdae24,133,101,32,South America,18,712.65
8e4a65c74a7f4ba6aa3543c2f19c70f7,69,16,53,South America,17,108.13
8e4b7eea7d2042a59bf739841f5390fb,265,218,47,Asia,18,1621.69
8e4d34ee0b4e427fa492be451d0f169c,365,344,21,North America,17,2623.97
8e4ea8296fe2412f89f37a3ab8252019,183,144,39,South America,19,1145.58
8e504ba1357345dcbb83a85b776a30fb,333,307,26,Europe,20,3060.03
8e50ff0e811c4b9184a6d6d16560d4a4,227,174,53,Oceania,20,827.31
8e520d7e7e2141ef8f90d7a8de816d86,103,52,51,Africa,19,377.59
8e5244ddfcb74b73b34094db43c8387a,305,247,58,Europe,21,1032.23
8e52a1eb5f1f4c78bf244879551916c7,111,73,38,South America,12,626.74
8e52bc177f594adc9a7257b779fea482,278,236,42,Africa,21,1672.97
8e55549e02ff4605a1d92aa2799e5017,365,361,4,Europe,23,2496.95
8e5731b9be924283b2784fc7ebc74adf,47,6,41,North America,22,102.02
8e57ea88314d4d23bc3d2d505a7c5409,118,90,28,Oceania,16,859.71
8e5b898436b04c3db9f59a0991966db4,184,136,48,Oceania,16,1766.1
8e5ba9e52a314262a5761dccdbb5cd2c,331,296,35,Asia,20,2686.38
8e5c1ef6c11b44c994044e8eec178639,227,182,45,North America,21,1382.03
8e5c30ccb6fd44e7b96e2143cd77a852,39,23,16,Europe,24,220.27
8e5d2c44fa5848c3a79b2285a0c3ea4a,364,351,13,Europe,23,3053.59
8e5d7d30adaf418d9ccfaaeddf1db17a,363,346,17,Asia,19,2558.5
8e5e13d5eea94d0689b7bfd6a2eab547,150,99,51,Europe,21,801.17
8e5e4f5e80864bc5b884bcb6ed60a167,89,37,52,South America,17,275.84
8e5ea28d15a04ba9b15c350744f62ec8,262,226,36,South America,18,1460.78
8e602c6a74644f689b0d7c1604b84cf1,110,75,35,Asia,23,947.4
8e61f01efdd94aa7951c3782ca854d65,71,33,38,South America,25,472.06
8e65964df65c461983f78050b0af308f,253,199,54,Oceania,19,1540.36
8e65e611bdd0493eae0a60c852c30d6e,257,223,34,Oceania,23,2154.07
8e662f6d0bbb4a35bdc8f4945f39cf24,327,272,55,North America,21,1045.26
8e66bc482706400399841ef5dcf8af28,213,165,48,Africa,26,1447.84
8e686d52bfac45a1bab0e2f839c8283b,313,267,46,North America,25,1594.69
8e6c8ef8c6d741e7939b16c6ace516ec,109,59,50,Europe,18,660.76
8e6e260e8d6643eab115eaa431e1bcc1,222,189,33,North America,20,1776.44
8e6fd84d72374cd581809449afe7a43d,187,131,56,Asia,21,999.91
8e708cac2219464d82a1bfd46acb96db,277,219,58,North America,20,1257.79
8e70a3cb010440a6ad257f5e1e2f28a5,364,355,9,Oceania,23,1838.08
8e7436eb0445475e8770208b212dc790,342,318,24,Oceania,23,3834.3
8e748e7dfb2741c499caf2b508d6066d,55,24,31,Asia,22,205.46
8e749498246b4744b1b5da526235b94b,365,363,2,Asia,18,3009.57
8e74f3d69ce44b6cb9c35cc3b94b78f3,189,142,47,Oceania,19,893.62
8e75560d0b9149c69588e8042362c947,158,106,52,Asia,19,1024.77
8e75f120fe144fed8a578118f8c5e4d0,196,172,24,Africa,18,1145.75
8e7731b2bf1544ec8f58a1c925d0ca06,317,278,39,South America,20,1788.41
8e783d1792044093bf601bf440228411,332,280,52,Asia,19,2015.95
8e7952b9063b49e69636a12cefe2dcbd,290,246,44,Asia,21,1649.89
8e798a48c4e14360b1c33e6e1afcc80f,156,105,51,Oceania,15,664.02
8e799d091d08459b83154d3207891897,218,189,29,North America,24,1837.64
8e79a2d35e1f43d6a6f92526121ac90d,103,75,28,Oceania,18,580.72
8e7a66f0029a4331852c16b84993b8e0,255,224,31,Africa,19,1297.67
8e7ffa08fcc941c1955b2f9a615d27ae,198,145,53,Europe,16,1216.68
8e81ae0e3dd54ea19a80014bf4cfea96,179,125,54,Africa,14,914.52
8e85a44950ee4ce9922740099af6b40c,331,305,26,Africa,22,2139.4
8e871eedaf9748d7bb79f7b998ff19c2,107,68,39,North America,16,835.51
8e8739e64a324087af72bd7787fa4b5e,296,249,47,Oceania,21,1343.19
8e898664cced4185854bb951ae5324e0,132,106,26,Asia,16,1267.02
8e89c29e70414ab3966ab0e6c1a57241,191,170,21,Oceania,20,1459.53
8e8c87fab34c4cbb895ade68cb466642,185,138,47,Africa,19,592.6
8e8e1e74f4694cbaa3a15ad2919f86ca,63,24,39,Africa,17,634.38
8e91075639714773846d2ccff9e65ff6,84,54,30,Africa,19,652.82
8e92ad0420bd4ef798b14d5f1541ed97,180,143,37,North America,16,1459.11
8e92ce75cf7f4534a78f4baab5f6a918,255,230,25,Asia,18,1639.3
8e93a7e8342a48b2b197b6e425afe55b,334,281,53,Africa,23,1778.26
8e952c06bc684c36ac3639c9ab72dbcb,119,87,32,Asia,18,511.04
8e95757c50f74ec689d04b6ea954e441,359,331,28,South America,18,2507.04
8e99a60ea94c4246b5224dbc40b3a771,82,28,54,Europe,23,278.1
8e99e3c759b74991b5be0fe7f4501e28,178,141,37,North America,23,781.69
8e9b0b36bfa947f8a029b7d6ecc2b6dc,186,162,24,Africa,24,1358.42
8e9e753edf7941cbb8b14afff1eb3ea0,343,309,34,Oceania,17,2023.32
8ea09f7da9554f7eb4182f2d1e3c55c8,245,198,47,Africa,20,1520.65
8ea151bfd2a84e7aa3822cd41d2059da,361,331,30,South America,19,1856.88
8ea17c838f8f40e98da0cb1487a1b50a,363,360,3,Europe,19,2205.23
8ea6b753590b4010a1671cb1e9d7c57d,125,93,32,South America,24,844.49
8ea712012a05475dbb8874343d9a23fe,194,174,20,Africa,13,2729.61
8ea8ff31c1ba4740bfb2bc0c06b556d2,346,315,31,South America,21,2384.87
8eab1a0f3dce45abb6853057f5fe80e5,365,350,15,Oceania,23,1876.54
8eacc726cb764d9e9d0ec5afd38ad9af,316,284,32,Europe,19,2295.1
8eaebe4dabeb42d3a0492f7e12620d2c,41,11,30,Oceania,19,590.01
8eaf17814fef4be98cc39dd07de1ce04,365,338,27,Africa,25,2044.87
8eb19986c77c418dbc4c5eca3b3695e2,342,306,36,Asia,19,2294.36
8eb1c78afe7743c1a3b6b2617c1bee5d,345,315,30,North America,22,3346.06
8eb3f9173306449082fb7d3217f01df5,180,157,23,North America,17,1719.28
8eb4e7af0a344efab0662711cb708e2c,279,251,28,South America,19,2777.88
8eb5c9e3f2ca45f48d7962e7191d82a6,47,4,43,South America,15,383.64
8eb783e7d97749ce887bcc7b7ed37d21,192,153,39,Asia,19,1109.4
8eb82b587dc145b199be0204a712fc82,186,135,51,Asia,20,893.18
8ebac74e4f8c41c7bbd3426e41697a0e,228,205,23,Oceania,19,1754.88
8ebd459f3bb3493a9cd84c3d6b060d7d,164,145,19,North America,17,1531.31
8ebf34ce27e247e3a0afa546c77e23f9,30,9,21,Europe,22,55.9
8ec07dba8e9343d0a75f437b6cd1c59a,309,268,41,Oceania,15,2248.49
8ec307c725384b4cb08c4e133a368fd1,363,318,45,Oceania,21,1387.56
8ec344c7c36449669cf3f27e458bd3e7,298,265,33,South America,22,2678.4
8ec4f87c573d479f93994564b368e24e,324,301,23,Oceania,18,2891.92
8ec56f956c924387a318ff24e184080a,128,76,52,Oceania,18,521.11
8ec633102c384d3cbc6db2ed5192c9bf,132,76,56,Oceania,20,970.67
8ec78bbdf8424f9e8063e589e95605f6,277,257,20,Asia,17,2040.57
8ecd6d2ed019415d89ecab329102b81a,168,145,23,Oceania,20,997.37
8ecd827ed1724201929255478f38174b,239,202,37,Europe,16,1207.62
8ecf31f0d1eb4b1f8e9c36c9572f53bc,362,331,31,Asia,19,2580.09
8ecfcd1cbaf044528daccef64186fd52,357,327,30,South America,22,2926.43
8ed01b48f4c548999052635cdd24cd64,71,38,33,North America,23,840.95
8ed022137e304270bf8017d50d0cdd77,365,321,44,South America,21,2363.55
8ed5126f391e40e09da4b99becab823c,332,299,33,Africa,15,2223.02
8ed8d56eab804fdfaa1f705e07f9199c,189,151,38,South America,22,1600.67
8edb94c77e4e44c694783934c27889d8,364,330,34,Europe,24,2284.67
8ede7299fb9c47f289096bc107a741d4,363,308,55,North America,17,1441.01
8edeba0afebf4328afb1b6cd3d78b515,137,88,49,North America,23,786.48
8ee2872540cb42f5b8431bf47abb0c29,187,142,45,Oceania,18,1261.59
8ee2ef7ef97a45f6adc632e04752f83d,365,334,31,Oceania,20,2245
8ee473b25c9449daa707b0f4f274c478,277,220,57,Asia,22,1614.3
8ee512d9b629411abb168262f6bb2f73,128,79,49,Asia,20,480.21
8ee56411b0994b39a5a007ef0e2e96f0,38,9,29,Asia,14,298.82
8ee595a9ee3345cb9e097b833f4dd1ed,110,65,45,North America,18,527.76
8ee60b2a13474b8e9ba3a82a30dec4b6,364,360,4,Africa,17,2237.38
8ee77ebf38b140d1bdd282ffd5b1f59b,136,94,42,Oceania,21,883.32
8ee8ad5787db412fb1f77332432b62d3,77,25,52,North America,21,383.22
8ee905a6a574448b836e45f7bf00b1f9,333,306,27,Africa,19,2498.23
8ee9bf7e81584098b61674a708b57f01,38,8,30,Africa,14,193.45
8eea6498c8564072965362f03b247416,231,184,47,South America,18,942.31
8eeb92780ad54a869bd211f74f4b9861,49,4,45,South America,19,457.7
8eec808ae082443d86659c15f5729a3a,363,341,22,Asia,22,2487.28
8eee284ddb0e426cb69561b190213bd9,132,84,48,South America,23,989.18
8eee8659af634fd69fc11da2b469f552,227,204,23,Europe,24,2030.7
8eef3c560dd54c60908b847723884eff,189,153,36,Europe,19,855.32
8ef0d8e922ca480bb61283bb69b1c2ad,299,258,41,South America,23,2471.05
8ef1d450e23045dca649e3f03466a843,335,309,26,South America,18,2570.3
8ef21fbb478d4a2ea50ffec4dd90efd8,364,322,42,South America,17,1546.14
8ef3bc75207845c2996e06122ee4d4f6,50,7,43,South America,25,533.93
8ef41a88754a4f7394e62963a4b323e7,121,94,27,North America,24,625.31
8ef4deec657f47ab91c9aed4f12f0206,120,62,58,Europe,23,533.26
8ef825106a8247f1a5aa1ae58bc437f5,364,358,6,North America,17,2512.18
8ef8e84bb8174382b204c32fd98e23ea,343,301,42,Asia,20,2329.63
8ef9e144399043349dc06683df50d0e7,153,129,24,South America,16,1297.89
8efb3c0c32f44b77b60d4b142c00d9f8,191,171,20,Asia,22,1089.01
8efc57d76c554d4296c058273aa35a6e,80,33,47,Oceania,25,195.72
8efe8d9123e649629a4685643607c066,136,116,20,Asia,21,635.18
8f027671441647c7b7db2d8aaf1342ed,203,165,38,Europe,22,1151.61
8f02f915603542309c407d59f5e66afb,365,333,32,North America,21,2996.29
8f081def29a345aa96de3d735a405f82,148,96,52,South America,22,620.4
8f08c58877d54746a3b3d65554062c42,245,230,15,Oceania,23,1747.99
8f0a59378b864ecab4f3f292ee696a00,301,253,48,North America,18,1509.29
8f0bc23bdc9f47419d0bbc603dc24804,200,160,40,Asia,22,1182.58
8f0c76862801445884fa5267b7da9a3a,332,295,37,North America,23,1758.38
8f0dd16a84d4488fb55b4343f7dab895,360,337,23,North America,24,2258.7
8f1005b4210748f2a691b6762fe46af4,39,16,23,Oceania,19,148.5
8f12383e33124c92896857f5507e5d00,139,124,15,South America,19,998.55
8f143fdcf4964a82b0a6d46ecfe66292,89,67,22,South America,19,800.33
8f14bb16ff9a4c329631c34109a49156,278,238,40,Europe,19,2401.63
8f19cd4f2c644ea8ba152824c26a2134,92,52,40,South America,21,906.56
8f19ebcb7521421583398ba06462e3a7,295,247,48,Europe,19,1343.72
8f1a362434194f9784facf203ced5d72,233,190,43,Africa,20,1344.98
8f1b5c683e2d4c1c974a57673e8186a5,364,347,17,Oceania,21,2784.64
8f1c39a35f714c519b81d82330d92801,251,206,45,South America,21,1362.46
8f1f957cd3554197bd8b24dfc614ba4d,364,334,30,Europe,20,1270.57
8f21b632b5994c0e806a254cd8308ba9,290,247,43,Africa,15,1614.63
8f24fcac94704a66afbbc2a5c5a448d4,184,136,48,North America,22,1140.93
8f25de8338c745b490fec0110390dfca,364,339,25,Africa,17,2217.41
8f2750f319ff4cf88b0aed0c14f2c9a6,114,81,33,Asia,21,1292.81
8f28d702bce34788befd805e2244e969,185,132,53,Asia,19,1172.09
8f2c3a76c9e1468da71f0e5255680092,132,86,46,Europe,18,905.95
8f2d1fc702c94899b0450eaf0caf72b5,289,259,30,Africa,22,1735.31
8f2fa4c6887c476b8710da4f17c6e08c,80,36,44,Europe,20,534.2
8f31f53f246c4fbf890e93e8024832fc,353,314,39,South America,21,1999.13
8f32ad464d2a4e2e9221f280166a406a,286,245,41,Asia,23,2646.29
8f32f9d2a6474f679fe8420705a5461a,174,124,50,Asia,18,953.72
8f34806871404defbea9715de3f08829,77,37,40,Oceania,20,295.55
8f359c9187444f0ab4f0f641ba8652da,365,328,37,Africa,25,2094.07
8f35a8a69deb4b418560db6f4c5d28f6,65,17,48,Asia,22,554.16
8f35a958709245ceb547a09bc7a1acb5,131,92,39,Africa,26,1090.65
8f3907c8df944caba25c99afa4ac72a5,86,55,31,Africa,22,1018.96
8f3b544ab0114815b3a63717e605f788,55,9,46,South America,25,439.5
8f3e004c89d2474c893d99e38185ee30,258,229,29,Asia,18,2197.57
8f414296df6f4eb694bcc13864ae83a6,264,229,35,North America,21,1605.58
8f419692ca87458bbe729fcd020732d0,365,328,37,South America,20,3178.68
8f42806c2e0b4b7d96572c0d453ab3f0,252,197,55,Asia,21,1232.46
8f4406669d03438d86b6790c9fb78f56,116,83,33,Oceania,26,867.17
8f4547379f86411aad0bd03b20a21b55,214,174,40,Europe,21,1959.53
8f460cf087fb4922aaeba862bbbc6743,266,247,19,Africa,15,1888.03
8f476eb5d42349478edb89ede8d2e092,93,69,24,Asia,17,368.23
8f4a10137f01435ebee3a0bc5576f263,348,315,33,Europe,18,1980.64
8f4a1842098c496bbbd19fcb936f2347,365,365,0,South America,29,2348.29
8f4b9f61d9344d0c8587773b6fe14cb8,130,110,20,Oceania,17,1021.17
8f4cbee76c7244a3a1fd43d845fbeac0,276,253,23,Europe,22,1903.57
8f4e82bf295c40f3bba304062ba34407,191,158,33,Europe,17,1160.59
8f4eb80dc6df48b59835622c026caafa,339,295,44,Europe,19,1589.19
8f4ed27dfe8a4e6b87ba0db1207a8ec1,166,139,27,Africa,20,1337.9
8f4f59c99f824f078afa1467e2c5630a,315,288,27,North America,18,1754.07
8f505d3edfd94b79b10d3f8a77167b43,86,52,34,North America,17,501.07
8f51f7d64c464235982c45cd593d2782,66,17,49,Africa,19,445.58
8f5205ac64ca4f4ab54baaf7cf0665a1,58,3,55,Europe,18,567.89
8f55162c080f45e99200fcbb553df053,150,123,27,South America,18,848.27
8f5539d008ac45eb8d1874e9bca9d6da,186,161,25,South America,17,967.94
8f55834842c44fc69a7f66ed16f93f63,355,316,39,South America,15,1945.32
8f56133ed3e14986bfe2181c8a6323a1,168,129,39,Oceania,21,1191.91
8f5737c07b2d48a0981fa63adef58b97,190,156,34,South America,21,1168.59
8f584bff08b64abf97911797b7fc742d,98,76,22,Oceania,23,417.08
8f5999b10163468db6bbec220a85497a,361,320,41,South America,15,2093.19
8f5a1aac019f46f1852aa71975788f0a,278,242,36,South America,21,1751.19
8f5b3dc146844221bf719e1bc3a3788a,364,338,26,Europe,23,3706.27
8f5decc965da4d76bfa81fa1f6bcd11d,296,247,49,Africa,20,1635.43
8f5ee2a704cf4b0a9fc9a1c55da9c926,154,123,31,Oceania,20,836.44
8f5ee9e4e3f7472784e83f515d260c03,247,192,55,Europe,17,999.3
8f5f5c3e93174c8b81cf2469864ce6fe,189,159,30,Asia,20,1399.67
8f5fe384ec2d425aa9e5a8ecd4c26d97,344,310,34,South America,20,2637.09
8f613f94191c4adb86a6e1a778d89a0c,350,322,28,North America,21,2390.55
8f614cc43b1c4dad927ea809cae107b2,364,333,31,Oceania,15,2440.02
8f62bfe41b624878ba212283cf44e3ab,222,201,21,Europe,23,2011.91
8f6424f7cc4d47efa05795d936bfff01,215,182,33,Africa,25,1276.22
8f645a01fbb146debf8f7716542425ff,87,46,41,Asia,19,681.66
8f65b480a82a434ebbb17bd4fbbf56d3,99,40,59,North America,20,146.08
8f67c088c587498f8a49501524dad910,312,273,39,North America,23,1234.82
8f6d334a3b5d482a85636f023d8f6805,162,124,38,South America,17,1640.4
8f6fac71ab654b5996bfdc91f5fb3fb4,130,108,22,Asia,14,1050.34
8f710952ba6d460f9d1dd48c05051953,115,74,41,South America,17,946.62
8f74ef120d634b7887f9966b945e0e4e,245,194,51,Africa,22,766.56
8f74fb3d26a94eb9ab9f55e60260c89f,365,338,27,Europe,15,2208.84
8f7546cbd30446c7b3a0da6d1dbdf658,342,291,51,Asia,18,1484.3
8f7579724c6f4eb182ae6940dc400842,265,210,55,Africa,24,1281.49
8f78886997e149c8907ee7904a948ec1,148,107,41,Africa,17,645.11
8f78a21382384301ad9fe9156ccc95a1,245,207,38,Africa,16,1590.31
8f7e0093b45549c386fbd3679dfa364f,334,317,17,Oceania,21,2233.23
8f821703225c4745b79a512528895df1,171,152,19,Africa,21,1275.82
8f85d1f62a444b6bb64eec276194c61e,232,201,31,Europe,19,2160.27
8f86689a0d894668a74faf3eda539cee,100,68,32,North America,26,493.58
8f88521e828c49ca9b53c637d6103be9,123,68,55,Africa,24,764.95
8f8bee2636d345cf9f89b408767a536f,365,341,24,South America,26,1517.9
8f8c551ad3834699a47f2e822cdea33d,325,284,41,Oceania,14,2528.38
8f8d9567d9184b3d8d0b2f6376777cd7,196,167,29,Africa,19,949.75
8f9083574b974edd91550dc031978d3a,254,221,33,South America,16,1823.23
8f91fb504f044d2f8998b8d997c62e27,72,50,22,North America,21,826.42
8f942333fd294d5ea7bdf3b1149f0123,108,83,25,Africa,23,1058.35
8f95627fa5344e82a0370e1b461c3c8b,354,333,21,North America,22,3117.54
8f97981159d24c5a84dbaa2580cc2660,274,223,51,Africa,21,1629.43
8f97d6cf4b184796a640e431d09c9314,59,32,27,Oceania,21,192.81
8f990d1e5eb0452aad59a63b7365d0bb,182,156,26,South America,23,1555.24
8f9b5ea0d8e746c78decb4ec5f0fdb48,302,279,23,South America,18,2082.57
8f9ce4b22780427385e52a7aa3ac9755,364,344,20,South America,23,3077.38
8fa1f0c4ccb34fdfa2348f02001b8b66,285,248,37,Africa,22,1931.71
8fa292fe1f934267aea784cf02ca361c,308,263,45,Asia,16,1518.95
8fa32c8f42924fe99b9dd7ce09b58991,208,173,35,Africa,13,1909.69
8fa35a3139bd47cda1a7902b1c4f7526,119,95,24,North America,22,956.97
8fa5bc30c3004a7387465bbbf00ccdd7,89,50,39,South America,20,779.49
8fa7d38b3e574cf2b054b782811bf920,189,132,57,South America,20,1468.49
8fa8b8f4d2014c54a081eb5549849f73,99,47,52,South America,24,296.21
8faac0358880410dac463dc5dfb48fdd,184,135,49,Oceania,25,540.03
8fad03c36b4e4aa5a32bd69357cf2804,108,74,34,Africa,22,590.88
8faf036310d449bb844497723c4978fd,364,334,30,North America,18,1698.58
8faf48f7946e4338a931dfb090084662,34,5,29,South America,14,125.11
8fb174c9ee034cdf9f7ef9b5f529c564,62,36,26,North America,14,511.46
8fb1bf1fc2b14525b11cbae05ea6e8e3,93,33,60,Africa,20,428.2
8fb1d5cb14ce4b24b2e047b03e9ecb63,200,164,36,South America,18,1412.14
8fb3aaa26ac441959b8ac042820de4bb,365,356,9,Africa,20,1906.14
8fbac3732c4d4afaa4318a78a5cfaecd,272,218,54,Asia,21,1513.96
8fbb0060545d4761818b839ebb7bc72e,204,151,53,Africa,16,809.1
8fbc6c561c9d480195204fc354595586,286,265,21,South America,15,2214.29
8fbd16d83b4846f3a60c47f720b26472,361,349,12,Asia,17,2912.11
8fc035e0482847bca84286cf53896634,184,143,41,Oceania,18,1409.67
8fc0b155f3bb4921b38512fdbd85a9a4,106,73,33,North America,19,434.44
8fc1cc6bcaba453b89174e77c733fe68,260,210,50,South America,22,1275.81
8fc27c491db44a31995b9bcaff761cfa,365,312,53,South America,19,1647.53
8fc5137c559c408a9b240c8e5326f4fd,251,232,19,Oceania,26,1700.53
8fc521442318450a8403bffa1126eedc,123,94,29,Asia,21,1690.25
8fc53ea1572745e598b32054f3af8d7d,47,22,25,Europe,20,417.21
8fc861a9479f4f1b8c303d39f8661728,303,279,24,Europe,26,1943.17
8fc97e71c5154a3d9b9da26b314239da,255,217,38,Asia,21,2094.24
8fca7aade653457bb6f10a5e5e9b519e,103,47,56,North America,17,932.12
8fcd7f74b7c049bf888d11d67513cc33,363,320,43,Asia,19,2058.22
8fced58e709042408fd2cec2c5b7b649,363,343,20,Asia,22,1607.83
8fcfe8eab37d4ce285b3f61d7d9afcd2,57,15,42,Oceania,21,322.43
8fd0e4b5ccd64913933e9dd348f21b4c,365,363,2,Africa,20,2111.08
8fd1089358434e3a8bd79689f51c14db,364,345,19,Asia,20,2472.9
8fd177ea2a7b41d3b409c5171ae5170e,48,9,39,Asia,12,189.16
8fd19dfc9ed14b01b5047facb5a6637b,153,111,42,Oceania,20,655.69
8fd2e479eee645d3b01c755f2a5a2b12,295,268,27,North America,20,2494.17
8fd40386a09c4cd08499cfd1e24d1c81,62,32,30,North America,19,481.94
8fd51a6b89974e379692a66e9b6cd92a,185,153,32,South America,17,1533.62
8fd57db922a4432f8b9ca50eebf841fb,364,345,19,North America,19,2677.53
8fd60a86b9904aa1932d7b9e07b84928,96,39,57,Europe,15,365.82
8fda2723e2e34c4ca6f1d16772d6d5e3,315,278,37,Europe,21,1961.66
8fda7d1d45a34249bebf410f1a01446f,353,322,31,Europe,18,2236.13
8fdb61d526154687bcf5af197a554d6d,365,354,11,Asia,18,2969.55
8fdc32f8c44540258015bbb31394bc5f,146,106,40,Africa,19,1227.5
8fde1537d5854e99aa125c669ad6f468,108,58,50,Europe,21,522.53
8fde1dffeb3b4258b99ea888d90dcabb,320,295,25,North America,20,2536.31
8fde307dee704e989dafa0d97ef1c3ed,228,175,53,Africa,19,1204.81
8fdf85d4af52408497ba3c5829a94ecd,242,209,33,Asia,21,2253.95
8fe045bde11a4233b01ec285dc187004,167,124,43,Europe,22,1620.8
8fe30fab116345d39edb36bc1f90da57,306,274,32,Asia,26,1796.1
8fe77310358749f4a9c76806818fbd69,84,36,48,Asia,16,445.95
8fe9500cd3b14085ba90f217d0bd8e88,185,162,23,Oceania,18,1456.44
8fea1f721bf4484793f0dc20304e871b,214,186,28,Oceania,18,1407.63
8feaf418331f4ee4b40dd247c147c50a,338,305,33,South America,19,1758.23
8fec5c8c7b21420594b48248278f55a3,349,314,35,Asia,15,2086.04
8ff19dde973d457191fec845da751063,344,307,37,Oceania,18,2302.78
8ff1b9fa2e814e6c9890cdea44f374b5,164,139,25,Africa,18,1696.86
8ff225e69dd548ab9d9eb22d8179bffd,78,55,23,Africa,18,578.78
8ff7a1ab73a34adf9deb842f29f0716d,180,136,44,Asia,17,1065.9
8ff7dae796824dcab3a4be8239aca633,251,197,54,North America,19,1385.53
8ff9203d23c847bbbdb812e1b228102a,147,119,28,North America,24,973.18
8ffaac25cb334b2db93072bd62d4169e,192,141,51,Oceania,19,867.99
8ffb0a60eb8d451d8652dc6b6a28b893,286,257,29,South America,23,2327.87
8ffc435e67e34b909f3b21fd651e5d7c,361,354,7,North America,30,1486.53
8ffc4ac91d264c83b8721c7e8c5034b3,307,263,44,Asia,23,2296.8
8ffdbb92977749238ba0f53c072df5a8,333,292,41,South America,20,2035.26
8ffdfb1df4f14e56a6f3240dc3e133f8,58,5,53,North America,20,202.22
900072033e9b4723b6577da17e226e6e,105,56,49,Africa,19,338.49
9002709be5974ef581e05f0c9aa8741a,291,275,16,Africa,21,1523.74
9002aa9db8f54a96a3f1abd5efa5af28,365,333,32,North America,16,1742.9
9002b44daa704b1b8e662851d2f37d52,218,186,32,North America,24,1559.36
90062c3969a4490b9a3c93283a53e7fd,305,281,24,South America,17,2535.36
9008574921ef4f0c8afee9ba06755518,346,327,19,Europe,21,2085.01
9008c32c65fa4608b26e7626f2282c1e,91,44,47,Europe,24,521.99
9009e757eec84bfea402bbd63e5d09e7,365,364,1,North America,21,2765.74
900d9858d5e2436f8d80c453784e9be0,175,121,54,Africa,18,1285.73
900d9fbb70d546fb98e260d5fa9ff2f0,249,231,18,North America,17,2084
900dc8e2443b4b968101a66cb786b7ec,197,155,42,Asia,19,1304.19
900f24f9d83742b49fe1a04a9447dd7c,258,214,44,Oceania,18,1398.57
9011e957ad8c4fa8a26c1b2cb0f3e668,132,93,39,Europe,22,984.33
901299d6c9874637a40fc6b8e33747e0,125,83,42,Europe,18,1183.44
9017ff359a394e73adacb6684dea1b78,101,72,29,Oceania,16,950.05
901a089868df452eb29248d46b18f019,146,130,16,Africa,19,821.56
901a349e7279423a9c142b3923616470,365,336,29,Europe,20,2109.4
901ec36d47cb433f93ed8236d17d4b61,222,198,24,Oceania,20,1628.56
901fcc5a045646cfbcee72f7c5529300,86,40,46,Africa,19,320.5
90202cbf8aff436794bcd4144d498be6,291,268,23,Asia,24,1867.67
9022847e78384398a07f875354b4eccd,309,256,53,South America,15,1737.77
9022a5d37a974880b231248449e8049a,190,136,54,Africa,26,741.22
9024f09a607b4a62bc7201e77872ff7e,365,365,0,Europe,18,2507.6
90253026859b49039f579374a6cea776,226,169,57,North America,22,687.02
90253574cdc34ecc945729654db4b082,92,69,23,North America,18,697.44
90253739cce9499eaaaa3e75d42cec71,357,325,32,Africa,19,3042.27
902625cc65974254aed180502bd09cc2,354,325,29,Africa,20,2662.1
9026385f1ec742799e36233127d7a749,259,225,34,North America,18,1948.24
902720a4b0464b748d786b0e9369f750,321,285,36,North America,22,2104.79
902856f1d381421cafa4b28e770d002e,162,110,52,South America,20,1071.7
9029e89df38245538ecd3a2e2fddfe63,321,290,31,Oceania,17,2143.36
902c9fb5e48f41859fa8ac4948c3ae9c,354,328,26,Asia,20,2646.02
902e671965524ead97e9ec102fd12cb2,135,96,39,Africa,23,789.85
902e867e09874b4ca2211a80b920ee24,56,29,27,South America,17,411.67
902ebea0dcd547118f291a5c131c0a59,222,189,33,South America,29,1721.15
902f0c7790a14d44a473f88335d8048d,241,189,52,North America,24,1034.95
903068bfe6ee4e948aac32abc27ff7c1,102,78,24,Asia,13,855.61
90309357625c4703a51f06d243a4aed8,352,311,41,South America,22,2550.67
903192f218434dcd8e272e0b988c3cdc,181,149,32,Oceania,19,1823.97
9032dbc4599c4eb78dd26c8bd5108e2b,118,87,31,Asia,18,1278.08
90371dfbb9c34f82bd6b96988faf397c,192,156,36,Oceania,21,2025.85
90376738e626414e8609fbcc8fbd710b,61,19,42,Asia,18,335.73
9039c0b755b647a79c2b0aecc40772ff,267,209,58,Asia,17,1483.48
903d78af243f48819138bda672337c0c,304,267,37,Europe,19,2436.21
903df3bc4320474b9c97927e672f0d6b,218,184,34,Asia,25,1517.24
903f1223e5bf40338a7e1127a2b44f10,294,252,42,South America,25,2559.66
9048762e021e458e94f96029897ac977,300,273,27,Asia,22,2067.37
904c62729c3c4aeab599713e1d6a59de,119,89,30,South America,18,1187.64
904d73070edd42cc8b5fb110a5b5e027,150,104,46,South America,21,758.98
904da59c568e4e21a5cc4b490b20bdce,62,16,46,South America,21,234.98
9050087ff9d84f3b9ae9a75ee4b3354a,119,69,50,Europe,16,266.82
9050150a21164cbca6aafd53aa420dd8,259,207,52,North America,22,835.6
905196fe840f48c6b43d063032e65b3e,317,277,40,Asia,22,1945.4
9054e7e6829642799904f6784b0f2344,182,135,47,Europe,14,1088.9
905a653960f54871ba8b2f49c3c456ae,185,173,12,Africa,21,1670.75
905b9ebeb59440868f04c04114a8596f,248,223,25,North America,23,1808.71
90604dc8ef84437b96a5e01ed256986f,29,6,23,Europe,22,109.4
9060920655a949e7bd74c344fbbf8ba4,364,318,46,Oceania,23,2153.35
906145315e514560868b93a7838aaa02,74,49,25,Oceania,20,307.29
906167f51d26476fb9af43e25e12175a,140,93,47,Europe,16,847.16
906555dacfa746e3a20005d1a63349de,348,290,58,North America,24,2065.03
9065b2f45694474b812717cdd07ec0bf,365,356,9,North America,15,2639.48
9066c98817bd491ba78b510efcfcde46,128,100,28,Oceania,21,762.34
906777e37e4b47958a34bb416ebbc1d3,194,148,46,South America,22,778.45
906a916da10243239a4e4fcef974c1c0,48,27,21,Africa,20,298.58
906c7ade71064170bb6a6748f711f085,185,158,27,Asia,20,1411.69
906db1a4a5584fcaaebfa3dd8df1b849,233,200,33,Europe,22,1245.07
906eaea2afcf4816a879d50d7cd474f2,173,124,49,North America,22,645.51
906f2fe613cd49aaaedf97f7691bba35,331,295,36,Asia,16,2038
907018165366417ca76f9a3fc11b6ae6,57,33,24,Asia,18,522.25
9070a6b6800d4758afdc372ef42ff3d3,322,279,43,Oceania,17,1902.76
9070d72a73a9477e9dab39b14f6081f3,209,167,42,South America,12,1509.14
90728bd1acda402eab77874dc432e3a6,190,131,59,Oceania,17,998.87
9072c8ac41874970a8dc1f240558d89a,126,89,37,Europe,24,548.52
9077458f2a3949499618f2cdb70b43a1,97,60,37,Asia,18,740.65
907c37d3ba464445a74f9e55dba8fc17,181,131,50,Africa,15,924.74
907c568e612f4a2aa0bdf191e39ad72a,100,65,35,Africa,26,1134.4
907da9bdf4f2421180c857dae0afd596,161,115,46,South America,25,545.61
907f5a4331e54eae81832a022cc1f05c,92,41,51,South America,27,306.83
907fc93841c6438bae2b55df67907878,158,119,39,South America,16,720.84
90801eb621844d7d9f1bceefb13cdd87,356,337,19,South America,17,2038.38
90824a3da52a44e8b91a2f599a81ce95,346,316,30,Africa,24,3195.27
90828382cf484e1cb0d556ab7baa73b8,365,353,12,North America,19,2818.43
90877cde01eb45289f205535c4b554f5,79,35,44,Europe,26,765.42
9087cadf5af945cdb497ed8bd2e8b4f4,365,361,4,North America,20,2015.18
90880b52db9141c8a8c9f6818c993b59,161,113,48,Europe,20,862.01
908830ae9e81453b8b180befb582b018,365,326,39,Europe,23,2591.28
908914313b1f4aa6a564620fa472102b,339,322,17,Asia,20,2338.47
9089bd2eed86481ba9db3f1e21339640,347,317,30,Africa,21,2335.06
908a5816497b4c85a5cef9f859e602c4,130,83,47,Asia,25,549.97
908be6946f2d4613927349ca5e692c29,287,264,23,Oceania,22,1700.96
908ff1c538594cb6a94c954c5f37a06b,362,316,46,Asia,22,2244.21
90931e5c3b5247e49287abbbbf6b6e99,100,60,40,Africa,20,878.53
9093725600ef4521951516cdceab5969,64,5,59,Oceania,18,321.53
9095474e9fd34c8bbf57fec1fcb7e9f4,286,263,23,Europe,18,1164.46
9097b6d68e6a4486b20c49fc11a1c2be,259,213,46,Europe,25,1823.01
909b157bdc57477a92e9bb836f35d520,151,138,13,Oceania,23,750.56
909b52e26cb845779c24f21fbc506e69,200,152,48,Oceania,21,1242.12
909ba0a9156e4aab97ac50c86e57904f,49,7,42,Europe,22,407
90a00ac938bd4d24b9471745ddee69db,253,221,32,Europe,21,1980.81
90a019a0f35b45c18079cad6295cac3d,149,106,43,Europe,23,1021.51
90a4843afeec44d1a9c7a43515518550,338,313,25,Europe,22,1850.8
90a4b42f37224466b3fc03d8a3d297e8,239,188,51,Africa,21,747.75
90a5712909984b7faebf6c85d92a668c,164,109,55,Europe,18,1041.64
90a6c48639454488b2c956c600cf72f1,162,122,40,North America,26,896.11
90aaeb4825f04d9ea6410877111e7e45,349,297,52,North America,19,1709.14
90adc72bfb744cc3a334856af9272185,364,343,21,Asia,15,1853.2
90ba86405e2749118ba0340e395d9f63,242,192,50,Europe,23,1342.09
90bc25d21aae4257b24722a4bce062a3,287,240,47,South America,18,2318.91
90bc3e667c664311a398e933473d2f43,181,163,18,Africa,24,1094.48
90bca67965494976bea5a1aeeb6950a7,66,34,32,Oceania,21,400.54
90bd8f54aad44f0b9f59e01763d40c4a,43,25,18,Asia,20,407.61
90be16139af84f4490e803bfa1da9a8a,266,226,40,North America,22,924.76
90bf820ad3f3461e80f5cee7b84f8ff8,324,298,26,Europe,17,2754.66
90c18e47c2c04e8aa4a7d65a3929641c,59,41,18,Europe,24,700.29
90c1df6888014e519f8cb079072e791d,68,37,31,South America,20,359.11
90c23f415b04419d924ae5c5ecb7e5b2,109,62,47,Africa,20,529.32
90c29f06a96b47c8ae0882835d052cc3,365,340,25,Asia,20,1344.66
90c34c9fe21346e580e7bc1709d784f3,293,259,34,Europe,21,2114.7
90c5886380654c2cb74f3942577d8fd9,309,281,28,Africa,16,2446.64
90c73cbff4a14fd894661814c4c297e8,364,328,36,Europe,14,1336.79
90c7ade9e5a84b3897d84d3643b129cd,191,141,50,Asia,19,793.37
90c9d4d19d3c4cb58b5b588961392b2e,89,65,24,Asia,14,655.36
90ca293326484ccb8f3509ec863d4463,121,99,22,Oceania,22,978.21
90cab1010d6944b090f1e04e1174dab6,365,343,22,Europe,15,2769.26
90cac1cbf4d3491c9af68f3d04d5f291,301,279,22,Asia,23,2580.14
90cb8e18abd34467bd6a6bfb385fa00c,220,187,33,Asia,25,1095.38
90cd218de60847949264610934c327e5,338,312,26,Europe,26,2055.2
90cfdf284f124329b633ecaa04a88c32,37,5,32,South America,20,320.97
90d2c411250042c1b3fab47133c4968a,255,212,43,South America,18,1798.62
90d3496ab4ac4bfaa40edc39de9ffb4b,128,103,25,North America,15,842.89
90d6cd2ab29241daba4863886501027c,310,278,32,South America,22,2452.28
90d8fe01c9f04182af46e98f6555ce69,283,238,45,Asia,22,1624.38
90dc256573724eb49e82b6589e144dd6,325,299,26,South America,23,2411.85
90dcd116782040ba9953638edc90d218,215,174,41,Asia,22,795.21
90df0e0b28a6426cab96a5e7deeae721,66,18,48,Europe,20,449.74
90dfcf0add914fd89206651dcdfff50d,118,92,26,Asia,21,641.02
90e2ebb76d15492f8da2abd14c762328,46,14,32,Oceania,21,403.56
90e3c109ec984dbe85b1cd005808be28,174,147,27,South America,22,1355.88
90e57aa460654e19892287108b046a48,109,81,28,South America,24,654.85
90e63ee0a2c342e9991cf24c0693706b,128,93,35,Europe,18,836.88
90e8759b517148639348220262786310,115,77,38,Oceania,18,929.14
90e8b4173ca442fea48a71354e06dd64,123,69,54,North America,19,436.23
90e8e297461c4b0db16c2c7a4773f464,157,114,43,Europe,21,723.56
90e8ef9c2d624a438b7495f4ebc827dc,116,76,40,Oceania,19,858.89
90e96f734dca4249a7471d392cfb6bad,102,62,40,Asia,17,793.86
90ebd4bd6dde4a1ca2e98f7d33b75494,101,64,37,Asia,23,1401.1
90ed0f874f51400e98ec0b585d82d361,338,306,32,South America,23,2566.21
90ede8c3f64948bcb2e923da2b98e2b2,351,316,35,North America,19,2093.93
90f021928e234919aa437fb1e0b3f87b,69,45,24,North America,16,514.7
90f03f3fc1a94efab7ccbed32ae6aca1,365,336,29,Oceania,16,3006.12
90f1a7105ae9486f86e32db5e571e62b,361,328,33,South America,20,2724.11
90f2bd699f9f42f4b1f4f06f2384403b,198,160,38,Oceania,21,1109.35
90f4106e1e40428b96039d25bbd73aac,158,111,47,Oceania,22,510.21
90f574676e9449f7b9fd436a6e0c08b9,318,273,45,Asia,21,1751.57
90f72df413ef4fa9ab067415fbcc283a,365,328,37,Africa,16,1747.91
90f75f9acfb94595b9c39bdbad4f36d4,164,121,43,Europe,19,741.1
90fa1de31ecc4ee0af73d5b62c3dfb0e,212,163,49,North America,22,1096.67
90fa7a61e6854087af0d5d99ad24da31,358,324,34,South America,21,2871.87
90fd5c6b5f1d409f8151356f35c8ca36,312,261,51,Oceania,21,1553.27
90febc5210fd45dda880bd6120a3b99b,274,251,23,Europe,19,2468.22
90fed9cefdff4989aae67b3ca7691ce1,308,257,51,Asia,22,1670.02
90ff5a09a9d44ad9be016fc5b256a96d,227,174,53,South America,20,1025.6
90ff8cb55f19455399ceb16365c53340,29,7,22,North America,17,251.28
9105040f7dab44e886123d8ac15abb0d,224,171,53,North America,22,805.53
9106470eab5b40949ecdf172428b3d66,154,129,25,Oceania,17,931.96
9107338d3d4d414a9c9ae8fae57f821c,86,47,39,Asia,19,584.42
910a944d13d8482db0ef1733f10a145c,185,134,51,Africa,20,622.18
910aa51f998f4116a53174aefb70db8b,58,15,43,Africa,22,219.46
910c5420bfab4cbab3c74f29bb88cc4b,201,167,34,Europe,20,1365.02
910cc2a2b8de4b03b2acb5c8e7ea5df9,141,122,19,Africa,20,1042.03
910e0e06aedd4e8998a826098fed1c24,252,216,36,North America,18,2252.74
91117c5b1c064971b2da1bd0d322d660,186,144,42,Oceania,22,1426.25
911269527f9d4ec9a9ef2e2be7837d89,59,16,43,South America,27,292.82
9112d8df152b4fe4adae8505c84f546e,365,347,18,Asia,22,2540.1
91133fec6c704cf990721a53f792b7ed,349,302,47,Europe,18,2097.98
9113629f4e044f39b7dfe0e45f82f1ea,364,353,11,Africa,25,3285.52
91161732a48541cc89e12a6757348b91,312,291,21,South America,24,2613.07
911647501f6e4b688c63f29cf61d57e9,75,41,34,South America,21,471.96
91196f9615124b6ea9343ba7de0ab101,358,305,53,North America,23,1136.86
911a10c5fdad41458d850c5bb3b62eaf,295,250,45,North America,14,1580
911a39c2c22f4a0fbd0307e303f98cb7,140,109,31,Africa,27,1091.39
911bfb0ee9304b1ab662e5907842ea84,65,12,53,Asia,15,71.04
911ca8b72a46490bafcd952efb9d0126,263,222,41,Europe,18,2130.25
911eac5beb6c40bb8ac44c2d6f8761a0,129,76,53,Africa,20,917.15
9122bcf604654d9eae3351e6906e5310,76,42,34,North America,24,548.93
9123b5b28a464e5ebe1bc09309eeaafd,83,62,21,Africa,20,850.58
9124ec3c35e24a47a3e6ff7515339e22,365,327,38,Oceania,20,2466.3
9125e6ae3b794edebe8985992a31e77b,292,267,25,North America,23,1865.49
9129e1da6609493987363cba0810313e,151,109,42,Oceania,16,455.41
912a6cae882647d9b9176b9073e68876,363,346,17,Europe,17,2268.49
912afb52a5114b6d9d56d3926fcfb51d,314,287,27,North America,20,2180.82
912f037990c74dbaa547ec3c864818f8,288,240,48,South America,16,1953.17
9130c2b1800444c6a9b4335782e5c8f5,246,208,38,Africa,18,1239.05
91350c4b60894b9bb9f04ddd45730406,145,89,56,North America,25,743.41
91365ab88ded40f58cd5b54163eccbd9,280,229,51,Oceania,25,1661.46
913adab4a3be4f9c94fd83cdcd37a056,168,135,33,Asia,23,1255.44
913b7f3bdac54a2a8c4e81db4d517cf6,97,81,16,Oceania,20,564.64
913c28c152b549fe962726cad5826e12,106,66,40,Oceania,18,464.98
913e741a8ba6484598f70f4f69a6f33e,161,141,20,North America,24,2201.03
91499ed05f344e4499f3d95e3d2df2f0,333,307,26,South America,20,3104.39
914e4f292bbf423b91d73a88e87e556d,45,22,23,Africa,21,431.14
9150c69bd7734fe2a8ca1a071360f162,281,230,51,Europe,19,1622.32
9150e0f2430e4e91a64238e2537dcdba,193,160,33,Asia,17,1075.48
915389dbd83f4dd09e2545e423290f7c,65,14,51,Africa,15,442.29
915572de0ba44a9f82c714a4d17d38f9,304,263,41,Oceania,21,1826.92
9155d79bcd8f41c6bd6e190adf6cf954,168,144,24,North America,20,1207.29
91564471913341b8b305a37fa8a0443b,365,347,18,Europe,21,1871.4
9159c059dece49b691c4328d872b3e0b,364,359,5,North America,21,2924.35
9159db353bb94702a6c8db5cd0fd400a,167,126,41,Oceania,17,1104.2
915b18d3fe824d989a2cd3e6e596f602,308,282,26,Europe,17,3039.71
915be8f85c89483e8c25ba3e841304ea,136,95,41,North America,18,641.33
915e1bdb2f1043cc8d85ef919446e1bd,365,351,14,North America,22,2249.11
915f42174e54434d8730bd818966909d,265,248,17,Europe,16,1712.23
91609e353c8f4f55983ba3a8798af997,322,265,57,Africa,23,1530.69
916143eb463b42379a2ca6544bcf390c,159,139,20,Europe,21,1492.69
91634b5b41da4319b05d5164834fea82,362,319,43,South America,23,1716.68
9163b626608c472e8d86cac529289b6e,316,297,19,Asia,23,2096.63
9167ded0c7b245a890f4b7c0b8607f6f,243,225,18,Oceania,21,1569.68
9168c4a143304445aacfcdd1c59680ac,285,263,22,Oceania,25,1717.82
9169071fb770418fb92160e3ce88e05a,160,135,25,Africa,19,1102.57
916e08e9366f48aeb10146e63bf58f4c,145,99,46,Europe,19,584.02
916edcaac350491cb3ccc4a5c11bbbf4,88,48,40,South America,22,365.08
916f000d7d0c494eb2c8c09b8c98f74f,138,106,32,Africa,20,1183.86
916f1d63b873452cb9c65e018f4faeff,69,16,53,Europe,21,228.54
91730c20c41f4ce08c5d22733dc8a6da,109,83,26,North America,23,755.6
9173e8a85c894216b23472e6fc056a1b,266,237,29,Africa,22,1854.15
91747d4e0ff84f2b956b5b90697c4399,252,219,33,North America,25,1251.24
9177dcd7839b49079878fae93f6a98b4,358,304,54,Asia,25,1327.96
91784b6475d14b2ea094b91df6037f61,80,35,45,South America,16,462.38
917ab7f8211d490ba2cbab7e0e327049,266,233,33,South America,25,1816.44
917c0c0a6a554786a6a5d0a347af3642,312,270,42,North America,19,1278.71
917e63cd3a664c40bbad26c39809cd9d,365,331,34,Asia,22,1883.91
917ece673da14368b4546c0f4556bdca,209,159,50,Oceania,23,945.61
91801b557135440bb5b467d96caa4ef9,353,314,39,Asia,17,1975.03
91815371011a42138eccc5af547e7a51,65,19,46,Asia,17,184.53
918211779be34dc784875b9c3a3eb458,342,315,27,Europe,24,2614.58
91826797af49446686b0f057d502670c,269,228,41,Asia,21,1173.81
9184460335804d2e9b698066ac2c4af0,99,61,38,Africa,19,935.42
91864e6cc29545a3a7282a24c4de3b01,47,24,23,North America,18,317.14
91866c5138574044bde0a2f51f04ecf7,275,256,19,Africa,19,1927.87
91873633babc4b6ab8c06ca2298b5dfa,192,141,51,Asia,21,771.94
9188b0ffc22f4e958f1eb0fb82967ff0,73,35,38,South America,24,491.74
9189dedb3812470e8c0753e616dfc46c,305,252,53,North America,18,1861.45
918b9553388c4a7282c5d45c9ebddd37,362,351,11,Asia,17,1370.99
918d605c55e14c2b9620ac21bbd44941,108,54,54,Africa,18,420.99
91922b833840416696ba2b0b7f0dff9a,244,204,40,Oceania,17,1834.96
91923adb0d9e4595b252a6809363e6e9,285,248,37,Oceania,18,922.87
91932556bf7e423298e71913588bb764,156,126,30,South America,24,821.17
9195448c80474506877abf942684bd5c,365,356,9,Africa,22,1843.03
91982f91bab4414795f0495740fbc725,127,93,34,North America,21,1202.82
9198719a91764df7a9162420c66366b5,74,48,26,South America,17,599.17
91999fb9f94649ee8a1d5bc56cce5993,187,149,38,North America,18,1242.66
9199ec38ce2c43f3933785fdb926d29c,336,311,25,North America,22,2447.86
919a4c8f34bc4b01bd325e5bba42eec0,141,97,44,South America,23,1011.54
919a839ec72b40e7b7eb66f60e3dec03,251,226,25,South America,20,1724.16
919c9f183c2245e585168c15ad032411,298,257,41,Europe,19,1654.36
919db1e54d2843eeb4d1755b4f712c3f,256,224,32,Oceania,22,2255.23
919dd73afd82497b8dbc4f7f80d0d162,46,11,35,Oceania,23,329.5
91a28ae1ce004cc2a4159d1597db14a8,71,20,51,North America,18,324.91
91a2fc87012542d88e904d1f4feba78c,364,327,37,Asia,20,1762.86
91a31b84772d4b8296f82a17f6dfb0f8,269,237,32,Europe,20,1761.27
91a37298753d4ca48579061b44db04ba,348,331,17,North America,19,2657.36
91a5d94b564a4da2875f1975def6b005,104,77,27,Asia,22,482.71
91a67b8020754b4bab939efff3a00809,142,101,41,South America,19,611.95
91ab8b4aa2354112b9745de8fa35291b,156,120,36,North America,24,1014.54
91ad47edeef04fff988bbec803d87021,150,118,32,Europe,21,1117.8
91ae0bb0643041ac842ab5710a7115f7,214,188,26,North America,20,1799.75
91aeddbb897e4fe4bb89979e96e8b84e,194,142,52,Asia,19,791.53
91b01baae4c44b51aac3c8dd116764bb,336,311,25,Africa,14,3410.58
91b0340a8750422b85b8ed299b611cf5,168,132,36,Oceania,19,1060.53
91b1fa10966f434cbf386081000c9aa2,334,298,36,Europe,14,1909.67
91b2236abd4548978cee0c2689d3fc2a,158,130,28,South America,19,926.21
91b32af0327c458286815f99ede64b3e,181,163,18,Asia,20,1148.22
91b85bff966d4a779bb28488476001c6,147,117,30,Asia,26,732.26
91b9e7efe351438598837d5f4c6cd70b,242,207,35,Asia,15,1102.77
91bb3519a2da4d1db1b54d3c2ee83f03,29,10,19,Africa,19,226.05
91be6c10053141ea84ff2ac24fa10881,199,164,35,Africa,22,1277.47
91c0da4527454811ada65f8d7a884f99,65,3,62,North America,22,315.52
91c175d190d1401b9bf177e21c49bbd0,106,81,25,Asia,19,652.29
91c3cc09eb4f440b98950884ed5e4b55,156,133,23,Asia,16,943.99
91c943415f1345749b0c5b23da5a0c0f,209,161,48,South America,17,838.01
91cacfaf43fe45d29bb4634e7e7ad34c,364,343,21,Europe,19,2311.86
91cb25063ffc4877b0aef42f62d4a9b0,186,151,35,South America,20,888.4
91cc83a4221f4ecab096aff6317ce030,311,282,29,North America,23,2875.55
91d047d475974d28a7a1e9d4acecc92a,113,88,25,Asia,19,1467.02
91d0827f9b9a40e3b42abc1bb8d76a3f,133,109,24,North America,24,1135.43
91d2ff8943254853a4169f84c0b798ab,182,160,22,Oceania,23,1507.11
91d6b9ed57444612861798daebf4c798,247,201,46,Oceania,24,1903.99
91d6fab91528467c941820052f65851d,78,50,28,North America,17,665.22
91d95e40371740eb937e2a46b96276f5,309,280,29,Africa,19,2640.45
91da58a54218439d9ff6ab659b6fbc55,120,78,42,Asia,25,823.95
91da945ce6cf4764ba9dd15aa18104a3,330,295,35,Oceania,24,2222.73
91db869969ca41dc8d6d57650e7295b1,63,28,35,North America,21,471.62
91ddd2e25945457a99a46f1cba48415c,304,275,29,Europe,18,1922.97
91de247285e948e786f2c980d564a286,364,345,19,Europe,17,2803
91e0bd79c3094a6bb15c7567aa5c6f1b,305,279,26,North America,19,2683.74
91e20800872b4e59972de416f3e102fc,158,138,20,Oceania,17,1476.03
91e50ef5dc0f40e3ad636eb9d2c344db,183,142,41,Europe,23,1001.54
91e71a65c1b84b52832d26993aa0cce7,352,301,51,Asia,17,2038.63
91e7590e14724a56891ad0d9b29ca548,56,15,41,North America,20,641.66
91e7ecd84b324c1ca4e922a307a03f0e,148,133,15,South America,22,1159.97
91e921eb482e4a31b40663ec5f5745b6,142,107,35,Asia,23,868.76
91e97cd8cb034d9eb6ad80993e6f730e,83,31,52,Africa,19,583.34
91ea38d22fe9404da00bc5ca031e25a4,312,263,49,Oceania,19,1615.33
91ead80b492f49fbbb73812cd17de208,271,222,49,South America,23,1755.07
91ef7cf4d5024e00a263f20dc4702cf9,236,206,30,Europe,20,2315.57
91efb369bac4479fae53775abe0373f5,362,345,17,Asia,18,1865.21
91f0a10a506d4535add33deeb1a51cfa,275,231,44,North America,20,1424.07
91f0d52c2a1b48d1b93e9d51a8b64d72,167,122,45,Europe,16,987.69
91f1773a58464ac3b525e3d75ed5f1b1,264,213,51,Africa,20,1033.19
91f44b76472441208e86c84e0e9f9956,316,273,43,North America,16,1964.69
91f45a2e96c6454fb96f66093ab7473f,146,126,20,Europe,19,1253.99
91f5e02844934ad69dd627b87b16e7cc,281,254,27,Africa,17,2202.44
91f606edfec44a7fbd225a34302a0d1b,298,267,31,North America,22,2125.7
91f81c49c1894236b0bb0d83ce8fffbc,177,145,32,North America,20,1751.52
91f90e5703f34abc9c23428691d8d66a,120,96,24,South America,19,680.6
91f95ae192d5437fb7a6b65a59149c64,185,153,32,Europe,25,1273.97
91fcd0405af04d8aa3431b4bb07f8a9d,52,29,23,Asia,16,412.73
91fce09f1e8e488d89e52b993d4f5ecc,317,277,40,Asia,20,2327.6
91fe47a53e26416a806a73efe3c288c5,167,130,37,Asia,23,736.73
91ff2b04031e431eae421ef39ec86f24,38,10,28,North America,20,143.01
91ff425a985f4a15a6ba03408a366ada,244,219,25,Europe,19,2046.28
91fff105ac8942a4aa7420a1f5ae5c77,254,218,36,Africa,20,2603.73
920011ae008543bba279a405e5997f9b,270,223,47,North America,17,2073.64
920331e463e3449fb08b921de83c08dc,245,207,38,North America,22,1474.59
9203eeca832e4dd387b9a3e682adbf3e,218,178,40,North America,20,1583.71
9204e23d1c56495f92a122b5ba0a3e65,110,85,25,Asia,21,1060.16
9206f922de364a7db544ae1a74d2b510,50,2,48,South America,21,380.61
92080fc91e944c58b548575d7fb95a86,223,182,41,Oceania,20,1672
9208499034b545dcb2e8f7947244cede,222,185,37,Africa,21,1319.16
9208cb77922c4b58ae7d7d58b74d9684,59,22,37,Africa,23,690.68
9208f325bd1a40609c3088c414745bea,144,88,56,Africa,23,683.91
920ab1026dbc460c93baf033519a6536,72,55,17,Oceania,21,423.48
920f0a7c813d447b9782cfb5d1888578,191,158,33,Africa,19,1142.11
920f5a44b87040e0956e9fdffed9e8ce,189,172,17,Asia,20,1273.34
9210732bb6aa43089ac45069fcb74c66,142,91,51,South America,21,472.3
92136fbd3c9e4d8a9859cd5986e15718,193,149,44,North America,18,1187.11
9219ec5983264c289ee761433ac4a153,206,154,52,Asia,21,538.77
921d2d9c13834466b8931745515c5827,67,37,30,Oceania,18,423.27
921de3e7daf049a9b59cfb374caa6ff5,233,198,35,Oceania,18,1916.56
921e738b12c347e590c54dd515822615,336,318,18,North America,19,2272.02
921ee650d154445783453afd06a9c2b7,236,191,45,South America,20,1329.4
921fab5bb338442cbb11cdd4000276f0,121,77,44,Europe,18,343.62
9223f76361e34af4bdd9e3e2b2a49cfb,161,133,28,Asia,21,1295.79
9224de2c57964e5a890c859d37453e42,77,30,47,South America,19,594.06
922713cd077845c39c17399dd175dcbf,289,233,56,Europe,16,886.06
922b448de01043f0b5efa7ca1c1971c8,109,84,25,North America,21,556.22
922b7c6d85b24a139f3821e0972bf3e2,176,152,24,North America,20,781.86
922d17d2846f400ab4fda856b28daac3,270,238,32,South America,20,1440.03
922d4c148c594edcae664f2f65f67ded,259,219,40,Asia,20,1414.37
922d9e06d4504232ad7fabcd8bc131bd,324,293,31,North America,16,2238.06
922f0132e9964f2ebcbfa90976c5c2a2,36,9,27,Europe,22,145.21
9236ba53fec0406088835c05ceb04068,209,165,44,South America,20,999.65
9237d3823c8c4d20afa960b02453036f,189,138,51,South America,19,914.26
923949eaf51a451b85f85fff1d4e22c7,176,131,45,Oceania,14,818.18
923acca78bba406fbd0ba4730fd3fb0e,362,340,22,Asia,18,2081.41
923ae5b52fb642faa96c2ce4786924dc,202,172,30,Europe,23,1387.95
923c2f62ff00423386eaa866be1b2177,319,267,52,Africa,16,1206.3
923ce8733ba04f01b26e0f72e12a1b25,219,164,55,North America,19,1229.53
923d7d9589424f6bb890752132db9ff5,119,87,32,Europe,23,438.67
9240575b3d47473ea7dac5a4b8a436ef,197,181,16,Oceania,26,1444
9242c0c11d3940e981338bf1d63c2d70,164,107,57,Europe,24,1194.88
92435b9b0e8c4c6b8ed16fbfb3ba5513,188,131,57,Asia,25,1259.91
92448ca47f4249358c61ca799723502e,50,21,29,Asia,19,321.01
92471f1a87cc4052902806eb438446c2,283,254,29,South America,24,2208.93
92473e3dba484206866be81f3d56e157,114,73,41,Africa,22,1228.05
9247c4a4479e4447bfd6a8b9fe73db35,132,96,36,North America,20,1199.16
92481252e1304ed6adad858786f984a8,107,64,43,Africa,24,472.45
9248992d6af04c73a36935611da010ef,174,146,28,North America,14,1370.35
9249d6b69a6b4d59a65cdd03215b368e,365,343,22,North America,20,2396.39
924a4cfbdc7347ac9f4ca54adfcaacc6,269,232,37,Europe,21,1640.16
924bbd4baece4d59ad74cca8568666fd,57,32,25,Europe,15,510.82
924bee4939a14c28a45c3c7f4c28832a,166,117,49,Europe,17,829.84
924cbda4553c4a30a0408c73fa966812,220,172,48,Africa,19,1027.25
924d71b4fd6045d7b4f3eb030d477204,125,89,36,Asia,26,576.62
924df774a9ae4720964096defd5ca88a,128,85,43,Africa,13,860.34
924f1f86122b4d0db8546bfead5e8a11,115,77,38,Oceania,20,709.46
924f566918f4457797b37601722b06f5,278,225,53,South America,23,1639.1
92501716a2404848989d08d1c1cd87ac,212,188,24,South America,20,1337.01
9251de842e9c4ec1bdd0b36fc15c265d,227,211,16,Europe,20,1630.8
92552f30d1224a02954d26d11c078374,363,363,0,South America,22,1646.59
92573223f60d4268aeab530417c24113,183,153,30,Europe,22,1631.79
9258069c148a46619be22eb293d33491,51,15,36,Europe,18,385.99
9258b8b43be24e0fa877818f2ac78b0d,293,237,56,Europe,21,1237.96
9259c72c76254c779f911591096de99c,191,135,56,Asia,16,919.02
925c4d8b58a2471bb385e80f7e266240,264,234,30,South America,15,1606.72
9260f45c585242428911a9b8e6c9cea6,281,263,18,South America,23,2429.21
926175c8eb4f4ea6af559d34b60a4996,75,37,38,North America,19,474.64
926192e42bf348dea0f4452af8ebea72,279,242,37,Asia,22,1715.48
92619a3e969642df94b4666d14d682d6,290,240,50,Oceania,16,1193.52
9263f1d5169f4e62b52cc1e1060ffc2f,328,288,40,South America,20,1417.21
92652f5fada24aeb94a85f65da197e3f,210,188,22,Oceania,20,2078.61
9265cdb0ea8a4221b8c4b78d380054f1,208,177,31,Asia,21,1444.83
92670c55c7124856bc9c9014076334e0,270,242,28,South America,22,2004.88
9267e9bd46e44b07ae4603bfbfbc97ab,191,167,24,Europe,18,2068.08
926878a97445415abd658556e16b14a6,204,175,29,North America,19,1719.59
926bed6a7d3548f2b2475883f0d8117a,120,69,51,Asia,20,746.25
926c8ae217b748f29e8bd1c4f14610c3,364,352,12,Europe,23,2320.69
926c959dc0754076a6ae4fd284f5cfdc,364,351,13,Europe,20,2315.35
926de324bb8b4f19a33b60b8b94758c7,284,250,34,Asia,22,2267.36
926df23ea67e4c188f67b49152be4d7e,284,267,17,Oceania,19,2130.7
92732b0ccee147aba572400b48b5b697,185,155,30,Asia,19,1400.51
9274eef700694af9b1a06ff35d41ffd6,153,119,34,Europe,22,1017.01
927592b4d7fe42d0be8ba0fcdfa95113,288,235,53,Africa,18,734.38
9276128cadd64723b4462bc19982357e,346,303,43,Europe,17,2458.09
9277b7c61ae14369831c867e3e08a9ea,256,227,29,Asia,15,2105.07
927e6e3fea5349d9ba53c5c5725624c8,213,177,36,Europe,18,1337.62
927ef83214ae44e88b457685777d93f4,317,264,53,Africa,21,1391.98
927f31ca540a4eefb2d25d711bd3e2a9,165,131,34,Africa,21,1080.11
92824938ee6b4399a88d07839479be1b,147,101,46,South America,18,532.85
9283164801b347d9a548a86ca911e872,71,30,41,Asia,23,596.9
92832d46f2d5446981f21831c207e449,210,150,60,North America,21,769.32
928594eaa48046389afe3bb34a0dbb23,152,116,36,South America,22,935.15
9286336f981241048b9389837cbe6a73,227,195,32,Oceania,18,2265.48
92866c51a06c4cfe83119275b35f5ab6,364,358,6,Oceania,18,2255.13
9286ebd22fd94794a8c3d7c0c74e783c,205,183,22,Africa,14,1544.73
928ade8eaabf43b8ae13a8c9448f8c9d,345,297,48,Europe,21,2015.25
928af170dd0f4cb3bfc15d0d9a00f000,49,7,42,South America,21,265.13
928c210f497e453f8cbe797bc5192ac3,278,234,44,Asia,19,1428.66
928d79deb11d421eaca4ce7f2c188951,52,3,49,North America,14,337.7
928e4f5a39414fd7bb238b57461a2cef,79,47,32,Africa,20,812.12
928efc75051844448f4ec09144d908a8,192,160,32,North America,17,929.38
928ffb36778e46088f374eea7ac2170c,365,356,9,Asia,17,2120.09
9291c1634951403bb88b5710715a2dbc,182,158,24,Asia,18,1037.8
9293b1c1cf784e39b5f7edbf8d5b2635,253,203,50,Asia,18,898.63
9296a9d314324622a9a7849ea43e5f38,325,285,40,Asia,17,2589.2
9296cf849ef74bdaa85bf01d3129e19a,62,11,51,South America,24,372.73
92987a4729f744589117c259d0b89bdd,49,14,35,Africa,17,206.91
9298d64cecd24224b8c52a55265703d8,90,55,35,North America,21,741.69
9299ecf2f1684466beee71176073c657,337,308,29,Europe,24,2343.4
929b499bf0d9483f830321f83441d430,92,62,30,Europe,24,475.71
929c28168bd34c7f86ef7ca3c308e0e2,218,178,40,South America,18,1399.08
929dd4c7e9794eed933f6ecc96d025d3,258,223,35,Oceania,25,1601.24
92a1d38226da4a959acd1c761605c2e3,156,112,44,Asia,19,797.86
92a2523ba85049dd8131b65b554315f5,184,162,22,Oceania,13,1194.42
92a25e04fae04e608d14dbc22093eb78,329,294,35,Africa,18,2861.91
92a326a3bbd84f8fa49e8d57c422c69d,126,73,53,South America,27,652.38
92a3a727707b47e6bc977fb1ad46ac03,24,3,21,South America,15,180.39
92a5f4fbacbf467c9f9d511ff3aa5c6f,317,279,38,South America,21,2032.12
92a5f924223e44eb9557c886940c5f43,363,343,20,South America,18,2285.28
92a69e3dd1cd4422b9ec7bea313e6b62,47,12,35,Oceania,26,441.17
92a6dce383454326abfffd3cc9a0f524,191,160,31,Europe,27,1289.27
92ad6265298548338f390780e0814031,89,31,58,Europe,18,61.52
92ad86f176514102b09c14715dba5cce,233,187,46,Europe,21,1185.96
92b11e30f2524a3689752d75336e4071,364,347,17,North America,23,2751.89
92b348f2af304bf48399ac38dc17df8b,42,6,36,Europe,20,319.25
92b382357e834f09839cc5e5183257b6,360,325,35,Oceania,17,2275.74
92b6a3e58a0b4161a7295f8dd6deb38f,365,354,11,North America,15,1822.49
92b736c1cf0143898888ae66217bdd1f,266,222,44,North America,22,1331.28
92b86b2ddd074e909b2c9a520c0bc009,191,153,38,South America,25,1198.96
92bb87165d0447fba1c512638cddcf47,360,298,62,South America,17,1955.88
92bc8f754d724c98bbb6303909acc51b,314,268,46,Oceania,19,1730.44
92bdde40021d4470a9eb09247003a4f4,365,351,14,Asia,21,2152.05
92be494dbe0a4badb4baa22226315578,79,40,39,Oceania,21,394.13
92bfb30f5d624c56bc343cf258a35b6e,243,207,36,Oceania,18,1545.82
92bfddca0a0242a89cf95aefb99a0709,156,139,17,South America,21,1248.43
92c0991612a4476d96330c4ef78c57fa,193,152,41,North America,24,1444.18
92c1ed6ee98b43eca23cbe3a60ccceba,39,2,37,South America,17,331.44
92c82be51dbb49be87bdb3eb86b5d57d,138,98,40,South America,18,1399.29
92c8efbc9bdb4e7494728a7d05921114,65,23,42,South America,22,241.54
92c8f56cbd724521ab186bc6f905df7d,242,216,26,South America,12,1704.91
92ca96cfc18749adb576977008355d44,318,266,52,Europe,20,1387.85
92cf2e85df8d4b4cb0b7e53aca7b8c05,258,230,28,North America,18,2067.33
92cf78cfb90442c0926cf7d34ce067a5,334,301,33,Africa,20,1754.57
92cfb5ce8a2244e288a4e5f1ee221cb9,67,9,58,Oceania,22,181.17
92d02ea9e4594fd78988740d94b3a299,94,69,25,Europe,20,690.99
92d0d803aae549d8be7fa5bda2dc38db,364,364,0,Oceania,24,2448.34
92d16b68b8dd4b6298d05c24e39cfe37,162,122,40,Africa,18,950.73
92d1cdcb7c814686b5e7b532ff8e3bc3,258,237,21,Oceania,15,2453.61
92d59b9e6f6c4fb5b156c9835f9b0f02,338,307,31,North America,22,2611.7
92d689a5b0bf46d2a2355337ff0bbe12,326,271,55,North America,20,1647.46
92d98f6cacdb46399c98fb56abe3de7e,141,96,45,Europe,23,787.75
92dbb2fe9e3641fcb894d6e022656d6d,97,48,49,Africa,21,367.36
92dbd6620e1b47a288a2b497d57c2e96,303,252,51,Africa,21,1580.54
92dc084f417a4c19ac6b5093032a27c8,197,163,34,Asia,18,1187.13
92dd687731c24672a7ff50fdfea547b7,265,213,52,South America,24,1239.57
92df55b5feab41c99604c1d063921aab,365,364,1,Africa,12,2199.85
92e0a14a938449c38c0b70d3b194461b,207,187,20,Oceania,25,1643.58
92e20564d60f4053b3e5187a84f36b48,184,158,26,Africa,18,1429.79
92e27c87fa72494ea94b817eaec98da6,62,35,27,South America,27,486.31
92e391da10d441d9ba3443f97a198061,255,216,39,North America,21,1454.82
92e3dfebce1245559512a811b94dc3fb,242,197,45,Asia,16,934.29
92e62e234f2048b3a854711f096d14e0,283,252,31,Europe,20,2184.7
92e6e529e96743edbe6fcdac418b7d4f,261,238,23,Africa,18,2232.98
92eb1bf7feb047609e09ccceecc9e810,118,91,27,Oceania,20,804.16
92eb6448f2e9484f846e1944e923c6c3,363,339,24,North America,20,2444.08
92ec03131c92439b8a442ad78d7100d2,306,268,38,Europe,20,1886.07
92ec4eb3dab34cb1b9b515a6fffbf826,327,298,29,Asia,25,2749.43
92ecf4ce5fe04e6bb651535978affc53,364,332,32,North America,24,2614.06
92ecf7a1107c41539e2eb08e5a887a94,216,165,51,Africa,21,1489.38
92f0addf5868449b87eacad94aa597d7,365,324,41,Asia,22,1018.13
92f367d2c0474479af600f1a915e3d0c,183,131,52,Oceania,19,1006.14
92f3fa431be1473a8cadfef4e28a9d69,73,35,38,South America,21,434.6
92f4cc8556154bcdb266efb14fb8473b,85,59,26,Africa,18,1003.01
92f546a488ad4e789b6cf9493c78982a,282,243,39,Europe,16,1872.62
92f86c7550b24382b530779c0eb7f25b,242,199,43,South America,21,1828.09
92fa3c8a056d407a9c91da8f6f438c49,221,180,41,Asia,21,919.92
92fa4df0791c48d68c647dffec6e4674,59,31,28,Europe,19,486.78
92fab2f1b922482f966db7a1185b2409,234,197,37,South America,19,1425.89
92fae270047b4bbe9b1ed67b55878766,188,135,53,Africa,24,819.72
92fe19ecfe774772b49594d7fadcadd3,362,323,39,South America,18,2161.54
92ff12f30df64310a0bcef97276c9794,355,322,33,South America,21,2229.35
93015e0b078944028e59b5883af5a652,270,235,35,Africa,20,1821.29
93017fbfb384481b96aa3e22485dc19b,87,32,55,Europe,22,305.48
93023c9cf3234911b1fc88ec481c69dc,131,82,49,Africa,21,1098.56
9303563f124d4944ba78ecb8070b36a0,221,177,44,Europe,26,1562.34
9303a40d3a8645efa12f521e5f47dd38,41,10,31,North America,23,477.04
9303bbe7aac74fbcb3d762538bc39f85,166,117,49,South America,25,1172.95
93044216b0294c7397d8ef5c2c3f7ef1,77,25,52,North America,16,276.32
9304de2ae68e40f49bbec65916cf8e79,126,107,19,Africa,22,764.26
9305776e3deb4f73ac444617a56af7ec,363,354,9,Asia,22,3107.62
93057ddc0c8b4670a4214a9d3e627fe4,88,55,33,South America,23,516.18
9306367f62b145fa9c8c81a12b1f4f2d,365,327,38,South America,21,2033.06
93076b17340745be9759cb9cb6e13614,329,300,29,South America,28,2959.74
930a2b39fcc64fc395a2a210a2d7e399,172,117,55,Asia,18,759.27
930a71b0b9974b24984581783e46c8d4,132,88,44,Asia,20,705.59
930cc5d4d859413c987e8f11fc2f22c4,203,164,39,Asia,19,840.51
930dfc0bb6524fdfb2506a6ee616de0a,41,4,37,Europe,19,303.66
930f2e189a4a4db7b7c1ef5c51b0516f,151,119,32,Oceania,19,1150.88
93108da5105243da8943374c60e23fda,364,344,20,Europe,17,2712.23
9312834e9bf34bc4ac5da8f96dd79441,78,58,20,North America,21,796.5
93164a62627e45d5bb887c6d742251b1,174,143,31,Oceania,25,1396.13
931796712efc47a8b74218389ec76b02,365,332,33,South America,21,2373.15
931f974e4db24b44b7e997126a71ee52,207,151,56,Africa,22,1201.46
9322e5eb9b9a4d8f86fe829a66905804,222,183,39,South America,23,1757.07
9326e81b7d1f4339bfd57cc3646c7b4a,364,330,34,Asia,20,2762.82
9327efeb69254446a77b2390e2522bc2,360,325,35,Oceania,19,1828.61
932ca08ec22c4f2c8ff11543771a0d54,55,6,49,South America,20,216.96
932f0653ef53482e8282a302da4bbd75,363,334,29,North America,19,2191.95
932fb406b2ed41c0b5cf648bb17bcc42,199,167,32,Africa,20,1053.62
9331dcf1c8f24b93a3eafd9f9d772c10,260,225,35,Africa,26,1535.2
93328c2ffa8c4504ad7cfc97ab0c6e1e,273,246,27,Africa,17,2344.38
93329d6bad2348fbb1072795ba023bf4,130,106,24,Asia,24,756.06
933450aa0a704c2098500036384c56b3,78,49,29,North America,20,440.99
9336439b50634f91bc2bd94961a7f875,115,81,34,South America,24,888.5
9336925b978b40b98d2dc174735f778d,99,81,18,Africa,23,1041.2
9336eae689f24f38a0088d3c85610774,244,216,28,Europe,20,2185.98
933ecbf73a7c41689e1b8a45ca4224ae,229,180,49,Oceania,23,1273.71
933fe16093274acdab367892cadb1812,261,237,24,Asia,22,2173.4
93401978e31349c9875d88d88ffac8fd,278,234,44,Europe,22,1920.69
93403a2951b942f98d8793b91a66a6cf,225,185,40,Asia,20,737.79
934057b1eff14391b6b01ba1e96ed4b6,73,35,38,Asia,20,980.6
9340fef7e2ad4cf89333079df8afc069,357,312,45,South America,18,2772.16
93425a55089d4e718f629437ef571ec3,250,217,33,Europe,16,2098.74
9342dd2ff9444759b345f52814c1208f,41,8,33,Europe,19,153.28
934326f57edb4ccb9fabcae554b84f02,345,319,26,Europe,15,2699.62
934553463a8a4369917fa533c1ba1762,215,166,49,Africa,18,768.88
93463fccee404160b6b44a2ae373131f,344,305,39,Africa,21,2283.63
934708caac9844378a48930e0d07b4d0,207,162,45,Oceania,22,1430
934c1b3924d44dc29e7c5391351673c8,176,146,30,North America,19,1564.86
934d2c7550be4b779b3c0a0cb4589053,364,357,7,Africa,16,2924.59
934e1010bb3e43768003450e97d8e74c,282,236,46,South America,19,1774.68
93543bf2b8dc49528874b63594bbb392,199,177,22,Africa,20,1347.68
93558be12708419fa732f6ecb30769b1,161,126,35,Africa,18,967.88
9355a4ba257f48d0b51762b23641164d,112,60,52,Africa,23,580.19
9357472c6a8d49559f97f03a63f6c4cf,212,185,27,Africa,22,1983.83
9358d96fcbca4f7eae75d3f14e1bdd20,234,182,52,Africa,22,1081.48
9359d52623954108aa950f628fb6e4aa,236,214,22,Europe,24,1432.5
9359d5ed13b04cd98dad7378286e8a96,364,330,34,Oceania,14,1577.97
935a050d754846bc9ef5374f8e41a858,117,76,41,Africa,18,856.37
935a582cf77f489499655ffda81cd77e,241,193,48,Africa,20,1517.98
935bd75d78754c44a7cc425b49a73e5e,304,268,36,Oceania,19,1875.36
935d7da7271c46cd82e6c4f205e680ac,65,39,26,Europe,19,529.83
935f0894033e4d208ffee1bbcbe53d4e,73,51,22,Asia,19,611.87
9360a6e606ed42ee8df0a43c05a1bade,364,343,21,South America,18,1933.77
936112541db04bd0b1cce17fd269f395,351,304,47,North America,20,1912.18
93612e0c1e234c1c913b8b03f754abbe,79,31,48,Europe,17,365.02
9361785a0bfc41e4a11587bb48b69ff7,218,169,49,Oceania,18,901.86
9363172388ec4e7198909dac9c1758af,184,147,37,Europe,16,880.29
936554949f924356b0378c093423b460,163,146,17,North America,17,1189.87
9365b1416f5b400ca8c668baf2dbbc3c,74,38,36,Europe,21,635.84
9366d6ea382145fd963edf76bf024ae5,302,278,24,North America,23,2864.37
9367397b886c455c9b0029621887d321,365,359,6,Oceania,24,2628.31
9369a4ab4f56496e8a10d6cc7ef48b81,159,134,25,Europe,21,1175.65
936a2503db0d4bd3bdd16e9b287a0feb,138,96,42,Oceania,19,584.59
936ebf69c2b6484293a9be203d2f40cc,325,289,36,South America,19,2051.23
936f1bdd7dd1442790f1f39d42570e7f,207,165,42,Africa,17,1271.37
9371a8c07be1489388993197c0bd22ef,168,145,23,North America,20,1664.61
93763b67501e423c9fb64e4402cfcc6a,110,97,13,Europe,25,1119.3
93768e5dc420425ebf60394c2d71e9e5,171,136,35,Oceania,16,1563.83
937798b8ed0140c7a8f5bde1b9164633,162,117,45,Oceania,23,1469.36
93793bd21c0d44198fcb9f67ba4a6144,87,32,55,Oceania,20,452.14
937c1fa4a72a43bbbe99f9029a8612af,243,220,23,South America,21,2045.77
937cca78e6a94766a2103bc6f0749ed2,202,143,59,Oceania,26,705.11
93805bf0e23641bcbd2833c1026cdbc6,276,231,45,Asia,16,1463.84
9381858d2244480ea2934005fb58e956,287,261,26,Asia,25,1434.13
9381de2db7ff44f488a3ff619c66566c,113,80,33,South America,14,446.68
9382cd6e5f1a4119b735a60d150e5885,190,150,40,North America,19,1256.66
9382e43a8bbc4895863380d6642d6e42,129,82,47,Oceania,20,479.98
9384e4f635bd492fbd9a3c669d669ed3,238,204,34,North America,21,1961.87
9386d700a4e248b5abaece3bc767e9d0,185,141,44,South America,20,666.7
938b4ee3051644218933f84ca629612e,310,277,33,Europe,23,2003.61
938b9319d8c74eeab8a2533d13988daf,293,271,22,Africa,17,2636.9
938c5b097f7c4a73af38e8c3565a5c86,334,310,24,Africa,19,2256.88
939195aa5ec04b71bd08085ad2bb3779,192,156,36,South America,19,867.56
9391fbc7844e409da75168ab766f5c2e,190,129,61,Africa,14,516.6
93923173f6204139a9af5e3230b889ef,195,153,42,Africa,14,1056.23
93958888b40e4f8cbe42353c4cfe4a73,251,218,33,Oceania,16,1687.14
93962c61d8b84f9fbc47c18f894c26df,253,203,50,Asia,20,1470.22
93979318aace40a3b906549b6b52e765,165,138,27,South America,20,1323.35
9398c563095e49baace5af778f6895a6,310,280,30,Africa,25,2325.9
939a2b222cd141b29799f29fd96bd7e3,59,22,37,South America,17,173.73
939ac2f4c3cd45e1addd3023e889dbd4,242,209,33,Africa,12,2659.67
939b1f9078b7440da4c23edfb11291d6,360,326,34,Oceania,22,2446.93
939c8dde965d4e638f85dab58ab897e2,302,260,42,Europe,25,1261.95
939f9e80b1b140a8b006dadb77379081,300,252,48,Europe,25,1004.65
939fc9dc12a94ef7a7eeaad2701572b5,174,143,31,Europe,23,1499.45
939fdd27e3a24462806d8ddcbbf89aa8,99,73,26,Oceania,23,612.09
93a22ef0e14d44f89513f56845553372,273,226,47,Oceania,19,1938.19
93a57ce6c6fc407a9ea91f98f19dc8e2,261,215,46,Asia,22,1474.69
93a64f257b154e89a481fde6081611a7,34,11,23,Asia,18,451.08
93a7249c57344697b0ea52085381307c,101,56,45,North America,20,655.8
93a7bc04d3d04c268d7dd636dd3d623a,121,86,35,Africa,22,1151.67
93aa685f29e6404282fe95e1caf416d2,251,216,35,Asia,24,1095.49
93aa68c0b81746899e2ed1506819d0c0,174,148,26,Oceania,20,1514.81
93aad3c260a64b618bdb2be317bc39c7,284,252,32,South America,19,2277.74
93ab84bc496648debc6b3ce500bb7f6e,253,218,35,Africa,22,1531.43
93ad3919415b49aa92453d49fd0dd19c,310,255,55,South America,21,1739.9
93af29ca593c493ea0fe91d2c316568d,58,6,52,Europe,18,266.68
93b00c90c4484f72a6678a0898180277,43,12,31,North America,14,177.98
93b5b334f326471981505325027a8b4b,54,17,37,North America,18,489.53
93b6a02cd56143509cb8ce3c5f781d23,134,86,48,South America,21,429.78
93b75f1521214e139ccd697bfbdf3fd2,114,77,37,Africa,24,570.67
93b83f3faf104a3abdcfb7787f3927c1,233,178,55,Europe,18,1295.2
93b89291d58b46bfafff02e460c2cad9,39,15,24,Africa,17,442.16
93bb91c67f35411c90253c7f9d5a47d0,274,246,28,Europe,20,1970.62
93bbd52dad2b4f0b8645c97e3bd7be5b,57,11,46,Europe,23,365.52
93bd2c37a23543ceb58695e2686a3fe8,292,252,40,North America,18,2091.72
93bd5987d935428ba759a5d08d4e4e2e,206,167,39,Europe,25,1727.11
93be29dbadb6469282a9150befbbfffe,229,197,32,South America,18,2033.5
93be5afaaeed4ad38df58efa159e019d,247,209,38,Oceania,21,1457.34
93c2cacdfbb540698c2ae8e28de96e39,188,136,52,Africa,21,792.44
93c326cc0c774bdbbb7b56ffb1da27ea,232,187,45,Europe,15,1621.4
93c78f44b185458f8812c27840761cce,277,257,20,Asia,20,1978.76
93c7fe2d375d4706a9c14bc6df371558,364,332,32,South America,19,2189.85
93c8332fcb05427e95f53c712bef9477,141,86,55,Europe,24,859.79
93c90de1ffa4463fbbe94465d21b18b8,196,150,46,North America,18,566.14
93cc78e02b4f42a28989b475eb31e105,174,128,46,Asia,19,770.58
93d31ff73f2344feb1b3e6b029e493aa,203,173,30,Asia,23,905.72
93d4874ad2c74847910c08155e9cdae4,78,43,35,Europe,24,283.55
93d48a6b50b645edac6c9fccbe7f91aa,143,114,29,South America,19,1232.79
93d5d97764a24afe82cda2395f89cbf3,174,144,30,Africa,21,1935.98
93d6266c301c4fdeab0250dd7e8bf4d7,192,155,37,South America,22,954.86
93d6a148b1ea4462ab59bfdad4829844,347,296,51,Europe,18,2249.83
93db01eaa1f045d685c178b251f4d2a4,304,247,57,Europe,21,1481.78
93dc5743ac5a4938a3d06a6351674cd0,283,241,42,Europe,21,1456.82
93dcec2bcb0e4ecdb6561a1ff408b3cc,40,24,16,Africa,15,232.02
93de016b19ac4432bc5532ab58d29d68,326,298,28,Europe,18,3105.01
93e29d78517b445e94fa68c7b47e17b6,95,70,25,Oceania,22,465.64
93e4134884494a348bd626ea159e4b98,245,208,37,Europe,22,1839.9
93e5c24335554143a620377a0a808924,101,74,27,North America,17,1020.59
93e600017b4047f5b9fd880f5c9b956d,364,336,28,Europe,15,2139.43
93e824635bcd44cea6f693149ff2e622,108,53,55,South America,17,663.77
93e85b7ebf6f42ec8217983faf2be163,200,151,49,North America,19,902.84
93e912004f004b8683494da6b069dfa4,68,14,54,Oceania,22,210.14
93eaa869313a4647a6e740adc017f666,365,356,9,Asia,19,1521.44
93eaffc41ccf4e3a8f20caa1d41d4423,359,344,15,South America,18,2787.97
93eb264c26364be48cc8a3c96bd879fd,209,153,56,Africa,22,935.72
93ecfa0b13f84707b16dc74a5a2842ca,194,160,34,Africa,23,912.96
93f101f915d0403bb7c9de16caf70546,299,268,31,Europe,19,2264.3
93f355fdf36c4ec7b989966c4eed0bc7,249,208,41,Asia,20,820.74
93f399aebfd04b42bc2254307a4fc209,103,58,45,South America,20,686.74
93f52fde1e8246678459b7b166f8229d,291,270,21,Africa,23,2550.98
93f7761da4c84dd5b1bc465601d7c351,293,268,25,Oceania,22,1966.42
93f8d4f96c8746c4927e1a1871b329bd,352,333,19,South America,20,2151.93
93fa2883cc534ec1aa89eaa76c9583c5,183,148,35,South America,18,1466.4
93fdffdd43854022b469c5c6105e213d,347,300,47,South America,17,1671.61
93ff3d3590b74df98ddb19e01dc7c019,113,67,46,Africa,20,868.24
93ff63b4aba047719cb7c4e3905898c4,269,236,33,Oceania,21,1407.36
94056a9b617a4ab3a3ad806bab41d809,306,277,29,South America,22,2371.43
9409663388dd44228bf408dc596a273d,289,256,33,Asia,23,2096.4
940969386c2e4d379276304585bae337,133,99,34,Oceania,23,858.53
940c798662064106bf8a8a590f2730aa,303,257,46,Oceania,22,2493
940d8bc0115546c4830ed9ca2e605790,243,188,55,Europe,12,1549.37
940e6452225342ba872842fe5f2725e2,365,345,20,Asia,20,3031.53
940e83fa95124c3cbd06ed659045256d,365,360,5,Africa,23,2810.82
940eaabd222c4d1f9fd4df4ac242c81e,144,122,22,South America,16,1074.59
940f4b044bef4bc6b10636d2932a2079,365,357,8,Asia,21,2889.97
940fc9b3f0634cbcbcdeb4a13d9d860a,259,231,28,Africa,21,1589.4
94101cdcf6354b6ea5859023daa5bbbc,308,280,28,Asia,21,2615.67
9413f5a85c2e4465809dc7ef1672b1c4,364,356,8,Europe,18,2337.6
94170304a2ca4cf38e9d96cf337310b5,107,81,26,Oceania,18,1123.23
9418d3769eab47e0b531ea51533347ad,358,337,21,Oceania,18,2830.59
9419bc7c7787401c84fbca5da1fc37a0,335,316,19,North America,21,2895.81
941a9336304c4fe1838086f5bee5302d,325,293,32,Europe,17,3372.81
941b580beb274a63832e207239e38598,365,363,2,South America,18,2781.23
941d19d91d244ef3988479e6e27b685c,81,47,34,Asia,22,506.47
9420704402de47b5b4607dcb9fa77add,350,317,33,Africa,23,2375.06
94211af57d0742b19882a14c16c64410,335,291,44,Oceania,18,3163.76
9421b2a43206411ebc91e7713d49ab05,50,26,24,Europe,21,273.56
9422550513794386a933455adacaae99,365,336,29,Europe,17,1133.8
9424052730af4067b91d6093eb96941d,280,259,21,Oceania,25,1953.05
9426a1b591c54887ae9569cfd84f5a1d,319,293,26,Europe,16,1744.58
94274f126ccb4d46ab7ccea3154a4ca4,295,273,22,North America,16,1191.06
942812bb6f9747549d967f37a440f5a6,138,113,25,Africa,19,1219.9
94291e6f3b084b4ebfad5e6050f4c1f0,93,63,30,Oceania,23,488.25
942dadb1db494f8ea43a55213b2da0ed,277,247,30,Europe,20,1948.81
942f0684bdfe42169f0f1cb43703b71c,350,291,59,South America,20,1827.44
9430b3a3c98c470e9e4bfc7b4ebe4c94,365,326,39,Europe,20,2103.29
943193a4f8084f09b12e2fef9f5c674e,146,113,33,North America,15,973.5
94330d0ad9bf4ae7b555b6affba68db4,362,340,22,North America,17,2874.95
9434bcba5e4a481294879c5e38173251,365,357,8,Europe,17,1783.56
94362f36bfd845ed871ecc03a1a6c2bf,249,221,28,Oceania,19,1853.21
9437fb8d1cc94e2ca788e35435ad2ef9,104,79,25,Europe,20,560.19
943845da77e94647bbb626a7dddc0980,68,26,42,Asia,21,527.5
9438f1377e7d48fd991ca3b13acc82b8,41,9,32,Asia,21,331.42
943965b6bec5456580824293dd5a691f,62,18,44,Europe,20,314.06
9439aa39e54f49e3bc1d2f3a378a884d,247,195,52,South America,24,1095.5
9439e3fc44e24d34b9d7480e6276fb86,312,260,52,Asia,20,1764.59
943a99fd990f4359a98fda9239368d99,99,54,45,Africa,19,930.14
943bb60f22ef4675a0b78bfa76cb38be,333,297,36,North America,22,2302.53
943c191d039d46dda2421618294450b3,365,335,30,North America,20,2162.31
943e36ef55a34e69812c82db7889a265,309,273,36,Asia,17,1904.17
943eb99ce2894c44ba1cdfe1f91c4b8c,123,89,34,Africa,17,904.97
944012399f734908bb1884ff5842ec77,113,69,44,South America,26,750.75
9441d4fa705a402cb216aae3d4024f58,164,117,47,North America,18,661.15
9441f8641200468f9ba79a2758398ee8,201,154,47,Europe,24,289.28
944203a74a4d414181fcc3da415057c3,130,89,41,Europe,16,418.02
94456940b8dd43a4a803698a28c01bdb,354,316,38,North America,21,2231.99
944656fdf4b24df394f029dd896ccd48,290,232,58,Europe,19,1653.61
94490c350379469382dc4ec0f49cebc3,331,306,25,Oceania,21,2253.03
944a4bd2f43749f3b8b8decb4bda672d,111,74,37,North America,19,390.62
944bdbd96ed84d618c7d41c5323fcbd5,121,96,25,North America,23,1146.06
944e1478c29a4923bb15e0ab1904f3be,107,60,47,Asia,15,402.74
945092131f2149ea9798058946a4b42f,192,170,22,South America,19,1512.92
94565bb2cd5e46739df041ca63b78cd4,299,268,31,Asia,22,2475.23
94565c33c6f04035bd9bb95ed1e1ead4,222,194,28,Asia,22,1452.93
9456e75ef3ef40579edf2a3687d262c0,143,115,28,North America,19,935.21
9459578b3d4c4887acf53fe8a21a206c,285,257,28,North America,20,1871.33
945b21331d6444fbb7f6e50f40ae7c7a,214,184,30,Europe,19,1592.46
945ba6d4bd4f4c74b5ada7567913ed3c,279,237,42,North America,22,884.07
945e71551d784555a4816ace4ddc689e,221,181,40,Asia,28,1187.98
945f3d169011442ca2892ac04bb161e2,82,65,17,Asia,20,984.15
94604245c48843e28ac8efb854759988,147,130,17,Oceania,15,1057.02
94606a8ee0584c3fb999ffbf84b512d8,361,338,23,Oceania,16,1579.58
9460cfe7741e4ae0ac0db45a20e68fc3,362,355,7,Asia,19,2272.88
946167d6e72a43ff962ee72ebd330f6f,351,316,35,Europe,16,2568.48
9464965654d444f1a1b535dfb6a54604,275,226,49,North America,16,1630.11
9464cd7652474847b9371e4ba2a6f776,363,341,22,North America,16,2013.84
946503a5d24844abb8bfe24b43c96b33,224,205,19,Oceania,16,979
94655832cf604b46ae0f1a62b8e5b83b,93,58,35,Europe,19,372.78
94655dfdf2a34cbe886ed0f816af2594,97,50,47,South America,21,504.46
94665f6843104373b11cd6baeef36a9a,365,346,19,Africa,23,1857.08
94671e79e82f41fbbf6deb7e7f3fd2a3,84,61,23,Asia,24,553.07
9467faa1f71041c7b88c323d7f5ffc93,155,127,28,Africa,22,1391.65
946c1cb8f01a48f18feb8c88e1528d6d,202,169,33,Asia,19,1714.53
946cce225ec2445da067bb5b3a2b828a,176,145,31,Africa,18,1274.2
946d981e29eb4ea4813c13563a70bab4,142,122,20,Europe,20,1079.52
946e81df32374beabe4903e018d18099,112,82,30,South America,26,954
946fc5999d3147f9b9057ee80d535144,295,264,31,Africa,18,1842.2
94714b25cdda430887c20d8f025df7c7,72,48,24,South America,19,543.94
9471eefe34b9432dbf1a85c473e887e4,81,42,39,Africa,21,406.57
9471f06bde4d412fb253de570917b95d,203,161,42,South America,21,1290.2
947383028d7442fea387f426e0e5ac8a,138,99,39,Oceania,20,962.43
9474d00a7d6349d085876c0a9b773d28,237,182,55,North America,16,1356.06
9476c5c5b6ad4ad791d7c6c15fc3ece7,177,144,33,North America,21,768.09
9477c776995349239a11f92b7edbbe67,58,20,38,North America,23,401.92
9477e486f5cd4d149ffdbf8371371c9f,297,268,29,Oceania,20,2864.05
94791371cfaf470b85d4f3e29195e1f8,102,59,43,South America,15,473.16
9479212d815c4b2eae0facbf664bb0b8,198,157,41,Oceania,18,1445.04
947a6363dea94966a514903bd1400e28,293,260,33,Oceania,20,2580.28
947d7bb947ac4f8aa96b6b9858923165,339,300,39,Asia,18,1747.6
947f41581aee41b3a49c6abec4f89c33,308,285,23,Asia,15,1922.52
947fefb8bf664cfca5c032068725d796,365,348,17,Europe,19,2072.97
9482cf92a03b4787b4536eaf06b3e1fa,248,215,33,South America,23,1582.74
94848d9e75f448e98d332298774481e4,240,199,41,North America,25,1791.16
94858a64495144da8717e9c5afb7e347,106,78,28,South America,26,462.41
948605b839d74e278f70b7f592032a5d,102,73,29,Asia,21,587.88
94863a0e10bb4bb7832ec04223d417ac,115,75,40,South America,18,1076.76
948795b159f442948e4b62ee3434d9a7,315,278,37,Asia,22,1543.78
9488089838b3433aae97ae24cbb702c9,40,3,37,Oceania,18,289.44
94881d861d6f43da82d8e5cec6fb0392,119,80,39,North America,18,1101.61
9488b929f3214f57bad5f8dbdb407911,38,20,18,Oceania,18,195.26
948be6609d7b4a138326d69c1a6ccb14,72,50,22,North America,22,353.04
948d000b994e40a5848b971545e94196,252,216,36,Asia,25,1660.96
948efde55a75448c8583a6bc41398c88,252,214,38,Oceania,21,1425.37
948fd5af16ca4be0b58abe31673c3fc9,364,355,9,South America,23,2255.87
948fec331fea4a17909a0d1dd136fa71,237,211,26,Europe,9,1986.52
94905724d8844dadbfdc1fcae8426aa4,120,86,34,Asia,20,632.99
9491f1b4a6324069b57ebc9f9ea473e5,169,124,45,Oceania,20,974.71
94932af886a24ce7afaad867bf4e2481,253,222,31,South America,19,1544.57
9493cd1d78b6465b82c33f37243b8db5,49,8,41,North America,14,355.02
9495fecd358c432ebb35dc21cf634b2f,68,31,37,Africa,22,201.44
94961f2c36ac4ddcbe8cbc44278acb96,159,131,28,North America,19,656.14
9496adc5d5644bfb90c644537c885530,357,312,45,Europe,21,2546.73
94997840c24e4a44836ed384c5e49cea,66,47,19,North America,19,498.09
949b0801800b4a17862c4d72e3de0e0e,314,275,39,Africa,17,1514.48
949b6a3ef8e6454b900c9cc645310ef0,64,45,19,South America,24,321.15
949f0c5580444a5d801bd37acbe5b262,254,206,48,South America,24,2017.76
949f5f698cd440dfbc98807b5340501f,111,56,55,North America,19,572.05
94a05d6f296c41ccaf5287204ac0b5b2,361,349,12,Africa,19,2070.73
94a1996ea2014ba9a77b59a38d8eaf3e,362,313,49,Oceania,22,1677.05
94a202a52801447e8a8142c452e3b099,320,301,19,Asia,24,1967.09
94a268bbd8c6448e9f4bf9b0733cfb3f,156,125,31,Asia,28,1374.45
94a5249fa6cd477e8956175ef2bb1726,273,251,22,Europe,28,1958.17
94a669b5c8e24680b69f22293ac0f083,228,183,45,Africa,23,1360.65
94a9083673664db0b8d205b17fce3739,293,267,26,Asia,19,2258.91
94abdb868e884221b6e62508870e9585,46,13,33,Africa,22,492.37
94ae14fdcaf547698d41c2d6b1245962,33,7,26,Africa,26,204.1
94aeb63416e6493d8cb46b4515778882,131,101,30,Africa,22,1498.22
94af03bd9ae84335b05031c422502b34,365,332,33,Asia,20,2709.8
94b03445938e4a61b95f7875ae426773,95,45,50,Asia,17,620.73
94b1660694384e42abbba49140066399,274,247,27,Africa,15,2050.55
94b249e3c60b49f78d35b98531830dfb,237,182,55,North America,23,1800.9
94b3aa21fd4d4222a16aabf200519450,365,349,16,Oceania,15,1881.83
94b4e963008b4c99aff6adf733127de4,237,222,15,Europe,19,1670.31
94b54a88c584497d8309f20cb5911d29,347,301,46,North America,20,1192.69
94b59a322cd240f193d66e87d209e0b8,365,343,22,Europe,24,2209.94
94b69c2550e64b8da1785688f722d660,227,198,29,North America,21,2094.15
94bb803dd64d40cfa310051667023498,362,337,25,Asia,23,2170.2
94bcaa6685564c8384c3370986a5a07f,158,131,27,Africa,21,818.76
94bce1c5eb9240979ad769588803137e,107,73,34,Oceania,19,538.48
94bd39f70117418b9e884458ede2eb93,365,358,7,North America,28,2340.74
94bf4ff7d9e54e7fb8649f5e01217a32,365,345,20,Africa,26,2271.31
94bfac42edbb47a99deb2ae60c2e72a0,357,323,34,Oceania,21,2923.18
94bfb35067ee48efa1b740ca511c006b,203,165,38,North America,20,1364.02
94c6446eb01c45229712f950601b3fa2,322,290,32,Asia,17,2205.65
94c66b2551824b5b91140ea3d5fb0b60,217,177,40,North America,27,1029.69
94c79678a61b44d8a3a5daf6f2da3815,232,192,40,Asia,16,1688.98
94c90145b7614c16b498e15525db84c7,303,265,38,Africa,21,2156.07
94c902307556430d8235d05660594359,266,221,45,North America,25,2219.39
94c9a4616fe149dcafdb9fa06ddc2c8d,88,62,26,North America,22,563.3
94ca03b64bbb40ab973171b6aaa2424b,79,40,39,Africa,20,660.13
94ca5e3fe3794d799d2a571e7cc9292e,201,158,43,North America,17,1177.32
94cdfb6d89b04582b93ddea66c75d2b2,242,182,60,Africa,17,567.81
94cf9512fbe2489ca807e2efccc60cc0,184,145,39,Europe,20,1050.21
94d00117dc664234b2aef8d6debaf51c,158,133,25,Asia,22,1497.66
94d0282509754127b05f15401304f83b,167,113,54,Oceania,19,475.42
94d094cf661d407da385f86c835a9251,223,196,27,Asia,18,1922.01
94d0d8559f1541d0beff4cbbe26a488f,135,101,34,Europe,22,583.08
94d1e65a79ed4234a4d5d63796ced0d3,279,245,34,Africa,17,2134.36
94d21b16ce3b473bb7fbedc61791626b,363,328,35,Oceania,21,1564.9
94d3276c07b34e2a89f85703d4f235a6,280,226,54,South America,18,2135.03
94d49fb9f8cb47acb8d171dbd82f1fc9,145,113,32,North America,24,1148.48
94d525b1f14541f48728f036f3d48cc3,140,101,39,Europe,21,1085.27
94d7310602f7436da6ba0457b25dc697,149,123,26,South America,23,1736.43
94d7678eff80409482278e363d30728d,158,112,46,North America,21,749.55
94d7e613c2b34665a87ff16eb8dd1c88,123,102,21,Europe,22,968.26
94d7f72c54184048bbd683e11613cc66,236,199,37,Africa,20,1294.18
94db9466ba064e91bb4c22922f3109e7,190,170,20,South America,19,1327.35
94dc8623c65f4e3f8b5f0f7246791993,212,176,36,North America,19,1356.93
94dce7a0bd2a4d919a8196bdadbaf03f,203,149,54,South America,22,960.34
94dfb82d6b2f4ef69b756e6ee7f4796d,349,293,56,North America,20,1734.06
94e1340474df4a1f801b3efb0d97056d,231,201,30,North America,20,2016.59
94e14d04a3a6469eac0f8beb17e1fe54,214,186,28,Africa,20,1638.44
94e435bd255645c9afa0a8216716e6d1,241,209,32,Africa,16,1423.85
94e5ea59f43b45e6be3e65a70629aed3,364,332,32,Oceania,15,2447.02
94ea9cc4868146668b507ae07686d4be,196,149,47,North America,24,686.08
94eaf7dae51648ea8777698815c4452b,91,37,54,Africa,20,691.08
94eb39fe45a14a8caa7c72e3c6f2e9ae,301,259,42,Asia,26,1661.97
94ee0318219a41f8bf1c7f59675c8639,242,224,18,South America,21,2092.39
94ee3d2cc65047888e2d4cba976eed22,253,226,27,Asia,22,1775.4
94f3d10f0dac4224a34149aa8c7050bd,293,258,35,North America,20,2050.1
94f68d89f7044d53913810917693b2a3,318,263,55,Europe,22,1764.56
94f731a5bcd649bb9057a8a46e4eff0f,364,328,36,Oceania,20,1596.12
94fbae1dbf4a4c07a9106083407de6b2,359,332,27,Europe,20,3321.55
94fbb3b66d024ab69dff4a9ae6c5c3e4,256,224,32,Asia,23,1982.06
94ff29ade5e64364a13a09e6be2ac023,215,195,20,Africa,16,1758.85
950229193120490fa58f597eb75e1c05,67,47,20,Asia,24,636.4
9503f624018d445095568acfcdab9a5f,104,64,40,Asia,19,808.1
95059867b89c4dc9ae72eeff833f5014,216,193,23,Europe,25,1238.06
9508f55106d84355a4d917025a971be0,164,141,23,North America,25,1251.85
950bf486e1cc46b6b7bc8feff63fcbb5,34,6,28,Asia,17,195.89
950c044d33454576a37011ed4869105b,197,161,36,North America,20,1326.98
9510b717ebe5407eb6de21b6014e2e0e,200,183,17,South America,22,1635.2
9512f7453778475b8edbcbeafb3f142e,273,224,49,Oceania,22,1072.69
95134940aa724c7badedfd814287aedf,363,355,8,Oceania,19,2212.38
95145db42c484ac19e0d28ea5bad1f07,211,183,28,Asia,19,1892.41
9515da529b58421587d0eaf20294b07a,359,337,22,Oceania,17,2809.27
951790a3c2364b658384c55ced476c06,362,311,51,Europe,19,1799.57
951923d226bf4547a3f2eadddbeb0993,161,108,53,North America,23,990.3
951bef48b73249148c783349e2accbae,59,11,48,Africa,23,250.09
951c9fee4b764872944b21172b2b6a7a,365,345,20,Europe,23,2313.75
951d96a4b3b9432d88fe6a0a27450b2e,297,261,36,Oceania,23,2181.16
951f4a6d08584bbd87c51ccecc1a56c0,346,315,31,North America,18,2693.79
951f9367083c4f929d68485a0d69f73b,166,129,37,Oceania,16,1300.31
95200acf96874c4c81e9e99e6f36aad3,343,304,39,North America,12,2134.18
9520932d8417496c8b605d3b4fa4e9a2,289,270,19,Asia,13,2016.18
95219eab45b94a28be9fb37acc9d8fda,245,223,22,North America,20,2055.01
9521f4acf6034af6abcd0d61b7dbe8d1,363,349,14,Oceania,21,2392.02
952438a851aa46ffb235d715841c91a9,254,201,53,South America,24,1071.41
9524db98ba33432592ec0205e6c418d8,267,235,32,Oceania,14,2604.4
9527ed312634498aa6303d55ac971e9e,305,256,49,Africa,19,1503.28
952b973da2c14b9480f7cf2c6332cee4,365,331,34,Asia,22,2568.52
952f7349b4ac4a059f23b60923e6ef14,277,241,36,North America,26,1848.59
952f7e0e48ae4e3d8cb6d5d8bd22feb7,276,252,24,Asia,18,1863.25
95324cab3e2f4ac3aae6ac4c4924e75d,209,176,33,South America,20,1601.02
9532812615c14e62b923ff84a6a448c6,108,59,49,Asia,18,555.34
9532e52122a84d77a56c0875fc75358c,286,237,49,Asia,20,1379.57
953701cd04d348b7a3208b3d13b36077,298,279,19,Oceania,21,2504.51
9538497633dc482492dad76e2219325b,122,88,34,Africa,23,702.53
953961094e4f47ceb52e1784866ecd13,170,139,31,Asia,25,1440.17
953ac042cdf14633ae415efb23e926c3,237,199,38,Asia,18,1783.27
953c1577ce3045e1a48d47a19ca275e2,272,222,50,North America,19,1577.63
953c210686884eecaa0bf1aeee711a7d,304,279,25,Africa,20,2893.33
953d784e6747474ebca574f23273e8e4,320,272,48,Asia,20,1336.71
9540b63a6c97499e9fe0d498d904d2b1,202,151,51,Europe,26,795.03
9541715d8e77496294d8237c7a0e28f5,97,56,41,Africa,14,716.77
9541b14a1d2d4f46a8b68f89c78662eb,114,84,30,Asia,24,1150.44
9542eb83f0e748bc9838ddcc2fda44f7,226,182,44,North America,17,1441.43
9544dfbe79934c59af5856980fa87db2,294,249,45,Oceania,20,1740.13
95476f8f364a43d4831254e46a62795f,352,303,49,South America,23,1348.15
95482553fcd54bd9bf9c2ae03b31620b,221,203,18,Europe,16,2123.32
9548d5eabe004070aec381de72afb24a,310,277,33,Europe,16,2212.3
954cfd922c30437a873cfe15c8d32626,175,119,56,Europe,17,682.86
954e668b0161437f9b323efe51412bc9,314,290,24,Asia,21,2544.4
9550aa1281ad4783a9c3eec61cd6e36b,324,298,26,Asia,18,1969.12
95525f941a3e46fda7cc11e97ce30605,249,206,43,South America,26,1255.55
9553f3620c864588bb636db04ea5f83e,365,349,16,North America,18,2860.34
95548ca31b9e450c8075c0f20aad7b02,40,7,33,Africa,18,41.5
95551c756cd847c092a6d3a1ea54c466,323,281,42,Africa,23,1443.62
9555b3da5b1c49a4bb904786c616f800,49,27,22,Europe,13,476.33
95565eb282cf4551a0a9b065637a02fc,84,65,19,Asia,17,477.19
955bc9e28235428eb773c7b75ba21146,135,73,62,South America,21,538.98
955f39f5c1db4988bc139f5600b8261b,91,53,38,Africa,17,714.31
9564d88bada94be98b7ec8a8c592e111,249,228,21,Oceania,12,1738.75
9568bacd6e3341e398d1386362b95cc5,93,71,22,Asia,19,695.54
956a71fe410a4e99a7fb78186df64bfa,182,141,41,South America,21,840.27
956b1b2ffa704597b4d459a1adf9a384,236,202,34,Africa,23,1568.52
956bdd0089e44d06b489e28201cc67b1,75,20,55,Oceania,19,409.07
956cacad9c3c4d64ba1cf798e6a6b339,107,77,30,South America,17,1100.64
956da83ef2cd44698f9937d7070b6f1d,229,176,53,Oceania,23,1119.93
956ee0e7001546718ec0920383ba1e52,48,19,29,South America,20,530.95
95701777e2c649f9bc0d09c8a16750ca,59,17,42,Oceania,22,310.65
95707ce4d96546a6b6ada829166455ea,97,58,39,South America,18,313.28
957141a4daf54b539ffc3737b701a570,42,23,19,Oceania,26,55.64
95726f1df003452b8a833e94337a4598,66,6,60,Europe,21,422.17
95732759850f41c2a891eaac2a1c2c78,150,111,39,Oceania,18,587.6
9575526c7dcb4f76a6a37734e4c9a5ed,194,150,44,South America,21,727.92
95759d28a30744bd8fadbdacf6b4935d,365,344,21,Europe,20,3149.43
9576dc1e6b5243d5877da634e643cd9c,149,98,51,Oceania,18,579.77
9577af3c59a64bff85601a2abb307075,289,260,29,North America,17,1537.64
9577d97913d348f3a487ec2b298b13f2,194,149,45,Asia,24,1175.17
957a219b73014d24b27616ee5022d65a,201,185,16,North America,17,1228.29
957b131004594d409c3a590dc8b08d24,340,298,42,Oceania,21,2630.86
957c3db8079e4094bfa22239f6b1d6f0,263,234,29,Oceania,13,1986.36
957c751f3dea43c1890446b8e071d481,364,350,14,North America,26,3207.56
957c7ba82e084d388b741bb84f286f30,351,312,39,North America,22,2360.97
957d21f3b33a480a8c0abdaa15811b40,362,353,9,North America,19,1459.54
957ede95b2d44116a91449c174a492ad,178,155,23,North America,19,1643.01
95808c5e64e84a819c2b9162d63058aa,116,59,57,Asia,19,426.91
9585607a24b942deab12a4a924ea0aa8,159,117,42,Asia,20,1001.31
95894262a5b0430e8cdac3bface2c8b0,334,289,45,Africa,24,1957.07
958bd5531abf479089afff71dcb253ba,365,312,53,Europe,16,1670.64
958c6477ed7a4dafabce012403e92b66,49,6,43,South America,24,272.75
958ee63d097c42d28b850e141abc2907,342,284,58,North America,16,1596.98
95948df5bb884334934f19d1f48c71dc,365,358,7,North America,26,2863.24
9594f1e752544b73a1f909c8d995644f,78,59,19,North America,21,612.16
9595f302bdac4f11bcb682f02f1a03ee,165,133,32,Oceania,19,708.51
9595f6d17a9b4f7095c12b20d6076c76,344,312,32,Asia,14,2571.93
959ada3d1c624fd589c134ef1d3170b3,93,41,52,Africa,25,462.97
959c761362f64ce38ffe24e0be7419b7,141,118,23,Oceania,25,1005.4
959e23cee9804e1c93b51875b10f9fd3,364,318,46,South America,21,1855.6
95a13c324bbe4fd1bf58e04cc02ee3fb,93,44,49,Oceania,20,456.44
95a5150b5991482ea70b42f03ba467e3,243,220,23,North America,21,1876.85
95a60c3ce29247f38c2ea43ac86c724c,296,260,36,Asia,24,1854.96
95a73c3be637479d8704b8109d34604e,209,171,38,Africa,21,1688.19
95a8ec90004948c8b77d496d787c2746,356,315,41,Asia,18,1667.83
95a97562bd7f46d4b9e97c6cbfbd7300,206,155,51,Europe,18,702.4
95aacd88ad4b4d31a8f74425f5d76172,357,322,35,Europe,18,2153.32
95abfe8bd3e74d7690e08a46efdf1cb7,124,96,28,Asia,20,917.98
95ac06b80f1c49e684b8a7f6e0ebcb1e,362,340,22,Oceania,18,2182.27
95ac3b979b434b5ea161aee0fb497508,328,301,27,Africa,17,2604.22
95aea6cd11f943eea40cafab1cee5d26,63,22,41,Oceania,19,419.11
95af804742934b7390d98946bffcaa3f,113,85,28,South America,15,1229.11
95af9109067444f0ba8b609b5c5bbb03,317,302,15,Oceania,21,2085.52
95b097d25bcd4b5fb66bed9fdc0cb106,248,209,39,Africa,24,2166.87
95b77e5b195a44129571377376cc605d,66,8,58,Oceania,22,719.36
95b83bef44ba4a9eb1b492a95efef16d,308,269,39,Africa,24,1915.77
95b94cda922a45a8bd510e3d4f35888e,50,25,25,Asia,19,376.98
95b981ed1b894af9bbb88c4c8854468c,365,345,20,Asia,19,2657.55
95ba9024486e4e5a93fff3ec6fa7670c,192,153,39,South America,23,1412.58
95bb2a95d33d42e28602e373c68e0fc1,154,116,38,Oceania,23,671.47
95bcdd3260cd4de1a6de9f0a0abb976e,201,149,52,Europe,18,714.75
95be14778a3842c0bdb2bf897d6ec3ce,355,307,48,Oceania,18,2758.88
95bf630f0a744b4cb659b3ebe76dac52,303,280,23,Europe,25,2207.94
95bf7a6f0a984ea4812263142dde916f,207,183,24,South America,13,1201.65
95c469433a7f424dadad06f4eef93a6e,98,78,20,Asia,19,654.43
95c74523a7da4ec3ad66da4506825250,363,316,47,Asia,20,2036.47
95c93e06d9f742749ebbab3c2d4fbc3a,365,355,10,Asia,21,2659.92
95cb4168e5424155afd62367a6c17778,357,336,21,Oceania,17,2361.38
95cc4058a3fd440681f2671425ebbb2a,365,328,37,South America,18,1259.37
95cd3581e75c45e59e83169b1d927318,145,115,30,South America,20,1027.67
95cd97d04fe44979b94ba5fb987c8885,122,76,46,Oceania,22,976.13
95ce2226694b4c81a9d3b9ded2323423,153,97,56,Oceania,17,553.84
95cf9f26334c48cf94830e9bc241da59,351,335,16,South America,21,2664.47
95d05ebf24ce4a0b86fc0cdff3d9d631,365,348,17,Africa,22,2279.28
95d097181ec044b9abc40970533f4eba,359,340,19,Asia,19,2584.1
95d1a13d75d44c1e8731417de380c043,358,307,51,Africa,18,2368.08
95d1c19143984bfd8a0b9e999cfcc997,77,49,28,North America,20,792.62
95d1e84c936c44ec96d2b1f6a7b03524,68,29,39,Africa,20,278.27
95d240044509420a81602659d7cc3245,42,16,26,North America,17,298.55
95d525e3b88b47f88378137cd9ac7b7c,142,105,37,South America,26,624.2
95d529953f2341ebad0503d5b0233917,275,222,53,Europe,18,1690.39
95d5ab8e6a9e4142b5e22a6990dcd99d,150,111,39,Oceania,18,742.13
95db1cfbe2124a46aa9a2a3530d8b12f,140,93,47,North America,27,472.98
95de6d503ddf4a2e9942ea118efd95d0,361,346,15,South America,23,2250.9
95dfd44b08424b02a03627ee72897a40,261,233,28,South America,20,2455.01
95e79cb25278408e87e59db94ea51713,57,4,53,North America,27,209.68
95e9506d976a4efba18830e4e73f50bd,344,311,33,Asia,16,1810.57
95e955bf9e63465bb52199550ac603c5,365,355,10,South America,25,3148.92
95ec1022eb5b4e7099d540e2b1a4cd77,362,327,35,South America,16,2429.85
95ef6299ed3244c1b084e68c764135f8,300,257,43,Oceania,20,2633.81
95f1709a3c364ed0a68fd283560ed1d4,340,308,32,Oceania,23,2309.55
95f1c2ab4eb74caf96a8b4c5db56bcd1,60,34,26,South America,20,87.17
95f295a3b3a147c6a461b1a18dc4b878,271,232,39,Oceania,22,1142.57
95f2c23e2f6a4df394f5ac1f097d38fb,232,191,41,South America,19,1314.74
95f3abcd7ed242328b3345be59584916,191,161,30,Oceania,17,1092.12
95f6b9e8f9274c488a168c620c19b736,250,218,32,Europe,21,1361.97
95fa8add48e34117b90368a5799264ea,65,11,54,South America,22,195.56
95fc51cfb65c464c8a26d6447d8c1147,132,81,51,North America,19,753.26
95fc64337b654958b0d098f2dd67a2ad,365,326,39,Africa,23,2271.17
95fd8c6c9a28437bbd788caaa5f788d7,103,81,22,South America,27,853.07
95fe1c6e6bc2441c86c63f370dd9b116,278,241,37,North America,22,1694.94
96007a2f18f5458cb7463f1d1d69b40f,274,252,22,South America,31,2410.02
96048cdcde6e47d4b11ba3311c6258b8,365,321,44,Europe,18,1595.13
96057efa946746468a00ec90d22df3ee,275,253,22,Oceania,22,1649.44
9605a87f242644fd9e70a212c01b7359,303,260,43,Asia,23,1963.09
9605c784cdf641a2bf6243497aaae532,313,261,52,Oceania,22,1645.93
9606ace228ae4376b874995d96df84f8,232,200,32,North America,20,2170.88
96070985876f449b8de0c8ec5ad95247,268,242,26,North America,20,1652.44
96079c0933564262bcfd510acd38d4ef,354,324,30,North America,23,2881.93
9607e050ad2442c0bd42a9e1c3f8284b,119,93,26,Oceania,22,923.57
96089e5428114af8883d5bbe6f9fb34b,205,179,26,Africa,23,1777.37
960cf5638ffb468691143419f2735d76,365,355,10,North America,16,2212.47
960db3c584c241b29a34f843e5e7febc,117,74,43,North America,23,652.2
960e1f57fdf649b7b34ed11308dbf3d7,253,204,49,Oceania,18,1332.52
960e827396ec44c3b7a6da4f1808d276,206,169,37,Europe,19,1360.76
960e89f9bb2a4de28aa852e9656f82f2,98,55,43,Asia,17,686.81
960f1dbadece4695884bd345e048fa04,309,281,28,Oceania,21,2172.28
960f7d2cbe3c4950b77ce9ef2f606573,278,226,52,Oceania,22,1324.54
9610616b495e4609bc46cb9424b8f252,356,310,46,Africa,18,1967.22
96130492f7044e9b81912a0d8a8f73ff,365,357,8,North America,20,2972.23
961428bd823b41c2abd15ef9a890c3fe,23,3,20,South America,24,268.62
961520f598874772968b1adee8771eee,233,206,27,Africa,19,1702.56
9615eb37de134b6fb36b04c61b857446,321,278,43,South America,16,1537.59
9616b360fad64f7e92f61b8befe00414,105,71,34,North America,16,588.71
96172a2a837b4844982cdd456ed79f4c,141,101,40,North America,23,534.66
9617a27fec534490820d4519fc0322cc,147,114,33,Africa,23,999.27
9618b7f07018429692c7f2121bf5eb9e,339,291,48,Europe,17,1679.61
961a508ebd464fffb9bc0aa05cd1a40e,365,326,39,South America,21,2299.24
961b3d7afaea4f8aae71c63d9a65c249,128,97,31,Africa,17,787.95
961bde5fd7ce4f3c8412f3a93dc3a253,98,48,50,Asia,22,655.84
961c115d3e504ca38c268deb4edda3cb,358,326,32,Europe,16,3263.83
96216dc0027e4edd834f18c6e1fcad73,362,323,39,South America,20,2632.82
96226f054fd34f0d9f72979192659c78,364,316,48,Asia,19,1652.42
9623a12cfad744cc94f0f07d15275836,365,349,16,Asia,22,2824.59
9624dd15bc6147578e45e0ff46da0ec9,347,307,40,North America,22,2488.72
9624ff58546a48cd802c5a91112f519b,88,54,34,Africa,21,1261.15
9628b2f03b78402a8020cfc2a3e07676,76,30,46,Europe,18,170.98
962977cdfe084bd2bf4f613950bdb446,188,164,24,Asia,21,990.31
96297c9bc55047e291adbcb3642a4c8c,136,119,17,South America,17,669.37
9629974d6d334ff3b37c414759120c77,92,57,35,Europe,24,706.47
962b337ce11644d6a66d53fa4eba4662,261,223,38,Africa,19,1198.03
962ba2ca1d734122ad83eec3089db24f,203,157,46,South America,20,796.85
962c819fc50f4bd2ba2a80edc3f53e28,215,185,30,Africa,19,1423.07
963003aa60a54b8f8fea99c30d350b76,295,241,54,Africa,19,1723.83
96310ee4af914424bbea252474bb342a,205,170,35,South America,24,1103.13
96317834e2074dc8af5208cca52741b4,311,289,22,Asia,23,2187.74
9632856b8c0e4d65812cb2fe62605a00,262,242,20,North America,20,1783.24
9633a324d54c49978d4e60d611ba3df9,172,117,55,North America,19,672.71
96354f5221f64e56b16aa43e877adac6,198,150,48,North America,15,1005.91
9635767f0b314fe5a9daa178dfcded0e,298,244,54,Africa,23,1843.66
9636a79419084735af9ec0aa4b6e8d56,305,279,26,Africa,21,2665.07
9636cfc491b94e5cb323a629c174c210,50,26,24,Oceania,20,381.62
963959f36d97429b998d04b221bb718f,98,58,40,Asia,18,530.48
963a32698aba4bbbab331681fed03d2d,365,361,4,North America,20,2612.02
963a866b3d1d444f902418e259f3dfbb,188,165,23,Europe,17,1795.72
963bc4e25c7448d78d16898de9774bc3,53,17,36,North America,22,156.46
963fe15584b14b82bd1e606fed93e0d8,90,51,39,North America,21,705.89
9640ab22e9d94338a5cbd61dc531a552,273,230,43,Europe,14,1769.65
96416d246e3444349c9dd42211eca675,131,107,24,South America,25,938.06
964283b6aec8408192b429a28b648925,203,153,50,Oceania,16,1044.99
964369854654411f9b44aef7bea4c0c3,278,240,38,Europe,19,2213.68
9645886234834f9a88bcee3d3e96e6e7,365,349,16,Africa,19,2046.44
9646af052a3d4c319e0163143f4f60eb,65,27,38,Asia,15,346.69
9646bf8635114140ab669b4d26b75a21,231,195,36,Europe,26,1603.39
964a9f4911d54ec083f800a500fab71c,365,337,28,Asia,24,1707.69
964ada095b1a4b13bb96ffe22718f80d,361,323,38,Europe,17,2186.89
964b0d683d004dfea23384ae96692584,87,51,36,North America,22,566.98
964c66e3748c4a29a8e18e2da0fcc9c1,59,16,43,North America,24,446.5
964c738a64a34fe8868ae2a9abb15b3b,78,51,27,North America,18,309.56
964c9985700f4c4fa6bcafb407672c02,187,138,49,North America,22,545.97
964cec0a47c847cfa14e524918fa6376,74,49,25,Europe,21,451.92
964d99a441c340e7a70977357b3a0e3a,225,167,58,North America,20,888.5
964e6e5471534689a912023015fd1c86,80,45,35,Africa,21,652.02
964f4718abf647a2b68129ee10923f5a,286,233,53,South America,23,1266.02
9653143635594120956cb67c6ec30e92,212,157,55,South America,20,1385.43
965502d7ff6143c98b128c2fbbe1ae75,328,289,39,Europe,16,2320.59
96572117c55f40de8a3f94adc2a8f93f,254,215,39,Asia,13,2118.02
965883bb46ec4bd9b07f295ab1cb9c54,131,100,31,Africa,23,1254.85
965911d6246c44ee993f27f7cf136a49,329,302,27,North America,18,2409.85
96594b5e3ce542c09abf8a64a2875829,349,316,33,Europe,21,1745.5
965a98fd99d5484ea48e32c094735d4c,71,34,37,North America,21,783.22
965eaa8c822e457789e9af670a77487e,109,79,30,Europe,23,714.38
965f535ae5a04ac5b78a2d022a9dffe5,232,207,25,North America,19,1913.35
9661dda0241443ac91b9f658aaa860ac,342,317,25,North America,18,2166.49
96623b3d6fa74c6abd9c9c09f0a3f026,226,184,42,Africa,19,1462.61
9663359cd5ab4299925855dfe76fd16a,111,73,38,Asia,18,870.17
9663ef8a88034c078f742a1a29b6de94,198,171,27,Europe,14,1480.95
966437d7c4324841930c9bfc18fb1ba5,110,80,30,Asia,18,635.41
9667f6c4c65644928af25fc5bd7c4cf5,63,36,27,Europe,23,470.52
96682fd4166b4ca4ab9cbd0994960bc9,147,125,22,Asia,22,1696.93
966b9cb1df4d4006bc68c89243ccaea3,329,285,44,North America,26,2314.58
966d533a82c24e85b4740f5809f2507b,205,185,20,Africa,21,1813.2
966ef7de01b941cab2f43bf10a387734,175,131,44,North America,23,784.67
96731772c06145ecb2cefdf25871508a,365,342,23,Oceania,20,2187.44
96779b7a399f4b9bb7ec2797ba771456,46,2,44,South America,21,44.16
967c3a95216c4ee2b035ba8c3a01ca6c,364,336,28,South America,23,1669.52
968100a8dcb240d8ae837bdaca8e44c9,97,73,24,Africa,15,694.79
9681294188f54669ad50d3918943d612,143,125,18,Asia,18,654.31
96812a8fde4b4f5fa3ffec9c6e671ada,120,102,18,Asia,21,821.62
968286cf64534f8a8f424c914d34fa37,252,212,40,Oceania,19,1606.59
9683411d77a14ae69ab28404627348cf,316,287,29,Africa,19,2201.76
96835481647f477cbd36646fde7be8a9,361,348,13,Africa,21,2606.77
96840e8fff3d461a8e5441bfb1efa4a9,345,300,45,Europe,23,2605.4
968581970dc9400b9dc17a38a05a8ef3,75,48,27,Africa,23,779.92
968667afc0cd4d76af1f4145052bd5cc,191,144,47,North America,16,983.99
968736dc8a73402b8d87bc28c5f1203c,199,160,39,Oceania,15,1906.57
9687bf134a04443fb935492ca4df1fde,185,137,48,Oceania,19,1014.11
96887edcad4e4083b9acac299271ff6e,188,160,28,Asia,20,1256.46
9688f18c95df472c8021acfb38e9866b,267,214,53,Asia,20,1273.24
9689a23b7a574b2888d299ec694aee0a,265,218,47,Oceania,19,1471.43
968b1627d9bf472a859192efc8ce8d21,365,365,0,North America,22,2334.38
968f9e205f21480fa310cf3e52ba1c22,363,348,15,North America,16,1408.17
96909eb503f24901b1fa55926afbe427,166,125,41,Asia,19,1177.33
9692fe3393ba40d0a9bc5b54e59f5bd1,262,238,24,North America,18,3162.4
96947becae8a46b99dac149fdaeaec13,362,355,7,Europe,12,1114.42
96948a1d65a7400ca4e132e6858c3bf4,150,129,21,Europe,23,965.66
9694b8fedcd2402086634e2b2e6b2f21,46,6,40,Europe,24,216.73
96950b5dad0d49f0856e08b6790561c6,157,129,28,South America,19,922.32
96955d6a48614f099d1e19d46202aa2d,305,263,42,Africa,18,2562.22
9697795669244f9ba14ffc75bbb2ec87,242,207,35,South America,15,1597.72
969908f11270474abc2d23ae01353ba3,332,279,53,North America,22,1306.87
969e0e78352f48deb055e321fc13f575,53,37,16,Africa,20,450.44
969e66d1df5e4bcb9291f0b3ca91bd85,39,6,33,Asia,19,301.93
969f92ce9b294a3294451110f210e356,354,332,22,Oceania,19,3196.64
96a0210489fe44b9bf2e4b28417a3805,53,1,52,Africa,22,298.46
96a234a2bea8449ea08021dde6a99b2c,365,364,1,South America,19,1701.12
96a41cc1bff74878b1bb6fb203e7e6e5,107,71,36,Asia,17,761.36
96a4e038af3f4495a4ae38bbff5afb22,66,20,46,Europe,16,319.57
96a5781e5c4d4ddba57b3b05f8b0f65c,87,40,47,South America,21,249.62
96a76f1dd5924a37908ae6bd73dbd395,292,250,42,Europe,18,1972.48
96a84131efcd48f3801d392eb6290f36,238,193,45,Africa,16,1950
96a8d87b621c411dad16dd5a60f61c89,278,238,40,Asia,19,1265.58
96a9bee3d2bd4659a54c7b36fbccff19,140,107,33,Asia,19,953.13
96aa635760e94314a224249a85e914c7,65,29,36,North America,25,602.58
96abd01ae71c40d0aa531f01a26b99b9,64,36,28,South America,18,453.6
96ac6af2f06c4602828601a492e37e5d,224,168,56,Africa,22,923.25
96ae9b8d719e431fbc3db3da8995e992,271,218,53,North America,23,920.9
96affe03fe4c45af8076f91eec7994ec,90,52,38,Europe,17,718.34
96b284fad4c841ac837e78b23af71cf9,211,155,56,South America,21,833.99
96b5f605ea204beeada74b33ab4bb9b4,295,258,37,South America,23,2371.78
96b71d0f4e934c738351e8bc3955b1a2,201,174,27,North America,21,1567.24
96b7850b10374f61974ad5cff04c390b,362,341,21,Oceania,19,2707.3
96bb71fbb1964a91b788889d4fc624f1,180,129,51,Oceania,18,1585.31
96bc3841816c4a99996e2fa98e75b51d,151,124,27,Oceania,17,1294.3
96bc5200920a402887343d643520c244,301,253,48,Africa,23,1549.8
96bc534c6e884fc8a92c4cd1f09bce43,291,247,44,Asia,23,1114.17
96bc836316e343789e04258426e977e5,355,338,17,South America,14,2927.64
96bd5923afea406195d4f9604e3928f0,318,262,56,Asia,18,1125.66
96bdc27fb5fb416eb5a72206788c9555,361,312,49,Asia,18,1550.08
96bf19ed82b941eebb3c9072f744a4b4,170,128,42,Asia,19,1168.09
96c172c63ec9467da28e292a0e288aaf,211,153,58,North America,18,1059.72
96c5b70f611047bb839feca8521df3d8,144,117,27,Europe,19,1077.8
96c5c6715e9f44d2874f64ac7786e037,129,81,48,South America,23,792.81
96c633040c1e48659d830f200a59f8db,219,168,51,Africa,20,870.34
96c8dd9dccfe4e3aa6f5ea54b7ea39ac,269,237,32,Oceania,17,1482.54
96cae1ea76ab40eba6d926b52761d5ac,178,150,28,South America,21,1154.03
96d0be2d8b1b497699b60b71f4491897,81,44,37,Europe,23,716.81
96d362cc31ad45d8a6a9e6d1bb323617,114,74,40,Africa,18,690.89
96d3f3e2fc3147f4b5d5b05a68e489f0,47,15,32,Oceania,21,316.01
96d51c435ce34ac591e3c15b9af10094,261,225,36,North America,23,1316.89
96d606b8e57d4eba99460bd55f09f817,225,187,38,Africa,19,2445.64
96d846ed4f454736aa64f7cf1a7aff27,345,290,55,Oceania,19,1765.79
96d9853228ee428da4048eae20b80737,206,184,22,Oceania,21,1511.55
96da4ba2125f4dcb9496313f619276d9,115,88,27,Africa,16,800.26
96dbd60795784323b2e84bc9c7577fcc,243,197,46,Europe,15,746.89
96dcb81bba1d4042b1405ad21371ae30,58,39,19,South America,24,535.62
96ddf5f482b747958e3666659dcad16d,104,88,16,North America,23,711.88
96dea86795f74b51a0d2bea6b075352e,89,56,33,Europe,20,715.15
96dfa0253488462cbe0259de481fc3a8,196,165,31,Asia,17,1820.39
96e136ac8ced45c0a736e3f0322e5302,34,20,14,Asia,26,360.67
96e4df2f79f14b28a35bed2635f509a9,246,199,47,South America,20,1320.61
96e63b6c269b48c68f0db102632ff1ab,140,111,29,Europe,21,968
96e63d0e2d0649b8970bfc7774a9c1e1,104,84,20,North America,17,888.1
96e94e1c18aa4f27ae8d1885778a06a8,277,226,51,Europe,21,909.17
96e97d6394a747fa8156e2a54764af44,290,270,20,Oceania,18,2524.33
96ea7031dea743f6b2cd3f0dbf5beae5,262,227,35,North America,15,1770.52
96ebe3d4a5784cb9884667bc2423cff1,259,201,58,Europe,18,1394.29
96ec0250ca704d93b9943739f97d99d0,322,288,34,Asia,16,2224.61
96ed664ba9cf48c3bff72108b14111c1,365,322,43,South America,20,2426.25
96ee0d558e2b4ebd855d5480face67d2,87,60,27,North America,21,610.53
96ee8b1f46a44c8e843cff2dc9f55382,357,337,20,Asia,18,2476.46
96f7dc36a72f42519078f5aace9320b1,358,304,54,South America,19,1486.6
96f9e7406c0241738e66fc790a6b84b5,26,5,21,Oceania,21,150.64
96fc89d3ea414f63a8ad8154577614e5,149,115,34,Africa,21,476.87
96fce131b5e542deb5bf332a151b478f,184,136,48,Asia,21,952.67
96fe4c04d1654def85da1e109a011d0f,244,208,36,North America,18,1491.81
970087d9d3de4ea5a8b93a4b93e9d27e,31,7,24,North America,23,145.13
9702dc4e24824f708989d1e10d851a8e,363,356,7,Asia,15,1651.25
9702f24aa795449282b68926ee68c58b,278,261,17,Asia,25,2003.73
970406bc984341b98062034dbc0d1cd8,157,139,18,Oceania,17,801.02
9704555ce1004657b506994378a9ea05,284,259,25,Oceania,23,2308.6
9705a17b8dbe4884a997e57a93cc9e41,126,88,38,Europe,22,1154.25
9705cfeb1f154c7ea84dcc94a8ee9c12,186,139,47,Europe,19,1133.37
9706c9726ad14b99ba2f34881e20ac3d,148,115,33,Africa,22,588.45
9707365629ff407a8ef4d35a73cd2d18,215,194,21,Africa,18,1558.46
9707b4f3af4b479ea96902e138941914,133,96,37,Europe,22,1081.9
97082ff770a5419db5b2e03a428ce6f2,360,323,37,North America,21,1332.81
97087e8fd5fb4998b00b08b1d8325bdc,292,262,30,North America,26,1689.89
9709ef06bfa2463780c158620e06f168,61,4,57,Oceania,19,202.18
970a395cb563470185c50fcb9e56b2e4,311,286,25,Asia,19,3157.53
970f81a1cc1745fdb4a9911f4405053c,305,271,34,Asia,15,1649.1
971219f39da94639ac85e0f42c197b9b,343,315,28,Oceania,18,2624.76
9715fae9b3f54290a8953d00990a549e,87,49,38,North America,18,825.34
97179323da104b68af4a9319dcacc122,79,52,27,Africa,21,454.4
9718bdb20be74d889a95c102c09b113c,365,337,28,Oceania,21,1934.86
971936f0bbf14695bbd0d976ae9b47d9,232,196,36,North America,22,1517.12
971991fb24e84c13a3fa9909ed66566e,353,315,38,Europe,22,2696.55
971a265ddbee469ba40bd36fa56848d1,99,68,31,South America,18,398.45
971af5c7b1634fa8bca56d15d0fe1cb8,52,22,30,Europe,22,580.66
971b920138314a1283b30f145bac24ed,310,271,39,Europe,19,1525.82
97234e8476ea4ffa853feca86e6b1c2c,365,345,20,Oceania,20,2391.75
972363d40f8e42c9b3e5e8b7a8dee2ba,337,298,39,Africa,17,2527.07
97245d9d42c844f8be5fd203e355b441,338,311,27,South America,23,2326.87
97255dbecbc04639b0ea7fadf767b844,353,336,17,Oceania,20,2175.54
97255edccf1a4bcfa6437112694b8944,364,326,38,Europe,21,2296.5
97285cce167c4c5486327507712a7764,51,16,35,Africa,22,255.6
9728de4701f44250a432416537875b40,290,260,30,South America,22,2299.39
972a1c9811524d9887291811af8e6bfb,347,333,14,Europe,20,2549.12
972a6676fb3c4575a03290c5bbe364d2,62,45,17,Oceania,15,513.22
972be26854b44fe7a694637923cb4cb0,310,277,33,Africa,24,2657.46
972c1cd3ee0a442f8ff987d6ae2a9a5b,314,296,18,Oceania,19,2364.43
972d6dba2fae4692afd9781c2fdb970d,236,202,34,North America,18,1659.2
972e2d5d05f1433a9cd2d164cdd604af,365,342,23,Europe,12,2320.7
972e3d8b1c854cd38ce448eb4b46ed6a,364,336,28,Asia,24,2676.13
972ec61b5f1d45e1a929fd035d340198,118,76,42,Asia,15,331.52
972efc57b1a74e068bb67ec4967469c0,89,40,49,Africa,20,363.17
972f3cffb5924a9e957b7e6a5335c220,278,229,49,Africa,25,676.59
9731bf2686ac408086f2ccc11e7acf9e,96,46,50,Africa,17,357.05
97336bb01cd94953a594f4a5229dd0da,204,190,14,Oceania,21,1305.33
9733b372971b416bae698096511884a6,345,321,24,South America,17,2259.25
973457cd89c44f74a5ae23406b080d14,233,208,25,Europe,14,1759.22
9734eb184ef240528da7f54c736b7f03,181,131,50,Africa,22,652.97
9737c33f513c4d119055589741ae20ba,56,7,49,Africa,19,139.95
9739307dbb9342e192849e45b5641a5c,364,363,1,Africa,15,2293.21
97393e4c9d644050bbe450ff7c71d41e,125,75,50,Europe,20,630.33
973b1a4806664a0aa0df44e168916d69,200,182,18,Europe,24,870.55
973da8dbd578447eb875a560b1b86d67,332,281,51,Asia,22,1618.64
974152e335b849c691d071d94e289cc9,259,222,37,South America,22,1706.86
9743471f1cf148db873d393a6b9e75b5,61,21,40,Africa,22,315.18
9743fee326544b0e8cd6b63af31fdca2,314,266,48,South America,20,1421.32
97443863dd1d47109e46887dddd4d44c,218,176,42,Oceania,22,1550.17
9746d6b928914b02950dd51ec63ff36c,347,323,24,North America,16,1796.1
9746f2d4afd049178e37900e17b28331,340,283,57,Africa,22,2447.01
974742a7f1344b7dbec23ed727e982db,230,171,59,Asia,18,1040.51
97479768132a402eb975922ad655a566,362,328,34,Oceania,17,2153.16
9747b8f251fa4e3482a9ea1d828663ba,98,60,38,Africa,17,210.92
974a214c4d644a4e8bd853ebdd49ffd5,139,84,55,Europe,23,1025.42
974c5a7cbaae4cd3a14f1886383782ed,308,292,16,Asia,21,2260.54
974c6f01b13948c685705ef4b058dcb7,193,166,27,North America,21,2422.27
974cb543d52c4d718c7404214ca9bfd6,40,9,31,South America,18,254.15
974ce6bec82d40738b311dd97c0d4471,300,250,50,Europe,24,1257.78
974d0d0cad584391b43d942956e09ce4,254,201,53,South America,23,1267.32
974e3c37d6ef4992840075c96500ee14,69,45,24,Asia,22,498.7
974e6557261a4bb2ac17fe6381d1b684,290,232,58,Oceania,20,1305.94
974f190b43fd4de0a5b2689f102be45a,48,24,24,Oceania,22,226.27
974f52491019494db8bebc69b78338bc,278,237,41,Asia,25,2195.04
97529ab72b574bea88527a959e23c3c5,291,256,35,Oceania,19,2309.44
9759097d5f634d35a27462fd22f31393,328,283,45,Europe,20,1506.97
9759b642b17c40909b60b09e8a552a61,106,71,35,Asia,19,761.69
975a3aa25d1041a18b1b2c492c4ec222,345,318,27,Africa,25,1913.52
975b2a7e7ef4494b86dd94c4820a6a1c,131,102,29,South America,15,969.54
975c5e616532412fad5bab636b9a9a89,250,209,41,Asia,25,1766.4
975cb5c385d8424e9d01f641a209914a,213,198,15,Africa,22,1311.51
975d199a920d435c8c2cb4441f9ca5d6,249,211,38,North America,19,1207.77
975ddc49239f4580a9f0fe2afcbd9d34,105,75,30,Africa,26,470.57
975de639a8264c738ad09bb2019a2a25,319,289,30,Africa,20,2170.59
975e93360d1749d599373877cb99e447,71,18,53,South America,22,375.8
975f869a41f542f3a2ff28c81fcd3522,111,79,32,South America,19,730.62
9761b829cb904ac198ac4065209195bb,363,314,49,Africa,19,2581.53
97632e31b4ef44f2b289949b98629992,357,309,48,Asia,21,1691.38
9763eb8f75bd4c488f244a13f8704cdf,291,250,41,South America,23,1985.77
9765921a182c4f3e861a55b619d1b369,275,237,38,South America,17,1978.39
976977edad8f42f58325b17a40856531,227,205,22,Africa,16,1871.39
9769823cdd8d468489f960e91e399a7f,61,15,46,Africa,21,636.94
97698a935d6e4c9aaf8e612f7118a0a1,358,314,44,Oceania,22,1759.33
976aa2d5d33b41f2b44cef004cebfea7,184,151,33,Oceania,22,1241.67
976d3f558da44d3fab59c68fea003346,357,315,42,North America,17,2633.54
976d7dd859f84814945e0bfe1e11b049,358,310,48,North America,21,1783.85
976e6538998446a59dd4bda99af1990e,352,328,24,Europe,23,2106.5
9770b1b8340e4947a460c181db0e47a1,364,343,21,Asia,21,2734.02
977143fb6ba74e8ab32d3c04c4228b2f,196,175,21,Oceania,21,1358.72
977471425be74d9db12d734ae9257b33,116,81,35,Asia,17,697.5
9775e7fc5fc54141babdfabf312a41aa,365,344,21,Europe,21,2497.2
97760da5e4a54270bd53753bbbae8d60,211,177,34,Europe,18,1122.23
977c4456821f4e4ea7efb8eab4ec067c,311,268,43,Oceania,16,1670.54
977c8dbd019c4686bc6c7f936d6af0a5,263,222,41,Europe,14,1078.94
977ce92ab6fa4631aeb0bfbe540c0adb,123,71,52,South America,16,446.36
977d8bea9b794392a1628423b7cb31c7,184,146,38,Asia,21,1589.61
977f140d5da147ceb29cf913d4cfe812,246,192,54,Europe,15,1070.61
977fc6aa0b5c4cdc8daebdcdd97ed6b6,258,213,45,North America,23,1252.58
978053b8cd844c1c9435e0f038d2780e,362,316,46,North America,20,1823.67
97823aa2f35342af9018bae7573bed5a,85,36,49,Asia,22,470.75
97826c44624b481d8105af21b1c1c377,100,42,58,Europe,21,486.51
97842cef9c834849a126f6d359951384,174,138,36,North America,20,1472.92
978456979192493395618d61ca3a17bc,300,254,46,Europe,18,1584.32
9785dbde258647fa94208f34178a7490,168,133,35,Asia,22,946.72
9786e5c3faae4e6f9c0a81700d666aa6,167,129,38,Europe,15,1081.61
97884f621cd247e385ab27edee61cf37,82,43,39,Africa,17,751.35
978916d665bf49b189042f8f688470e3,281,241,40,Africa,27,1882.36
978a524b5df44340bb4d3e98c5d26ad8,285,241,44,Oceania,25,1801.9
978b20584cc649caae43ef2c297d82f6,74,37,37,South America,21,610.39
978c183bccf7483c80898ddcd5b5c857,38,17,21,Asia,24,421.89
978cd11e6d4d497cb9bc6d3409a4f489,327,279,48,Oceania,16,1975.85
978d1bfad59b4f98a0c096127678552c,362,308,54,Asia,20,1033.53
978e4cd8cc67451494fbdd3ebe694504,78,39,39,Asia,23,528.66
978ed4351e1144d5a57b6ceec0e6f9c9,135,88,47,North America,21,760.33
97920b9d1edc4c6493a2a2955f78d959,283,247,36,Oceania,18,2302.93
9792160841a74905ab75d1c3074a7fef,267,244,23,Africa,22,1768.57
97925063224d4530870bb99acbe697d1,168,121,47,Oceania,19,1025.86
9795059d36d9462b81b68851496248fc,321,269,52,Asia,17,2148.87
979581dc375f403599027f2abd5d4db4,27,6,21,Africa,18,227.07
9796022a42f444fd8244fb11c55eb493,98,61,37,Africa,25,711.39
97962e5d4c5e4d6a8645aeb2d083c915,216,167,49,Europe,15,1330.9
9797bc5b86ec4625adc3af0c0159caa4,33,14,19,Oceania,19,125.4
9799aef9aa1e455291b381ab799708e8,356,316,40,North America,21,1631.53
9799c13c025f45508b9b2eb5b1ff786a,365,346,19,Asia,19,2161.2
979a3c6533f64ef2b4a1cd6097649720,333,286,47,South America,19,1546.93
97a1bf38311641baa844692eedb73453,365,361,4,Europe,21,2388.22
97a22f052cfa4aba8b2aea843926c1b7,305,278,27,Europe,19,2470.13
97a27841f67d46fc9be67bc2eff26209,258,217,41,Oceania,24,1254.3
97a45da8057945e89bc17eb3a1a35855,73,43,30,South America,16,345.63
97a5c41584544d19b027f8ded600f0bd,210,157,53,Africa,16,1065.95
97a63fd7b8ef458d8a0bb715a1a2e142,125,95,30,North America,19,864.31
97a715bd1ea349d9b3efda3b751e6fc8,249,225,24,Oceania,22,1867.79
97a7368e3d7049979dfcc1f5542f1587,216,173,43,Europe,15,1412.79
97a75d62beb24c43b7edcc6f6ee83387,282,242,40,Europe,23,1420.67
97a7da71a0fe437c9c8582e23f31395f,289,249,40,Oceania,15,894.57
97a94c7be9fe4e95a3c206e3d8deaca4,355,336,19,Africa,23,2367.12
97a981b7d11e498c8726eac7adb6274b,79,49,30,Oceania,24,867.94
97aa23cb28434d6c8045e387fcaf51cb,303,262,41,South America,16,2084.34
97ad427bff9b495f9bb3c794354ee29e,307,281,26,Asia,22,3114.02
97ae480f98ea4357b9e3deaad41f8f97,52,19,33,Europe,17,396.34
97b18134fd9c4c0184cec5e7d816b049,364,355,9,Europe,20,2295.09
97b2d63a32114be7a1158e0479e8a1ea,364,330,34,Africa,22,2034.4
97b3b02fb5d04e7cbce0c617c5a55ced,111,80,31,Asia,22,954.65
97b4f6fbe1f14f1494828e46a559832d,239,210,29,North America,21,2426.43
97b54a761a5d4e18add7768d0b2afdde,51,16,35,Asia,22,118.86
97b7208e53d54d06a2742ce19e524e1b,364,359,5,South America,20,2729.2
97b7b5b3a00543278026acfc412bb8ad,60,46,14,North America,22,393.79
97b8a5ca9c4c4b778b34e5a8a7b5598a,364,356,8,Oceania,21,2517.74
97ba50c056af4c34bd81cfcd597aa62e,109,83,26,South America,19,419.38
97bb839effc7402d99b105674c9201e0,187,149,38,Africa,18,1479.03
97c68830bbd049cd85e9078b0183c6c9,319,267,52,Europe,19,2204.87
97c7d37dc9d542f2bde4ea1bc68215e3,365,359,6,South America,18,2826.89
97c808e7f8d5488d86a054c0d58f4cf0,186,141,45,Africa,25,1297.31
97cb7c29253d4b9cbc40de9957f5d425,167,124,43,Asia,13,1133.2
97cc04de0e8a45b6880da1464b948413,205,187,18,Oceania,20,1921.88
97d03aae839540e2bc0e5591b7aedb4d,315,291,24,Africa,20,2123.64
97d30b2fc363410fa531a91715481308,39,14,25,North America,23,191.88
97d31c19b6d64eaa8edc02fa95a80d22,305,266,39,South America,23,1902.04
97d361cfd83e4a3ba258d19ce47be9c0,45,33,12,Africa,21,306.23
97d44209676e4721b27c92b2fec3d226,158,111,47,Oceania,21,1197.62
97d6934f50704b1f991ce1af62381fc1,197,145,52,Oceania,17,1381.82
97d6d901fde248ddb50150e4a7f38c50,254,228,26,Oceania,18,2267.39
97d6f818308941339ec35a6dff3dc8ce,242,199,43,Asia,16,1482.97
97d6fc21d52a493aa326e6a28fd3c5d9,364,339,25,Asia,21,2841.88
97d7e09a7a284832aebb01ba9a5e65e4,117,91,26,South America,17,722.83
97d9fa0be1d046a69e17e6eda2af61c0,37,6,31,Africa,22,355.79
97daf12d91c74547841f5ca70ceadc68,344,304,40,Asia,19,2081.09
97dc9a3db1a24fe78ba942a708cb0f24,122,85,37,North America,20,1331.5
97de4052d80849769c7a94c2ed4ca5c2,128,108,20,Europe,16,598.81
97de64c511844c11a2e47a4ff98b0a4b,138,85,53,Asia,20,398.02
97df289839bb466fa640dc71460e78ce,239,200,39,Europe,22,2045.84
97e488f97f614e8eaeed8487de368d1a,305,279,26,South America,18,2837.05
97e7b4e8a16d477da42a732d5cac0985,227,191,36,Europe,15,1510.43
97f0537eb3df405085f15983a9bb1e21,210,185,25,Asia,17,1126.15
97f425c6c12e49b7842ff7d1d5ab2fca,271,218,53,South America,19,1659.81
97f45eb89c904c8681df90029732d4e3,228,182,46,Africa,18,1519.08
97f5f3f377234f29977bf6fa4bd8b5a2,59,14,45,Oceania,22,182.6
97fb3c254d754cd3b3b178258a03cf6b,146,110,36,Africa,23,1684.45
97fb4b58cafe4c558239be6f8cee8c63,44,9,35,Asia,17,704.07
97fb5640196c40998c334e0a99e130f5,115,60,55,Europe,24,465.78
97fc02a970534c24bae46a8d787c1139,363,331,32,South America,20,2466.09
97fc87209e984ff8b1deb4a22a9bfa7d,316,293,23,South America,15,1352.67
97fcfe8aebd8460a937dbab591a9dfbe,120,83,37,North America,19,705.27
97fddb57660f484aac2a38c1420995a3,363,331,32,North America,22,1179.1
97fe3d78439349f1a93ea0b28b6231bf,235,189,46,South America,15,1118.49
97ff0a483bdf4678a75716b62c3a7cb3,260,239,21,Asia,20,1579.07
97ff53535a004d1e8c71230ef3de1553,120,74,46,North America,22,840.72
98000c839501493f9d6f3868c7df70cf,211,168,43,Oceania,23,1821.29
98022581c8724020afbb55279927de18,43,10,33,Africa,17,330.03
9804709ad88d403e801af4cea4245e00,44,11,33,South America,24,271.51
9804e62185664ceb8ea283b3757aecbe,198,167,31,Europe,23,1801.91
9805058e864743f8aae5f3faba303b9c,365,363,2,South America,18,3436.78
98081c9872624bf1833720ca236fd4d8,125,90,35,South America,24,910.34
98087c7c8f5042429201ae7c90be9a19,353,301,52,Asia,19,1933.67
9808fd4782b84045b21ac345167638cd,352,304,48,South America,18,1883.55
980d48ea089640ea9b2cebbb727b2bd8,23,12,11,Africa,19,408.33
9810b04c5ba7429ea9ad605b39ee544f,204,173,31,Asia,14,1204.38
9811071ab191459eac06566fb6797481,92,47,45,Africa,20,505.63
9812c9f29a85480886801fb9cb95b828,224,181,43,Asia,21,1731.44
9813f28602ee4b5db70efe697dd4fd77,71,50,21,South America,22,506.6
9817303f9a8a471b8e16676f23a3b5c3,168,141,27,South America,19,1033.72
9817e0b97bd848abb61476f5efab8a53,364,343,21,South America,20,3414.41
9819f3c9a61b4aad8d4a470effa64f9d,176,139,37,Asia,19,1161.53
981b6fd45fd34a95878f519973c5a4ef,365,360,5,South America,17,2897.09
981eb95f564445c1a6ae4c287bc08de8,272,233,39,South America,15,1314.47
9820c4303e7a409e87351995dbf3b27e,363,318,45,South America,18,1766.93
9823355ac9e84afbadf1a2bce4f66090,274,245,29,North America,16,2310.75
98266707eb584deead11ac12d44a8276,191,148,43,North America,20,758.05
98268204b5394cdca59488d5026f3c51,345,323,22,Oceania,19,2446.47
982c93fe6365421993c75d1cd458d928,237,191,46,North America,21,1305.25
982d060b0cb24affb00917044ce2a4dd,173,152,21,Europe,20,1174.98
982d6ec61c664ffdbcd35b63ecc79df4,362,344,18,Asia,9,2033.33
9830afed181c4d87930f8f7b8e624656,181,125,56,Asia,23,692.5
9830e137af2642f987af54e785d2ec91,277,226,51,Asia,19,1793.01
98324b4d304248e69fad37ed05fd1ae5,175,151,24,North America,18,1034.73
983531577fb943f396cb32f213287e91,299,267,32,Asia,18,1923.56
9835d3e46df34384abd6eb4bd44b0947,276,243,33,Europe,26,1945.64
98363f9af72044f2b85e492f33aba556,176,134,42,Oceania,19,1417.68
983752d0680f443491168662571e4301,331,305,26,Europe,24,2388.43
983956917e3c40b2a3ac1a3702ba4c55,191,134,57,Africa,22,766.8
9839b03d50ab4b5585fc0274e307fb3e,317,279,38,Africa,21,2366.98
983a1390d1414656a8fe599f8df0ca98,337,320,17,Oceania,22,2002.15
983bdefa960741cbb19900b6b4917e83,125,81,44,South America,23,522.93
983db5020fa843008ee1b62fdfcdac67,139,89,50,Oceania,21,687.39
983e2569f6994ba5a029acf19155b01c,187,163,24,Asia,16,1134.63
983f2fec04c14773b7216fd03e02ba05,363,335,28,Oceania,23,2417.11
983f582a2b784cd3ae8ba4f9face6ea5,343,296,47,Europe,20,2209.42
984060161ea84a8caec0e8570917f640,206,161,45,South America,27,1055.53
9840c8cdbc2d403c8a61737b45eddfde,228,201,27,Europe,20,1876.77
98415aa0925e4f03ab5fd4bbe67e733c,360,337,23,Africa,21,1339.03
98442e27b9534162a14a2eba28c0267a,211,185,26,Oceania,16,1697.66
98458113ec844d1b802dae7a2cba624f,347,316,31,South America,20,2638.41
98473ae25b0f4fd29529f75f281f50bd,114,66,48,Europe,12,242.08
984a6d17fcf9488088ffc7351588483c,365,345,20,North America,16,2334.11
984aa057e2874d38b72a890c57b8702e,248,191,57,Asia,22,1582.25
984aa483d37648908255f8fbad93c8c4,346,308,38,Africa,15,2729.75
984b230fe73c46bba1009688d559f9d3,365,337,28,Oceania,19,1901.16
984c17ca3bea491fb9c9811645d8b81d,204,183,21,South America,16,1033.95
984de6d44c3e46a2847385111d05be98,159,137,22,North America,22,1550.3
984e174c60a94fa48acdcf97268d386e,292,245,47,Oceania,20,1656.61
984ef1b92c544500b5213623cf9adf0d,237,200,37,Asia,22,2003.77
9850dc42d2d546c2a3225f6f7a0025f1,314,266,48,Europe,12,1617.03
98515147d43c4b45833b09d941f60a97,357,312,45,North America,19,1996.96
98538f0c49ad4c7fa3b1e63a255e8a32,209,173,36,South America,22,1676.15
98569d6e2b0a4681b78e0c8b79cb7c3e,193,141,52,Asia,19,871.3
98576742caf9459fbecc1c6bff029abb,312,275,37,Asia,20,1876.91
985801f933154040b0164a912f2894a7,343,303,40,Africa,16,1753.85
985834e9ccbb4c52964058c90a04dda8,86,62,24,Africa,19,570.37
985ae80099c943539013595777ee7a58,297,267,30,Africa,21,1497.96
98600636595140659cbfed9ece7ed47d,172,123,49,Europe,23,764.46
98633f7d5f3c4e13a8b34e380da0a6a6,362,342,20,Oceania,23,2930.26
986416c4148140f996480bf487c3ac01,26,3,23,Oceania,25,213.36
98643f1729614c9da22cc791c9c32f37,363,310,53,Europe,17,1612.35
98656776ae3b4d908f550e1fb13c3103,214,181,33,South America,20,1367.71
98657aff7dc54885b6e905f9ff0dd735,296,272,24,Europe,22,2705.48
9866727414bc405ebc2fd575de456233,215,175,40,Europe,20,1421.13
986b016210df4c9c85961ca61b705953,340,299,41,Africa,19,2588.32
986d9b06e3194aa9b6bfec73b9efc3d3,195,148,47,North America,23,971.74
986e34eefeeb43bf90a8c4cd92d8deba,261,237,24,South America,21,2317.18
98700f470e514c2eae1745c5f6c22a01,265,210,55,North America,17,1387.26
987076bb818f47669aa871b19303c536,259,218,41,Oceania,23,1138.97
987295fd47c440efae67c9cad5e641d3,324,289,35,Asia,17,2137.77
9872a0f4248c4d19a8eb84e5314fba98,275,224,51,North America,18,1835.76
98759b4275944994816ae0e1216c4fb3,349,309,40,South America,23,1771.29
9875e86203464892bd1d0fc52ab27337,365,335,30,Asia,20,2704.38
987674c544314c9aabc759515da6d22c,287,241,46,North America,21,1627.23
9876e0e22d724603a92f2e1f47802ab8,112,84,28,South America,20,475.1
9877bc4cdcb749c08753b9b79a9c84ab,341,307,34,South America,19,2760.02
9879e8318234419c8e00518c9d0b4d74,109,61,48,Oceania,17,643.81
987a5ed4f04848e5b002ba42e0a44a98,201,161,40,Europe,25,1149.89
987e7792e8144919ae4906c288e2cf54,326,287,39,Europe,25,1727.38
987ec7e27212441f9a3ec2ba40249e2c,241,204,37,Europe,18,1570.31
987f01123e1244aaabfe978c8be99f61,245,206,39,Oceania,21,2608.86
987f40b40fbf48949be5ef2957f05636,223,185,38,Asia,21,1198.75
9880095634ab4ec88c5c28b52fe97580,346,315,31,Asia,24,2425.39
9880c156be5d41bb8d1891cc2370d385,361,310,51,North America,25,1892.83
98837da1a9ec45a9aa0a7ec4db3174d0,314,268,46,Asia,19,1775.07
98869a1d07164d5a9b4930773b88ccf6,37,17,20,North America,15,318.3
9888d39956d84cb9ab90c72d3cef731d,201,168,33,Oceania,18,1060.39
9888f76cec354a2591d848067850ebcd,293,268,25,Africa,17,1694.59
988bb37c90084007a3571fce247a2230,278,254,24,South America,21,1857.14
988c7865764c42b28c03821182017bc4,115,94,21,Oceania,20,1189.38
988d84989b2e4d9b821627bb72a7d85a,186,139,47,South America,20,790.61
989056ac8f6042309aa0153b464968d6,363,349,14,Europe,21,1816.16
98906ca7a6a74aa0adccd3ad1bec47c1,160,143,17,Europe,19,1676.24
9891405a0ddb42f980f98a28318147bb,305,284,21,North America,21,2611.82
989350b3698848f0ac8409135db3a469,365,325,40,Europe,19,2159.44
989791ca9b884261b34878dee6e62ec5,162,107,55,Asia,23,833.47
989863521e3b458a88ee11732c4f7a62,315,287,28,Oceania,17,2043.67
98a26d3714c3451b9d691d7e4f02f09b,363,337,26,North America,18,1863
98a36b62654f4f95a8979f02638dfe90,136,99,37,Africa,17,1049.18
98a44e60c96b416cb4a4bc29215b42ea,57,5,52,South America,24,328.7
98a567475771459eb416971ea9bb8acd,334,283,51,Africa,16,2093.46
98a92af068304f318ec3883851b72c30,333,307,26,Europe,19,3035.72
98acd2010b694947a883e4f12b2694b4,206,160,46,South America,23,1237.04
98adc16c476641fb8f6b27be96345797,365,342,23,Africa,18,1731.66
98adfdbbc5b14a05b7d78a7c794c3d8e,254,225,29,North America,25,2005.69
98aedab0d3ae41fab31a7db831e3900f,363,345,18,South America,23,1582.07
98afc2d0107d4f2f8b92ea5e15b08d4d,152,125,27,North America,22,1689.44
98b09fa419ad4fdcb5948899c6b3b984,281,246,35,South America,21,2311.8
98b0ac6c1beb437d9ade49b8ea9500f1,327,290,37,Asia,14,1723.65
98b0c784591e4884b82414cb7e9b5e61,363,332,31,North America,28,2519.19
98b1ae49ab9844268244e5feb5e20a0c,349,323,26,Africa,27,2108.22
98b1fcd424d9423fbf3143287f12485b,211,162,49,Africa,20,1364.39
98b203512aaa416794c7b86476073c51,365,343,22,Oceania,18,2334.82
98b26ce470874dbc8d6d5756214f6b4e,80,36,44,South America,21,388.2
98b321e79143413ea1687e7b06c5857f,359,326,33,Europe,18,2428.34
98b6325ee1564b81a8faef61b1cce4bd,353,327,26,Africa,19,2039.16
98b8aa4b0ede4394a90796f81f4a59c2,188,139,49,Africa,16,580.05
98b9696fe7404e46904b7c4012414652,74,33,41,Africa,21,559.03
98bba225f1554b329b7a6b045c5f3eca,145,104,41,North America,17,573.24
98bc8402ad274daa83b0d947e70fee2e,109,72,37,North America,19,792.44
98bfb409a9fe44c2b95a5a4a7c5e7775,61,16,45,North America,22,419.35
98c310cccae340d7bd4b6faee50d09b5,205,150,55,South America,25,1341.19
98c4667416e34c4b9d16c76048af9120,262,243,19,Africa,15,2190.4
98c468031cd3455682062af27330af22,246,219,27,Africa,13,1934.38
98c7b41fcff8494daa5e5f5f357918fb,207,179,28,Europe,20,1359.83
98ccb9efcad64f3ca352f8d65faaca76,50,17,33,Oceania,23,234.96
98d0ae5767d848b1a9286ab17fa20c18,195,145,50,Africa,24,936.93
98d20e537b6d464cbb2b95b3af16d1e3,324,295,29,Africa,20,2844.93
98d26ae89672486f96eebb2c0a0468da,102,68,34,South America,18,717.44
98d58e8117ed4cc9b235ac89abe7a5ee,119,64,55,Asia,23,670.14
98d5b5e2d5f843998de88bdbf0c509be,356,299,57,Europe,24,1581.09
98d66cba2b044ecfac00d4d46f1880c6,290,272,18,Europe,16,2110.24
98d72ac02b634736a9e1b5d649f52f72,90,35,55,Asia,23,297.48
98dc358e32244e1287d8364e113f61f0,142,101,41,North America,19,1071.17
98dca283ef24490392774d35399c6d53,312,286,26,Asia,22,2782.22
98ddd9d18eff41a28963f172f79632e5,350,332,18,North America,21,2503.48
98e190f40d2b4513b127b330045c4de0,344,316,28,Asia,21,1749.11
98e2737c9ed84981bdac9285179e1794,46,28,18,South America,20,294.46
98e4a832df3d416b80c7f2922873fe86,181,136,45,Europe,22,1105.83
98e73511a30040a6bdc4db25968f7af5,365,341,24,Africa,17,2071.65
98e75b1da88d47b08c3a12ed4ec60675,138,105,33,South America,22,666.68
98e849f0e2fb4cf8963d36b4abd67578,288,238,50,Asia,10,1722.48
98e9856c34894e4ebfa10ba076356a91,270,229,41,Oceania,22,1234.17
98e9fa1445d34fb485551459c655a180,103,77,26,Africa,17,1199.95
98ea39641b494034b4b89296b4a6e6f4,134,82,52,Africa,18,960.04
98ed4c5979904f938a0dcebbad4e2713,335,314,21,North America,19,3096.12
98ef69fb1eef406bb600abf4f1784d54,47,16,31,North America,21,424.05
98f09ef34b514b7ab336a9b9d3d0c6da,327,317,10,Asia,21,1864.11
98f6463078254f05ae5b9e0910e708b1,355,321,34,Europe,23,2372.9
98fc07e81bd04e5b9fbd0a3951aea6a2,353,309,44,Africa,22,2933.84
98fc81d270cd468da71d4d6601e198d7,364,357,7,North America,18,1839.51
98fd066d999240a1b6512cd119e025c1,139,99,40,South America,20,987.52
98ff41e1d6f84a4682070867fd9a6e5f,243,200,43,Europe,18,1136.85
990156d220ac4dfc98a7f0f431567375,238,182,56,North America,22,1192.49
99043e6afdfd4dbeaa920c135a431c71,167,141,26,North America,20,1154.39
99068c8ce3424e90b6acf48497d0dab5,180,161,19,Europe,19,1673.9
99076ea2b0a8435e8380d1d4f9a38e7b,252,227,25,Europe,16,1726.7
990a11de32d44413832d8e9684db3bdd,343,289,54,Asia,21,1853.64
990c4d72635f477e8d5100c9cc986363,66,16,50,Asia,19,392.44
990e012596a548eda643134c68687e3e,215,191,24,Asia,17,1766.52
990e6c7239074db1aa99f9695e830fad,272,241,31,Africa,16,2315.84
990f211d27864823845951666c05b3d0,111,59,52,Africa,21,489.6
9913a3d69cda4c40b3404781f8f008ec,128,75,53,South America,24,555.2
99156cb01d73436d889467aa9f0a6b4e,288,249,39,Asia,19,2050.02
99160d32e72046baab0528504ceec6b1,192,138,54,North America,21,941.92
9918f2452d1e4e468b7c90c30ca8cd59,352,331,21,Oceania,17,2786.99
991adf49f309408f9adbe0fb338c9dbf,140,120,20,Asia,13,970.02
991ae34c18934ec3ab32934fbbff2cbb,321,277,44,Asia,26,1710.94
991bc999acf1411b9b74da48f157bbc3,313,275,38,Oceania,12,2354.47
991cae034b8d47b085899af04b8a1043,365,363,2,South America,21,1980.5
991d724a3b7345fc9bc075d835317e1d,207,153,54,Africa,24,961.4
991ff81017e740ae9aa011a0ca146f2a,274,258,16,Europe,18,2016.95
99216fa6bb5b43b1882e1176afc48e45,212,172,40,South America,23,1487.06
992206d868fb4d44a04414dfe2dccf13,264,228,36,Africa,21,1972.61
9924d554adc64e988b5dc1139666c48d,335,308,27,North America,21,2292.87
9925772c48b54d12a2d22973ca192c95,206,178,28,Asia,21,1713.66
9925a79c59ae4a21bddd35c0fcfb0167,139,103,36,Africa,24,752.78
992777e0770a4764bc44ffbb153181e3,350,320,30,South America,19,2322.22
992be53d18ca4f01ad5a966755e1f70b,163,132,31,Europe,18,1387.39
992c54c04d8841299030301193b01782,173,134,39,South America,22,1415.33
992d47d07ef64e068c24e53c824b7c31,362,344,18,Oceania,20,2460.26
99310d21e6c34cbb9f9b92d783e6efca,171,123,48,Africa,22,762.88
9937540ed8b54f5d92dfa0660d4ba373,101,53,48,Asia,23,368.07
993fd9e77842403bbf054851c5fee5df,58,3,55,North America,16,465.71
99407ee5dbe0400c9dbbc9762b87fa3e,226,202,24,North America,20,2318.99
9944ac6f0d3d48278da63cecb65f7cc7,159,116,43,North America,23,817.56
99452ea104a34cb5a76fa79cd1cdf3e7,83,54,29,North America,21,571.33
99487034be04474e8464fb9e782446c8,98,51,47,Asia,18,556.15
9948dc09e0e8420b837f27b6aa7e3df5,49,9,40,Africa,22,293.3
9949e66b8e5544a2b3d19b9826c5da4f,327,294,33,Asia,26,2132.1
9951d84edce042c69286e524e30865fd,196,143,53,North America,18,898.78
9951e76cddee4b05b000f92b11c3655b,120,96,24,Africa,18,755.66
99567e511bfd4519b2b90d15b7cba997,214,165,49,Africa,22,1069.34
99597d74bfe246ac96677d5a861b4faf,309,269,40,Europe,20,2283.78
995ba0da26da4d7a8709d455546cd1e2,362,336,26,Africa,23,2642.46
995fbf0316df4557a29ba1da94058f3f,160,124,36,North America,20,1028.43
996118e58f9b4cc399aab576e5cb5be1,322,287,35,Africa,26,2591.14
9962e4ee404c4bacbc88c9970bf6c9ee,258,237,21,South America,19,2024.79
99630e38a9da452a9d522db9a10a5569,174,124,50,South America,22,839.91
99637bd4a2fe4c42bcb6fd2c8ce3dacc,162,141,21,Africa,18,927.42
9963da6a03cd4dab9142d5b79b6686bf,40,15,25,Oceania,19,251.82
996679356c05480580c0f33fd2262821,242,201,41,North America,15,1059.61
996810f4e4614f6abb8148886c3511c5,364,341,23,Oceania,16,1862.53
996ac467f43243b19e86c9c81165bcfd,262,221,41,Europe,22,1823.73
996b74590db94db28817848f3e2e4f8f,310,282,28,Africa,21,2167.6
996b895124d1426899b5c6f322307da0,94,73,21,Europe,19,605.29
997165c6a5c74e36b378a3faba221078,260,231,29,North America,23,2387.6
997285d260d342698378b2e0691eaa09,210,169,41,North America,17,1069.95
9975b12fcaa24da89479803cc47230b3,115,81,34,Europe,26,793.33
9976f528857b4ad2a330514191718ca4,24,4,20,Europe,21,455.9
99775d7066134dbbb1665a8306d45ed2,180,136,44,Oceania,22,789.04
9978fd303c324ea7a3359c9ba2442fae,104,56,48,South America,23,359.31
997c138dbf344d689dc5f2b8cc114f5b,261,208,53,Europe,13,851.63
997dab64679945c89e3c7720fa7cb8d0,178,126,52,North America,16,1171.06
997dbb6015924489818685473c6a3183,112,86,26,South America,20,635.97
997e50217bdd480587ff7ad5c625b933,64,40,24,Oceania,21,392.82
997ed82db85e44d9a7b28d7db67b0589,246,216,30,North America,21,1842.61
998135fc83c649de8dce530c70f50bbe,146,124,22,Africa,20,1052.4
9982ee4c2aa4428b94ff91586027cbfd,333,286,47,South America,19,2374.34
998407650f0a4f148acb2bb89ef13674,57,16,41,Oceania,21,294.2
9984b62cd2244199beeafb886622d509,149,96,53,South America,22,918.45
99858cd5df3e453a941d72fe04f958c1,143,107,36,Asia,17,1529.82
99870cb303bf4886b09b5d385b8a5abc,123,70,53,North America,19,465.46
9987b8ea87b14a359885369f278f3a09,216,181,35,Asia,18,946.54
9988660b1dc64c25961f2107e6c55b6d,343,320,23,Asia,22,2748.32
9988e4aa277c48599806aa4f2a6726d8,238,213,25,Africa,18,1602.74
998a9035ce9c400ab36d4f811210819f,134,101,33,South America,24,1137.21
998b819fa5144a07b1a80f8c3a444beb,271,234,37,Europe,19,1702.55
998b9baeabf14f0980e8670af5a6963b,312,280,32,Europe,22,1771.69
998bdf738f8c46c1aea14dfd6438d43e,316,278,38,South America,19,2528.58
998cc8d9aeea44f19cc40c1d36a3099c,347,315,32,Oceania,18,2201.91
998d83ca28c1482ea2be5b86b2c07d93,47,9,38,North America,19,254.17
9992aac5791142fdb182a96e30a44b77,48,2,46,Africa,22,347.05
999562ee2e3445cfa20c5691bc02eefd,218,184,34,Europe,19,1803.45
9996777500164e818abe4c6ddeccf826,171,152,19,North America,24,1200.61
9996b2e9583c414bbf1f3b55b6eecbb9,344,323,21,Asia,23,2625.8
9996c491268549a398f301e218d44cff,283,261,22,Oceania,16,1719.84
999893f2cda84d1aae7ac7e03a2f2fb7,322,263,59,Oceania,26,1564.19
99999c64008c45eb84f2bc02901bc631,139,115,24,Europe,21,933.13
999a383f6f7a4f33b23456404f430fea,65,30,35,Oceania,20,584.58
999ca2d60a32474c9134eeaec10e622e,364,361,3,Europe,21,2560.74
99a067b1a0cc47b69137a493c6f16d96,292,248,44,Asia,19,2365.26
99a0f29eb0ce4b04a8d2255f249b2d74,35,19,16,Africa,18,368.57
99a1f2a1b5e7495daed2c1eb0b00afa3,191,135,56,Europe,21,548.87
99a23b8176f94c81a63ef64178d4af67,135,91,44,Asia,22,1059.01
99a3595432f64b38ad85dbac000de163,250,239,11,Oceania,24,2329.24
99a44f2c13414146adc6985f33861aad,116,84,32,Asia,21,900.65
99a5512ab2414b9ab63503450fa31dec,236,215,21,Europe,19,1746.47
99a5c1ffe6a7420cbfe5f450ca77197e,47,21,26,Africa,16,531.09
99a6506cf3df4f2c8d3ae64b92c3f082,168,161,7,Africa,19,938.26
99a69d3b8b9a4174bd989ebde7a387a1,279,237,42,Oceania,20,1932.96
99abfa0e14844ff2924a7c57c668963a,99,55,44,Europe,21,798.12
99ac12bd5c08461eb15c10f141dccb1d,365,323,42,South America,22,1106.58
99ad1697233e4c8faa079694a3eb1bf2,268,237,31,Europe,21,1830.24
99ae2617bec647bfa2e0685d810ecf00,264,218,46,Europe,23,1249.15
99aee1ae22654a3c8e554578ce4f13f3,248,215,33,Europe,19,2168.67
99b36c6214354d6a8a30693515fbc612,153,99,54,Europe,19,555.6
99b654f02b13450bbd466978b0ca901b,271,242,29,Asia,17,2123.19
99b6ad636cdc460caf127559f6bc9d7c,171,119,52,Africa,18,749.84
99b7362213a34d97b27d02334e70a6cb,220,186,34,Asia,20,1824.49
99b7e28a96a841fcbb4d5bcd188919e2,308,256,52,Asia,19,1379.38
99b8752041fb467eb55b23cb30b1e5c4,86,68,18,South America,26,683.63
99b8c0eff3a44421b5e4987c0c00728c,98,44,54,North America,22,476.5
99b8d46829194380bbbc52b21ad64b77,242,202,40,Africa,20,1727.54
99bab80b6eaf4a48b60945a607e10a8a,181,152,29,Africa,21,1435.75
99bb5e034955431a9036c5a67b4e993d,111,87,24,Oceania,20,760.43
99bbb9650d844d79a698b57a28dbed6c,365,355,10,South America,22,3123.48
99bc095187de4e1ba16d2f032de59026,337,299,38,Asia,23,2262.22
99bc435a19a240b5a7a68e543fded524,214,174,40,South America,18,1341.91
99bfc1c5b7b64f248c7cd7cb24dcf423,41,11,30,Asia,19,282.77
99c02e4a260b45618ed01613881e0b62,261,230,31,North America,20,2235.22
99c11da9b8a5444dbd4cc22cbaf1c976,363,330,33,Europe,20,1803.29
99c251710b7249a587ef5b439da7ae22,185,137,48,Africa,21,914.56
99c269e48fda4b48b8e14fa694edcf50,97,62,35,South America,16,535.46
99c2bc8017a74f868c4bc3ffcc1e25b1,88,49,39,Europe,20,663.08
99c63b8a2253479c8dc3f41575f19b3f,167,123,44,Africa,21,1089.78
99c7a252abb247e299fe460a7b9fc7cf,361,339,22,Europe,24,1772.19
99cc1fe85a6b48f89768658d5939f99d,116,70,46,Europe,23,565.16
99cd9138f7d0473ea702d7300e9dc42f,355,306,49,Europe,22,1281.2
99ce18314f824f0b8b347ff83ad1d324,227,177,50,South America,25,1250.61
99ce44dcb85b4b1ea61494839bcb60b5,45,19,26,Oceania,20,389.12
99ceff66a3864a07974cafcf9ada45e2,269,248,21,North America,21,1556.89
99d025c3d1104aa0a7d4e2a887c5a022,78,45,33,Oceania,21,312.41
99d035f8c6214f4fabc9c2f6ffea2cfc,176,155,21,Europe,18,1135.45
99d0e3a67e5244688b7a68648a37955c,313,291,22,Europe,21,2523.03
99d0ec751ef24cfdbe9c9ac07087fda9,132,107,25,North America,17,901.92
99d26e6744124faba7f02070574fcd3d,365,335,30,Oceania,24,2169.59
99d30419b4a04a49a2227cd258532040,169,139,30,Africa,19,1451.58
99d354ddac4d4a64aa6676939b0de578,153,112,41,Europe,15,1070.66
99d40df9c6c9473fbaa1ed57bea2874a,309,276,33,Africa,18,1846.29
99d45dae45814f948967eaa3d87d8dc2,358,307,51,Asia,20,2365.52
99d53c47818a4d1db74f21c1f5ac816d,363,354,9,North America,17,2706.21
99d583349ef044e593c91f04c73caafd,170,152,18,North America,21,1529.68
99d6a47df4fe4417adcc0bfc1da3282f,74,29,45,North America,22,701.76
99d7357489b34ef98a95314eb56cb917,176,147,29,North America,21,1628.31
99d88bca733044e28d80db110052817e,342,306,36,Asia,16,2387.72
99dc00a3e9a941c5bd370443e935831f,265,221,44,Africa,26,1189.26
99dc46d1a59d42638c88ecc1b430be37,120,82,38,Oceania,16,821.74
99dd722cc4a74c96a3e436ec7ae4bb08,159,102,57,South America,19,880.18
99dd861357974ab4a68e2050e2439f89,187,153,34,Oceania,19,1302.33
99e082cf548b483ba61386137f4089b1,363,331,32,Oceania,24,2803.32
99e5575879a74750be2bf8088c5e783f,136,101,35,Europe,23,992.17
99e66dfe776e40bf8cd3c3ab8e057ccd,132,78,54,Oceania,18,598
99e69b7b804b48819597f7e03c342bd5,362,354,8,South America,23,3574.32
99e79c49ba8f46c39102d9a5e75f6f69,240,218,22,North America,21,1901.91
99ea4a2c5a244f58b2f732c89ddf6e88,363,341,22,South America,24,2443.24
99eb164cc567425c8177832584ceb688,365,314,51,Africa,20,1496.67
99efa27f92954b00bea3fff5cf4809e0,63,13,50,South America,15,299.19
99f14a3cd6db448a9838e17f9adab1f5,120,84,36,Asia,19,1160.76
99f3ab1b70124c91b13e15bc520f80ad,80,46,34,Asia,19,290.92
99f3f521f8744012ba57481071a935ea,331,307,24,Europe,14,2025.87
99f579fb628a4d44a1662066606e9ce3,78,30,48,Oceania,15,568.35
99f8342801e34ca692e581fffc36a620,131,75,56,North America,21,666.14
99f920d4b69e4136925d6f72dd5f8465,46,11,35,North America,22,316.81
99f9bdca56864cd0a7b47eae4d3cc7d7,130,88,42,Europe,22,511.44
99faffc9e8ba4646bd845db5ab2313a3,310,269,41,North America,16,1290.5
99fbc1ad69434795a6ecfdabd685ca7c,363,333,30,Oceania,17,3106.84
99fd661ccc8b4defb466be9c6a31fa78,135,93,42,Asia,21,480.78
99fe9c29956840c892e42e1ddd473760,320,276,44,Oceania,26,1754.92
9a004c22a0c64e8db2c3d5538c41787b,208,171,37,North America,21,1409.81
9a0097c3bf8b45f4829d058a6efe162f,292,244,48,North America,20,678.66
9a0690741115444da031874e8da5e2be,313,280,33,Europe,16,2427.81
9a06cb3ff14d40ada3a4f1db4cc14fbc,294,256,38,Asia,18,1754.74
9a0785c0e4ed47809756210a08d8c934,200,174,26,Asia,22,1262.03
9a08c24a93d84ffba95c7ba891507bb9,138,94,44,North America,26,522.46
9a091e4600e94fc184cfb23d106c3d77,365,330,35,Oceania,23,2150.42
9a09bec7599f4a4ca1ea5b3fc0e628be,201,155,46,North America,18,975.59
9a09c32f57814a59b2b63b1e5321aa04,160,136,24,Asia,18,1205.46
9a0ab99ec97e47089793009cd20596db,155,129,26,Africa,17,1602.08
9a0ad3d7c4ba4cfa8160297e7b9b53ce,229,188,41,Africa,20,1213.91
9a0b51e3c73d4450806929b3467156b7,108,91,17,South America,26,931.69
9a0d16b33c234b5a9213412db118dcf1,174,144,30,North America,20,957.94
9a0e3af3b18149949b44d6d53413e6de,295,243,52,South America,18,1290.01
9a0eaa1acac549e1bfedc69be2fd7b60,147,115,32,Europe,22,1225.27
9a0f992a948f450a818c2ced3f94ebd0,141,113,28,Africa,21,967.13
9a101bab337b483d911c74ed7c155a2e,343,309,34,Europe,21,2011.12
9a11491e37d246c587ce335cf9e9d0e6,353,316,37,Oceania,23,2103.09
9a1255f14aa54a8b837d3f95cbbe42b6,122,103,19,Asia,20,882.22
9a131f1266104cb0af6db138955eb68c,34,10,24,Asia,20,171.79
9a15b3a96e374be4a3a3f5249c0c4434,365,354,11,Africa,19,3126.58
9a16a28be7e543079f7839da4fc464b4,72,41,31,Oceania,12,654.01
9a17ac8e3cf3437b8e116f9acf6ba6e8,48,20,28,Asia,18,318.02
9a18299de9794420b221e98b2a9680cb,365,362,3,South America,22,2873.27
9a18357cd77244a2b28fbaafae0f61ac,365,362,3,Asia,13,2100.65
9a199e6016f84286832bc0090667d9e2,264,239,25,Oceania,18,1907.97
9a1b30df077848e1976f7b68abd27896,180,151,29,South America,18,822.81
9a1b8aeb5b884ea28bdcfdeccb58787c,188,146,42,North America,24,888.06
9a1e9855c03748a199c95985cda3af5b,87,46,41,Asia,18,255.64
9a21b480e69448f8a1d803a9b153d2ff,274,246,28,Asia,20,2088.22
9a23a4d1cc22405db77e4d399ffc9998,100,74,26,Asia,23,204.3
9a243d4ff6ee40d0877d55b0b810dfab,154,109,45,South America,15,1371.84
9a25750c36ca4448a64264d74eaff1bc,277,254,23,Europe,23,2059.5
9a26567b691840848a60be7609a20355,113,97,16,Africa,24,734.72
9a291b944a624c5b8584d13585f7442f,283,245,38,Asia,18,2511.11
9a2947eea0e742d09d775afaac8b7fdc,278,230,48,Europe,24,984.84
9a29dbd8557d452f86816dd97ff7ab2c,336,299,37,North America,18,1479.77
9a2a7207a548482ea39d45a705626732,365,340,25,North America,23,2693.25
9a2aaaa8e5a446bf86baacf655c6ab28,342,294,48,Oceania,20,2022.18
9a2b294dfd9246b292d82fb773853ce7,328,307,21,Asia,18,2463.14
9a2b519726fe438ab69c7f26c4385c2b,365,365,0,South America,20,2521.06
9a2c101838b34fcba90b2ee1ec18e720,265,211,54,South America,18,1109.13
9a2f7bb82b2f474eb2400ffe0b4aa479,269,233,36,South America,23,866.35
9a3026eb4ed344adb92d45c09b76091c,190,156,34,Oceania,23,1455
9a31d14ca34c495cbbd10fb974c1c86c,62,22,40,Oceania,25,225.56
9a3360a75fd04de3a81fd3f8dad2f102,365,361,4,Asia,19,2256.85
9a33a0719f514639a780cda18dee695d,259,212,47,South America,20,1513.22
9a34c7dc9faf441da3f5dfe74f61e39c,223,186,37,North America,18,1568.95
9a3591bc453f4fffa63a4fcfa5316865,34,16,18,North America,16,158.71
9a3629fc7efb427f870ca3c28e8e275c,184,148,36,Oceania,19,1434.04
9a3719e38e834d1d8d29ea7ca508ba60,339,298,41,Oceania,23,1370.87
9a3779daa0aa4848b6fb7e060219cb03,80,36,44,Oceania,21,481.9
9a394e4286c944e6909cac40066abb7e,92,48,44,Oceania,23,1055.65
9a3a6d854dc342c983315542764ac21f,362,354,8,South America,20,2191.82
9a4189fd467244ff8f254027d554ae9b,258,212,46,South America,21,1574.48
9a44e98cdf8e43a0a40c41cc5c328c93,154,119,35,Oceania,21,1191.23
9a45da66504a48fcb749ff27242d09ea,184,136,48,South America,22,530.24
9a464c5e50e541098cc855616b9227fc,269,232,37,Africa,21,2010.68
9a476117e2de4cd5bd02cd193af09ae9,322,295,27,Africa,12,2379.36
9a47828e55c24aff8005a7808393a321,208,178,30,Europe,17,1576.97
9a47d365d7384c1685c4680e7dd515a7,233,185,48,Asia,14,1005.97
9a4d0997d4be42f3a49ab17822409ec1,267,209,58,South America,19,1428.33
9a4d778721bf40cfb320163aeefb4840,246,213,33,Europe,14,1614.84
9a4ec29910484bb8ab270ebd2c0eca4e,271,241,30,Africa,13,2244.42
9a4eca285ccc497187159b54e0857ff3,364,353,11,Europe,29,1204.37
9a4ed2abf90a47fe91a5f270bfb11174,152,122,30,Europe,20,899.03
9a4fed43befd4005917a67096b5f2639,364,338,26,North America,24,4359.05
9a523c9c6004469797bf2d6e511b9f23,92,44,48,Europe,21,722.57
9a53aaad7efa43369f3e42f5a282b0c8,351,295,56,Europe,20,2285.29
9a55085ee9664e86b0d29c023ec3411e,80,55,25,Asia,17,603.84
9a5685272f3045fd832adf0710fd4d17,106,56,50,Africa,15,527.15
9a574e39cc214e97b98cc5f5fca98fda,315,281,34,Asia,20,2189.12
9a57c4b867ae4fe08a3b3ea986a4c918,355,305,50,Asia,18,1774.32
9a59a438c91d460f96fe060d934f82f5,300,263,37,Oceania,18,1513.44
9a5b62387a8540429e8429b1165d113f,193,142,51,North America,22,1258.66
9a5d5c0cadd340a5b49ab1479824236a,96,48,48,Africa,17,644.1
9a5dbe348ece47499703d0cd5eb4e42a,125,100,25,Europe,17,1577.18
9a62a41123354b0aadf6aa52f88eaaab,182,131,51,North America,26,955.56
9a630ef1f80b4f97a291330339cf9c06,134,121,13,South America,22,1105.97
9a63eaa4144743d2a4d33ff702d8c0c2,167,118,49,South America,20,680.13
9a66ad861b3c4ec486bc2ee673f6c516,247,199,48,North America,20,1673.25
9a688088834b449b86aa2d6a5a803663,142,90,52,South America,17,1146.29
9a693bce25da4db1abc47c33891d13ee,175,117,58,North America,28,728.4
9a6d9703686944a8ab7b5f59bcb831a8,116,89,27,Europe,20,709.13
9a6f002cad524d428ae8cbf31a3d1a1d,36,9,27,South America,21,212.15
9a7307bf4a4e42a897ee1a3f16bc84be,104,76,28,Asia,23,690.87
9a75b1339c3145518a616aedb35e4a54,365,310,55,Oceania,18,1722.78
9a768bfe27c446e58fe87fd79d70e0f7,294,258,36,Oceania,24,2049.24
9a785fa4cff2442cad74693986724f43,41,6,35,South America,19,428.79
9a79c6cf7edf4f2d9748c44b973dce5f,246,200,46,Asia,23,1389.97
9a79d8bba16b42dfb442cf2d74576c45,219,187,32,Asia,19,2386.44
9a7a36c61ef34877a43e95e083b3de61,247,225,22,Oceania,20,2114.05
9a7b27bfe61d4dcd8eb580fef3821413,325,277,48,North America,20,1389.65
9a7df6ce38bd4595a0f5622c09753158,169,147,22,North America,16,1675.36
9a7f022394434f1ca6acf48d71983ffa,163,121,42,South America,15,1312.34
9a7f892b70624881ae389b88325e1df2,270,231,39,North America,18,1634.13
9a7f9a98d46a4e6cac51f6153b00eaac,113,90,23,South America,20,783.58
9a80dbbbd3b349e88f8933db51c64d24,365,331,34,Africa,19,1552.7
9a8933e7abb8441a96afcdff2134dfd8,247,201,46,Europe,19,890.11
9a8aa13d65e84533b9e1d1b35aa8b3cd,188,163,25,Asia,18,1798.09
9a8d4343ec4741e8b3c0ea5abee9dfde,220,189,31,South America,17,1530.23
9a8d4b2725c54423bad72f2072cb5028,139,95,44,Europe,19,561.61
9a8e2123725d404abde08d5efd0ab87c,168,153,15,Europe,18,1564.12
9a8e59c832404177a89fb07234e22eae,261,221,40,Europe,24,1994.22
9a8fceb19a334efcade014716f2b0d4a,365,365,0,North America,16,1517.68
9a9192cecd864631b4b33399fc904d39,241,217,24,Europe,18,1651.19
9a929ea69c074879b99903742bd29d3d,343,294,49,Oceania,22,1772.98
9a9430192d504ccabd5084d81f426c22,265,223,42,Europe,17,1838.53
9a94913f0c2d4bdbadcbf6934b543340,84,56,28,South America,14,411.12
9a959931ca3a4bc58c669f95bd6d37ed,364,355,9,Europe,19,2392.65
9a96b07991de4ef787d485158e23b8f4,113,90,23,Asia,23,1211.91
9a9770c761c244deacf808e15995378b,46,7,39,Asia,21,497.81
9a97916d0b504e10a35d403da75bffde,320,288,32,Africa,22,2592.26
9a9a26625b5342a0ac5c7d5d1132dc23,350,294,56,Oceania,17,1475.58
9a9ca3f279fc41b68de629286dbcfa59,132,92,40,Asia,23,799.99
9a9f0971808d48c19abba3b0b25b8c0e,352,305,47,Oceania,21,1726.31
9a9fa46f1fa148f7a93138bef53eb6db,363,356,7,Africa,18,2430.42
9a9fe7e701af40cdbd59895a64f87157,330,282,48,North America,23,1222.21
9a9fff2d5e3841f0b02eb1d265f6e9a2,75,31,44,Africa,15,254.79
9aa1e6ec1c214fa08a3ae31880b90653,251,206,45,Europe,16,1471.72
9aa287685f6c441fb1977a2f66409b80,209,188,21,North America,21,1437.83
9aa42439d6cf48f7b0776047c88589fe,183,150,33,South America,20,1559.61
9aa6a0b83db3466b83b9d7eed21d3cc2,58,26,32,Asia,24,469.61
9aa81f80ab75404d978f923a6f93dad9,148,130,18,North America,17,1008.59
9aaab88750d04420941c64dd468addbe,348,310,38,Asia,19,2043.58
9aab7a68c0f543dfb3d73c2d9f88d8b6,194,138,56,Africa,18,718.49
9aacfc59d79c45f28c8e2ee0fd6f55df,210,174,36,South America,21,1590.97
9aaed2e2d2e44a2a83ffd5f006094ae7,134,88,46,Asia,17,1216.2
9ab3cc3772994ceeb86138d284e9bc54,295,245,50,Europe,14,1510.79
9ab5382c23824bbb8c3ebfaf3705f360,365,349,16,Africa,22,1841.47
9ab61618f196401ca3cf3d382a658d1e,326,308,18,South America,20,2533.44
9ab68d933cc04e62bfd8b33aac969634,211,191,20,Asia,19,1473.87
9ab71d55851a45d19000b11f9803e2b1,165,113,52,Europe,22,1598.6
9ab7cbbf36944f04936d872667a45c2d,238,188,50,Europe,21,1067.81
9ab8b668b2f04f4bb07767845fb142c0,304,269,35,Asia,21,1696.19
9abddb3ac3d84abea2ce71857efbdecb,216,188,28,South America,23,1210.17
9abeaf6c373649a38115d66ae663e778,231,181,50,Oceania,22,627.06
9abf2d81bbfb47528498d1836609833b,86,39,47,Africa,21,345.35
9ac0049a4c6b40499f2eb582ed1c95a2,79,39,40,Africa,25,486.76
9ac06ea13cda416a96dae99121dca16f,260,212,48,Asia,20,1598.72
9ac38139b0b04e168088b38de6362373,244,224,20,Africa,20,1492.26
9ac684d1ae5147a89bf5b401f5f453b9,253,209,44,Africa,21,1258.97
9ac72644981449a3a7592c362a2beb7b,139,82,57,Europe,15,261.05
9acd2da911a94c81a559409927cca2d4,127,97,30,Oceania,17,726.69
9acfb97c275c4527adc5cc455b98b340,363,315,48,Oceania,20,1990.11
9ad2147e6bf34cfa891d56d4fd1fa6bf,311,292,19,Oceania,15,2340.58
9ad6c9dd830e413e933357db31db2eb4,144,94,50,Asia,19,933.82
9ad8114586484360b535e691a72e7390,115,74,41,Europe,20,875.65
9ada0fbd6f36400282e7e663b1a8a595,86,62,24,South America,14,555.15
9adc64a71a084d70bcbb1b7a3ba55efe,131,82,49,South America,17,488.46
9adc92d936f34ea6b5356cb6f95e629e,257,210,47,Oceania,24,1622.92
9add69ecba454a8a85e2c8d6dbeb8788,61,24,37,Oceania,19,253.33
9ae014367efa4556bb4d7f6a76843442,260,237,23,Africa,20,2414.27
9ae07dccabf04a38bb4c37085636aea0,259,239,20,Africa,16,2205.22
9ae1595e943b41909311dfac8a96d3e6,321,298,23,Europe,16,2889.12
9ae3ca0860d74d11b0ec8e637a5ee823,290,250,40,North America,15,1262.37
9ae42d39856e42bfba4fef4912ee3ca4,134,87,47,Asia,17,853.81
9ae5d5968494415093a96488a60fb7ec,270,214,56,South America,20,1425.36
9ae6257786b94a898e9cace97fc2254c,225,171,54,Asia,15,862.4
9aea594d1e0d4f94b6dff01ed65305ff,365,354,11,South America,18,2245.65
9aeb4f786f294646b73da75d0e993473,362,333,29,Europe,21,1540.35
9aeba310278344e38e10b07e27da38fa,203,176,27,South America,18,1590.22
9aec2c58ba1c48008b69ca14e9ee8671,320,270,50,Africa,20,2260.18
9aeda4291a81422d9f861fa80cefd2bc,358,311,47,Oceania,22,2091.32
9aee9e71b7b34237a95dd7962affac02,118,90,28,North America,19,1036.39
9af0cb1332d94f248bc04f6af487832a,294,275,19,South America,15,2061.74
9af21f130cac4e45bfa1bb2910b7fb74,281,266,15,Africa,20,2660.2
9af5e07fdbd14fcf8c9b1de9ddaf4922,126,97,29,Africa,19,1121.74
9af62b605a03490ca116d7d8ee3b5b30,325,298,27,Africa,24,2320.18
9af84294a2b84223bac3316f0f1f1fac,208,196,12,South America,24,2061.02
9af9c2f6e185488fa3e6e60639ec950b,92,48,44,South America,19,787.87
9af9da604ee14c74b674f9cdaa85d7bd,286,230,56,Asia,23,1510.11
9afc8e4bc5e44fe3978af047e7172d12,179,158,21,Europe,20,1152.42
9afcbffab19048a38e61f35f7424b751,226,191,35,Oceania,22,1758.3
9afe74e8fa8648e98fd500179af7b8f4,83,64,19,Europe,20,789.83
9b01f9cf7e8e461983830805e530acca,250,212,38,South America,21,1421.84
9b03c5cd24b0420db85690b05544410e,286,245,41,Oceania,22,1823.74
9b03e10791cf4daa9accf796e9dbe9a1,317,283,34,Africa,16,2399.79
9b04a880a1034facb3e2aa03a5b22586,251,192,59,Oceania,19,1275.02
9b04e89bc76542bbb88603afc3ecde91,190,168,22,Africa,19,2163.35
9b074e02781647ab85f502d15dffc040,32,2,30,North America,21,178.75
9b0876421d3c455abb5d6c02bf9a08ba,54,7,47,Europe,18,295.1
9b0a602507754336b78597d718000a74,224,180,44,Oceania,21,1567.35
9b0d5613920046e589e6c18d57ac92b7,226,208,18,Europe,17,1967.07
9b0d946c0aa048c2b43055f8cf0f29f4,365,345,20,South America,14,2196.5
9b0de3c70578409c87d17a3e9cf37d00,215,182,33,Africa,21,1724.68
9b12b3411e594de09aa4e328f0a45f53,302,247,55,South America,24,2167.3
9b12bc190baa47fd9746f3130beb3bca,51,22,29,Asia,18,179.3
9b13b0baf9594a1ebd6c5a32c0be9190,207,174,33,Europe,19,1958.48
9b14b3e9cf4d4b9186df74b34bd14dc8,270,244,26,Oceania,15,1958.35
9b1a367c8d9a411581dea2405684b930,339,316,23,South America,18,3275.95
9b1b6ff3b3be49479732525576a900cf,341,316,25,Asia,23,2618.56
9b1bf1ac4361460cbe672951e1785c76,130,84,46,South America,17,402.72
9b1c309facae470d800d5b459ef89916,283,244,39,Asia,22,1964.46
9b1df4d204c846378cdcf1aee14165ab,364,344,20,Asia,19,2742.68
9b20b6cfb6694498a50987b3ce5cfcdf,224,170,54,Africa,19,939.91
9b21152317574d2b9eff3d60dff7911b,61,42,19,Africa,18,329.27
9b22af49cc3c4c1e83409d3e79b748c4,231,193,38,North America,16,1502.04
9b293e6ede944c1ba1533f5cc3cb8454,365,339,26,South America,18,2469.68
9b2a225a30364863be58b2bb0d464b69,298,270,28,South America,22,2012.66
9b2aa2f2d24441069274e310506fb083,157,102,55,Africa,15,1134.23
9b2aa6f2fb8e4b71a659b28c16b22973,346,322,24,Europe,22,2166.41
9b2c2bf2d6f04dbf9f688c0b51c1e4ba,105,53,52,Asia,21,818.89
9b2dd1410b7d43f882ea8c476a45a602,82,40,42,Oceania,18,301.68
9b2e40f475214056bce2ac41a1f0e037,317,294,23,Africa,19,1959.66
9b2e74255adf4df0a6ba06a130154ea8,107,78,29,Asia,20,1029.1
9b2ec07ca23a4b1881a392141ad54e89,122,92,30,Oceania,19,917.54
9b2eec3e734a4836a27b94f24188a6b7,301,274,27,Europe,21,2174.97
9b2f22a434884bd18474da06d1d53b71,364,357,7,Africa,15,2999.26
9b2f70b0dbc54ae0a529316e810935a8,83,61,22,North America,21,1023.17
9b333c67522946e6adb784d56ef16802,77,28,49,Asia,16,510.33
9b34e3067c474e0cad429cb3beb82009,61,32,29,Europe,17,443.53
9b3542e60a7c4deb938804f3b0b034bf,298,262,36,Africa,16,1693.08
9b370cd16fa54790a2c424c575abc493,333,293,40,South America,23,2405.4
9b39e46050684f64ad82707b6dba7ed9,361,333,28,South America,20,1967.52
9b3c39d8092141eeb5a48e0cf556b9b3,315,265,50,Oceania,20,1812.08
9b3c46e5601c4de88de3b51c2b260223,118,64,54,South America,23,525.55
9b3c91fe024e44699a794561f7eb3840,153,116,37,Asia,20,1042.29
9b3e53f8be424e8bb17bb66da085a75e,176,154,22,Europe,21,1427.15
9b3ef4ef41a54f27b9a82c1dd1bce69e,218,177,41,Oceania,23,1251.31
9b3f35581dc4454b888e52743b6c2549,200,174,26,Africa,20,1352.14
9b41f725ce5d4979ae4d5e0a240d2c8e,259,222,37,North America,16,2068.47
9b438f36f63b4db69fe933d7e6bdcbe2,54,18,36,Oceania,19,426.77
9b47c47b90564f1ea995b72d3b3b0a77,170,153,17,North America,21,2045.74
9b48ad89cb0c4c7abc8719c7b0c9f6ee,294,261,33,Europe,18,1889.59
9b4a24e4f5d34a3380c340c980e6cded,218,191,27,Europe,17,1341.58
9b4b65b70f4f44649942efd8c3c482fd,136,83,53,South America,14,584.84
9b4c3ebf092a4aefab021efd755fb4f8,212,188,24,South America,18,1586.59
9b4d23eaf08c437ca2d8e9cfe6c0fbcd,363,321,42,Africa,19,1970.02
9b4f87918f80447a932f5c65ad2193f5,338,293,45,Africa,17,1671.94
9b4f8897c7c940be98e19349fd3f0353,163,132,31,Asia,16,1453.97
9b4f9668f440470a986e1caf43347d0e,74,42,32,Oceania,24,147.05
9b511d519c5f42d79fc14f75c1545b5e,258,223,35,Asia,20,1224.05
9b52af02cc13449c84bf0e92a74a19cd,325,285,40,Africa,23,1811.61
9b52f751eaf94e8f816b2739b6f293cd,237,192,45,Europe,18,1428.37
9b56994280544013ac47625f0715cf5d,62,39,23,North America,18,363.94
9b56b23d19204acd8269874dc0e0cdd0,334,290,44,Oceania,23,1823.88
9b581b2e435e4fd39f7eb994553cc1b2,277,243,34,Africa,18,1489.44
9b588a82e3424352a7636eac11131c23,364,343,21,Oceania,22,2045.42
9b5b2ae10c004af3b7139e83b5519117,59,21,38,North America,12,321.11
9b5c480990564f7ea3a7f01212b65a5c,53,9,44,Oceania,17,280.88
9b5e349aa132410bb3ba58d9c2870e8d,289,238,51,Europe,16,1344.28
9b60a8b2a279472dade0d7ea9a0e3c31,122,92,30,Oceania,18,1363.16
9b623c35552d4ff897dbed62cbbb712e,255,231,24,North America,16,1607.66
9b62855438454c53b1d26df428525ba6,229,214,15,Oceania,18,1977.7
9b62eef800404761aa3a9d8f5e2b4e0b,132,84,48,North America,20,650.3
9b62f211da28458b890c53af434c0c10,153,103,50,South America,24,509.21
9b633f3f7a7345ef916ad4aae5fad137,338,286,52,South America,17,1936.01
9b67149027d44283aea8ae8bfa72cf77,170,120,50,Asia,21,1366.48
9b67987e1cde4752a84dd950cad8e1e3,339,319,20,North America,17,2314.64
9b67bd0d7f1a4b8db9401045ec1d9006,149,98,51,Europe,28,525.73
9b691155192e4e38b7603b616eb7d50e,100,46,54,South America,22,630.13
9b69cccc0d854923855e84c837f54a67,201,184,17,South America,21,1090.24
9b6c4c9f2f0f4740a41ab98bfa827f2c,49,11,38,Asia,21,449.29
9b6c889c952a437da264b5e01dfeb3fe,116,83,33,Asia,18,626.11
9b6df35a32fc4f3e8595e437e0186b42,146,105,41,North America,21,868.74
9b6f5170e08e4db3b7d28d92d525c0be,133,78,55,Europe,22,368.68
9b7186b372b748fcb92e81e5a714ab84,223,187,36,Europe,20,1335.33
9b71d761f8004fb49b5c2e829f840639,138,106,32,South America,20,857.69
9b7378d18b9048018e9349baa06f9cc7,361,345,16,Asia,16,3205.03
9b7383c44a4a4e09a6eaa54cd738f0ba,361,310,51,North America,14,1840.37
9b743b6f7769442aa06ad54026281f5a,252,204,48,Europe,22,1158.56
9b74b2e7da8847d7be70b61f0f3b30dd,157,123,34,North America,16,825.52
9b762ce0bbdc47d1b050aa6bd9033e46,220,187,33,Europe,22,1752.73
9b773f7d2cfe45e68b44f646c8cedf73,365,330,35,South America,18,1700.16
9b78009e6a1a430da1dcde9962c370f7,365,362,3,Asia,20,2183.54
9b7991ab4a424e2f9efa5fb41ba3c309,294,244,50,Asia,20,1473.99
9b7add26e47f49f59ece0066f20d59d6,227,174,53,Europe,21,1181.32
9b7af584aad24e70a1edf329b83c81e4,276,246,30,Africa,19,1991.99
9b7e1380de684df69e34029dbba37da1,241,208,33,Africa,15,2281.29
9b822c6915054c47978aa0c1a0e63eca,105,59,46,Oceania,20,579.12
9b82a8d1548042639571dc029829e433,95,50,45,South America,17,495.16
9b849a34daa04f6d8feccd46bd5ecbb8,296,246,50,Asia,19,2560.77
9b84f426bc7744a08bc6f444bfe5db28,29,8,21,Asia,24,340.29
9b858deee1ba43b6bb7c91423f580a84,365,339,26,South America,21,2529.39
9b8632b0765b4f1a912bbee9699c2a02,339,316,23,South America,18,2526.29
9b8886fe106f4bc6987632c05b05546e,207,159,48,North America,20,1062.84
9b899c8eb5634b16a5af3d69d5bbe5a5,304,266,38,North America,18,1856.4
9b89eaca746c4b76addfc461cd4869f2,344,325,19,Africa,18,1941.31
9b8acb0d1801458e98a5594a0fc5c1b2,118,100,18,South America,16,854.29
9b8adc84c5ee4de59e47e894112fd6a8,187,138,49,Asia,18,642.93
9b900b5132e34350bebfdd33035dfa32,330,288,42,Europe,21,1816.84
9b90d81381894122b7936d754dac8454,242,194,48,Oceania,20,1211.81
9b93c8f362454a77a58dcaf463d0d61f,337,318,19,North America,19,2173.54
9b946cdf4a4f405b97ba664acdd86e05,273,236,37,Africa,20,1956.73
9b961664ad224406a7ad755a2a1cb8e9,365,333,32,South America,20,1894.49
9b99532c345741e29a0d42873f57a871,168,145,23,Africa,17,1474.52
9b9c6d49c9b14b2086500688676e875c,206,179,27,Africa,27,1403.39
9b9c7612a6e24d5dbb41006d43d8fb17,329,306,23,North America,22,2244.23
9b9e5221edd044aebec9a9675e6c4144,147,116,31,North America,20,1227.17
9b9e552011774b25ad09c01bf8c9c31b,293,253,40,Asia,22,2461.11
9b9eda918456420cb3156a6e3bbde8eb,294,265,29,Europe,18,2201.89
9b9f1a1e6f4941eca6cc42779ace7152,196,174,22,North America,16,1748.96
9ba069cc40b84119b362ecf425adcd8f,365,327,38,Asia,17,2390.26
9ba0b45a8a324bc49359ab97d41fd835,153,114,39,Oceania,28,501.61
9ba279c603b14e3d92353fb9fdd24d50,365,365,0,Europe,20,1700.02
9ba2998a18104b07b3b4d7007a00ad37,153,118,35,South America,20,695.48
9ba44e69fd3c4eeab6bf0f24308b9920,92,57,35,Europe,20,552.66
9ba4a540bb494ea09f5c101d7fcb50c1,359,309,50,Europe,14,2384.9
9ba5647e04104d6abe318b8f3ac5c2f1,225,186,39,Europe,27,1814.6
9ba7d086fda04d3d94ae7e17886bf695,138,86,52,Oceania,17,428.46
9ba9566a7d094261a113d7c4b74d37eb,233,182,51,Europe,24,1393.14
9baa88d4a6b54282aefab1d9ec462849,171,113,58,Oceania,20,827.02
9baa9c1a1cdd45f9a1318122708e207c,238,220,18,North America,18,2110.15
9bab6df044154deaa657606889872d2a,233,208,25,Asia,21,1764.61
9badb347a14c4196aa442a16f3f127b7,358,318,40,South America,22,2443.35
9baeb26f2d294c84a6f6561cd5c92fa6,365,312,53,Asia,23,1940.36
9bb0244a95364a279130cef2746a61c1,87,41,46,Oceania,23,586.63
9bb1f1171c1c45028d11657a72593258,159,105,54,Asia,24,951.34
9bb268b2e3104227bfea40fc96aa4c53,112,74,38,Oceania,19,339.47
9bb27c039cc549ee9b038d6d58a49362,143,97,46,North America,18,683.87
9bb311cad7db4931b281d87259489ef6,59,21,38,South America,22,335.98
9bb3c193c45d41e492f7024b41ea4bff,321,297,24,Oceania,23,2308.81
9bb451996d55496fb78d9ef12dbd1e0b,117,60,57,North America,21,729.82
9bb99fa08f09405eb2099ab21da014c5,296,243,53,Asia,21,1755.5
9bb9f4d179d04ee395b5f6da4cccaba5,116,87,29,Europe,19,793.99
9bba6ed0d4ca4997a223458bbc4374c6,338,285,53,Africa,21,1788.89
9bbb93363e12461b8fd0efb2598fb9f5,42,20,22,North America,22,226.03
9bbbc53b8058427c8652fdb1a7583b0b,92,41,51,South America,18,677.68
9bbdf03e04c64a859ccf94512d11cab2,256,211,45,Africa,17,995.47
9bbf2a7db9de4608ab786ed26a47716c,72,49,23,North America,21,413.4
9bc3d8c4d6f0446c9618fdca131ec090,98,59,39,Europe,20,430.42
9bc6bbce64ec411fb118ace408a17b8e,310,280,30,North America,20,1982.4
9bc93f7ec05e4a58a5c9618f5aa7625b,88,30,58,South America,24,477
9bcf047722994ae08f1e70653acfda11,54,1,53,South America,16,260.8
9bd168a440844cbfb38f4d2b725b5568,190,129,61,Asia,18,921.2
9bd842ac0bfd40b6b6b43a8f9bd609e4,45,16,29,Africa,23,151.03
9bda2ff91dd3438f86e3bcadbed3faa4,249,210,39,Oceania,24,1381.13
9bda45d9556c4c33bec6951e12d9c97c,136,117,19,North America,16,1173.2
9bdd890a6c5747468d48708ea6caf2c1,36,2,34,Asia,22,280.78
9be10ca13b64448885e1a5c495fbfbd5,281,246,35,Europe,20,2229.77
9be123ae08184099a552ee5c29b3719c,363,324,39,Oceania,19,2107.55
9be1f682194d466d9f46bd21f1878859,81,59,22,North America,11,643.99
9be5a299f68440608d6b49d309b426dd,351,309,42,Oceania,21,3164.69
9be691143ff8428da20c29382f05f0c4,354,317,37,Africa,26,2149.81
9be8017c5561425797ba152e0ce1ab08,179,146,33,North America,15,1011.88
9bebca53fc8948dc867fc5493920d6d8,238,191,47,Africa,24,778.82
9bec95dbbd3346829f436465fb137bf8,121,78,43,Oceania,19,717.2
9beeee67ea0e4c5bb7f8f4c8cceeb287,285,245,40,Oceania,19,1583.12
9bef1a5a24d040da8ed36fab4ac27be8,365,315,50,Asia,20,1760.65
9bf03b5e4c584c568c913b012d3ae883,365,313,52,Asia,18,1744.95
9bf0f91576fa49a4a173c27b57fb1471,253,210,43,South America,18,1467.84
9bf27d52052f4193bf2fcc0608ed2494,354,316,38,North America,23,2295.39
9bf39e36dd7a45509f99eecef7b2b455,295,259,36,North America,17,2031.3
9bf3e6a2b29d4dc086bc077bb241da60,361,360,1,Oceania,14,2829.09
9bf4759cb39841e9b8d7dc1bfe7233c6,225,190,35,Asia,17,2038.58
9bf4efe428f94ca1b310b32b67e37f00,145,96,49,Europe,23,692.46
9bf69004a2c84b69ba0c9211fdd12dac,322,305,17,North America,18,1693.89
9bf6bb32328244109457b407827415f5,352,319,33,Asia,21,1976.43
9bf6c32df5b64422977e8ace81273a93,363,356,7,South America,20,1522.76
9bf74c5cc00a4ee88250774b7fb795b3,83,59,24,North America,20,352.32
9bf89e2ce0164c0494bf28658ef4e221,63,31,32,Europe,21,378.92
9bf9d699bf9443479cc97cb1804ff0eb,326,297,29,Oceania,23,1840.7
9bfb655754a841be8f1d5412890f9e87,298,259,39,Europe,17,1656.26
9bfc1c62fbee40c796e42619ec40f820,83,36,47,Africa,22,374.67
9bfccd08e15d482f8e06c45b7a59472c,57,39,18,Oceania,15,490.82
9bfdffd328d34572a19170ee506f9fb1,240,186,54,North America,20,1036.31
9bfe50dea25e47f5a75e6708c47825b8,324,284,40,North America,16,2456.15
9c006cdfae3047aa8d94583c316b59b5,118,75,43,North America,25,538.5
9c008393141d44f787ef876e89a85ad0,116,86,30,Europe,20,995.04
9c061b09fa12467db55a8804c736e8b6,244,201,43,North America,19,2168.53
9c06513664df48d98acf06e31087b794,114,62,52,North America,19,467.24
9c08592d1efb438ab24a0a4fb7040ed5,87,45,42,Oceania,19,476.02
9c0a1b7422af41619defed1d118e01e5,349,315,34,South America,19,2863.86
9c0b787e359d4e06ab8c0bb7a3bba0e9,41,26,15,Oceania,16,261.43
9c0c10630046499c83729c861be32116,142,98,44,South America,20,733.6
9c0db50579014e40b3f4eeb82ea6768a,284,257,27,South America,17,1887.18
9c0dfd92db1948ff920eb61f6392b9c6,220,196,24,Europe,19,2230.66
9c108e42911243479392b7ebce32b993,188,168,20,North America,16,1298.22
9c11c6f0d679448f85ba50add6c81570,248,202,46,Africa,24,1500.48
9c13822326954a098ecb14544d4ff4cd,146,105,41,Asia,25,596.47
9c14072f89234f5fb799c093c9ab5620,301,276,25,South America,18,2417.9
9c1630a801ae47a7ad3523393bbc6279,365,329,36,Asia,16,2289.01
9c16bf43df3e48909f7d551587e33bd5,256,224,32,South America,22,1737.52
9c17cd1e7dcb4efcb0e774b69b44310f,248,214,34,Oceania,15,2288.99
9c19a78781394702b96a9316bbaf459c,287,243,44,Oceania,16,1031.93
9c19e21d2e944cf587b3d7cd2815d078,216,180,36,Africa,18,1490.32
9c1b5cdbb393478fb534c81642300922,283,257,26,Oceania,19,1778.18
9c1d44a6719045d5b7461834e3fcbdb5,365,332,33,Africa,21,2166.71
9c20afefd7654589b6ff813df1f75e0c,140,96,44,South America,19,961.38
9c21d95486a24ad59bc40901ab25c22b,348,304,44,Asia,20,2010.31
9c2520999d6441e2be97b94ae4238b6f,261,208,53,South America,24,1261.8
9c2649a43e6149259995bc372b787941,273,241,32,Europe,22,1639.08
9c269dccbadc4e9b96a2f7359dc34578,42,21,21,South America,18,260.6
9c275360161e43a2b46f69d688615a80,47,1,46,Africa,14,254.56
9c2784f33f0b4247acea415f8242ecf2,327,292,35,North America,15,2441.94
9c27bc7f9fbf421495a83b8432bd46c7,360,360,0,South America,27,2149.95
9c27fa59036c40059b3791357d8df5da,328,299,29,North America,19,1960.99
9c282fa9558d47bf942542c9e39b65ed,256,216,40,North America,21,1284.99
9c2e8ecd7ac7459992dfa18a57dcae18,365,359,6,North America,21,1818.83
9c31a7e932c04f02b5b3e2a7ffd665c1,55,30,25,Asia,25,329.88
9c31f1b77d3f4b5bbf65224253fecc14,165,110,55,Europe,24,868.6
9c32baaee3224affa2693f08b07aa8bd,241,215,26,Oceania,18,1745.69
9c34345527b647a892d4f34bb65e8964,54,14,40,Oceania,21,351.77
9c35425a81aa421d9ccbe888d036d6c7,251,214,37,Asia,19,2193.59
9c36094ab4e34c18832ca8e756e2d04c,101,74,27,Africa,26,535.97
9c36529c7e7942b9bcffed872c95c0c1,127,84,43,Europe,21,581.92
9c370e2e1b4b4de3b15c7097b0382066,202,159,43,Europe,21,1264.69
9c38ed4394b144d3bdce906c7787f933,188,142,46,North America,24,580.23
9c38fd2f96344801b2fbe416237ef56f,365,364,1,Africa,25,2507.81
9c3911f47f7a4fa8a73fd3a023dd8a12,326,288,38,South America,25,1756.69
9c39f3bf55a74534b2bb983d4abd0940,351,294,57,Africa,23,1952.79
9c3b1e08eddb409e91b12ce21549f920,288,238,50,Asia,25,2285.17
9c3c8f6801894cd4b690a30bd262b589,101,88,13,Europe,17,602.5
9c3e01f410084274b749a26ea3e19170,239,189,50,Asia,18,990.6
9c41abc1ad9f415a8cbf6b28916ac5b6,205,168,37,Africa,18,1472.75
9c4539f4cee44b7c8fe7bb8e3226a1cd,32,4,28,North America,21,170.33
9c46923643af4b188c372da4eb38c1a2,237,207,30,Africa,22,1746.93
9c4c5d07c7154459b7be96ef34e67a5a,364,351,13,Africa,22,2916.78
9c4c87e595ec4c82b7f620b654b67479,224,182,42,Europe,18,1543.18
9c4d4aeb7a63474ca31eed7a430f50dd,216,170,46,Asia,15,1286.08
9c52563a4d6e4857bf7f27904245554f,33,11,22,Africa,21,140.09
9c52c74a26364eb1a590c39a53a9243e,140,87,53,North America,21,717.93
9c52ea8b93934ecea4b7bed89192104f,248,220,28,Asia,19,1871.52
9c53d14f7b9a47a99a9b57492835bf5b,36,19,17,Oceania,21,228.83
9c5777f9d91b40db8e4c73f6856a74aa,339,316,23,Europe,18,1777.12
9c5991b74c2e4cd494492ae0c6335d74,293,245,48,South America,20,773.19
9c5b3b840a2942339255a8d9645799d7,289,247,42,Oceania,23,1597.04
9c5e49f734c54c078f053eb9c96fd540,309,283,26,Europe,20,2017.47
9c5e84932d024cbd8801b420e66211d5,365,342,23,South America,19,2012.25
9c5e8b73fae1413bb92ba605788124d4,304,272,32,Asia,23,1378.21
9c5f21df0bb84b1b905171da099310b1,148,94,54,Europe,18,625.17
9c61a0935dbf4dd6aa0010ac50d38d03,71,18,53,North America,20,290.93
9c6e628c88df4d1abbb82e4c65718358,365,365,0,Asia,22,1726.98
9c6fbf4c6f7d433e866365dcfc827509,83,45,38,Asia,20,619.38
9c727cfe143641f38e0cb728fa58c33c,172,125,47,South America,16,662.02
9c72fb01a9894b1e802be8e7dbdd92a4,105,60,45,South America,19,383.3
9c737b9a9fd245b0a2a440149d95ace9,121,91,30,Europe,20,782.97
9c7484b7276546d5b97f240b5aace7cb,117,82,35,North America,22,576.71
9c759f5114784ecb8df86f1c1221604f,147,122,25,Europe,21,1674.7
9c75fcdee4184267b907209df8095a31,307,259,48,North America,16,1647.11
9c76b93bed4e4450a583ad75cfc0331f,92,58,34,Oceania,21,354.12
9c76df9072be40df87bb7a50dfdfcd0c,182,135,47,Asia,20,909.78
9c7897eac0c94f5f93541e1d68c443db,136,80,56,Africa,23,473.93
9c79ab06f8d24d819857977b93d4ba71,87,52,35,South America,20,510.81
9c7a5eb28b314717b845a91da366abc0,305,255,50,North America,19,1361.34
9c7f9335311a46608e8ab240ced41b1d,76,31,45,Europe,20,349.4
9c7fff60c8a04ec587ad6e45a81501c0,178,161,17,Europe,18,980.38
9c805fd5c9a64de0978830a557c8368c,139,107,32,North America,23,996.58
9c8141313343461fbf9b248511e5908c,163,143,20,Oceania,11,1359.67
9c870e7c0e6845f1b57b1d12f9e3edb2,364,328,36,Asia,14,1735.91
9c89c513fef24982a8ba0665212fef7c,108,87,21,Asia,19,1132.47
9c8cd27df0b54044bd25ceecdc8eb1d2,365,358,7,Europe,18,1610.91
9c8e562dcfee44e78742c9e754f45cb8,303,279,24,Asia,17,2510.77
9c93ba400f6d42edb2320035d8d9fe4f,357,325,32,Oceania,17,2644.33
9c94e5e73865463796eb43094aa9fa6a,129,84,45,Europe,22,660.25
9c98a7e4378f45348a4d35c3feef0a96,102,67,35,Africa,20,670.08
9c98f6b01a864651ad0a2c23f2b3e2b9,101,53,48,Asia,14,361.75
9ca061f302ba4500be730d2661aa3b7a,61,12,49,Europe,24,773.95
9ca07b44305044168097cb56d9cccab4,242,197,45,South America,19,774.8
9ca17e2b81ac4d8cb93490743f62f160,180,132,48,Oceania,26,688.77
9ca35fd1b4a84939b84818b3befe55a3,361,324,37,Africa,23,2251.88
9ca732557e204d9a892e6ddefa326635,54,18,36,Africa,23,490.59
9cab99aa89af4e41bfd29deee46145ed,361,345,16,Oceania,16,2824.19
9cac4f05f5f84c3ba8dab7df3af9dea0,116,68,48,Asia,22,567.71
9cae8cba12614b33835d3fb81aaef2f7,221,185,36,South America,22,1560.8
9caedea04c3449d79970c3e8d228906c,261,229,32,Oceania,14,1724.97
9cb31cf872f94acd866e3049b75f2fb5,118,59,59,Oceania,22,189.57
9cb4b6c1a7f042e48634cadf954954a5,113,62,51,Oceania,17,695.95
9cb535caa62a4414afd410a37d986af4,324,295,29,Africa,21,2069.58
9cb69e7191ad4b8d9f18f92c4e7aad9d,45,3,42,Europe,21,185.77
9cb99295aad74fd6b8cff22e3430bd2c,309,262,47,Oceania,20,959.09
9cbb5cbe47b747b2bed12f8fea3eeb50,325,286,39,Asia,27,2069.93
9cbb6d8ffd61443ba994f5a9bfc42bdf,262,215,47,Europe,19,999.05
9cbb6dd850a54d6b9264983b7a78676f,320,268,52,South America,26,1340.7
9cbc72b3b1fc4131a0bb6fd8041db55b,269,243,26,North America,18,1684.02
9cbcafd3c036433f89ccd4e0b6777a6a,363,323,40,Asia,16,1375.2
9cbd8fcdadf14c1d8c079893dba6421e,95,69,26,Africa,16,541.18
9cbf5aea2e68441b963cef4ff10ab148,329,305,24,Asia,19,1989.53
9cc25b2a27ac4baeb3b94b06abe8aaf4,65,45,20,Asia,18,450.61
9cc38c587425482bbd3efe1448a7690b,182,131,51,Africa,21,1105.72
9cc3a44993c2450c90c9cdb3cbd97f8a,153,124,29,Europe,19,1547.55
9cc4449e62cc4d168e4957fca74389ac,119,67,52,Europe,22,441.61
9cc5220665e141a982f4be2d7e87d7a7,263,256,7,Asia,17,2012.16
9cc66de7eebb46f291f8128afee929b2,191,170,21,Africa,22,1613.68
9cc67f376d384b3582807f25ec539660,160,124,36,North America,27,1345
9cc71f1fc65d4c35a8c8f7d0b06f184a,327,286,41,Africa,17,1994.52
9ccafd6d980c406f8eeba920b486ce4b,212,174,38,Africa,20,1685.99
9ccb1ae765904e069c22e032a3863d0a,364,355,9,Asia,19,2034.45
9ccb63c7043c4093bfbf543e863a0860,241,203,38,Europe,17,1943.32
9cccd5126b6b48709fb7010ee7ce84c4,267,236,31,South America,17,1860.25
9cd0a72693d4466bb0992d43aedb4d48,166,115,51,Europe,18,603.08
9cd4e273cf4e4eaab52e500006c47b81,274,219,55,Asia,17,714.33
9cd6ae31915e485f8697f86d7fbb229c,80,55,25,North America,20,253.69
9cd7675ecc2d47acbd0f4c50b3bfe7d1,99,61,38,Africa,20,587.85
9cd817cd05c14aeb946dfe7075fe8391,50,7,43,Asia,22,515.65
9cd8bdfaa92a4f41894c13e4aaf9f133,194,139,55,Oceania,22,990.77
9cd9d202ed6a4fa5aae0087975bfa533,345,315,30,North America,17,2944.6
9cdc244528794f19a8e4e73de1528955,62,12,50,South America,16,331.53
9ce003b0f42342e0821b69a070e0b9d3,317,261,56,North America,19,1694.23
9ce07f5151344410a006aab6c437f1bc,153,112,41,South America,24,838.93
9ce0a34ce63c4a908e2c0973091acb97,89,59,30,Africa,21,954.21
9ce39774d8cb48c39762a132948e86c0,349,289,60,South America,16,1969.55
9ce4e733d1cd410b8594e2dc5e978d73,141,83,58,Africa,23,860.13
9ce7a6fe177547d7a8f618e96c444462,80,28,52,North America,20,623.73
9ce82cca284741209ecb134215ba78d7,184,135,49,Oceania,14,886.3
9ce8cdd808b74f459e2b19f305fa67f7,86,45,41,South America,16,411.37
9ceaf69bb1d3476890f71ebf456b4945,75,27,48,Oceania,16,379.77
9ceb06e616b541dabfc7762e144f4c19,220,194,26,Asia,17,1885.33
9ceb091ffa644dc4a7932a4c92fd805c,183,128,55,South America,19,780.04
9ceb7174e8c64cae936e4e89b3dab14c,131,105,26,Oceania,20,1184.46
9cec513065e641a2a025dc308a0cc12c,364,352,12,Asia,22,2126.95
9ced75fee8714d2283f195595d9e7db2,77,40,37,North America,21,573.75
9cf03828d6e948bd87019de5f6cbf5d7,42,2,40,Oceania,18,117.05
9cf0c279334d4d2c8421e31f3f19372f,365,333,32,Africa,23,2532.57
9cf12701cb9d4dd582239592e558bd1d,206,172,34,Africa,22,1358.52
9cf143f3052e4a439f595f6d90d98e99,215,183,32,Oceania,20,1431.38
9cf1b7e9a165499d93b1ae0b62e3afd6,347,326,21,South America,25,2281.4
9cf4eb73065d43b79253424ddc801c06,271,220,51,Asia,19,1218.58
9cf4efb4191a4fcfa63516154f069884,184,129,55,Africa,21,977.78
9cf6624feadc45b096d6149da566346d,231,176,55,Asia,19,1600.74
9cf70574a8e34bc6a763fbe54c33f4f4,118,86,32,Oceania,24,867.99
9cf73e8fc07747279c64278e068bac48,327,280,47,North America,22,1957.48
9cf848ce23dc491e9f2db3f4787d3aab,168,129,39,North America,21,1046.17
9cfb53934f5b4589ace0394776ec3d62,179,146,33,South America,17,1746.51
9cffcacf4c3c4deeb88f281eb9fdeaa6,131,70,61,South America,16,258.79
9d08db541ef44659b013444818a3f7c0,364,318,46,Asia,23,1652.04
9d09437eaee04c50ab736f2049c4ace8,76,55,21,Asia,20,711.38
9d0b592fda7844d3a4ac088c71356a61,64,4,60,North America,17,443.22
9d0b92f65e1b4d28a7636aea88b81bd0,154,120,34,North America,21,707.95
9d0ba43e2256479ab5a8661a8cab42c9,211,180,31,South America,21,1033.47
9d0d97c2b06b415b936489bd03f76980,31,2,29,North America,23,238.02
9d0dc136e968411099657f870e948e76,359,317,42,Oceania,20,2090.32
9d0fc96dd57f489b9c5963b15d90f261,84,45,39,North America,21,723.71
9d14bdf4dc044199b7ca42290447f511,159,113,46,North America,17,886.62
9d1601c81ee84b6fb48d06a6be7b31e4,304,276,28,Africa,24,2521.49
9d16f44360524a58b49832ca947cfdb0,104,57,47,Africa,15,672.43
9d17225c906343eca24e61c9114be7e4,247,204,43,South America,23,2012.35
9d1860d73fdc41028d0a54123f625b85,95,42,53,Oceania,11,386.96
9d1a9c7ae79b41aba995c0e7164dedda,357,350,7,Oceania,20,1620.55
9d1e4b616bf94783a54bf1830a02d515,249,221,28,Africa,15,2555
9d1e5938f1d3429787a24f7747254a7b,259,209,50,Asia,22,2477.52
9d1edaa6b53744d5a032943cca7d6d74,365,343,22,Asia,23,2264.08
9d1f37af98334db9bfdc0f6697ac4d92,233,207,26,Europe,16,1456.8
9d1fc4fd730e43899c5ecf7c9f834882,42,11,31,Oceania,22,802.64
9d20825f6bd54bbda3f83b495919f98f,274,246,28,North America,23,1922.41
9d221a72409b4ce4819d65a1cf95982b,146,115,31,Asia,25,1012.64
9d23a8c9361340fbae911416a09fbf52,361,307,54,South America,21,1768.94
9d23f7da9b6a40d3b0f2b665d1b21acb,104,52,52,Europe,20,661.9
9d241dba9e854c7b9a648ece04ca0949,206,169,37,Oceania,13,1451.22
9d2472d228c1428382602ac3d8f4f190,247,214,33,Oceania,18,1871.38
9d271b9a7e9c44898c8978d3beedb143,289,243,46,South America,19,1579.84
9d2abdf6b8634fe08441fd810087ab06,185,160,25,Oceania,24,875.55
9d2c252996fa4a70801a1752c7ef7ad5,277,241,36,North America,16,1973.72
9d300e42f1f44d4db31d8252b3927d02,79,23,56,Europe,22,488.5
9d324a17356647aca744672e81de7723,227,195,32,Europe,22,1877.01
9d34e2b663794ac29dc517426bcaa9c1,315,273,42,Europe,16,1030.75
9d364e7fc44d464496bf534e53e43bbc,140,129,11,South America,25,1003.17
9d36d3ec36d64b61b63cf1f7369884f3,352,322,30,North America,20,2408.68
9d370b054c4f4de781af0cd0260c81e3,133,104,29,Asia,21,929.41
9d371970909249ec84bc9fad350659db,243,201,42,North America,17,1851.94
9d374d8865684b72a39a2d90d6ee737e,24,12,12,South America,20,161.86
9d38a00157624439aee75d9c7e4b7af8,253,209,44,North America,21,1871.72
9d3994e69051497b842893a19aecfefb,333,278,55,Africa,13,1929.33
9d399760abc842188292fe48e2aeb7cd,142,95,47,Europe,24,962.19
9d3d2cebc58a45adb7836b95bcb60c9a,319,271,48,Oceania,21,1253.77
9d3fe37acaee4467b66b6a4076e8cac5,190,143,47,Europe,23,1137.41
9d4100bd770c43d0adf7e809ef0c21a8,80,30,50,Africa,22,221.37
9d428f5cfba24df88d253370ab4f46f9,79,36,43,South America,21,288.06
9d42d1c6b57548f298ff5304b0718c9d,128,97,31,South America,16,395.9
9d43d18de8ce4af0a997dad37220af74,301,252,49,Asia,17,1104.15
9d458eb5e44a43a29d04465243ba6c8d,229,211,18,Oceania,23,2123.41
9d460c1965654e818a107309fb69f28c,91,41,50,Oceania,18,456.82
9d466740f73847e3a6772d24e6b6c210,172,128,44,South America,19,943.83
9d467800556046c082f232d6cfee9df8,193,153,40,Africa,21,1594.14
9d4a71ff79dd4edfb6419b7b3f275761,309,280,29,Oceania,19,1891.8
9d4b02c4883c4311904fbb2a0f181456,91,50,41,Oceania,17,488.11
9d4c12a14e6d4010a2fcf9f1fe12003c,340,290,50,North America,20,1683.31
9d4fb85628cb4b7780172c49bb25352f,201,163,38,Africa,17,2076.28
9d50a0a1425b40f4b8f8c7c19488cff3,269,239,30,South America,25,2168.59
9d511fb25c6f4fceaa72d5936f79ab5f,169,136,33,Europe,23,1587.19
9d51c7dc51784d05bf71508033a3a57a,148,114,34,North America,19,1310.04
9d5271dd68404c5e82d325c1ac38e1fe,122,106,16,South America,19,1395.13
9d52ecc90a964b50b311412a44f643d7,301,259,42,Africa,17,2089.58
9d5478ef63904a07a8f76e7fd5c9135e,365,336,29,North America,24,1955.88
9d561b7b45a540fcae33ea4c93046047,321,273,48,Asia,17,1474.01
9d583922d30f4ff9b4ad6013a041f1fd,170,150,20,North America,18,1795.85
9d5a4c5bd387457c91f837b298fda95e,318,294,24,Oceania,18,2771.36
9d5ab24d16c24441a6eea4aefb3a64a6,235,206,29,Oceania,16,2044.93
9d5e208be7aa477e9a0b112255788912,165,123,42,Oceania,22,1116.31
9d5e55ccbb0c457b9ed867e903861aac,90,59,31,Europe,22,444.38
9d603401343d4b19ab4fcce0c4185d7f,269,242,27,North America,17,2116.16
9d6040a391a84f62923f33a14c429930,365,363,2,Africa,19,2116.45
9d61ab9c39744fff8c2c1fb64471ca11,280,261,19,Asia,23,1655.4
9d6218e157cc44a8b0bae3089505f293,350,336,14,South America,17,2686.54
9d63c2ea0556462d851fa7eee1479e4f,147,128,19,Africa,23,816.6
9d63d9848a8e4f8e99e2966cc4446f15,90,56,34,Asia,25,305.85
9d650ed0dfec4c71b49303e0a947181f,187,152,35,South America,25,1374.97
9d66f49cdf0e47209dad9835f59ac779,333,301,32,Oceania,18,2086.03
9d6781a350ef4e16925549858c15256b,365,339,26,Oceania,20,2597.72
9d685fa34167437dab152f212108bee2,252,214,38,Europe,19,1689.64
9d6a435097134e70af6460d2b2f80f6a,219,183,36,Europe,18,1000.06
9d6bd33421a04299b1a6f5a0712387e5,120,86,34,Asia,20,870.76
9d6c502a704c4954a38fedd98b71f875,334,317,17,North America,14,2605.39
9d6e2d8113ca4c2f8ed2d75a230a303d,54,7,47,Europe,17,120.99
9d6e44eecebc4bfebe5bfe41acaaa2b7,296,256,40,Africa,15,1568.59
9d6e504969b54595ad201f203d4fac57,224,178,46,North America,17,1331.41
9d6e711726f543b88fcc0578ce3ef5c0,259,245,14,Africa,17,1560.37
9d72f88bd5d1419b9becef336f468a12,335,287,48,Europe,24,2205.35
9d745122bb334d979cb7a4826e476aa5,364,364,0,South America,19,2323.15
9d746041f5d340aab0edbe6389e4d1b3,62,24,38,North America,20,598.96
9d74a53426f64c73846766c3626c86a3,364,362,2,North America,20,2055.23
9d754cb971964e57991dadd85b880cad,125,74,51,Europe,23,546.21
9d76067ffe754d22baa6f197643ad00b,242,217,25,South America,20,1666.2
9d761628bccc4463885a80877281309f,214,164,50,Europe,19,1513.25
9d784a6b06174aa3b368f57ddfc777e1,363,356,7,North America,20,2723.56
9d7ad45ce8044cdb9e7c81ea8cc0dd03,365,344,21,North America,22,2253.14
9d7b3e53b40e4c7e932745330c4908f7,120,93,27,Oceania,20,1085.54
9d7b8327526543569b595ff9813b609c,67,26,41,Europe,24,401.34
9d7d3b6415fb4781a353af334b3e35da,345,293,52,South America,28,1684.59
9d80a2ebbb424a2286716a512e93dbbd,340,308,32,Europe,18,2394.95
9d80ac8eab784dfc8dd35afbabc9b22b,325,302,23,Asia,27,2690.18
9d81574c86e447c182c1237593c9291c,339,318,21,Oceania,22,1735.36
9d833fab20024a4392d5b40dbb523c9b,364,353,11,South America,23,3193.47
9d840adb02e440de97ac26dfda216bcc,208,168,40,Oceania,18,1431.54
9d842c7062fc4185800a7d6aa6aadbc9,254,225,29,Africa,21,1750.83
9d85affd715a4cc1ae8be1a9245352bf,52,16,36,South America,18,336.95
9d8634cf4725442babe97b0078a42b9f,42,11,31,Africa,18,120.17
9d876741af7f4e01a035d3386a741b89,113,74,39,Africa,13,676.9
9d887be5eea9482aa4d485805b206372,339,307,32,South America,21,2807.21
9d8c4f24f12b4a24818765c3fd39dd45,280,261,19,Africa,19,1833.92
9d8d17d66e6e4a688688234c67e321c0,168,120,48,South America,22,1186.24
9d911157821c42d592deb0f5ea62b5e1,263,236,27,Europe,21,2037.52
9d916cb9dc0c43109c9354034b5b1a86,360,326,34,Asia,19,2208.33
9d919cb58fa54c4fadc54cfe2e152da5,350,322,28,Europe,18,2209.25
9d94af894735431b85cee0954a1ca91a,141,99,42,North America,16,656.88
9d97261f7d714fc3a8f2d8b6db06b73f,83,43,40,Africa,24,513.22
9d9b5c96c4f44aff990c0bfa50051a74,266,224,42,Europe,22,2343.74
9d9cb1e516584b5dab7b5fb2302e3f44,236,194,42,North America,23,1475.22
9d9d35e197154e8c8e411a8331a27907,264,214,50,South America,19,2054.99
9d9ef57dbe9e4ed2a155a8f62369a7f7,357,321,36,South America,20,1991.8
9d9f6d24f5aa4df58c4a3cbf43a87fb8,228,197,31,Europe,18,1553.14
9da0582fe3e247fe9f0ae2571d3436dc,363,337,26,Africa,17,2301.39
9da095019a0e4180a38ef1e440b8ad33,154,113,41,South America,22,954.92
9da1ed99a5b54594994832a8545acdb6,365,327,38,Asia,22,1401.72
9da22682eb9d44fb814f497ca7ab7973,362,314,48,Europe,20,2021.69
9da40dcbf11a46c0a9782da57231e055,92,74,18,North America,23,911.18
9da997e3c4974b93bb26cc5cb54da23a,227,201,26,Oceania,27,1830.04
9da9a08c177448618672cf570082357b,87,52,35,North America,19,634.75
9dabd819e4f84294b3fb3b896f102cd0,96,46,50,Africa,22,259.79
9dad2ff69e20483aab143413a89c147c,305,263,42,Asia,20,1417.69
9dad9d26e0e54cb9a553cee612d461e5,105,54,51,Europe,20,545.1
9dadf34ca3f6488c8bef0f7184518368,96,50,46,Europe,15,683.92
9db3975dbd1f4e468060c6522d57a435,354,333,21,South America,14,2373.85
9db4cc9ee3a2469ab556ab2de327ab1b,59,21,38,Asia,22,526.78
9db6b39b2c0e4f30ad93c77016f30b3c,264,222,42,Africa,19,1307.4
9db76633395f4d0a804bb11ac6de5d74,307,286,21,Europe,19,1589.95
9db77a9df2dd44a8b19f35d07e0ad0d6,209,180,29,Asia,19,1705.42
9dba10ce9998452fad3e61f8dafc9b74,77,46,31,South America,24,455.11
9dbdf7a16c034c7d84eaf702c23a5122,203,186,17,Asia,18,715.96
9dc025878b1b4751b8064e5badf1c52d,89,63,26,Europe,22,538.68
9dc12eda05334d42ac9d886d0cabea52,296,271,25,South America,22,2679.69
9dc13614e56c49ddaa989b8e92eea8d2,26,5,21,Europe,22,328.66
9dc244ed9ac64d45a98c1db9933400e8,207,167,40,Europe,18,1421.13
9dc2bd43053f42fb8a2360490963c3d0,95,58,37,Europe,18,590.98
9dc2fe3244f544d898ff399f1354f284,184,142,42,North America,21,1193.43
9dc4ea79969a40ef820c4f2ac9f26a73,188,156,32,Oceania,23,1349.88
9dc4ebf1421c4699bfc73d18bb292dbb,365,328,37,North America,22,1768.23
9dc5c1ff7593415ab87ad760a027a1ac,278,257,21,Europe,18,1449.35
9dc6713540324dff8718bdd18cde7836,158,119,39,Africa,21,925.05
9dc6bff2a39e4b7cb457f11a6a60019e,123,69,54,Africa,17,624.83
9dc72a96e18c452ba9e40badaa6afc9c,152,120,32,Asia,18,595.53
9dc749d5d9034958a56a45920e257d9e,119,88,31,Europe,27,990.73
9dc8cce0ca7a4936987bea4fedc288cc,241,203,38,Africa,17,1690.97
9dc8d69906384f1590d70ba5009e6e24,174,135,39,North America,17,1061.28
9dc9305b1f7640e89cf785de658e4d59,80,52,28,North America,26,667.62
9dc95c66a0534aecb4824837a637387a,319,274,45,Europe,22,1748.67
9dca14c4e38c4b09802b978ce31ba558,312,280,32,Oceania,24,2778.86
9dca8a5cfa414a51a365a28f8b81bad1,115,88,27,North America,18,449.97
9dcaba9676d34394a47078e5033b3a0a,131,73,58,Oceania,16,902.38
9dd06030c05f41de8f5f5f9a645136ec,289,263,26,South America,18,1563.37
9dd3df9fc6d2428aac84e931c0d35f2d,122,95,27,Africa,26,797.33
9dd506c433fc4ae0bed07c1b0d168c6a,358,318,40,North America,22,2969.22
9dd5e24251d54cdda04d56220d7f3fea,363,338,25,Asia,24,2806.65
9dda7097139e47a4983c0a3803b69201,365,341,24,Oceania,23,2313.7
9dde052bfbaf48fcad8661f2099fd88d,325,285,40,Europe,21,2312.89
9de07143b2a2410aa5c633b64b152d40,337,294,43,Oceania,21,2788.28
9de1061e1dfc45e0ac84860dfa133c98,85,56,29,Oceania,19,690.57
9de16167b214422d8ef835a7bbe9b1b9,261,228,33,Oceania,18,1620.99
9de4574e0c014605b91798e276c97a5a,144,96,48,Europe,21,562.95
9de5a34f286e44cc94a091126505c02f,84,59,25,Europe,28,579.3
9de636ecc15c44548857594c1e906f90,88,45,43,Asia,20,776.42
9de8136dc939407a99adca5533be2381,355,323,32,Asia,23,2305.41
9de877349e8048c28439f416322d5544,211,176,35,Asia,18,1434.47
9de8bd0b5e5446f2af8f323e3c9bfe89,321,302,19,South America,19,2594.35
9dea7995b5be44e6b6c3bbbdafdbf65b,115,64,51,Africa,15,485.63
9deadabcf2a64b409387a0f7c98691b8,167,131,36,Asia,17,971.57
9dedaf74ac634c48a69006bf5f7bfa2f,286,253,33,South America,20,2741.1
9dee89f3dcf64abf9584ede3ef946d3c,280,258,22,South America,18,2235.76
9deebf2f667e49bfb34371b6b7c7ea23,154,132,22,Asia,23,1027.8
9deedfc7d9cf4b71b8ab58482bb4a3f6,298,285,13,South America,25,2144.96
9deff6777efa45d6a040da7719ec1234,85,55,30,Asia,20,584.29
9df12f06fef5422f8714d896aa38a56b,26,7,19,Oceania,26,53.12
9df1853a7dab4ed5a2b735a8553b927c,51,30,21,North America,18,236.45
9df668d393b44b86999a366ec20dbc1f,146,94,52,North America,19,920.1
9df779a3c3404a8dbdc11e34420971b9,92,66,26,Asia,20,915.3
9df8e7dd216447d4a5288679fd8a0a87,338,303,35,Oceania,16,2506.28
9dfd49bad8aa4422b0931d26c44c6e25,340,312,28,Europe,20,2660.44
9dfd7a6196d747e8a0f581bb093c7441,89,69,20,North America,17,589.24
9e01e36f3ab74ecb9c8530a43218f6cf,113,86,27,Africa,21,635.01
9e044eb37eb5401db5f17f99c63461b8,52,13,39,South America,22,267.52
9e05496156e544d9a4e7ddd6b51ed5da,73,51,22,South America,18,778.06
9e06365a3e8f47a282ca99aa4853f217,94,75,19,Europe,17,964.55
9e0991b388a04cffaece556383f1fb91,159,141,18,Africa,24,1276.88
9e0d67457cd94040b89d9905d000b1d5,89,29,60,Africa,24,383.27
9e0dca91e6cc4bf2ba40685433b82445,199,148,51,South America,23,872.98
9e0ddc6b541d4a69860bacd65acb6ef1,320,261,59,Africa,16,1381.48
9e0ec5604f2b4b579d913d322c0a97a1,250,206,44,Africa,24,816.95
9e114c1cfe234dc480af9fb84eafa786,268,226,42,Asia,19,1425.73
9e12b924e801486c8b7c4473417331c6,341,324,17,South America,19,2718.51
9e15694d703344bb911befef93d2b150,54,28,26,Oceania,20,226.36
9e1586539903477ea7a8818ff729fbc4,299,249,50,Asia,19,1438.09
9e15cfff56794eab91a995fd6eb7c3d9,88,40,48,Europe,15,406.3
9e15e3971c8442d588dccbc8b4f18cf1,344,312,32,Africa,17,2120.51
9e15f96059c049c2883d279b44d930e4,88,42,46,Europe,17,368.46
9e18897b578246b7b26446fee2d0fa07,308,268,40,Oceania,20,2139.88
9e1a4ac811ac4f7d946d65e78d7c3224,291,266,25,South America,17,1930.43
9e1a54c5efba4486af79a03d315f1210,249,216,33,North America,22,2141.28
9e1b2ba157e24585a29cfc9f6ed1053f,274,238,36,Asia,18,1808.23
9e1c1f6a95234ce5913188331945196a,212,172,40,North America,24,1395.56
9e1cd33751434f1d96ccc954f8ed9c40,252,196,56,Europe,21,1030.89
9e1ce804511a4918a41932fa86c79ab1,205,170,35,North America,23,1113.21
9e1e4dcec9ef41f687cbba5671528bf4,150,130,20,North America,20,643.41
9e21867d4835427fbef7c51bb54255f3,101,56,45,North America,22,396.02
9e23259821704db1923bd1eae1be4979,56,2,54,Africa,17,564.63
9e25f24b195043bb93d5c1bf949ed0cd,132,104,28,North America,25,836.13
9e266d53d3ed4e74ac1a21a39061c86e,308,267,41,Africa,19,1900.05
9e2c87a5ee7c41c59ce90bdce1cd5b6f,148,122,26,South America,18,913.18
9e2ec226f810467eb4defe6bb76e9916,73,40,33,Europe,18,1039.57
9e2f722e87c7421a8b5e0360801ee53f,118,86,32,North America,16,750.25
9e300be3e97145c2b7f73d77d6e25dd6,338,306,32,Europe,20,2218.2
9e338708aee9497d9f812e1c63ab2922,342,304,38,South America,14,1996.18
9e374a00f492484ab0e9fc1cf13b8181,277,244,33,Europe,26,1718.76
9e3d2fb6750945378d0b1eea17085863,142,115,27,Africa,16,1418.72
9e3d5c9bc5a44307a4a81e7d9f2d16b5,294,262,32,North America,19,2140.84
9e40312fa50f4e5fb3e6a37668f81939,355,327,28,Africa,22,2421.02
9e4182067bc249e6ae3db0cfb23405cd,138,87,51,North America,23,577.42
9e433c424c624bb68973f578dd1e6a4c,354,306,48,South America,23,1963.27
9e477f687d0c4faca9ba340693776a02,186,148,38,Africa,19,1478.26
9e4ac711a6014bd382292020be34bf50,170,151,19,North America,22,1222.43
9e4bb31b58cd44e89c738c42e7d471f5,364,344,20,Europe,19,2173.68
9e4d16cdf8d64500bb1f7f80ca82719f,197,170,27,Oceania,20,1484.12
9e4f4cda656e4961a9da08ca35f5337d,268,221,47,Asia,22,1159.24
9e50d97edeb84eea8bb8815cf037f291,148,117,31,Europe,23,1119.21
9e537e57e1284c4c9c1ef0be50032c9b,285,256,29,North America,16,2167.02
9e539a4e7f36422d94bda2ebf4f3c3d0,83,40,43,Africa,23,506.77
9e586f7968084c889cf836dd02a8ce24,171,125,46,Europe,19,801.3
9e58dcc9ca094c2a825fb8aeaa1f002b,164,138,26,Africa,17,824.98
9e5b2de0b32b462b9f884e73ecb96b9e,254,232,22,Asia,17,1445.54
9e5c6e1934cb4bd4824330840db2eaf0,120,88,32,Europe,24,772.51
9e5f672d8dfe4228a4bb376686048b9c,329,283,46,South America,20,2311.96
9e5f8326902d43da91bc1f6c74a127bd,189,132,57,South America,23,490.49
9e5fb06240e244b58ba23b86054fbe4e,89,48,41,South America,26,402.57
9e62e4e037a14b36a1ce7fdc23725059,362,326,36,South America,19,2064.19
9e6535d29ff8499f98c225ee99d80677,244,210,34,North America,22,1777.15
9e6a98a435a341b19cb2dff952f9ac41,201,146,55,Europe,22,903.29
9e6c62ff4ca64948af39bb9962d8e830,257,205,52,Africa,15,1234.29
9e6eacd4b2f2432ab3fa06af3e2b1f7f,119,65,54,Africa,19,580.73
9e72ff2603ad4220b5b52e7624f3469e,143,122,21,Oceania,21,639.91
9e731f7d901941e3b750ea285213f850,227,186,41,Asia,18,663.82
9e74b530a100440f9a7e83041c02153a,324,290,34,South America,20,2074.59
9e750f3828444f08b3148f204edf19fa,186,164,22,Asia,16,1790.05
9e79fdcc90ad4d6aa7a1fdba0426f088,128,82,46,Asia,18,691.86
9e7afb48c4f74c26aa6e3708583bcb59,265,247,18,North America,20,1618.23
9e7cbb7d220e4eb3afbfd74f8f465acf,107,69,38,Africa,21,750.92
9e7de31387844c07924b7f529d343725,185,157,28,Africa,18,1066.15
9e7f9438376144de81198be456399ac4,245,216,29,Oceania,19,1286.72
9e7ff994fe69465fa2779faa270a22e1,212,151,61,Asia,14,1269.23
9e80185e96dc469d9a6b7b980b858042,272,227,45,Oceania,22,1469.22
9e801a11c70e40c5b7f61fe997db9756,155,112,43,Africa,23,916.36
9e80eaf07aa64daaa6b6e2483e48edd8,227,208,19,Europe,21,1544.92
9e8103b64b5f48c9abe90dc8a388c3cf,362,344,18,Oceania,14,1976.24
9e8384ecea1e4e6bb4806999d9633099,112,74,38,Oceania,23,644.22
9e84107a719342588b587040256131a5,150,117,33,Oceania,24,1371.65
9e84be30feb44d0caa76d697fbc6e9c1,363,331,32,Europe,25,2598.56
9e85b0f2afb544ed81651eb2ee268b92,207,174,33,North America,18,1050.31
9e88933138b14714b52ac998c6f7426d,162,120,42,Asia,17,1454.48
9e8a90b865f94946962ea97b1ca46253,266,217,49,Asia,22,1693.03
9e8b415ea0f248829e135f4826f65856,86,45,41,Europe,22,477.3
9e8bf3c7063e4cdfaa70e32079eee79d,71,42,29,Oceania,22,632.56
9e8c177f2fc64f2cbc209d6fe4991bc0,59,34,25,Asia,17,593.12
9e9081073cab4e278caf5d0dbf19b5e1,336,300,36,Asia,20,2936.72
9e91cbfc14804b2c8aa3a1c3f23cd59a,239,189,50,Asia,18,1200.97
9e92bf39435c40e485d028a3369fe30e,363,357,6,Oceania,15,3602.68
9e932f65b282483ab369b105495d320b,125,84,41,Europe,20,955.7
9e9490ee44954d869d10b1632f8c73be,285,259,26,South America,21,1831.66
9e9761255f1c472db932db5f7d0bf4d0,139,100,39,Europe,25,561.74
9e98c3b80fee43929d64445c0b7947e8,221,177,44,Africa,22,1718.71
9e99d73b7806437f8e37201b2b9baecb,217,190,27,South America,15,1946.61
9e9aba23229c4c76921b8f6be68ac869,254,236,18,Africa,21,1675.83
9e9c5ff5882a424bbfc05c2f01cd042b,76,49,27,South America,20,443.47
9e9e978bf1fc4150ac6c78a8b0508ad5,300,269,31,South America,21,2561.48
9e9fa1b624db4a70921a275ba39f64f6,365,323,42,Africa,22,1586.97
9e9fd805b321479dbf2393942a190853,307,258,49,Asia,24,1310.88
9ea1e0cdc9384a24a2666ae362cefd05,241,206,35,Europe,21,1718.26
9ea2e59f870247d7877087cfa310a4dc,243,206,37,Oceania,21,977.18
9ea36a9328e74310bb67b917102dc225,330,305,25,South America,22,2416.8
9ea40a2f12b94edd85c36f71090eea0e,133,106,27,Europe,18,869.52
9ea44fd5eb584491a8b1c0db9dca7235,55,31,24,South America,22,489.96
9ea49a4959ed42f5a1b26890ff5b35df,67,33,34,Oceania,18,332.71
9ea52a70989b4d2593d1d1b00bba74d2,48,15,33,South America,22,294.43
9ea6fc3454484dd18ddbeebdb9a5451c,329,301,28,Oceania,19,2178.68
9ea845b1ad564c05ac5d901652268976,357,328,29,Africa,22,3868.52
9eac7e9f216b402fab255454a1f4cb0b,326,289,37,Oceania,14,2353.47
9eac961658064833bcd8f849a9b7a812,195,163,32,South America,22,1551.27
9eacf0a815dd4f67905c11f87d6951c8,246,198,48,North America,19,1326.58
9ead07acea90451081b00b84dbf14a83,319,281,38,Oceania,17,2022.75
9eae7fde2a804f3e88b3e4413beb613f,49,13,36,Oceania,22,251.86
9eae8602a6b54e1a8a93c7da28c5b6a4,161,114,47,South America,19,836.5
9eb0688d0b18401297686eee8a86e506,364,319,45,South America,18,1935.47
9eb3cd4d8c1748fa8c0a0925c3b14bba,363,350,13,South America,25,2408.97
9eb5a577af8846c2b231eb807af7d79a,112,91,21,Oceania,18,971.54
9eb6d357a7a04edf8999def5707ad7db,248,225,23,Africa,19,1869.59
9eb7670de9a74ede8e1e4dbb67a96421,360,305,55,South America,20,1792.79
9ebfb4dac4aa4df1915315af9116fd5c,274,235,39,Oceania,20,1868.54
9ec2255f05b34812a7f9e80690d1faee,54,11,43,South America,20,329.36
9ec72040f05845aa8716bd6661c0b1a6,183,159,24,Oceania,20,1579.96
9ec86d33d0a7426cab2c8de32e2b2f8f,325,272,53,North America,19,1692.06
9ec8a4322ba1422b9474d86ed03cf8c2,175,150,25,North America,21,1752.76
9ec93b26b7b541a0911ad22c5abf3568,359,332,27,South America,14,2948.57
9ec950648df548c197761036f579d47c,206,181,25,South America,21,1116.97
9ecbaf171e9549ddb3c4f43a4f4dca5f,220,170,50,North America,15,921.64
9ecd50c491aa4998854e32c7f27c2294,111,76,35,South America,21,627.4
9ecf9ba8e9f34cd289fb9b9549a3200b,284,270,14,Oceania,21,2466.05
9ed2c2c0a3ec402ca2eca9ec6ff8d782,151,135,16,Asia,16,1400.05
9ed4be16ce72491791cb2bf8a640bee2,365,321,44,Oceania,17,1704.75
9ed4be547a8844049a87deeb22c842ad,363,338,25,South America,19,1992.91
9ed82b787d234157837449a7528eaa71,198,156,42,North America,22,1092.2
9ed97653df4347bd80311e2121288cd2,87,45,42,Oceania,24,671.45
9eda25e3833b4a3285967fa3f8a3d3e1,177,154,23,Asia,18,1006.74
9edb0eb04e9d444b9ebb8e3c42b31e8c,364,356,8,Europe,20,2642.6
9edb525563214652b418de33acb395e3,106,50,56,Oceania,21,528.89
9edc9853ebb54df994268b579641104a,183,158,25,North America,18,1477.62
9edf9f4942c24fba9bb9916780d1b240,205,170,35,Africa,21,1778.67
9edff08d08d34e2298f132431c394cee,146,96,50,Oceania,22,328.41
9ee056d605394e0a879890ef18dba047,63,10,53,South America,16,58.91
9ee07d1b651a4e58a1c37fc44d191963,346,312,34,Asia,23,3142.72
9ee14657c7e5417eb29887303b058ece,239,217,22,Asia,23,2422.24
9ee47db5ad274ca7a911222433f84ce2,363,344,19,Oceania,28,2342.62
9ee6f39fc9b74f17ab36ad3c4ba45355,57,31,26,Europe,17,707.9
9ee7e37a59c44efe8b8673744d8e784a,50,6,44,Africa,21,214.82
9ee977a98c6e4ed5abd1d6ba06591157,287,267,20,Africa,19,1448.45
9eeb1d6065a94b51ac5e209068f30052,206,157,49,Oceania,21,1186.03
9eed98a5109f4b9583590fcbbe4b9db4,84,38,46,South America,22,630.36
9eee8e39d72641d5a3c8351b2117ab1d,245,208,37,North America,26,1888.04
9eef3cbc8a1446288552e845404ece82,122,84,38,Europe,22,948.69
9ef4f738ca404e128ad00fc5125273fe,25,3,22,Europe,16,171.68
9ef6d1555ee6453fa2dc75069927b9a6,58,24,34,Europe,21,329.33
9ef863358fa44754b3ca3021c44e2885,343,314,29,Europe,22,2566.78
9ef8e6e1226f4d58967ede7c0f200d43,165,117,48,Africa,22,1306.26
9ef94f33497042628634a2e9454b429e,58,22,36,South America,22,480.39
9ef96a56aba14e5d9e948304581b6565,204,177,27,Africa,16,1626.23
9ef97a32eaa84e4fac1ef3be5138a28d,324,279,45,North America,18,2548.46
9ef9bf41d0a24b1d9f91757d5c3c6c52,216,166,50,South America,18,1080.4
9efc37da4f4e494b966dba556794aefd,157,137,20,Asia,22,975.88
9eff193ffa46471f8b67a7593b3a32b8,316,264,52,Europe,17,1356.81
9eff7c1013f245668978fea8aff0b731,122,96,26,North America,17,1046.87
9f002330fc564695aa92602b0e4f8a71,328,274,54,Oceania,17,1496.79
9f00608b538840459557439a7c3a7ae4,296,272,24,North America,23,1808.77
9f036305e2c149b49b5d9aa831d0e1df,251,219,32,Africa,17,2055.96
9f0384d8c7d84ab488f464ab8946e902,232,204,28,South America,19,1489.82
9f056fe6cde6477c9f8ead2776161268,126,92,34,Europe,21,471.05
9f080ab8fe35487a84d9d5925d648b09,296,262,34,Europe,20,2084.1
9f089b9d82074d7f9636c485bcd6d0b6,358,327,31,North America,24,3413.23
9f0a6183c7ef4adfafc57eb1b451354f,363,315,48,North America,24,1817.75
9f0a9ebbaace45e092c14521e38c4932,148,92,56,South America,20,808.61
9f0be121dae34fb1a57f7685c418bb26,95,56,39,Oceania,17,618.03
9f1106fbf1a74489acaf14487deff09b,346,321,25,Europe,25,2606.66
9f115557d6744afb94a9ce657a3eb291,364,323,41,Africa,25,1610.42
9f11cdaac0614c7e8ba5da2dbd8b27b1,295,248,47,Africa,22,1650.04
9f11fd602886441c8f0285626b733a81,363,323,40,Africa,22,1987.56
9f1385ea677b40a3bc7b639cf680c7bb,202,163,39,North America,22,1643.61
9f1435ce549f436cba0bc6990748394d,286,257,29,South America,15,2754.68
9f15cab7713946db974e804c0a22965d,326,283,43,North America,22,2337.11
9f17408fba0a4cabafa63567c73711cb,261,200,61,South America,24,1314.99
9f196d40965c463090d5a8b70e7f1524,131,112,19,Africa,21,911.9
9f1ad12fdd244a18b4745f9d42046ea6,325,294,31,South America,21,2687.09
9f1d2f1693554febbe5a9c0e7d292c08,348,322,26,Africa,25,2971.97
9f1d369a155e4f92aa6156ceb5d80c77,364,350,14,South America,23,2874.92
9f2006c4271a4df6aed557c1f55b79c2,357,316,41,Africa,18,2348.53
9f21fb0879f24c249ab3619895b68c10,244,201,43,Asia,16,1593.29
9f242450518e47aabc0e2c3fba9ed66c,212,164,48,Europe,17,1143.43
9f255801b4704e0995968c1cab0286f0,286,256,30,Oceania,19,2609.77
9f2586933fbd47e4bab34cce3f49bc9c,295,261,34,Europe,27,2204.68
9f26f5e3ef584bf3be0f73347715013f,169,121,48,Europe,16,1281.95
9f271fa67c9a48f1b7990c9b607a561c,258,214,44,Oceania,24,1742.6
9f276242539c4e95bc5af4b6a4ee56a5,239,202,37,Asia,16,1718.81
9f278d7005dc4693bb758185fa014d9c,204,155,49,North America,13,1279.62
9f27f5ef3faa4a1ca314386850cf2563,194,164,30,Africa,16,991.64
9f29a7d795994f6da998c8027f4bd637,292,259,33,Europe,17,1800.62
9f2a3eb30c44441691bd9834f6e9faae,311,290,21,Oceania,23,2162.99
9f2bf06fe392408aa6896d940829f19a,55,3,52,North America,18,599.83
9f2e6d93800241da8a34b8fc166b05cd,93,61,32,Oceania,21,630.43
9f2f2855c32d421991f796623e92fa0a,199,164,35,Asia,18,750.3
9f3013674b6545f493f5ddcfa0239972,328,278,50,Europe,19,1480.8
9f311e8661534289a2a4fed9afa25515,99,78,21,Africa,18,434.73
9f31afd77b4045a7b1a8a8970e892f47,363,361,2,Oceania,20,2600.45
9f33133e175b4f129f2e61a596667a48,356,311,45,Africa,18,2075.94
9f3678413b1d48ce83a8d313a53afe47,38,21,17,South America,21,241.07
9f39164b2e2d4fda87cc7dfbc66c952c,186,146,40,Europe,22,1727.77
9f3b83441f6b4026b14185e98f123388,133,73,60,Africa,16,787.84
9f3c008e101844b39fed14ca82045343,184,150,34,Africa,20,1566.07
9f3cbc4e57374e488203433c703f2b1f,93,56,37,Africa,22,783.06
9f3e0a7f45414624a1ef61d77335552d,46,29,17,Asia,19,96.89
9f3ead489b7643b1a8dc03fa159987c7,272,220,52,Oceania,23,964.48
9f4025346a1746aba275ca438eb115af,332,299,33,Asia,20,1719.69
9f41b0bb0eac441abae49fc6b60e5e21,178,155,23,Oceania,21,1271.3
9f41edeedd2a46a8aca51aec73f78420,345,322,23,Oceania,20,1986.86
9f458a433e994b2f9ae9a2de688b97bc,363,322,41,South America,25,2710.75
9f48329639af4fd7af033cc3afac61c0,95,41,54,Europe,21,427.38
9f49aa1c16324dab86d23859d85a2a6a,363,357,6,Africa,17,1594.08
9f51bf8fc079441e94f5cfe6ca28d469,82,40,42,Asia,25,176.74
9f565df63d504098a5181c21c3436d8b,77,30,47,Europe,19,166.62
9f58437e7274469d813b94ea3c329046,364,337,27,Oceania,22,2745.05
9f58fa1161f64f38ac8362e6179b302c,285,235,50,Europe,27,1368.21
9f5b9984f9c34cbc91e6e992b448c275,169,107,62,Europe,18,1051.72
9f5f47e077734d23a647e1a1d124720e,226,208,18,South America,17,1359.46
9f60ee2e47564d208403aa07e87df5f9,155,115,40,Oceania,20,791.74
9f6314ba0e474e14bc36538ee170e684,47,9,38,South America,20,182.95
9f64b1dccdde48be82ababb93ec22d7b,341,317,24,Asia,23,2123.19
9f64d04fcef643f68a98863677dcfdbd,248,204,44,North America,21,2014.94
9f67b21f3c0d4413bfe90bb6112cdc6c,298,239,59,Europe,19,1914.26
9f6c1643142b485d8fe976a06ed8e8c6,228,187,41,Asia,18,1817.04
9f6f44f68c5e4eff807062330d9a50ff,124,103,21,North America,20,1045.99
9f735ab556474d2396a4652b5edbaf7a,192,150,42,South America,21,1355.57
9f73b43ce3024ee4a42428ba0f1b8e95,81,39,42,Asia,19,470.25
9f73dbd9fe244c2e85e7c069e70a4747,170,128,42,North America,24,1473.13
9f74153402c14269b1a1b6413d692901,309,285,24,Europe,20,2363.47
9f75dfd2ba8145968f9f0a7207966d88,73,29,44,Europe,26,236.84
9f778013fa484b5cb8c8e11b67858c19,280,228,52,Africa,18,870.48
9f7ab715b47b431e9b7155fb1fa0420e,113,84,29,Europe,15,1308.43
9f7c7eefc1be412e8fad48da1229d2d1,193,143,50,South America,17,1598.13
9f7fae7305ae4ee083e7265a6673986d,147,119,28,North America,15,1188.97
9f80b3f005a34902874c0e4f3091a297,322,268,54,Europe,21,1944.85
9f82e22670324ab99f6fc1cae0e389b0,260,217,43,Asia,14,975.79
9f886bdf1f444fbd94f1ceebf0c9f235,236,218,18,South America,18,1545.97
9f89f9a0d6e04452b9f121f7160500d7,329,279,50,South America,17,1222.32
9f8a3a81fc564e5e8972b85058b23405,214,184,30,South America,19,1356.96
9f8b7d75114142d59c16039a86197673,207,171,36,Africa,14,2007.79
9f8f17c954a34942a091dc1d8315a6fb,179,133,46,Asia,18,1657.28
9f8fffd64a2f443d97754c7863b97c17,258,204,54,Oceania,23,1683.73
9f90f3ed3f3c4fa5b66011d7c7ac6c34,270,215,55,Oceania,20,1438.06
9f92b182863041fc966bafca844fdf48,300,274,26,Oceania,17,2163.11
9f969ed0d63a46daa9ee1bde108decd9,68,18,50,Europe,17,367.96
9f987ac3688241bc9af54e63bd1feaca,189,146,43,Oceania,18,662.81
9f988b84d95749d5b4a9e106a7c6794a,263,206,57,South America,18,843.59
9f99e00bf0514ed3852da7fb6577abac,118,90,28,South America,22,636.55
9f9ad36a841c438688301649ff6fa53e,65,20,45,Asia,24,138.27
9fa0508bd0b941459ba5077aa0ef2909,156,131,25,Europe,17,1303.71
9fa26197e65648c6aec1abceedd4f48c,364,325,39,Asia,17,2402.73
9fa3088361d348aeb1b0335fdc6a952b,357,320,37,North America,21,2233.29
9fa342e0626b4c15977b055981dbb37f,196,162,34,South America,17,1600.85
9fa3df285c294167883f8efb9f6b4af1,209,167,42,South America,18,1311.19
9fa550ad9fc543cc84adceed5c9e7cbd,247,203,44,Africa,22,956.33
9fa6715763c749efaeb127e62b2e335c,250,214,36,South America,21,2030.26
9fa68d1a61c74e73bb74c2dd07ad5acb,173,136,37,Asia,20,1431.7
9fa70b0497b64002b363ea4578a74f65,365,364,1,North America,19,2571.02
9fa8d328c9984dffadf0ef0d949f846a,172,143,29,Oceania,16,1075.86
9fa939500f494370897895d840c53053,270,210,60,South America,19,1252.49
9fad2dab8be24fdea277b60f5ba976cc,129,103,26,Oceania,22,1314.88
9fb1752af8244540aaa8abfdb175e526,206,175,31,North America,16,1875.21
9fb2ada4aeab4bc1bda9b514c5d02bc5,361,342,19,North America,18,1943.03
9fb2ec7ea8ad4f999d0f396ee00e50f5,271,213,58,Oceania,22,1658
9fb44bdf452c411fb6b9a47da69772b6,212,178,34,Africa,19,1617.17
9fb4b3e6df9b4b369e0b35bea4a6f259,351,318,33,Europe,22,2073.1
9fb4c1b6d0ee46c89bbb9bc810662a96,365,348,17,South America,18,2017.52
9fb5d1afb51f4e5fbfc7563814226af6,169,142,27,South America,20,1613.67
9fb604dfc39546c5b4471bd37cd8cfdd,330,277,53,Africa,19,2186.35
9fb651ea0d2d4cc4a68accff28b465fb,133,101,32,Africa,20,810.5
9fb7c3395be046ecb56d627312250fe0,365,352,13,Asia,17,2412.91
9fb9ec3f07964c32a1727ca09e21f8ae,211,168,43,North America,20,1527.7
9fb9f0af3b254efea0bea4a4a8efb71b,363,356,7,Oceania,21,3105.84
9fbab725e8dd47e3a24087c22993ad44,86,33,53,North America,21,484.6
9fbc501e863d40f0ba180f3e684d2de3,108,83,25,South America,20,590.52
9fc04f7282c34044a1d56b11b6f834a1,74,27,47,Africa,20,341.36
9fc351c80fb84dbbbf6ea2d490b3e5d2,285,256,29,Europe,21,2158.45
9fc352a43e32426892d40c95eceb9a65,264,217,47,Asia,18,1376.15
9fc3d1f8db2b40edab28350a0a96e043,364,353,11,Asia,15,3394.04
9fc4f4de07a0450999c5c389270dc26f,151,103,48,South America,24,518.72
9fc68e1d6f6140d18bd3227a43260301,229,177,52,South America,22,869.81
9fc691471a4c4bb78ffe6647c2c943ca,270,251,19,Africa,19,2613.04
9fc73cd827db4c078152a6a785c2a630,77,51,26,Africa,21,713.9
9fc825a63e414113ba40fb9151a6cbec,307,266,41,North America,23,1471.57
9fcb11e6a0454ce7b6111863eb127abb,244,195,49,Europe,24,1006.85
9fcb2859d5fd45439fa9c468262c8812,134,86,48,South America,20,788.55
9fcb2d523e6344848f717854c618d95c,130,89,41,South America,22,711.76
9fcb4fd63ca34bddb9c8f27807f72aef,356,301,55,Asia,22,2053.36
9fcc0c1a45964c97a865d701f32190c0,158,101,57,Europe,22,683.55
9fcd76da9c114dffbff7ce907895679c,300,247,53,South America,18,965.94
9fcde35da31c4ce281bba3bc513173b0,189,149,40,North America,19,1178.29
9fceb5508d264168aae61747326483d0,345,303,42,Europe,23,2567.63
9fcf619e42d447009ae7c0e74872e877,199,173,26,North America,24,1557.37
9fd36af16f624af1b13a2eede449e257,114,63,51,Oceania,22,400.17
9fd8e5d88a474c65a24cae120743e679,365,358,7,Africa,18,2671.33
9fdae2b8a46d412c99b4c8fb87009adf,272,239,33,Europe,20,1714.62
9fde3b514a2f42bc874b0b992e22a000,352,333,19,North America,21,2755.8
9fde45439f704498a09fb3cd171beb05,58,23,35,Oceania,17,506.08
9fde6d57d6d3478388d1d9a5542db3d4,272,248,24,Asia,24,2273.67
9fdf0b7e505c41dc83cad94a0b24505c,325,291,34,South America,18,2492.12
9fdf5ad4475440f1878be0d652a2cb7b,78,55,23,Asia,22,426.42
9fe260b9eafb40b28c6524861d2880b9,361,356,5,Asia,19,1766.25
9fe5f8ec62a94906b5283f61db757090,156,114,42,South America,24,1629.55
9fe60bc14d734f3daad549065e9c3191,365,331,34,North America,22,1493.33
9fe60fe796714da09b8aef6056b730ae,208,175,33,North America,20,1568.86
9fe7a26b0e594dd2b5739867d259e3f3,58,8,50,North America,17,433.15
9fe87af544964ca8b1997a899e562345,322,278,44,North America,20,2049.6
9fe9cebd92994a53bdb71d1286efabfc,242,207,35,Europe,21,1533.93
9feac5608ad6464fb0c07fa5cc7d44bc,112,56,56,South America,15,537.92
9feb70eb605f4ba1b264b30f6307b073,229,178,51,Europe,24,1184.62
9fefcdbc1ce84695ae9a9e930ba6b0a0,213,180,33,Asia,21,1136.28
9ff12daf8d224698bafa39a1a882f225,228,182,46,Oceania,11,1516.11
9ff20ed5fe7944ecb37f2e5d6cdfe5a0,362,330,32,North America,25,2388.28
9ff2375777b443f2ad72b46d5d9c99fb,99,59,40,Africa,23,587.94
9ff47d2d523c4321af7cada744a573ef,319,291,28,North America,17,2155.91
9ff49291d1074379975aec1bbf80d823,171,130,41,Europe,18,1191.26
9ff590cc56854e91b87059df6f481247,231,185,46,Asia,18,1191.59
9ff6ca9a47ef494e8fc175c5297fbeef,213,188,25,Africa,19,1619.37
9ffcff33b15a46e69f002830e6aa097d,73,26,47,North America,20,147.69
9ffee264cd7e45b096edd7b4a81a520c,123,89,34,Oceania,16,603.05
a001d1965462478aaca9720e82a8c6ad,207,169,38,Oceania,23,1684.83
a003544871784ffb8fa5643b4ebef841,342,304,38,South America,19,2358.29
a004fbb41af7463fb98274d04df6e290,98,64,34,South America,19,834.28
a0052c545ef54d4f92b1695799bf49ed,155,109,46,South America,21,458.7
a0075f047cbb4cedb0f96709350b8dba,215,176,39,Asia,20,1806.51
a0087300e7994b96a50dea5c59fc8ba1,79,52,27,Oceania,24,304.44
a00a71c1d5dd49739dee26d75082f296,324,289,35,North America,22,2341.06
a00b3b5fbf5e400c875a2a110aeba612,352,308,44,South America,20,2128.7
a00b570766c543de82a89c6e332f732a,106,84,22,Europe,22,969.11
a00d28fbee414b12a91b264fe5761808,158,132,26,Oceania,20,1041.55
a00d69b990cc42a5ba1f78f7b7c84dd3,50,7,43,Europe,24,192.83
a00e079f502542c791ca9946a9abedc4,153,113,40,North America,20,1031.83
a00e2eff9f334604ab59459acafe2bfc,150,100,50,South America,15,647.51
a00e9bda68df41ef89571e214df83993,338,288,50,Europe,19,2305.21
a00f2c82a6a646f495dccd33c7337d69,97,73,24,North America,18,811.85
a00fe6bad5c34c48bda18e0f32971877,81,50,31,North America,21,848.43
a0132b11af6448de97df1200a474045d,72,39,33,Africa,25,481.49
a0132f9dbb6440089842c2d8e906d3c8,151,129,22,Oceania,21,933.94
a01366ebd3bc4a679937d200629e7178,33,6,27,Europe,21,113.21
a014295bf9c0487fa1ca81070deef721,265,244,21,Oceania,16,1954.21
a0164461217f44af8b375ac66270f1b8,131,82,49,North America,18,1128.14
a017af9df6c84ea3b6f9d91f7fd84974,109,74,35,Africa,17,636.28
a01990965a334e28a9efd638fd602d20,222,177,45,Oceania,24,1222.37
a01a985508784ac58933f72b6f2d0545,228,188,40,Europe,20,1580.52
a01cac32dde8452ca4c1c91802b3cb11,154,105,49,Oceania,18,638.75
a023ae6dd8184a218880982c9c29e4b4,303,274,29,Asia,24,2278.58
a026185a592c46bd9be0fcef84fbf5af,111,64,47,Oceania,20,417.26
a0273f30de2c46799aedecb53d2b6388,30,6,24,Asia,18,63.34
a02794cf809d4dab91e6a67933b25cb1,60,4,56,North America,18,375.62
a0283948064c4d7e8d04fb7374c0dce1,241,203,38,Asia,24,1327.37
a02b0863abca4725aaa1aa208a3d1e8f,363,339,24,Oceania,22,1722.85
a02ba6447dd54b27bc181dac9d526088,259,217,42,Africa,18,2041.15
a02fa838e52c4ab18036ff100685f1cf,187,161,26,Africa,19,1224.43
a02fc7cd56eb4927b11ea25901a2cc7e,205,161,44,Asia,18,698.21
a032bf1ed7464c19a8bdac0974287777,345,306,39,Africa,18,2627.67
a0363306d895451da86b73ea00bd973c,253,224,29,North America,22,2036.09
a036c54d72dc460ea640e5fbe257acdc,127,82,45,Asia,21,1231.37
a0376314ace843958d0fb3bc88076a47,287,256,31,Asia,25,1888.67
a0394b7fea8a4059aa98314a13499f5f,202,150,52,Europe,22,1106.17
a03a79ded9bb4cb5949a288690176254,302,254,48,Africa,19,1693.27
a03b482441724bca923b702d74f3e8a2,254,209,45,Asia,20,1574.15
a03c533e2fc94a87a1e80d14e2d1d0c0,144,88,56,South America,20,523.72
a03c7ad1389f42ee9d4ee6eb7ef637e1,210,181,29,South America,19,1348.16
a03c85ec506d4d2d91ca5a2ff8f196af,213,179,34,South America,16,1413.8
a03ef475b2134abeb91c26772f7efca0,209,172,37,Asia,23,1586.56
a0401662a43f41069cce554752442e0b,115,89,26,Oceania,24,1435.39
a04276e15d3b409994152e18e663feb8,260,225,35,Africa,16,1230.31
a0444fd059ed46fa9bc4f0a007a244fe,134,110,24,South America,20,1302.67
a045a89ed2784ecc820dce2539e3e666,164,137,27,Europe,20,483.37
a04814c06266492985a9ad8e7258aef7,365,350,15,Africa,18,2555.29
a0484fae18aa414e81c3313efd396388,214,174,40,South America,21,1377.75
a04903c962ba413c9821b696cf75e9fd,191,136,55,Africa,19,1166.84
a04c08de3b8a41bf96f6010aa6d61fd8,90,62,28,Asia,23,599.19
a04faca9c07545b3b36e247effda1014,278,253,25,Oceania,21,2298.9
a05012df393c4396b3d90881c9b0e60f,317,274,43,Europe,22,2995.07
a052b9b065934ce3b76dd911ed680fef,154,96,58,North America,16,241.56
a05339509c914cbd9aeedc86ebc6278f,346,293,53,Oceania,18,1138.98
a054453acd09487bafd6b5b4dab07738,280,236,44,Europe,20,2330.39
a054c4aaafbb46ff9bfefd4b611297cf,319,283,36,Oceania,16,2159.76
a0593e21e5054413b48eec2601eff59e,91,66,25,South America,23,611.79
a05a7eb6379247a8a66fd29b1862c5ab,318,264,54,Africa,16,1496.67
a05af0d86b7043b0934e49d872c4e39c,363,329,34,Africa,21,2152.82
a05e97e584b5455a85f3c889924dd255,365,339,26,North America,19,2512.93
a063a81c17f243ad8c71b4cc1f3e2941,77,56,21,South America,20,439.95
a0640fae827d483091e8b969cdf719ea,51,35,16,Africa,22,327.7
a0642ead1a4346bc906e168baf55188c,149,98,51,Europe,22,387.45
a06466d2c2d045cbaa87eb76a84898ec,354,325,29,Oceania,21,3227.71
a0649b63fbed46e7b6db87a8a0bc0e42,232,204,28,Africa,20,1794.76
a065bec49f7d474eb3b0048d4070f717,334,300,34,Africa,21,1744.06
a066a9dc72f0415181de88df4aff6609,199,159,40,Asia,21,818.07
a0672782a7e0470ca5d267a6a2e06e84,220,179,41,Asia,23,1833.99
a0676389507b4659b295fe83edc6dc3a,242,196,46,South America,25,1141.53
a06825068b584019a814bda72d0c496d,175,141,34,South America,14,1282.85
a06858eb592840e7b6b8d3ee64ea8870,109,80,29,South America,22,764.6
a068c3a89a2447b1a09201943ca9a6f4,150,134,16,Asia,18,1128.61
a0692518c0c645939a59d860a0406d30,152,105,47,North America,20,747.27
a0694b096a0a41e49982f3d01b778b08,365,332,33,South America,22,1844.65
a06c7234cc0c445aa8a711c54299d886,163,106,57,Europe,18,934.47
a06c85d584ad46c49f3839c755c1548f,154,124,30,Europe,20,948.67
a070644e9c2e45a6ac4f755a9309975d,237,189,48,Asia,22,1228.51
a0717b93dd0f427895b9a621063bf5e0,281,240,41,North America,22,1819.49
a072242957ce4ce598dc44954b8ea442,98,70,28,Oceania,22,717.03
a0734b86076842b2865b57e16043bf63,295,261,34,Africa,24,1675.48
a073b0cdc948447a959e942499156737,74,53,21,Oceania,20,597.94
a07de8193ae145b792fb914f51f39d41,84,30,54,Africa,21,515.7
a07e85dc4c17422daeebca326bc6fde1,94,57,37,Oceania,15,577.11
a0803fb885d64dc9ab6edceb37f76c0a,66,41,25,South America,17,675.37
a0804894779848d8ba73fb7cbf03b08f,208,187,21,Asia,19,1476.29
a081c2ebf61f48efa0b08117b6f5094a,262,233,29,Asia,17,1878.63
a082af43996a49a5a2ce695e7e120d94,126,78,48,Europe,15,542.79
a082ff255254486493049bfb230c9ded,145,124,21,North America,19,1367.04
a0831ca33e634452ae7af8690231d113,189,162,27,Europe,21,1373.38
a0869f231a28415185c095593e08d65a,71,38,33,South America,16,354.15
a087b6a68273480db7825aca36fcf162,59,12,47,South America,16,289.65
a088f113fb1b4a09bd564183acbb24ba,259,231,28,Africa,20,2141.43
a089d4a5f7e84337ab9e30a3a7decd36,89,52,37,Asia,22,543.11
a08aba9df3f74db18f024ae4f9b98d4e,182,151,31,Oceania,24,905.13
a08cc3c3fa6146c69d54f1a882a7b8c9,298,252,46,Asia,20,1158.2
a08e3b738e9e4b00ac1f7c738d54554f,319,271,48,Africa,26,1384.49
a08e66e2120343ba9f7a23412280edb8,38,12,26,Asia,19,346.52
a08fa2e624bb42c98bb1e42524af3c29,170,141,29,Oceania,12,1371.95
a08fa73b28f64869b2fd4d211700bccb,37,1,36,Europe,23,157.48
a08fcc7943884d32b5b296cd4882f3db,216,183,33,Asia,18,1564.03
a0932338c4fc4c6fb7b672c035065a68,345,319,26,Europe,22,2141.59
a09664be87ab4ea2a68d2deee0652dea,354,308,46,North America,20,1999.05
a09672d2e5594c3cbcb747f345fc3cc5,149,90,59,Africa,23,468.24
a0994eec41024e7ab62ecbbb56345187,324,276,48,Africa,20,2002.49
a09bf5ea761f462bb5ff83ededcf57dc,276,223,53,Europe,21,1540.49
a0a231a3a14f4a909ef112fe6e07205d,134,81,53,South America,19,628.64
a0a444185cee472ebaeffed31f8f7a27,304,268,36,South America,19,1784.46
a0a57b19988f4c6089c1804f157b2371,109,60,49,South America,24,574.89
a0a5a1ec7da04276ae965f6adc312019,234,189,45,Africa,17,1661.08
a0a64fbc54234cd38e42b38414723d57,328,301,27,Africa,24,2510.96
a0a88e109638428785f9477cf1e63048,49,11,38,Africa,24,337.13
a0a91c35c02f4f5c81b1806f7585fa05,78,28,50,North America,16,496.27
a0a9c423064940de89e46606c5b588f8,35,12,23,Asia,17,416.18
a0ad1e3c6ba6444d8877d31b4019dbca,240,200,40,Europe,22,2136.72
a0b0215fd8b543cea48591fdbe142b32,195,151,44,Europe,22,1253.9
a0b1a6f7709b4f45b13da2c81c756f04,100,71,29,Oceania,20,1017.3
a0b313bcaea64e14ada4a52d4af2530e,346,319,27,North America,25,2229.82
a0b34287b8df445aa9179581bff4acb8,337,324,13,Asia,22,2358.82
a0b4d6fe8cb94e2f8b9aff980f0bb1a1,52,11,41,South America,18,139.78
a0b4df296d9f4745b23d8254cbc2e240,299,259,40,Africa,17,1837.58
a0b66915371d4a4193b6a491dd5b0d00,212,165,47,Asia,21,1178.52
a0b7bd50e1524064937c9b2b7fc5fdf6,64,14,50,Asia,19,283.14
a0bb163cf4b949f792850d2b35d36e46,172,131,41,Europe,18,829.25
a0bc3ab20b714c84b57520a4fc1df523,359,309,50,Africa,18,2452.2
a0bc938bc42c4c2cbdc5bc32c5e15056,285,233,52,Africa,21,1749.98
a0bf1cec2aa84d03b4a80d5716180c23,127,99,28,South America,16,604.19
a0c78f3720064bc9bb9a1dcee60afba5,166,141,25,Asia,21,1490.17
a0c91541436447f9be36c12d5fc7fe4a,93,52,41,Europe,21,418.04
a0c97e11a530492d8ee48f82af26a80d,207,156,51,North America,22,1084.66
a0caa65346564406baa30ec098f5ee2f,91,50,41,South America,23,666.3
a0cb2e9994194877ba125efbfaefbbbb,263,238,25,Asia,18,2002.91
a0d2aea8618b45f09232373e1574d82f,156,106,50,Oceania,22,1268.23
a0d336c1f674450eba6e4a4f54ccaa78,52,18,34,Oceania,19,618.33
a0d3e7c28d954cc58375a3b665a27774,365,326,39,Oceania,17,1612.87
a0d56706072741e6a46c1d60e54f0752,334,308,26,Asia,19,2638.6
a0d5cc293a2b4f5e988cacbb625c2979,363,316,47,North America,17,1899.5
a0d6e2ea64f44f4f8957bd025aacad86,336,309,27,Asia,15,2827.22
a0d807f4691d4859b059c77a80499d30,317,284,33,South America,24,1859.06
a0d810a70a4246e294e2db4ca3dea4f4,107,50,57,Asia,19,502.21
a0dd6c5ffcac4d32a2cd385554d56943,264,209,55,Europe,23,1598.43
a0e11e2a2c5b40668b76401761058405,253,201,52,Europe,17,1309.63
a0e12804e96d4d4abf903079fcba366a,91,55,36,Europe,18,566.55
a0e15cea4eb240d28f54bb4e6d0e4f6b,329,299,30,North America,17,2173.8
a0e5a09be52d42e489c48f28aec4836c,128,86,42,Africa,22,661.92
a0e6fe0aefee47d59c011d976dc02c66,362,349,13,Oceania,18,1944.59
a0e7830029054bf485d3352a11547f5f,307,254,53,Oceania,21,1357.56
a0eab770e5c94bdf8c62f2a1d7272f4e,127,73,54,Africa,17,1052.77
a0eaf5a15d9644e58453ec6f06cfdc87,364,358,6,Oceania,23,2052.62
a0ee862c3a7248cb8cf8f99b1161424b,97,39,58,Africa,20,610.36
a0ef5234da2c4a4381df3a9b99147242,76,39,37,Africa,17,573.95
a0f27627007148f3a66eca2fd12f2ff9,250,207,43,Europe,24,1862.66
a0f45de5480744ee8bd744e9171f3fd3,172,155,17,Asia,19,1590.34
a0f6be35a5c84afeab8e6734041eed5a,364,331,33,Africa,20,2342.49
a0f6fad62d5e4b6488b3664f85a968f7,98,71,27,Europe,22,1001.84
a0f76d2b2a004d0fa8a4d1ad5ff30d81,358,338,20,Europe,18,3101.6
a0f87a3d1f4942c68471256e0cd5a923,183,162,21,Asia,17,2420.75
a0f8d20d164d482cb872185d912ba853,297,263,34,North America,23,2142.91
a0f8e3a01f6e44e49ad8f8d31b57c21c,119,90,29,Europe,22,987.35
a0f91410d06540d6874794e1058ba319,316,296,20,Asia,21,2396.64
a0fd98edfda1497faf20c6ac7d124918,215,192,23,Asia,17,1679.84
a0fe92799aac439b9bb3a10199207f4e,61,13,48,North America,20,338.97
a0fecf8f45a347e9ae14231d00a4a4a0,39,17,22,Africa,20,289.23
a0ff627a7db8456fa6863406c16f540e,126,102,24,Oceania,26,1146.7
a100bbf6f42b4add8d5a494767525b47,354,324,30,North America,20,2884.12
a10215643a714db49a69e9b2fdf1dab5,244,202,42,South America,18,968.58
a1026f3d6b4a4aa1a34090bae4ca2bac,241,188,53,South America,15,1603.7
a1029830515a4319baaa4367899b4aff,33,6,27,Oceania,16,293.9
a10326e5a3214ff69f60832e83ad3f8d,219,171,48,Europe,21,992.61
a10407a6f4684c77b2ca72676c77c292,229,188,41,Africa,24,1545.49
a1040c308d784a7caf3c052783b784fe,301,251,50,Oceania,19,1474.05
a106914f63ae410e84d828d4930b555d,177,121,56,Europe,22,1036.78
a1084f5abddc4d6f852ef097734b0053,364,342,22,Oceania,19,1482.35
a10a20b826854c0c9e85bcd79e73883e,202,148,54,Asia,17,1057.68
a10b89d7b8b14568bd7b54448888b2fc,101,53,48,Europe,24,632.52
a10de49858324ebcb243fe973a647fa2,364,360,4,South America,25,1490.04
a11361e7d3df4cf0bda6d4eff36cde79,340,316,24,South America,20,2868.8
a11367b4155e4f47a339cca733a5c008,255,207,48,South America,21,1128.45
a115691ece5a4ba087bf18ef17e0eaa7,362,333,29,Oceania,18,2400.34
a116c22e966d4940a65141b4d0ab4add,258,227,31,South America,20,2263.9
a11887307ba144e69c1679d2281db1e2,45,24,21,Oceania,17,473.68
a11a14bf019946e2a02b6100b7bc57cf,286,231,55,North America,21,1442.03
a11c9430ece1454fa0c58502dce336ae,304,258,46,North America,21,1744.26
a11eac12610e42ada714cfad933fde32,340,305,35,South America,23,1759.14
a11eb29c12d94f4db3ae2ddc2aba2210,232,188,44,Europe,20,1341.98
a126831fcede4a739113c1d17597ec81,365,358,7,Asia,23,1908.66
a128fd41fc5642e0b68b87bb57bce348,72,26,46,Oceania,19,474.95
a12b1e229e9b4373b51c03edf4a0ecdd,108,85,23,Asia,25,630.97
a12d8b9c8aa842ecb601d56d9a5af63d,262,229,33,North America,16,1519.93
a12e5d449686468982092aa123f1c52b,67,45,22,South America,20,779.93
a13151ea8e6c4528b4f372bc647c885c,193,168,25,Asia,18,1299.04
a133937117434f62831d377ba0b36638,213,152,61,Oceania,20,992.47
a135001aae04425bb8bba4a1a711c0e2,290,250,40,North America,19,2292.11
a136cdc9b56a41d08e91e305b00d2d24,349,317,32,Africa,22,2354.24
a137c23b3f15459d8a32328309b5529f,281,239,42,Africa,18,1474.4
a13a5ee4233c46e982fa1b03865f1cfc,345,325,20,Europe,23,2364.5
a13b01069a8d499985a0ee1168747712,144,121,23,North America,26,1083.71
a13b3ff2cd404789822760f1e1460620,320,280,40,Europe,23,2215.92
a13b7c2531094a738efe92b998c717de,364,350,14,Oceania,22,2667.4
a13bce561d5e48338ab0c6a4e3a43f3e,223,191,32,South America,16,1867.3
a13c082de08348b893e8997d1cef6814,234,203,31,North America,19,1158.29
a13ca5ec6e324cfe82f5ab68a6a90e82,188,157,31,South America,18,1530.74
a13d54aecbfc499bae25e8e8a41dd044,281,257,24,Asia,19,2188.98
a13d72d54dc34311b553d3c38bf9ec03,73,47,26,Oceania,15,625.58
a13f8ecd2dba4fa9aa5eaf36cb82463f,309,290,19,Europe,20,2484.75
a144958ae62a4810986bb1263408e769,231,202,29,South America,22,1529.41
a145623eaaed48bf981302ae87f491f5,210,158,52,Africa,20,1026.11
a146cf1cf51346bebc4fc14e67c0f4cb,117,89,28,Europe,20,743.1
a1475c4722294f96bb7317149b9a7c46,326,300,26,Oceania,23,2997.71
a1497e699426482ea6bb7bbffeede005,363,329,34,Europe,19,3045.42
a14d8723b36c41819bf6ed5080e31112,365,340,25,Europe,16,1872.36
a14fca842c7242cb9e3322983cc20f59,218,170,48,Europe,18,1770.11
a1510187f90344659ab07c144707f3ca,173,143,30,Asia,18,1173.78
a15255a34ca749879a1b919e9a468016,346,306,40,Africa,15,2206.29
a1539bdcdad1498e81e98eb7b284712b,151,117,34,South America,25,689.46
a1558f3c648e46e7a1cadeb6860a001f,77,50,27,Europe,19,573.77
a15a0a5ffb9b42eeb1f4b46d894dc6e8,149,118,31,Africa,22,700.02
a15a10e6587548bfafacf5bb142cbe8c,228,186,42,Europe,15,1354.08
a15d19ea04ea4ce4bd4d8f45f3cc35d4,51,25,26,Asia,24,246.41
a15d3e1830b7430ca1a0823821fa9ac9,192,176,16,North America,18,1023.57
a15f42c77cf84971a8703cabb4834b0c,365,339,26,North America,19,1466.35
a15f4dda3f2b44a6a675986a1b3cd58c,338,307,31,Oceania,23,1753.22
a1608d06831f4ac49ca0484732e5f820,236,203,33,Oceania,19,1789.9
a1608e27502b4c1fae4633549991a4bc,53,19,34,South America,17,837.38
a162121804904ee5bed048e678acfb60,195,144,51,Europe,20,830.2
a162f05284d7468ba9c6211e8ed37598,183,128,55,Africa,14,1010.77
a16355faea854209a906e158215d6cfb,92,48,44,Asia,21,670.26
a1665d6231164eecae52e6077095ad19,143,107,36,South America,20,1143.51
a167d3f056bf4e329f7fc57222ec8feb,217,202,15,Africa,19,2064.17
a16995bb321343d888986d43c2937419,365,327,38,Europe,20,1823.67
a16996b3a3f24b668171ab28244e8185,279,252,27,South America,18,1945.89
a16c4f96703b4eb6bc3b8ae6ecc085d2,144,94,50,Oceania,21,433.24
a16d515b3ee7467785832ac9387c4920,112,84,28,South America,16,746.13
a16e0674b6f44ed48e8bc80cf1b53bbd,297,272,25,Oceania,21,1659.51
a16e4c7671644fde86d388c2b4352762,138,90,48,South America,23,559.87
a17098f5c91e43d1af9d6f306f4889a1,107,88,19,Europe,16,1057.2
a171dd45e0b34bbeb84e63dce78f925b,183,147,36,Africa,21,1089.8
a172a146211942349e0dc5cc88a629df,353,306,47,North America,22,2296.46
a1759ee73f5449e5b1d5b40a2630b1c7,116,85,31,Asia,20,903.48
a176bef816c14dd6b5ab8ffbc0537de0,133,77,56,North America,18,695.52
a178d5be5e464a45a33127de42bfaecb,109,71,38,Africa,22,796.35
a17fc96c8b0e41309e63a7009e9aedd4,226,205,21,Europe,24,2283.83
a182e9d27c7c46ba8c94ecf5c8c58d82,111,84,27,Oceania,17,335.17
a18584c8543643fc88182af508e247b8,237,193,44,South America,24,1631.18
a188e519e452483ebc501c264f0b6f33,124,103,21,South America,17,1071.89
a189e2d98fea4b5da4e1dc76f6ca38e9,335,293,42,Asia,23,2435.12
a18aa58ae96347849bf73bfb1c6cdefa,166,136,30,Oceania,21,1476.34
a18ac6d242ae468caeb06509cf6bf21e,365,336,29,Asia,19,3070.73
a18db5bbf05c4d43b35aef97aa040d59,106,59,47,North America,20,572.48
a18ddf48290945f0985e3e8223d26a81,314,291,23,South America,20,1840.64
a18e5328d57f445585f03250c8009164,364,357,7,Africa,15,2387.42
a18eb00b4d114880bb431e703ab07afe,216,175,41,South America,20,1061.24
a18ee909e8bd4beb9529f19faa876a5d,245,191,54,Asia,26,1290.06
a18f030277ca4bbfa9dc5cf3b3570de9,19,3,16,Oceania,17,250.43
a1905b756c8941af84e1ec32cf7ee41d,75,24,51,Oceania,23,800.78
a191292b659d4fcb9c929f0d02bbe9a9,309,264,45,South America,16,1232.35
a1924bfa87634b2ab7489da8efcb3d99,267,216,51,Asia,21,1051.26
a192a56ac33348568b33b129a9360346,111,62,49,Europe,21,861.26
a19479a3b63e41c8ae793afb0d5830cc,259,235,24,North America,25,1853.5
a1957ca1bca949c89bc76a5aa9f10fd1,87,42,45,South America,23,236.23
a1958c92fdcc4d6b90ac8fc53275ea48,96,41,55,Asia,17,695.5
a1977c60cede44ef90fe0880b71cdf61,71,41,30,Europe,23,365.56
a19975b157034d90a25c06018b5bff77,133,109,24,Europe,20,1038.66
a19a5d68434545af88e8e847f9148dbe,364,358,6,North America,22,2623.16
a19b12bbf7e443009127aa6d915d066e,93,68,25,Africa,17,682.86
a19c2bb3c9f4445c860235dfe8a8796f,336,307,29,South America,14,2409.88
a19d55c916854daebdb23a557cbf3304,27,1,26,North America,28,260.17
a19e86a37d2c4ce78b03cb80756343ab,363,331,32,South America,20,1831.93
a1a12684566c4ce8aaec75627b78f666,363,316,47,Europe,17,1732.15
a1a84bb0f0a542bbb720a42be16c4d63,109,67,42,Oceania,20,632.97
a1aa59cf020948519f5dfc1f2322c0d8,364,332,32,South America,17,1317.64
a1aa81c090ef4a8f9c43d26696681194,274,222,52,Africa,20,1239.43
a1aafee5378f47e8be9147f895f9e22a,328,306,22,Oceania,22,3041.26
a1b0f1acb5454fb5b8b336dbd272a709,314,277,37,Oceania,14,2078.96
a1b20d09200249d7909be20fb9303487,122,82,40,Europe,22,1232.73
a1b2b5cb751d45f88d02d4cb0875be0a,247,213,34,Oceania,18,2156.7
a1b2e09fc0234a39a61f7c79fdb3c11b,79,61,18,Asia,14,406.11
a1b32955cce14aae86539639402cf241,116,64,52,Oceania,15,749.2
a1b4413c1e7b41c5bd44a3b3ee975c9a,306,286,20,North America,16,2288.27
a1b606fe0361447399eed953e5abc3c2,129,90,39,South America,21,606.29
a1b6fa1f6b9d41948929da052f3c9763,109,81,28,Asia,23,275.36
a1b7b01e6a294ba3b0d19fe72425e7fd,336,307,29,Asia,19,3032.3
a1ba70fb51534e86ba7b8da5232a1325,106,68,38,Oceania,17,636.7
a1c06db9b33544499d9b076f4b9a05c9,276,221,55,Oceania,20,1075.92
a1c0db5c29fd4a91807cdfe6308e9782,107,73,34,North America,20,1051.29
a1c528ac4fa441cea90abc3d14caf6da,177,145,32,North America,17,842.77
a1c82de522e14a07a4b30f5256d54a1e,365,330,35,South America,24,2148.05
a1cb4fff7116476ab1a9ae67228ff74c,284,245,39,South America,18,2091.82
a1cb76bea01244eb86599ea537a191d0,92,53,39,Oceania,22,780.38
a1cbe6dd74394ca8a72fc9da5895e681,308,271,37,North America,18,2751.74
a1cc3ed6eb3c47418fb25281dfd51d51,145,95,50,Asia,21,804.46
a1cffce8c43f4230a81585649159ce3c,269,230,39,South America,20,2402.8
a1d1fc79793847c38465567a692e1a77,46,10,36,North America,13,108.62
a1d219720c7c4c3994dbd3c89ddd83a7,321,264,57,North America,24,1060.8
a1d263ccbb1348f4ace7585259e291a3,269,247,22,Oceania,17,1694.38
a1d63ac672b14e11a69d977278a2c953,47,13,34,Asia,20,382.71
a1d6c9a219714570906fec2ed7f80e64,224,188,36,Asia,16,1904.53
a1d7c20bf5c74f1d8221cc5feec44ffd,365,350,15,South America,18,2506.06
a1d93fc39ba74237bf693b9b857e7a2c,218,183,35,Europe,19,2023.4
a1dc00f227de43e8adf9bc8d0e444e8a,365,337,28,Europe,23,1504.88
a1decdd9e52c45d196d62b83f41aa89f,111,62,49,North America,17,543.99
a1dee313da48457ea6977e0bd7b7f442,62,30,32,Oceania,23,610.71
a1e1cda9afc04c14af57491b2cde8b04,110,85,25,North America,22,1488.08
a1e2817c8e434f17b21f3d59971f0b3d,345,315,30,Africa,20,2155.5
a1e2d9ea8e324f27979eb42c73f44881,28,4,24,Oceania,19,30.65
a1e429d364d74bff839d128908c1f9e1,186,155,31,Oceania,20,1078.66
a1e56ff052ab4d9cbbd0012616662618,210,172,38,Oceania,16,2086.44
a1e594aadee147a6bf341f1231808d79,223,189,34,Oceania,21,1933.69
a1e5b01299434cb782a06778e248cc29,323,304,19,North America,15,2145.65
a1e9aab6b49b499db9b2f5259501afcd,363,349,14,Asia,21,1662.79
a1ec3a6a79c345afbf5402dab0fa2a06,116,78,38,Oceania,25,744.76
a1ed5978e7fc4466a8dd202bd82ffe32,263,230,33,Europe,17,2014.44
a1edba6b1e6e4aa784779230a902ba82,55,33,22,South America,13,958.34
a1edc92fab254b22baad6c018db879cc,365,336,29,North America,25,2303.91
a1ef2c24097e4c3f90169b526c5687ba,222,196,26,Europe,18,1624.37
a1f17cb9858c41ac901d25ed8f2f3ff6,364,355,9,Oceania,25,1838.03
a1f18b6cb229418b8b2b4e716637de08,365,343,22,South America,15,3181.83
a1f31455b73b4a7cb4b55e20ad69851a,347,308,39,South America,27,2193.31
a1f3c2e667cc464a8abfa5364304b165,339,290,49,Europe,19,1963.92
a1f592329df94439865b2c4355b582c9,156,112,44,North America,20,975.12
a1f9360b1ac747d694ae95242df5a0ad,102,76,26,Africa,27,866.19
a1fe545ad23549b594cd2c9679fa25ee,314,265,49,Asia,21,1786.13
a200d1eb76f34dc0be16d695b97d6c40,224,177,47,North America,15,1614.75
a201b72cceea46d196deea6de3a2670b,51,32,19,Europe,23,438.72
a204ac7290774b0491fdd99afcb8b276,335,295,40,South America,16,1342.54
a2059440365c42d2a25e704ccf2f8db7,244,194,50,Oceania,17,968.95
a207254acfd14889871b42406bb4292a,263,219,44,South America,20,1855.36
a207b0a5aa694c8d80889643891c5cf0,212,162,50,Oceania,18,1182.2
a20c40b58b9f4c6789bcef97678b30c3,234,216,18,Africa,18,1592.25
a20ef2581ca04dd9ace6d16d731b046e,112,77,35,South America,17,544.49
a21094042a7d4935bb1bed9c81b6e964,46,5,41,Asia,20,144.54
a210c7f01ae64307aecb421a50559d19,160,126,34,Oceania,20,662.89
a211d81012e24df68408b2d053c44a48,218,174,44,North America,15,1469.92
a212b09cb7174bb99c5a8aecfa8a362c,212,176,36,North America,18,1642.5
a213ec6e8fe54b70935736a00112b612,363,337,26,South America,20,2570.76
a21662a4b04643b3a91ef16e28cb5c50,278,246,32,Europe,21,1725.44
a216a2abece548aaaa15f3e56c4496d8,91,45,46,North America,18,721.74
a216efad47fd45dc8f4e3f986c182134,365,354,11,Africa,21,2653.27
a219204208654dbbbf1015ab5df000f9,128,82,46,Africa,26,961.63
a2193f431a8e4f45992bcc577d6ff4db,208,184,24,North America,22,1524.12
a21bd11ca9de4aa58d436c7a3ed82970,308,288,20,Africa,17,1848.59
a21bdaf74a8e413b99e8066c47429f77,364,359,5,Europe,22,2249.61
a21c64aa35fb40a79dba2a54694edc14,320,299,21,Europe,18,2893.74
a22302e624f9493e83a30f2bd4033533,227,197,30,Africa,18,2094.72
a223814fde5a4b02a3252435f0109de6,118,82,36,Oceania,22,761.08
a22658820b7d4e74928a3c164de0fef0,82,38,44,Europe,15,493.42
a2288832d8654a51bec2d975de341bc6,333,312,21,South America,19,2148.28
a22b01b457544231b645359df5417025,120,91,29,Europe,17,902.48
a22b458587144b4abb3dc04f7620b407,300,258,42,Asia,24,2982.21
a22ce65a0e0c4d2daee3dfeecbe517eb,365,356,9,Oceania,18,2370.84
a2303b2abb624478942eb298054f150f,90,44,46,South America,20,254.52
a231dc9dd0804dcab0e99183ecbf87e7,173,116,57,South America,19,984.61
a23297ddb449461aba6426436b614202,226,208,18,Europe,16,1784.92
a232a760dc9f4b689b7ab1511c87fb62,204,165,39,Oceania,22,879.75
a23510179b7f43c188da8bc806b8a891,292,233,59,Asia,22,916.05
a2351fa59bbc4d0eadd5eca8c36d3199,193,167,26,Africa,23,1510.11
a236470529404726bdc95af67fd79558,323,266,57,South America,19,2219.14
a23ab92a86ef413989dbb2a3ec9a15a0,45,15,30,Asia,16,239.08
a23b8ee9f5b143fdb4200621d7526193,79,52,27,Africa,23,427.99
a23c8057071c42baadf105a7a834f0ae,68,23,45,North America,19,383.86
a23e76cb370f435a8fd219884f3a3525,118,83,35,Oceania,21,1204.37
a23fe8bb66b047a5a8d313183375ae66,317,300,17,North America,26,2749.23
a24091d8b1d3453e8412009236bd8d65,218,184,34,Europe,22,1411.41
a244b6d499784641ac22012143b97a1d,248,209,39,South America,21,1710
a247378d971e487ebe98873f6bb0f2c1,135,82,53,Oceania,23,766.24
a248a626ba82443096d0afca8905067e,365,349,16,North America,22,2640.42
a249389db4744f8a8cb7db26d72a58fa,195,137,58,Africa,18,730.8
a24befccf37c4e19bceb1c63b04e993f,91,41,50,Africa,18,717.82
a2506d166a794ab3a579b48ba608679e,144,119,25,Asia,26,1380.62
a25350760c524e36a56384ca668e7092,361,332,29,North America,19,3191.41
a2547ae2d2604dd9a88145e6c6c80547,248,217,31,Europe,22,2040.75
a25500d9089f4cf1914bf394a5b745c0,357,325,32,North America,15,3053.63
a25681a367914b9e995ae09c81770f4e,124,91,33,Oceania,21,665.72
a256e20da6894b4bb6379fbd713de68d,364,336,28,Europe,20,2970.49
a25725a3ea434ec4a1492ad2cd974358,300,248,52,Africa,20,1669.36
a2574b58ed6e4467b95a8028b63662bf,91,50,41,Europe,19,899.74
a257f0fbc3c94ea7ae90fd754332d84c,261,213,48,Oceania,22,1402.46
a25a11677f8643509b4e78cd30ffbd78,237,208,29,Asia,22,2030.4
a25a6be873ae4ec38f945a5c3188a367,138,82,56,Africa,19,693.67
a25b3cc43141466e996ce24c9993f99e,247,206,41,Africa,16,2307.91
a25d6057e2e34988979fc87368eab253,362,337,25,Europe,18,2498.41
a25e857f8d134c9da16a0b1dfdf3346e,300,264,36,Oceania,24,2156.67
a25fb01a12174f7aa34bec16afc12f02,111,62,49,Oceania,16,723.23
a2622f8e65de4c5985923867021dc3bb,72,15,57,Oceania,23,203.99
a265cf58f003456598eae7b788932771,365,365,0,Oceania,19,1919.62
a26619c5f484461184bc56e1677d8b54,199,175,24,South America,19,1006.63
a26823e60bc84cf1892e3a5ec3ffa8f7,362,332,30,Asia,21,2765.7
a26b574916d64dd6a2333e5f1b03388a,234,205,29,South America,12,2068.78
a26c77ffa09944069bc633e3d25bd103,157,101,56,Asia,17,880.85
a26cfb453a154ba38b56b0ce3c938f60,239,218,21,Asia,18,1523.5
a26f3f1950c34b2dafdd826fc8c71393,302,276,26,Asia,23,2576.69
a2733b3a1d254686a0aa11b89afa95b2,264,236,28,Oceania,26,1272.31
a27398d9f6ca4918810fee4bf8ab490f,365,363,2,Oceania,17,2710.09
a274243645f64a7198b82a45932024fe,131,88,43,South America,18,716.78
a274ee71e85e49389c9e2067a5c5ead9,292,244,48,Oceania,23,1712.76
a27762bead8246da984bded5e4c0b23f,330,293,37,Asia,25,1890.42
a2776592fe1b4ab18620d50ac4846bf3,213,199,14,Africa,15,1991.85
a2776d8afddc47329a073d6e1352ebe0,356,315,41,Africa,20,1718.45
a27b8fbb297f402c8e93959dacfa54de,365,361,4,Africa,17,2351.67
a27d559181434e9bb44a32849bff9955,64,30,34,Africa,21,578.62
a27e22f1da4a428bab162b8938775c99,364,326,38,South America,21,1795.5
a27e801f934c48e7a1b95f98a2fa8c33,212,170,42,South America,18,1242.52
a27f8a8c90dc49b9832bac5ee4da33e6,228,211,17,Africa,18,1832.08
a282969d931540a390bec78162986943,179,133,46,South America,20,1029.65
a285194298e3448faafbaa560bf892c0,33,1,32,North America,14,499.76
a2853f88e8ce4684b3d56b70b43e33cc,84,31,53,Europe,23,158.16
a288e8f165fd4e5285b08f137b343ea7,102,71,31,Oceania,23,974.91
a289d116ec4a45bfb2dceac43eb3ff18,353,317,36,North America,20,2510.12
a28a1c3e147c4dcf860f09248beebc3a,340,298,42,Europe,19,2388.62
a28a3ae9c613429ebea584f339560cc7,108,76,32,North America,19,890.8
a28ea72821c240e98a00f3ec7365583f,362,340,22,North America,26,1695.25
a2933d31dd2e4ea482104f4b43ca0e02,153,131,22,Africa,23,1541.8
a293dc9fd54c4ed78c8198c0447f3499,141,121,20,Oceania,23,937.27
a295d1146df7459880b40e3ff7f1b2d6,348,313,35,North America,21,1878.34
a2999cede64e4527a54e3603b891e1bc,266,232,34,Oceania,22,2007.32
a29a129465b6440fb7eeb8265319c314,164,118,46,Europe,14,844.37
a29a2aaef6744ef1a37a2502f2a9114b,271,244,27,Europe,21,2337.61
a29b7cdb27254181818c4e0f0878d41c,177,155,22,South America,19,1441.18
a29d14c4ab864b37916664e8b9cdbd9d,330,292,38,Oceania,18,2038.85
a29d3747bdea4dc0bf4d7e6f7df2222b,57,33,24,South America,17,369.79
a29e80e5745447b78e3ae61104e838d9,41,18,23,North America,24,512.01
a29eb9b0335b46f38050cfe2b444862e,338,288,50,South America,19,2128.84
a29ef9bfd48f42ce8ba8bea85efc4f3c,317,289,28,North America,21,2504.51
a29f0395c816452f8429659e08f8e35f,242,202,40,South America,22,1655.49
a29f1678f33b4680aac1f0044ba41719,365,329,36,Africa,22,2245.76
a29f1ddc372c4ec5a3333a4a7f46edc8,363,326,37,Europe,21,1529.21
a2a047b8456542c387cb8e57f7464ca1,189,138,51,South America,21,992.82
a2a1350ca3bd44408abdc50a93284d10,172,143,29,South America,21,1053.21
a2a29ef0cf834504a7c7e1d2098893e3,132,93,39,Asia,20,957.66
a2a2a2fb2c8343a7a5c8f945d172c917,338,311,27,Africa,18,2406.74
a2a3be80ed1e49739283edff39b05e9a,262,230,32,Europe,14,2141.66
a2a4fb2964714b1981f8a5a589c5ba2b,253,218,35,North America,19,2167.79
a2a5762f2a064581bb8369a69142455c,333,315,18,Asia,24,3242.83
a2a77a5a47a449adb338e084162b0070,80,28,52,Oceania,24,805.47
a2a79539aa4e4a5b963d7f0f2053a0c3,282,252,30,Oceania,18,1755.9
a2a99d5935344a59a68f0c89b54cd09e,207,165,42,Asia,16,1662.49
a2aa191eba954575abd0420bca570220,71,36,35,South America,19,393.48
a2aad342a4554a9290714e819577a69c,316,261,55,Oceania,17,1875.56
a2af19c374f1472192fd6d6ffe5e113f,227,191,36,North America,14,1321.22
a2b256dee3e24bdea1b2bf3ddfa82d1d,103,52,51,Oceania,21,339.18
a2b5005c600b462d8bba29b78c16a38c,357,304,53,Asia,22,2129.26
a2b64988ff254a95a3e8621bc0dd8e60,89,59,30,Asia,16,707
a2b6d6a85f0c4d41b573126e51d40238,347,311,36,Oceania,18,2629.26
a2bb3d07492c44eda99fa0cf812cdffc,208,155,53,Europe,16,882.59
a2bc2d7cafa34b9e93e69b9f41171da7,258,243,15,Africa,23,1431.47
a2c3a35806f44449a959617c1d5ce2c1,113,72,41,Africa,17,608.97
a2c54ee101504f8d9e94f676496429a0,113,60,53,Oceania,21,454.15
a2c5b16bb5b04227857630b51e128dc2,235,211,24,South America,16,1497.27
a2c5e292c6bb4ae388456d61f799b892,46,19,27,North America,19,502.81
a2ca81af5b5245c6b09a73a5c3f126a5,264,214,50,Europe,17,1171.17
a2ccb1343994449f9f489084afe40aa2,300,267,33,Asia,24,1633.9
a2ccf47c116041e5a8c034982da8e71b,210,188,22,Asia,16,1686.25
a2cd9a981827465b97f7e83bef531988,290,233,57,South America,21,1643.61
a2ce429de1304f7e8e34769d351567f5,72,20,52,South America,15,307.71
a2d03083a8534c2f9458cf28001b9901,310,272,38,Africa,20,1816.4
a2d322e037b2486482b50e385fcfc448,106,88,18,North America,21,1046.17
a2d6dee1f7de4930811cfd6485e208a1,288,250,38,Africa,24,1849.21
a2d6e1eac459484c9bd9651094f4895f,338,291,47,Africa,23,1854.14
a2d6fb0dd92747f195acf100e3a52ba6,93,61,32,North America,23,858.87
a2d8902d454c4e0bae12ad20995aeabd,161,126,35,Africa,18,1008.52
a2d9132cb1574e049d529f5aed85df0a,156,107,49,Africa,22,665.17
a2d99a7cb09f44ed8c883c066f3cdb0d,363,319,44,Asia,18,2303
a2d9b98b3e674ddd869de87c5b46c0b9,87,60,27,North America,20,526.18
a2da5b175dd746939153f65d858da43e,116,76,40,North America,19,1076.37
a2dd3680a67e4112b109f420477c40bf,306,278,28,Asia,20,1848.07
a2dd63b5e109455d8bb858fcd957fc86,314,269,45,Europe,22,1849.43
a2de71d47c0743bd8922298ef439088f,194,162,32,Oceania,23,1235.39
a2e05b2e2d264976a0e32ab1096229fd,257,212,45,North America,23,1587.93
a2e0ec76f71d424da7bec2d313964d52,357,333,24,Asia,18,2539.61
a2e78202234e4180af59aad9463a66e9,328,298,30,Asia,21,2580.07
a2e846ce122a46339241d9e29e96a927,113,68,45,Europe,22,444.82
a2e8a5fe2e59468699b83404607676bb,365,362,3,Oceania,20,2174.99
a2e98690606b494d98d066e43535e430,187,130,57,Oceania,18,760.42
a2ea0fb0efc74c0999550830235dde99,353,331,22,Oceania,22,2556.07
a2eb66597ac748bab1303a0111232ad1,361,333,28,Africa,19,2880.93
a2efa75cb1984915a87976084a329730,350,332,18,Africa,24,2770.28
a2f3321ddd564389852cb460d7c7597b,101,74,27,Africa,20,1283.73
a2f3ad626ff546c391b257d3076e5a38,134,78,56,Europe,18,675.54
a2f5957d33d849afab3f1330467ee540,245,222,23,Oceania,21,1790.28
a2f7ef98911145eab2c8d33d62e2e1ad,359,308,51,Europe,18,1922.52
a2f895469a154752880676821e2b8eab,272,226,46,South America,16,1383.38
a2f8ccb4256149eb94161da379a81a57,142,120,22,Europe,25,1346.7
a2f8fcf9e4dc420e95ec62fde721479a,101,51,50,South America,21,752.53
a2f99023ecbb4a2297a8021192497ebc,210,179,31,Asia,24,1820.54
a2f9bad481884b6c9bf3269b48817369,310,284,26,Africa,18,1571.03
a2fd5df778ac45049b65b637b998fd0b,183,157,26,Oceania,18,1327.37
a2feaaf814bd4b899115d80d782d76df,121,91,30,Asia,21,997.71
a2ffb5bd126d4643aaaba5c0745af2ba,81,44,37,Asia,22,684.22
a3052ebdc5a44a89bf76bedd7b4d6924,167,124,43,Africa,24,1789.45
a306435728dc4acd98e7b8f45187d3fb,133,106,27,Europe,22,1411.53
a307dde7c7124bbe8989c7b89d70bf01,157,139,18,Oceania,21,1132.59
a30a83c1bd7f4dab930f26e23bbe0c95,364,354,10,Asia,19,2577.34
a30bcc53e31940fa86b42b976cced7c8,80,43,37,Europe,21,351.43
a30c417b43274f869829a884e1c7aead,91,56,35,Oceania,19,918.24
a30d649e51334c6a83af0b6cdd097f58,365,363,2,Asia,17,2512.64
a30d7412a91b41638e9bd8e462f92f9b,343,297,46,South America,17,1674.59
a30f3a449c8b4784a3b24a1477ae9aa6,55,18,37,North America,19,342.34
a314b0ec8a6e4a6baafe512e045cdb45,306,266,40,Asia,19,2525.93
a3151991dce74d249a273577eb01e370,346,316,30,North America,18,2421.19
a315b1a3b6a94a46aa0f1dba651c0d34,233,182,51,North America,21,1141.97
a316818174fb45489e2c3946fc6ab66d,77,30,47,Asia,22,340.3
a31a45e93cf9443c9da38fc024070e68,129,94,35,Asia,18,1009.26
a31af40c07cb4fa689f4969edcc90bbe,322,291,31,North America,21,2349.67
a31c15cbc0664e409cdba26ee2e2d016,91,61,30,Asia,18,760.25
a31c9eabc61747e2b0b4ba1897a0d10f,204,170,34,Europe,23,982.64
a31d562f62a04dadbfa8c7f99d054bd5,271,249,22,Asia,21,1577.83
a31d6c447cc04fabb56bbafa0a5792ab,71,42,29,North America,17,873.19
a32009f28c8344d285a1bdac87f28f78,365,348,17,Oceania,25,2047.37
a321a4f507314b1fb753605b52250933,160,134,26,Oceania,20,1132.53
a3262897ed5f4719945bec81d46865a0,45,13,32,Africa,21,200.11
a326e60f86b3433bab8592a88bd66bf6,33,6,27,South America,21,181.13
a32904bd02ca4d6a8ce9948bb38eee4d,140,125,15,South America,18,1074.3
a329685d88bb446b8bb70e118b4f7cc3,313,278,35,Africa,22,2062.81
a32a213113ac4d50a2200bc39b7c7506,60,21,39,North America,21,697.6
a32c3f026d62472b9fdb258cbd466b53,156,118,38,Africa,22,1339.31
a32ea756162e4608b17ba6420061c535,353,317,36,Africa,16,2587.04
a32f22028f2e4eecbc06b4625c8445da,364,338,26,South America,22,2506.77
a32fa10ba2cc4e7a93fc3359c03b9556,357,299,58,Europe,13,1623.82
a32fa94cd34c4f7c86f967b2086e0ca6,361,330,31,Africa,23,2349.01
a3321ad93d8b4e148ba00d21aa386109,276,250,26,Oceania,22,2661.43
a3323d13f3c14384a9ef9c9cf05295d5,132,116,16,Asia,23,955.07
a3324ad595254f05a2836bcfcc8fda3e,234,204,30,South America,20,2381.68
a332b16549e742d8a4deb3229e74e544,116,77,39,Oceania,24,629.23
a332f67a1706478c8c129b0369efba2d,227,205,22,North America,22,1656.66
a3339553d89545c5b0aa0d62e3fd88d0,350,308,42,North America,18,2309.82
a333b2a9ebda45f397373b1412f74a58,234,195,39,South America,16,1869.84
a334d077a2854f76b76703d02de969fb,273,242,31,Oceania,18,2149.33
a335f334dbba4bc7aedd67a55a72c82c,320,292,28,North America,20,2077.18
a33726f96ea24b74b75808223c06ee33,147,96,51,Asia,18,528.8
a33916925e1a4a49bcfc3a416afc9861,365,326,39,Oceania,23,1261.59
a33a1f69cdb340a68315dd1ff79e36e9,71,38,33,Europe,21,317.2
a3424f9618ac4cd3922a458f545691bf,331,282,49,Oceania,25,1649.18
a344a2cfeb6d42aaa69613513f606787,268,225,43,Europe,16,2223.4
a345b769908f4745930c4f7a6431f1ba,60,10,50,Europe,16,386.62
a3469f13ca174ee3b038705434965963,365,334,31,South America,21,2511.98
a3480436d9a545cb9f94450e7a1332fc,227,172,55,Europe,19,1657.17
a348b8ca24dc4b43906ff843333e49cd,54,17,37,North America,20,593.54
a34a3ea40f8541de9cbf4ccd9c79b8da,177,141,36,North America,16,1885.4
a35341a1473b445989f504ef9ce8719f,35,1,34,North America,21,222.8
a354b0ca0b0a416b86a0e1b53e10ec79,68,38,30,Oceania,22,557.25
a356b93016cd4cd19b6f6e482b9c1684,183,152,31,Europe,19,2369.68
a357ca4109894b83983a161a23fe492c,221,194,27,Africa,21,1606.17
a358017d177641a89a883507366fb783,157,138,19,Europe,20,802.06
a358e79cf5344517af32e257817f0dff,363,326,37,South America,19,2232.57
a35a6ed07f2249d3945c3ec3bb13e69b,299,264,35,South America,14,1421.02
a35c24cf95484504909591feb40b5797,358,328,30,South America,23,2477.2
a35c4a7244254e00aedfff9a64ff635d,191,136,55,Asia,17,1075.59
a35c88f1af464f97a3c484e24d24228a,348,299,49,North America,20,1545.22
a35ece36ea0f4a0a9dca9024189cb5bc,108,61,47,Europe,25,245.13
a35f20db35ec48c8a9cb78db0edb0674,362,359,3,Europe,18,2622.12
a35f62129fff46fb826b99183052b143,179,133,46,North America,11,782.99
a35fdbd7712047978631797cda7e0bf8,89,68,21,North America,18,649.79
a362325888544e06b3e5b1a26a1f6b57,364,353,11,Africa,16,3014.28
a3648690e7b94fc684167a77f2219f67,131,104,27,Europe,20,845.1
a36597da246f44c59bb9029be47bc62c,277,243,34,North America,19,2674.41
a365d3841b9f496b8a8a1a5ceb65cd1d,45,26,19,South America,25,440.42
a36666f892644e6586a23a8b53400ed3,213,171,42,Africa,16,1222.31
a36aff086626427e845820dcbf674632,50,12,38,North America,21,550.14
a36de25369a6460e85c520b5bf08e359,110,70,40,Africa,20,1041.82
a36e6fc577304261916f1ce69cae3bdf,306,280,26,Oceania,20,2434.75
a36ef1acdb0f4855af9865c03b2d5c86,365,332,33,Africa,21,2336.78
a370f852dd864610ba782514d1700914,365,352,13,South America,12,1518.88
a371db8a372e45e3a8aa16e89706ccff,315,257,58,Africa,20,1669.65
a373a4797fc14a378869bfc6e64d0757,353,335,18,South America,23,2676.6
a373d785193d44bea687ccbb687cc934,268,246,22,Asia,18,1901.99
a3742137e0654572bf10a05f1b0825f8,358,305,53,North America,14,2007.87
a3748a6e8be544f5a1e6fe5422d2a437,125,99,26,Africa,21,1031.39
a3758ac4cdf6400b980d9cd3fa235d86,73,40,33,South America,17,792.72
a376c9aa2b9541338388df42e91a6a4d,293,257,36,North America,16,1566.83
a376f1ee1fd64bc896865c53d38781a9,182,139,43,Asia,21,990.18
a37774b2bd0b4183a85baff3717e10e6,110,58,52,Africa,21,387.73
a3794aaca6f44d7c8a6022e2ae5a24c2,135,113,22,Oceania,22,478.78
a37a8151c9084dc6a5afc22afab8c3dc,175,132,43,South America,18,752.47
a37c4b91cd0b42d9881166340c2c92a3,119,88,31,Oceania,23,490.33
a37d4ae17a814ce3b0bd7fa662ece0a6,233,181,52,Africa,19,683.36
a37d5122c88f4df0acee9d58b7824308,26,5,21,Asia,17,348.62
a37ddb474d54452081a9cf3ff38cdfd9,100,68,32,Africa,20,740.68
a37fc29864c048bcb77c965072e80832,112,71,41,Europe,15,623.9
a38007e48f2f45efa40c762016674273,200,167,33,Oceania,22,1110.09
a3860a723cb34939b5cf97967cc937eb,56,9,47,Oceania,20,260.56
a3864b65e6124502819229646308d779,345,294,51,Europe,19,1612.76
a387aea834e34503a642f845d6a1eb41,56,27,29,North America,19,243.75
a389114867504ff390ae27ca09414f72,230,196,34,Africa,21,1559.42
a3894303ae4d46ecb97464222d40f6b1,312,269,43,Asia,19,1634.54
a389a09e03524866be94e42b47f976ef,365,337,28,South America,19,1827.95
a38a1d1ad9c948c69da70abe7c03151b,143,103,40,South America,22,611.55
a38b8bd834654ae48b851e158dce4219,233,200,33,Asia,24,1985.25
a38edf21130b45ee80aba73065ed1cca,178,142,36,Europe,20,973.7
a38f075e0d9a427989ba388278fd6cc9,218,171,47,Oceania,20,1682.99
a3901b99825d4ae3a8cdb7b62cbea83a,175,130,45,Oceania,15,1391.76
a3919abdf4a444cd989b828ab1a8b0f2,327,304,23,Europe,16,3258.5
a396ebfb08f84e61bb770c509c86c5f7,74,54,20,Asia,19,341.08
a39c845931b44f23a8a5377dfb493880,187,151,36,North America,21,1576.1
a39cd957c1434186933e76a535ce4593,278,222,56,Oceania,21,1509.64
a3a028c3304d4d8eb00a3f78dd97749d,237,201,36,Europe,19,1942.95
a3a1951fbf1c4d40bcb6f9710269753d,328,280,48,Africa,15,1092.66
a3a2c43367794d96864085961c5853d5,29,4,25,Africa,17,140.6
a3a489c41ae0498a97dad91b753fd795,94,74,20,Asia,19,402.24
a3a5209e25fb4ad1a5680650fe6c10c8,94,60,34,South America,24,671.07
a3a56d3cb17943648e3afda9b26485de,317,281,36,Africa,23,2338.62
a3a5fa095a2c4038802e7a4b8141a2bd,146,96,50,Africa,21,815.75
a3a6464179814aa2bf64a5844956e8a8,97,52,45,North America,25,449.6
a3a7b7cb15a745afb3035dfb44423950,245,219,26,Europe,22,2198.78
a3a8e2ff9a664d84aa8fe0e6d18bdfb5,262,220,42,Europe,16,2120.52
a3aa1b6489c64f77a4335a9a620b3d8f,189,146,43,Oceania,22,1200.58
a3ab18e7172447869f78d3f2b3e50aa3,191,165,26,North America,20,1359.08
a3abaa40be2d4169bf6942ffb86dd50c,144,107,37,North America,21,920.68
a3ae61438a99478b9a3728a182bcf286,261,239,22,Europe,21,2655.68
a3afc302196f4a1fbde9db8b0ab62071,84,32,52,Europe,16,297.9
a3afd830357241579ea88095cc7ad7e2,353,320,33,Asia,20,3422.83
a3b03076ea394f7585ccc510fc5cc32a,365,340,25,North America,20,1961.84
a3b1e13e057a415bb6d293e6972d2053,329,275,54,Asia,24,1795.02
a3b36f262ae04e26b7f72966f1cebe3d,50,4,46,South America,23,173.45
a3b5a4cac7224f1b9ec4b2947369f205,33,10,23,South America,24,264.67
a3b7fbeab8c54595b0ecc6eff5d8d136,126,91,35,South America,21,716.34
a3b811e4667841179e5ab191b6020933,203,185,18,Africa,15,1645.09
a3ba3a7b18bb42f78bc73c4901f1dbf4,342,322,20,Asia,15,1830.07
a3bab7d8941f441a8917db78c0623a38,237,212,25,Asia,21,1916.73
a3c09bfe630a419c95b453f95a42640b,67,25,42,South America,18,298.3
a3c0c89da0c84dc0afd601e10336cf42,64,16,48,Europe,25,365.59
a3c1684dd73e4c7589f8f0b2064c8a30,288,231,57,Asia,18,1371.8
a3c2da67ffe4421abcd3a7e824e53193,365,338,27,North America,19,2425.92
a3c3d8da7d3f4de7a1c94946e53d04b2,301,265,36,Asia,17,2267.91
a3c43e5f03b541e9b82903729158d8b0,117,94,23,Africa,24,1017.58
a3c58738c10c43a79b6a272c2523f44d,339,314,25,Oceania,21,2146.66
a3c5c8cf89744aa0bc0f32510fc3d5d0,81,37,44,Africa,21,188.34
a3c696a7060047a19e4bad236cb7e13f,64,34,30,South America,19,417.89
a3c6b99797604d9a99156cf692f6ca2e,234,182,52,Asia,20,825.72
a3c72b32492c4ed1bfd4906d36ceeee7,84,44,40,Africa,21,535.86
a3c76274b45a454bba9b85947f9a8e16,125,89,36,Oceania,14,908.81
a3c7780b51784a1b9bb5cbc1fb6ffecd,365,330,35,Europe,28,2619.81
a3cac80f8aa649099d17e45213cefb6f,280,223,57,Africa,22,1676.16
a3cb6bef7c35448e8104a951391e0219,106,79,27,South America,20,862.24
a3cd1646cc9947b58c750061238e92cc,196,170,26,Africa,22,1389.63
a3cd2869427b4ea08ac9c4e611057747,223,202,21,Oceania,19,1489.52
a3cd7b4c188a43b4bc64a9c114727b18,124,82,42,North America,16,386.49
a3ceb2934db74eb285337567f813be73,348,322,26,Europe,19,2521.61
a3d0aaec3d8f4ca48dacb27f8504ead1,310,260,50,Oceania,20,1766.27
a3d29ad2535a47f387443e4a13b081a8,350,332,18,North America,23,2689.07
a3d2bd6a1c0e49419980b71b11fa35df,363,326,37,Europe,17,3333.14
a3d4005c3b444be1960990d40d0ea132,365,361,4,Africa,24,2355.86
a3d646ac8a13433fae30c680b3baa665,364,362,2,North America,20,2178.28
a3d8b9a1b6ed43529c9d57de415d3107,220,190,30,Africa,24,1801.68
a3da195c0c454cd08d9c1d3ff71b0ca7,312,282,30,North America,17,2161.84
a3da772743b64f02bae03ffd7ee57792,239,204,35,North America,20,1745.85
a3dcb253386649529b295597836e867f,180,136,44,North America,19,1483.88
a3dedf340c15400e9ede3e6bc84db051,166,120,46,Africa,21,1498.97
a3e04a4bb0ab4fc1b0854fde2c226cd2,230,198,32,Europe,24,1509.96
a3e118238c1342daa38d010513e1ee55,125,65,60,Europe,16,493.15
a3e18b5078264bcd8a86e1c8313eb5ba,92,44,48,North America,22,321.5
a3e31b8fab924a1b8f45cc473981b12f,268,220,48,North America,23,1174.94
a3e3771a4b7b44d09baefe1cc08fd507,111,86,25,Asia,18,675.69
a3e41f7d9ab04cf5afeab510f530400a,71,26,45,Oceania,19,183.63
a3e50210dc1b44c7b350a021cb1430c4,315,265,50,South America,23,1095.44
a3e62b71818a4a91bc463f0435b7518a,136,85,51,Europe,20,541.3
a3e6ebf874d14b47b3e4f6119e113cc4,156,104,52,Europe,18,950.34
a3eb178cf0734d978013940d2c62f5d7,111,67,44,Europe,21,287.36
a3ee89e44fad446d9aae254d170727ff,176,132,44,South America,17,833.19
a3ee9b8325e247d79c8f0ff6fc67b101,242,201,41,Africa,19,1329.86
a3ef69451e3f4d46bbce44fbd930ebfe,282,234,48,Europe,23,1711.54
a3f08b0ac7e94eeba5a944250a056c74,365,363,2,South America,18,2498.95
a3f0ef8052b44938a261c32702236acb,235,212,23,South America,21,2190.32
a3f13eae5574489b8270a2930f7113c5,201,143,58,Africa,21,1591.49
a3f1891fc9304d1aace88df171d90eaf,224,194,30,South America,25,1557.64
a3f221d1d0c141ff9ff70a1619b02b66,100,49,51,South America,21,626.46
a3f2daff3d9c4f16b9ce4f91fab7def2,108,67,41,Asia,22,740.65
a3f47f84ca034bf1ac3ebe09da81820b,117,89,28,Oceania,16,843.88
a3f4cdd564ec4f469f045cb62c89ba85,132,98,34,Africa,16,695.81
a3f54481a173416f87cb37d5c9e9fac4,273,237,36,Africa,26,2231.98
a3f81ffaae4443d99b5b79cab59c543a,244,221,23,North America,21,1695.93
a3f88b4a8b99453f9e0e72b043f584cc,236,181,55,Asia,26,1012.75
a3fa219fedc54174a03302d4596c9fb4,117,94,23,North America,21,1431.48
a3fb49cd91df45bcbd0ed7fa65589f51,365,332,33,Oceania,17,1808.35
a40217e533db4e6f8a07cd0749aa8e0c,319,296,23,Oceania,22,2290.06
a4022ac3979b4ce2ad8c41970d10cddf,344,292,52,South America,21,2309.68
a408f5cb03564bf9b92873a5c86624f8,365,346,19,Asia,21,1734.93
a4092e1b064d4702bcb153af7c5a6407,134,115,19,Europe,22,794.5
a4098b70d4ed4380adf4d4330861d72b,364,331,33,Oceania,22,2243.1
a40ad08f42d44b76a65b6847eca29c74,112,82,30,Asia,15,667.66
a40ce210a32949509e98fe1c1cd15f87,240,202,38,Asia,21,2154.31
a4112e13adef410f93e0ad3459644005,56,23,33,South America,19,412.33
a4134bfa2f0c41f29077151672cc5738,362,314,48,Africa,25,1743.11
a41415ca95734763ad88f5ae39e3c761,263,210,53,Asia,19,1300.33
a4156b0e1b4349deb5d61a5db29f55aa,242,180,62,North America,18,875.92
a4168cd36e634aaa8ee1da2693a3e010,337,304,33,North America,18,1817.87
a41c20167fb341eb95e22ccf48ef60f8,340,277,63,North America,24,1636.92
a41dadea536541aaa36b578e5a7b6090,145,110,35,South America,28,857.65
a41e158066d9434bb85e4ad266e5fa4e,115,71,44,Oceania,19,1380.43
a4211951b35349dc91edb78e11fe559f,209,183,26,North America,20,1699.57
a421acaf80674f1ba7420f2378c93dae,55,14,41,Europe,18,468.67
a423e2ff06a74545b92d6486729062f7,365,361,4,Oceania,17,2563.74
a42a9315ac0b4806a63de7958f53f467,257,223,34,Africa,21,1658.1
a42a9f49caee4d4f82d94b70baec58a9,327,307,20,Asia,19,2182.46
a42b06bc5a44412e8491362db7275a49,281,252,29,Europe,21,1913.7
a42d3371e84b40979c271ffa5e02017d,179,136,43,Africa,22,1154.69
a430152dff3d491ab85a78888615bd51,243,217,26,Europe,18,1679.1
a43088e99cf943da8119a00910e35a4f,284,245,39,North America,20,1904.78
a431234bfa954c5b9db0b7471196267d,326,279,47,Africa,23,1740.73
a4314099ec294fe3879bef7e2ef34668,47,1,46,Africa,20,122.18
a432caca60d642b3b3b8777999925f22,65,42,23,Oceania,24,335.92
a439465d669546bb8b5a4f944a320f5d,177,150,27,Europe,18,1514.64
a43bb3ea85f94b69b62c55e8319286e4,341,289,52,South America,19,2185.92
a43bbd79189a4a7ba0d7589b64213107,110,80,30,Asia,25,901.25
a43c074df227407d97076858cf566328,316,296,20,North America,16,2264.34
a43c3f93413e4bb7baf03951adcf1eb3,127,98,29,Europe,21,762.92
a44181ff6c2b42ba8308cce80c79b4ff,317,292,25,South America,22,1980.76
a443a5ab060c4356a48150fd8ce016cb,348,323,25,Europe,23,2481.98
a4467232c2dc4554939b88a616da2939,153,118,35,North America,17,1287.29
a448d24d06dc4815ba8c3d37e5c0c799,181,143,38,Asia,18,1018.78
a44b87a0ae4c4ee4b04629de37d50f39,293,267,26,Africa,24,2211.9
a44d958bc6a04703b697bf07b2b2f08c,189,138,51,Africa,17,702.92
a44d9c1acc184d049e746a8ed4f39773,228,193,35,Africa,18,1536.38
a45026b9461949caa1eb3b2d9fc0e856,252,217,35,Europe,20,1646.54
a452245c6ad84d4592ed664e8402e787,228,196,32,Africa,22,1583.28
a457960299c941bcb933a0764bdf633a,365,320,45,Oceania,22,1829.21
a45a8f3cd91f4087be6a80a941be7807,112,63,49,Europe,17,809.64
a45b681fdde64783903de206832a16de,356,305,51,Europe,25,2208.91
a45f1a6265514a69999c495f74887357,295,241,54,Asia,13,730.67
a46195fca19547c4921f3592092e2602,364,347,17,North America,20,3344.16
a462ff8a853e452cafbdb40bec567b16,114,69,45,Africa,21,807.8
a463aab1ce594c46b23ef8e1b0458521,147,108,39,Europe,19,1340.34
a46488d074fc413281dfa255c10e0fa3,71,52,19,Africa,20,585.54
a46829129e4a47ada526a7fb1e40877c,120,68,52,South America,20,606.43
a469507926164c91b8076c98db78d841,363,327,36,North America,17,1668.28
a46c2bc8783347a4aa6edad1583f1b12,82,38,44,Asia,21,526.54
a46cb04a76c241dea7047b6f7ea7c823,364,342,22,South America,17,2818.6
a46d926141e240d0b820cd26007de9b8,335,280,55,South America,20,1699.65
a46d9ad1e7b04344a97df0cb18214be1,197,139,58,Africa,23,928.59
a4710607f9ab4fdeb900679a835625c7,247,203,44,North America,18,1091.55
a472dcff258b4aa19f719f1a58b5128a,123,86,37,Oceania,19,770.43
a47496320e9b438782913b6d7f10c2b2,287,258,29,Oceania,24,2462.64
a474bdd151ec43818f265a206f1202fc,276,247,29,North America,25,2129.42
a47640d27c1642f097118332759aeccb,267,229,38,Asia,20,1792.86
a477b0561beb414dbd6e23fd4411feeb,365,338,27,North America,16,2211.91
a47c97497c924a7da53c5f36d90ad6ce,134,96,38,Asia,21,952.92
a47dbf13798844c791740d7636304ba8,341,312,29,Oceania,19,2346.19
a4833ec7dbc34e16b88f16197377e246,312,279,33,North America,24,1638.55
a484f9896ac34e94aa7b4de29760d3cc,271,241,30,North America,23,1661.56
a48531acd86a4fc98a7db2a94a10f4f1,102,71,31,South America,20,713.25
a4861b0e595f4cb396132063d4d6bc49,55,3,52,Oceania,27,214.61
a487c926e4354096aaf766a4498adbf7,198,167,31,Asia,28,1699.01
a488a29c1a504cc8bc31f47ccf8ebb5e,319,296,23,Asia,18,2239.43
a489086757674d7c9ffa37f6f8c1f637,225,200,25,South America,15,1527.68
a48a5d22fb8d43abab94ca7c3c91f5ff,107,74,33,Asia,17,710.67
a48c799644a947a8a3ca45db73a3033a,365,336,29,Africa,19,1615.19
a48c7df0cf76431e97fabef10f754249,23,9,14,North America,21,208.93
a48cfb19071e4d7792bd462bf31e5999,176,146,30,North America,20,964.57
a48d8ce1f9654884b1f7610000584d16,114,79,35,South America,23,730.38
a48e0ada435a40cca46c194aacf6a3a2,230,180,50,Africa,20,1300.12
a48ec13924024da79d0e7165dbd1a8d5,178,154,24,Oceania,19,1400.3
a48f10510b4f4a2bb36e68679e4f17fe,178,126,52,South America,24,748.05
a4911d9ba56c431d93ec80d9c8a8c55f,332,297,35,Asia,22,1765.48
a492218363494999969f9217ae221b1c,264,221,43,Asia,17,1835.81
a49546a129fc4ed79f9d5c687008ba2c,290,266,24,North America,23,2502.39
a49568eb7b824d3bb98481ba994ecc54,229,169,60,North America,19,1260.28
a497b870a67c491a9854322544301dea,365,353,12,South America,19,2649.55
a49abcb2ee8e4b55952254c831d6cbb8,287,274,13,Africa,20,2739.37
a49b88c3bdcf4d91adbedccc47b100f9,57,19,38,Oceania,15,308.1
a49bf16b487845fb871a441f19a434b0,140,109,31,Oceania,17,1153.77
a49c210870fd485b9afb3d229d64dbf3,311,267,44,Africa,18,1899.31
a4a270d88bb64ccbac563d39f64bcd00,109,88,21,North America,23,824.81
a4a30a84fa4843a7be5d2c047fb3cbf7,362,322,40,South America,21,1369.35
a4a4602d889e4b278df4fb475b02b32f,131,80,51,Europe,19,783.44
a4a7114110674ed38cbb3d3b0ff1092c,211,160,51,Africa,17,1139.45
a4a7e3d6c550465591a8d1708f5414d5,296,256,40,South America,20,1285.29
a4a977d069b24e39a998145d121ae15f,344,307,37,Asia,20,2095.6
a4aa3665d7f048329dd931ff5bb638c6,355,310,45,North America,22,1827.44
a4aaa5643ae54402a4afe08195fdf71f,125,80,45,Africa,19,772.62
a4acd08084bf4378818f30b6809a9c2c,338,291,47,North America,21,1946.09
a4ad3e39855144a994ecaaf451495ec0,364,317,47,North America,21,1963.18
a4b1e327171b4b02adbebae573ad8a64,95,61,34,Asia,22,539.26
a4b44a36a3544b0dbe56609c1e07da8e,128,103,25,Asia,24,978.04
a4b44d13de054262aa3c13a51abf133c,171,147,24,Africa,29,1241
a4b4d288705e46d0a7bf38ac02618e6e,196,153,43,Oceania,22,1431.89
a4b5973bb55c42adb2e3e736410b73c6,364,356,8,Africa,15,2407.48
a4ba2c97c0eb4b74baef4aff753e6ab3,43,9,34,Asia,19,495.54
a4ba5871d7a641608d34ea5c0ed54bba,86,53,33,Oceania,18,770.58
a4bac703f6744ebc9d8eb3fb693fed34,309,252,57,South America,17,1576.1
a4bae84832d24f0997e84f35d2f8188f,348,296,52,Asia,17,1905.84
a4bbb5ca07d8474bb7054536b81466d9,232,189,43,North America,19,863.79
a4bc19f4cbf2459196004cf180e0d825,157,138,19,Africa,21,1424.34
a4bfc1f9f416473dbfe73d13e995dc01,365,350,15,Europe,19,2283.11
a4c42eab48ae4bb48b0e9eaf5b106361,63,28,35,North America,11,530.13
a4c47631662349079766eab81bb77cd1,220,182,38,North America,25,1873.04
a4c4b88a8e524d4b92742e855358e0d5,220,190,30,North America,20,1893.76
a4c4bcdb3c5142beba261adb98bfdee2,264,231,33,North America,19,1601.22
a4c5132177744343869bf13a2c0e66a1,116,64,52,South America,21,385.68
a4c6027f60ed4b84976f322a56a0216c,125,83,42,Asia,25,893.48
a4c7452179e54300817a3296aa3ed1a2,193,142,51,Oceania,20,1322.29
a4c778c254dc411a8df3d3811c9fdb93,63,26,37,Oceania,24,454.8
a4c7ebb70ec74f06aa5d0f3a42fc7f6e,238,214,24,Asia,22,1809.55
a4c8c69c64674809a8443cc6cdcee233,236,216,20,Africa,15,1616.01
a4ca14c4ca2749c599d3ade1a01aec92,194,139,55,Asia,18,1109.16
a4ca8709cd3241508c54c8d5ae6e26e2,147,116,31,Europe,21,824.1
a4cad8e9e8f149f3beb5bce579eb45d1,81,55,26,Africa,17,452.78
a4cc3588f5a1467ba86c8d6f1421b301,40,18,22,Oceania,22,286.87
a4d035d7036148c9964da3062ca76d5b,108,63,45,South America,19,669.71
a4d1346c8ef34515ac315d6861e3b961,226,184,42,North America,14,1497.78
a4d3633a643c4c6f846b1fa5928558b4,279,245,34,Africa,20,1620.73
a4d3be8033c14f4c8dff7405a5588895,220,180,40,North America,19,2280.6
a4d45ca6993c44cc871d029164f44be4,187,162,25,North America,25,1409.38
a4d9d47d1ba544c685840df6dcbb5ab8,61,22,39,South America,19,89.12
a4e08c16f6674ee79cec23edf9518d55,40,5,35,Africa,22,197.51
a4e26e9e35d147e397186a929face0f9,348,305,43,North America,18,1352.15
a4e39093b6904a63903131d7f33defa2,340,321,19,Asia,19,3372.74
a4e4309b76f1452b91f92d7d85006878,267,233,34,Europe,20,1789.23
a4e6d73a513b44d48804fdd49153f8d2,46,16,30,Oceania,18,249.33
a4e73036d7284aafb8dfd688979a34cf,134,112,22,Asia,19,1077.58
a4e7d394d29144d683509a6421c88aa3,146,95,51,Asia,23,932.35
a4e8632c614f4b2284728277464e3d0d,189,135,54,Asia,25,1137.64
a4e9257d403e4480bbe04c48b9c3c1cc,319,272,47,Asia,19,1263.74
a4e9bf4b47364707b38581731ebb0c99,239,207,32,Europe,23,1343.2
a4eb257cfdb649c6ba60366f444edc68,256,225,31,North America,20,2293.86
a4ebf33c3ae649348e64c9ea63e4d95d,364,337,27,Europe,20,2283.82
a4ee54022d3140fe85590dddac9ac301,262,213,49,Asia,22,1326.7
a4f16a7f7ef840b0bb24fef60b31cb7f,52,24,28,Europe,19,333.94
a4f174b89d374f7fb5a9323777cd934b,243,183,60,North America,13,1488.7
a4f1bd28e9ff40189dc1b94f837ceff8,102,48,54,Asia,18,467.69
a4f3d487ad2b47c7b67f69aa825dd7c8,142,105,37,Europe,23,604.94
a4f6657f808946f0a096f7f263944cc1,214,181,33,Asia,20,1825.39
a4f812f4acef4c6cabc6ffe58847b3f4,324,287,37,Oceania,23,2657.11
a4f8c6ffbb774cf0a52a1b40bbf33b3b,131,100,31,Europe,20,900.64
a4fa42267a9546d383576a876bd03ff0,330,290,40,North America,17,2061.83
a4fd357367264d5f908c926f84db36a7,364,343,21,North America,20,1790.13
a4fe56dcf04f433f8efab5d40ed17745,153,105,48,North America,24,962.74
a5000a35989d4232b79a9b53f9936b7b,364,364,0,South America,16,2065.94
a5002cd473d442f19e0b6dbe397ab3a7,217,175,42,Oceania,20,1760.97
a501b61dc782483bac483181ff0ec839,97,69,28,Oceania,19,437.32
a50280af95b24928ae082659e3c6eea8,53,19,34,Africa,18,238.56
a5029f2a5dec4e0499aef513f10fb185,121,73,48,Europe,23,649.13
a502b1cdca4f4d408370194984cfc978,270,221,49,Asia,24,955.28
a50359d8524f4e88a89f14b83683a39a,184,166,18,Europe,19,1332.26
a503ec2b310b4478ae571b5b630d7871,365,350,15,Asia,16,2143.49
a504b9ca15f84a40abb9da2cc1eb8ab8,228,180,48,North America,19,1255.39
a504f8decdfa43cd857b9bc34f64f16a,280,234,46,Oceania,21,1808.73
a505b240769d4bdf965adaa994e81462,365,359,6,Asia,19,2112.63
a50819b5afa148158678f956dd73f503,48,19,29,Africa,24,426.55
a5082d18f3fa4ae4aa5cc7506c69f433,296,272,24,Oceania,24,2699.41
a508d2ce6a274c95827a98f2581e0548,34,6,28,South America,17,198.38
a5103188347b40258950e9340fcd7d87,298,274,24,Africa,20,1793.57
a51071830a784e40938181fc3c9057b8,335,318,17,North America,23,3019.39
a511ce672a9949c5bc6811821be1f6f7,163,113,50,Europe,29,774.73
a511ceeef8ab428f97269c3d7154e69a,158,108,50,Africa,13,1013.28
a5127f4fbeaa4573a04a53f26db72cec,211,170,41,North America,20,1392.93
a512c687d8464dc1b7a8521f0e86e402,39,1,38,South America,19,789.66
a517513fa2ea4b93aeb8c233189ee6e8,231,176,55,North America,22,1373.9
a5183076f4f949ce820de18a8f588a5a,116,93,23,North America,20,879.7
a519eaecb96c42578add5ac60d404fe3,318,298,20,Africa,19,3164.81
a51a4606388b47a58a2a4907f050d09e,187,147,40,North America,23,1217.17
a51a8b02c6d34b859aa4e5a0a3aa1f81,193,153,40,North America,22,1594.86
a51b6607d8f049b886641bf351c056fa,74,52,22,Africa,23,694.05
a51c204cee1444babb402f16d2865f5f,309,264,45,Africa,19,1824.8
a51da7655c754125b9b2061fd4ca34c2,168,146,22,Asia,23,1207.15
a51eb84dee28480388596dced1a44825,214,178,36,South America,20,1671.21
a51efde6d8ab471fa1aa36b3b0a70bac,354,311,43,Oceania,20,2315.86
a51f49127de64402bc7220404f59bbe1,365,333,32,Africa,17,2556.94
a52022989e85462cb9fb97ce7cd296d2,100,65,35,Africa,24,755.46
a522214ef5294de499d79c7ee42d3773,262,209,53,Africa,24,1827.01
a52259646c63448f963d9c1f7ed3225c,269,216,53,Africa,18,949.65
a5229ca4f8d34f25af7239e7c756c1dd,95,73,22,Africa,19,306.6
a522d07b099144c29367eee5f1fcf643,166,110,56,Asia,23,1203.96
a523cf84cfd94d71903b9573ba06b59a,266,226,40,Africa,15,2258.63
a5250ead67a2473a95c9c9b655302c9d,168,129,39,Africa,18,1350.72
a525163d60644bb0b1f3d7df74430200,363,355,8,Asia,25,2089.19
a52b8e2cae234ed08d1141640399c8ce,29,9,20,North America,15,224.09
a52c6c2c679d4ab7b78a45da2a3562f8,153,118,35,Europe,24,829.6
a52ebeec5589465cab1446e4713c979a,135,111,24,Africa,19,908.81
a52fa7d8a5ba4eb28159a148c6934bb2,364,323,41,Oceania,17,2889.28
a530502b85c142af8867fad1f7689a89,74,51,23,Africa,19,497
a5305628a3d04730b758b74fdb98e62b,173,126,47,Europe,19,761.47
a53195959ba74af2969300ad3a8078df,340,292,48,South America,15,2174.27
a5319b772d06428395550494c72f2504,205,165,40,Africa,22,1745.69
a5321ac360b144258a267e840483d3a9,150,102,48,Africa,17,841.18
a533140e2fe246d993260d28c8a93bb5,125,89,36,North America,19,921.34
a53508e0b4f24c34baf960be31044371,365,351,14,North America,18,2728.88
a5353fb30eb440b5960386814b3350aa,365,343,22,Europe,26,2998.69
a535a4d1f645458ca3b245b14188a1d7,155,117,38,Africa,18,696.47
a53694c79cdf41378df8730690e32390,47,2,45,Asia,16,118.06
a537c203b3ae4ef1be84bf870f8049c1,291,251,40,South America,19,1725.52
a5380b6f16e641178514f5ce7a396274,77,34,43,Africa,18,514.03
a5383ec32a5e4d6f9a962d8473c2ac07,332,281,51,Oceania,18,2526.59
a538908947b94648a442822e47b46b96,192,163,29,Oceania,19,1147.52
a539473da9d644279da56dbd7e352a84,365,359,6,North America,20,1411.97
a5395f50e42540b384096db0324d18b0,365,358,7,Africa,16,3070.53
a53a92b164c443419368fbb8fc2eb827,365,330,35,Oceania,19,1629.17
a53ccccd05bc440b96d50919fb333fcb,103,49,54,Africa,19,841.06
a53d51e3b72c4f4785926eaa3cd7c4e5,183,152,31,Africa,20,1143.21
a53d91083012429d88497edf560e1697,226,185,41,Africa,17,1818.55
a53eabb837b34d82b50aa77a7b637aa1,312,267,45,North America,19,1738.97
a53f5e63623b466abe05ce9e07dcf502,166,134,32,North America,20,1363.04
a5400e3e5dd1498085622a5998c1dc97,55,12,43,Oceania,16,491.9
a541555cc534409884fdbe4b8a938047,282,242,40,Asia,14,2381.48
a541c19050354351affd36baa3b9e527,91,43,48,Africa,19,345.65
a54423f1a3ce49d9936587ccccaee1c9,321,280,41,North America,17,2370.45
a548af15ae244caea86491ef6abcd75c,58,39,19,South America,23,425.45
a548bbcc2d7f4edc92759e9965533698,365,338,27,North America,20,3637.37
a548d9c0b8444692b8c008808c1518d2,56,18,38,North America,18,307.56
a549ef2884fb49408217d1da1adb4ac4,55,35,20,Europe,16,733.55
a549faf86ad24432861074c8028bfbae,216,166,50,South America,18,820.62
a54b31b5f4724b73b55a7a617eebc700,55,11,44,North America,20,595.81
a54f032f0af24f5084010c062e097ec4,119,80,39,Africa,24,629.1
a550fdbdae9e4ea1b579a015902fcf7c,27,2,25,Oceania,16,243.33
a55461785956424daaaa4f59ab374c8b,80,42,38,Oceania,18,397.72
a554bc9c07e14a07a9dfb592c017a1d0,332,309,23,North America,23,2611.51
a555d7ae6a4942c98555a93a74e87c04,73,21,52,South America,23,452.87
a5571565611d4b8493d80c1e4306b122,99,61,38,Europe,18,612
a5575a7b779a48c89ce4bbf1fb823a61,73,32,41,Africa,15,339.91
a5595d2633cd4210a298dc671ae26ebe,337,298,39,Africa,26,1366
a55ab37a7768423089c9a505f3e0ff3b,324,291,33,Oceania,23,2184.16
a55c02e484bc4c2b990667ce9de577f3,172,147,25,Africa,17,1315.24
a55d8d21b7a349389239a28b9ff6e6e5,90,37,53,Europe,23,353.67
a55dcaa5bad6441b8f1a0a1c9f3fd014,99,64,35,South America,16,425.25
a55edf907add4a188772802df87ee45e,169,148,21,South America,22,1270.8
a55f24ccb7384fe080b6dfb6799da691,202,162,40,Oceania,24,1228.62
a5629d4d632044da990da8f32fbcae04,242,211,31,Europe,21,1598.15
a562eedadcf94cc3b8014b6aaa33b7bf,112,84,28,North America,19,184.91
a562fa8cae49436ba10c5f09c2a41ce1,330,301,29,South America,22,2998.8
a563f431d0c445988ee5b01821b024bb,81,47,34,South America,23,467.93
a5654f19541c455da403c169f0e8333e,297,257,40,Oceania,17,2361.67
a5657344454a4d2e85b815f93793b209,365,350,15,South America,19,2559.93
a565dbe7038f4c5db4f3614cbaa91d62,186,132,54,North America,15,812.86
a5685780fd8a4d5b823cfd8568728dc5,207,159,48,North America,21,1038.9
a569dc9c9a004110841a17985b4bde15,327,274,53,Europe,13,1504.33
a56df258d3794b7ab68d01951c69a3f1,365,352,13,Africa,17,2743.63
a56f8790653d4df396a467f8ee21789c,360,359,1,Europe,18,1911.5
a571324c9c2b43b9a0bc8e711a691f26,62,18,44,Asia,19,319.64
a571c53e96a64fe2baffe7c25ae64fc0,365,352,13,South America,20,1814.79
a571f55d636a4cb3b8fa2c6e6fc2bde1,362,319,43,Oceania,17,2345.58
a573f14386d940e68e3bdaa7d4fb1a95,172,131,41,Europe,23,925.5
a57435dd884d4ae0b30305fe8809fbfc,364,327,37,Europe,24,1676.58
a575ed3c002844bc9edc107ff18448ff,364,359,5,Asia,21,2974.34
a5784c2d05b24b5995a22c831b550c23,203,157,46,Oceania,17,895.35
a579c6987d4148febf25cac3a6d3f85e,234,182,52,Europe,20,1366.59
a57ad4fb6b9a4804b2b6254cef91906b,142,113,29,Africa,20,1297.6
a57ae770f9bd4570a7c18596f21b8c15,72,24,48,Africa,20,376.4
a57c8921b8af4fe2a6c7906f3ffe0e94,105,69,36,Africa,24,1012.9
a57e07d71b6f43f4af778cb548f5b16f,317,291,26,South America,24,2152.35
a57f8dc3aa2947388c0e99583e969187,365,330,35,South America,16,1587.36
a58018a7555e4bb2b9a9f70423b36501,140,103,37,South America,12,1390.14
a5802efedee4417fb6f2d1553dfd0aeb,102,73,29,Oceania,23,366.27
a58393ec25844299b59a49e91e43f5a7,109,100,9,Europe,18,653.78
a5839bd296cc43719b473c5b7d488050,256,206,50,Oceania,24,1519.48
a5845fef85f44ec4b93f04ee48c34879,305,289,16,South America,22,2504.47
a584a2da44b54f8685e98c84343cffe0,179,143,36,Africa,16,1148.05
a584ad0c87e4486ab3f664a5d84240b2,309,256,53,Oceania,19,796.66
a587048be0fe411fbfa1c3452d5f79a9,101,60,41,Oceania,20,574.21
a58782ef447e4d1fb748da6dea781c56,134,89,45,Africa,17,905.4
a5883fc6a3624072b172644a1b527d38,173,138,35,Europe,19,1447.32
a588992b1ce14a5fbbb6a2ca50ce613a,81,44,37,Oceania,26,675.15
a5890b85d8f24f6da88447841af28041,312,287,25,Asia,22,2957.57
a58a706bda584152932416b42e1a2f6e,212,175,37,Africa,18,1160.1
a58bd6d2ae1e41879466acbddf50dbad,304,272,32,Europe,15,1826.59
a58c624552d047778fb41ff96cd042df,351,317,34,South America,12,2764.76
a58c7dd90858484dba230c81b90c068a,187,135,52,Asia,21,1079.98
a58d3dd9a8ba4b989220f3b1d4f3b767,40,15,25,North America,16,312.7
a58d73e178464522b2a7e060e1b3de56,239,223,16,Asia,15,1555.44
a58d957522514bf0acfb8e4c34b2ba4b,365,360,5,Europe,20,3380.17
a58e4deb5b4740eea626167d6e1c597b,176,134,42,Europe,25,907.9
a58efcdfcbca4ebe9238913ce6bac97e,75,42,33,North America,18,490.14
a58f5c9f212d45308dc9d4c6910fd4c4,365,364,1,North America,25,2949.92
a5916a31d6e74bde919254bec4419402,223,197,26,Oceania,20,1344.7
a5949d3bd455405c8e11440a2be9a14a,319,291,28,North America,21,1869.12
a5954854dda342bfa931d24ff635f533,190,151,39,South America,16,1491.76
a599b3cfc07247f18098f6460feea1b7,218,168,50,Asia,15,1229.54
a599c9701f3c43c2951708e5e6221ca7,365,355,10,Africa,18,2218.7
a59fa4ff57094917a8ba794e25920bb5,183,156,27,North America,20,1392.66
a5a1667c8aa943bb80ffb6ec936bc6d8,221,183,38,Europe,23,1226.77
a5a1f875445a42c490c4a7d1ad699455,263,231,32,Europe,23,1369.9
a5a3a110c32745ecb807d33294826b7e,156,111,45,South America,19,1164.59
a5a667da663d42c291eb668ebb385ec2,116,86,30,North America,20,877.8
a5a973424799445a91841b16e3a912a2,358,316,42,North America,20,2324.76
a5aafebff161470e90d7a14be89ac35b,200,161,39,Oceania,25,611.88
a5b247db5ba046d0a81a0d09b0f31900,194,157,37,Asia,17,1589.29
a5b272f7736948dab5769f0272afba63,346,299,47,Europe,17,1098.33
a5b6091422af476589f2add6d88ee91e,344,321,23,Africa,20,2744.06
a5b8d26a69194c738bebc84e0e852a2a,77,43,34,South America,20,816.3
a5b9106804f644e49c832ebe08e0f9f8,291,271,20,Asia,22,2001.74
a5b97f303cfd4e9eb950b1f81f1fb95d,310,265,45,North America,16,2216.99
a5ba057dda34488693c575917f649719,117,59,58,South America,18,642.26
a5ba1f8b59e74c40a1c54b80a8a8f885,283,263,20,North America,24,2560.59
a5bbabab07f7460ba1f87c1b68e6cece,249,211,38,South America,20,1953.34
a5bbe885339842cba6bf9127c5e78634,47,1,46,North America,16,407.88
a5bc50f6f02f4192ba23fce979a1ba43,306,280,26,Africa,13,2004.71
a5bdf638a259478cbe784e117707b581,359,330,29,Asia,25,3523.11
a5bf016a78da4355a42770a74b9f3ebd,183,143,40,North America,18,961.87
a5c262c21a2a41b791c8b6d4f528bf8b,152,123,29,Africa,15,768.13
a5c340bec4244cdb82730919ec4d8d21,217,174,43,Asia,25,1591.3
a5c369f871f84b6db55d39c523d6c597,352,310,42,North America,22,2176.55
a5c62bfe109345b5865fcaf3b9fca808,269,227,42,Europe,18,1873.64
a5c6a51768e74fb58eb19bf1c9997c67,327,290,37,Asia,19,2323.45
a5c700d25b0f4e3fb43f227e699b7aad,151,91,60,Europe,15,967.33
a5ca54f018c24da9add448046da744be,364,326,38,Africa,16,3052.75
a5cb46764cae407b9d5f55ffcdc5d710,86,40,46,North America,20,412.1
a5ccd8ac8af24833b6a2d250bc1972be,120,90,30,Asia,22,515.96
a5cd00df86d947bda96597f701b85db1,90,37,53,Oceania,26,325.59
a5cd09f563be459393bea96456ac1547,293,241,52,Africa,28,1135.96
a5cd11e7b66543ecba4ef1aaa736e685,246,214,32,South America,18,1700.38
a5cfe5c23e464d4aa2f07e53c18c89e5,140,103,37,Oceania,19,911.26
a5d1a96d6ad041c8af4d1321420ab8d9,365,365,0,Europe,19,1348.41
a5d52481301048af83d02dfb201fd308,188,155,33,North America,23,1046.12
a5d67a7a92d04140b8144e09157e8ed8,70,27,43,Africa,22,779.47
a5d75c3d665243f48e624f6ea2f65b4c,202,153,49,Asia,18,574.49
a5d78dc54b004155b6e0fcea545aa1d7,323,291,32,South America,20,2102.51
a5da47739cac45018db12b86156c80b3,127,96,31,Europe,22,1140.78
a5dcba48a9fa471590aa3116ea0cebdd,362,357,5,Oceania,17,1658.45
a5dccc726dac4544b671f521c4f21b1a,76,39,37,Oceania,18,246.49
a5ded07b94f64e77a8f49c77788ccbf4,364,357,7,Oceania,23,1798.11
a5e1b86f2bd542b89dbd34e7494bf6a9,129,100,29,South America,18,798.4
a5e34af8c7874863a2de9bc0a3743d3b,286,246,40,Oceania,22,2264.59
a5e54036331e4d9b947b78e43c141882,242,194,48,South America,23,1321.79
a5e984fe0a1645cd9f866785b61c8cdb,266,238,28,Oceania,23,1808.78
a5eea68313ec44dd85695859d43fba27,341,312,29,Asia,15,1839
a5ef3fff713845c0b739f657f89cd5cb,197,151,46,North America,20,1064.23
a5f4ed9b11c548b2b64507956c62e796,365,337,28,North America,17,1648.34
a5f68520966c4e12b5cd1a9b25b36770,77,50,27,South America,22,360.55
a5f7740b0df349718025bb7d5559caf9,313,288,25,South America,18,2298.76
a5f7c06d4d634618b71f67b28a44986d,160,138,22,Asia,13,1064.32
a5f8d8b8ea4c4dcbba4025af1db979a7,141,96,45,Asia,20,706.06
a5f90d26b7c940c3bf4925f5c5035f7d,218,187,31,Asia,19,1027.73
a5fa19fd7b504fcd97385aed168a42ea,44,10,34,Africa,22,250.02
a5fa421dcd094729a367edd6878de7c6,139,113,26,Africa,26,1017.4
a5ff529d7302424bbd2ef90990b0f130,263,239,24,South America,20,1909.92
a600dafbb29048e794574fc80cc00865,245,219,26,North America,15,2194.21
a6027107c71d43ff99062696db092ee2,67,40,27,Africa,24,359.64
a603a64e3a0f49238b94e07583f3e888,117,70,47,North America,18,603
a6046c294a2c4dc4a4e8d7a603c977e2,83,67,16,North America,17,530.31
a6052efe4cd24616a3a5857dee1d3099,263,213,50,North America,19,1690.86
a607d6170e2649bf83651003f7298cfa,324,295,29,Asia,26,1883.22
a609f03bd8c14b619bef1cec2865a7d0,101,86,15,Asia,22,759.09
a60dc7e1ad8b41ff8257e3cfdd40190a,220,195,25,North America,21,1489.7
a60fb5ba2089499abcfaebe444ef1cde,232,192,40,South America,18,1275.49
a60fdd894f534c479cd6856234c54527,148,117,31,North America,22,1073.23
a611095354d64c8a87a19b43bd0528b8,258,209,49,North America,15,1303.92
a61194167ea44bcf94a8a286febaf740,193,150,43,Asia,20,1484.31
a611c83b39784126b60fa0ad12ce3a17,256,240,16,Oceania,20,2018.18
a614bf33163745caaa2043db2d9517cf,129,93,36,North America,13,1330.88
a617a747097a4fdda3306f776dc4fd16,153,113,40,Africa,18,898.3
a61a8d6f137d4724bd7b5bb4829759f4,355,326,29,North America,21,1943.05
a61affcf1ba54a01a4f9f88815e48a31,141,110,31,Africa,20,1524.33
a61b87cd90b34f798683086ef76abd6b,291,268,23,Oceania,23,2411.47
a61c6cc1444b4b0a918277ea510f35b9,225,182,43,South America,18,1560.65
a61d8db2411a450583580e279d714d51,364,333,31,Oceania,15,1989.94
a61e79dda1a64a16acb5160099cfd714,305,281,24,Africa,23,2614.68
a62251ec9dd147e1a3e7fad895cff96d,216,195,21,North America,17,1733.88
a62263c1635a496f8434d6bec92d59a8,266,225,41,Africa,23,2477.27
a622905922f94981add0b851ebb2d9c8,106,67,39,Oceania,22,735.78
a6290dd8633e4664b4a3b0dd29ca0b86,276,242,34,Europe,24,2385.18
a629f03a116f47dca6f2d9740caa964a,307,269,38,Africa,21,2526.74
a62a138b33734aa1b90abaacefb42e36,231,197,34,Europe,13,1388.06
a62a376fc4dc4ba491dbdb4a5e7ef866,234,198,36,Europe,19,1615.41
a62ad9d4caa9432daccafccdc63a379a,325,299,26,South America,19,2526
a6352e8b20064d1a90b9b5e4a0a37d96,331,284,47,Oceania,18,1904.07
a635bed6fa7b4de68b9942084c990dc7,148,104,44,South America,20,648.9
a636333045e84260bf51990b50d52c1e,338,315,23,Europe,14,2490.04
a63739f420b340ef87b399b40aa07448,285,234,51,Africa,24,1146.07
a63860c069e646ddb3e02269487bd294,364,319,45,South America,21,1710.46
a6394fbda01643029e298e7cdcdd0509,165,108,57,South America,19,645.51
a639ec932b6446cab40c1a729d231b3e,269,228,41,Oceania,19,2133.56
a63cad669bee4c40aed2ece8a9eb0e37,218,182,36,Africa,25,1849.46
a63dd55e0cef4b7d96861d750c4402f5,355,319,36,Asia,15,2019.08
a6412a9b991a49688884e7bc3eac16b8,288,245,43,North America,23,1792.9
a6416117dcc249f68ea1e1248a15515d,181,145,36,Africa,25,773.02
a643d79cad0e45ac9f6c3774ed40267f,256,220,36,Asia,15,2045.38
a647a6e53ee240c4a469bccea1678191,365,339,26,Oceania,18,2193.72
a64adb853e034c12804f86debbc9d50f,234,207,27,Oceania,20,1955.13
a64c79f0fd5844e885f74217bdfd366e,346,320,26,Asia,23,1940.7
a64cbb626df8438e82911a19916f6ee8,365,349,16,Oceania,22,1826.2
a64d3b938aef43039a1aed3b1cde5b45,257,205,52,Asia,21,1738.16
a651163558564fbf90badfb3e2aa13e8,363,320,43,Asia,16,1891.77
a6520f8d5b594e34bee7a9cd8fa69f8c,258,235,23,North America,16,1644.62
a652dbc04ab84ad8baee8cf9f933cd10,197,153,44,Asia,21,822.41
a652fc7078fa4ba98bf6e35f5c4b5406,203,169,34,Asia,21,1721.72
a6537cee411f4cfead60fcd2440343cf,365,322,43,Africa,21,1829.61
a653f0f917004dc0bd0b2c64b1748e57,134,79,55,Asia,16,664.93
a654701d83d845008127d348ed495cd5,214,165,49,North America,24,1554.35
a65521d86ede48b1b78d5a3830f5c9f0,319,290,29,South America,20,2757.68
a6552fc54f8a4c8084b6d79d6f75fa5a,160,115,45,Oceania,20,454.63
a6556cad0b184f81b85ab54b250f1359,364,350,14,Oceania,17,2714.23
a655dd6621754703bf491207f33bab9f,321,289,32,North America,19,2239.97
a655fd4c192943959883f80d3e02afe9,365,361,4,Africa,19,2818.13
a65731d90f5b4b7397dce9efa18180c8,364,349,15,Europe,20,2472.38
a658bb4257184cf7927c83a8fdca7d5e,149,108,41,South America,19,975.16
a658d24ba4d84f67b5aa81ee7899ca98,365,364,1,South America,20,3189.46
a6590df5af5e46dead1044e9a736377b,77,20,57,North America,25,379.79
a6591255559c4e86b3f93d076bffee57,275,227,48,North America,19,1739.29
a659383b962b45139d1ecd24c9050555,333,306,27,Africa,14,2344.78
a65b6912e6de4077be15532f3f5af9f2,196,145,51,Oceania,20,989.09
a65bc0cb8b924ee8bd481211abfcb4c3,302,277,25,North America,22,3122.16
a65c531247d5446882a6e85a84e0bc5b,101,74,27,South America,18,842.16
a65d811cd580499984abf9c440e25c2a,170,127,43,South America,20,1270.8
a65ec89c3f514203a6bf9fad1e2f4daf,173,149,24,Asia,19,1541.1
a6616d283553480fa52176064330cb92,329,285,44,Asia,19,2629.97
a661a01c83294f79a0cb982ab1000c9e,58,1,57,Asia,14,129.6
a663b8a7ecf7489e887f050416351033,300,247,53,South America,24,1308.76
a664065c0ae14d778639586b448be9f0,312,274,38,Asia,22,1976.57
a66838afa1de4645b2f7aa4bf2789cf4,347,316,31,South America,17,3061.68
a6698ada19f94d70924ef01daa82220e,186,141,45,Africa,18,646.68
a66bf0cc66784a2dab8950d1f57fa47d,152,133,19,Asia,25,1248.94
a66c8a1d643344e79a58ccbaf4318efd,192,165,27,Europe,18,1858.49
a66dfdf0cb7343b59100a34b05ac46aa,197,156,41,Europe,20,1368.42
a67110132dc547478ebf0bebde322840,364,344,20,Asia,20,1579.36
a67247547f0f4e87b495dec6b3bf2cfc,90,49,41,South America,18,742.55
a672bedd68334016832a5c37f00effde,131,108,23,Oceania,19,870.51
a67535febf024ef8a59412ceb27e10df,52,6,46,Oceania,19,314.87
a675ad7c0a3b4310a37ddd38386582dc,157,106,51,Europe,19,833.35
a67ba097e42844da9736d19480360994,30,7,23,Africa,25,206.28
a67c43d4807e498d86df1ef5f6608722,71,55,16,Africa,17,569.22
a681e5adea104e6da3809d1dcc83ac9f,155,111,44,Europe,19,1220.09
a68a4b74a772481ebc6aab5ac03f117f,286,260,26,North America,20,2049.13
a68a8b04807743c4b77b268ff4be0284,245,222,23,Asia,21,1889.71
a68b7fcce6864bdb87227e620ef61d9d,131,71,60,South America,19,346.19
a68c1397452a465a9e673c75192e2b5c,228,194,34,South America,19,1180.01
a68c91255a0d47a6ab10d57365480ff9,131,113,18,Africa,23,1022.6
a68e6d9acae74a38865086fd2552fcf4,354,335,19,South America,22,3021.66
a68eef8b88674704ab157207f153bcaf,154,100,54,Asia,19,696.18
a68f2fc0ec7b4293bc8c8b6edeb86a4e,165,142,23,Africa,22,1319.14
a691c0eeb3c9477aa9ecd8b9d1dc8c86,42,27,15,South America,23,333.37
a6934abb8bb2445fa1b24478fd80cdcf,295,242,53,Oceania,21,1871.26
a694c65387324b93937902d34326c042,83,49,34,South America,24,703.18
a6952c8b85824ce68bf50072192e7cc5,94,57,37,Europe,19,611.73
a6957dc7324b40b386c7510987e08eeb,362,345,17,Europe,19,2433.06
a695924936484d0d93ab3185ce7bbe71,359,350,9,Europe,23,1494.05
a6985bacca52453f93e6b2428a106ecf,178,149,29,Oceania,18,839.66
a698f889343643b3a1545220eac6a6ad,217,164,53,Africa,20,1005.96
a69a98aa7f924ca4be7bf6e9cd00adb0,341,314,27,South America,17,3086.68
a69bff05f5bd4e02892f59786f3815e0,283,240,43,North America,20,1359.63
a69c75106ee349e49b7ee0d65c9a86bf,116,81,35,Oceania,18,965.12
a69eefb79e764e09ab69c2ff94ac5bec,329,300,29,Asia,22,2919.98
a6a01948d30c4a3ebf721fb78c5356e8,331,300,31,Asia,19,2124.26
a6a155e28e7c4c8ca161f834fba40077,120,73,47,Africa,26,631.14
a6a4eeaea6914fdcbfeb5ff3ff8b5143,318,298,20,Europe,15,1997.24
a6a54d5cdd504dde99bac0faabe313cd,87,67,20,North America,19,655.39
a6a98f3caa244181a81e2fbe6e8fed7e,82,37,45,Africa,14,438.7
a6aad835403e4337aaf6693f77f5c626,136,95,41,North America,17,559.42
a6ab1d1be16544239c47e6febc7c88b4,135,108,27,Asia,22,814.01
a6ac01eba97447cd92dc3e4da2dc1939,32,4,28,South America,19,441.01
a6b1e140d81241809d47b79f43b61d1d,58,16,42,North America,14,140.19
a6b3c7cdcd344034a5b5bdd7312b1daf,319,282,37,North America,12,1613.57
a6b557eabb734c68a5180bdd277b03f4,328,291,37,Oceania,24,2108.55
a6b79393dc44481bb4e7199775fcb1a7,364,345,19,Europe,17,2018.8
a6b8100aeb2f4702a67a1b647658c2b7,268,222,46,South America,24,1400.55
a6baa87fd19247429f83cab4d1a9e9a9,225,179,46,Oceania,20,1209.68
a6bd6836740f466d87302febebd17623,278,241,37,Asia,27,1968.36
a6bd91ec8a2b428ca7e38134cea080ee,252,220,32,Oceania,21,1614.67
a6bdefc840154b7eb44869e6a9225ad5,312,259,53,Asia,24,1070.84
a6c0572571264a548397ce1c0951a7ef,155,124,31,Oceania,19,1630.46
a6c1254c79bb4925bbad36bb1a1b06cb,65,31,34,South America,20,483.2
a6c16612489a4d3282400949730c7bba,43,13,30,South America,26,294.63
a6c1eb48ea204a98b5b92ec5c3e089c4,144,102,42,Africa,19,532.39
a6c39a613c43480aa7b9f2090067ab5f,236,201,35,Oceania,23,1316.6
a6c423639b29488c93cf00db597c93c2,361,298,63,Africa,18,1573.27
a6c4b7e55f724989996752fada8b3775,196,147,49,Asia,14,848.91
a6c7ad9759634b208aa2a114c6f00675,176,133,43,North America,15,883.85
a6c7d0f0dd5d4aecbda3a09f76654a49,192,150,42,South America,22,1200.44
a6c821d43e304d5388fdff85aec56c1c,220,164,56,Asia,22,1235.09
a6cabe7f7dc548b7a3709bc0b5e4dcd5,226,206,20,Europe,23,1599.87
a6ce04051fce4cd68bee3fc52bd7a71d,123,93,30,South America,22,1089.4
a6d1c281702a4fdcb9c5e063041d8f4d,318,278,40,Asia,18,2081.38
a6d1e574070940259a2bb6a61b7da56b,238,209,29,Africa,19,1747.17
a6d251101b3249a2a2f2cb5478ae388f,362,333,29,Oceania,20,2515.49
a6d2fb08be3d45da9d1ea5d13a2a516e,194,142,52,Europe,18,923.3
a6d3862ace6049bab025802b7c1f63d1,120,76,44,North America,22,653.73
a6d38dd8c8e646448dbd06c1a840b182,311,283,28,North America,19,2071.23
a6d51664373743d7ab2b04e60656bf4b,89,67,22,South America,19,665.74
a6d5a550d76e4780b60ab8d7ae2318d5,269,252,17,Africa,21,2154.01
a6d808a77ddf45859739639f7119d99c,99,57,42,Africa,20,788.66
a6db03b40b0a4b64b1ae43b2672bfeb2,103,53,50,South America,22,297.18
a6db6591e9f64f458618fad8003ac96d,187,139,48,North America,20,968.18
a6ddadc921684ce19ccf87d4207b0c33,330,283,47,South America,18,1353.47
a6e010aabda447f8b1cf86821c5d4483,121,89,32,Europe,23,635.14
a6e3e687d9f04605994179a2d2e9c3ac,184,137,47,Africa,20,910.23
a6e4a5e745994b0fa0bc16b914b8d607,320,269,51,Oceania,19,1629.02
a6e5069bc3f84e40b8060637c286cdfb,36,5,31,Oceania,20,297.28
a6e67a7d791e4b8e93b67a7544698e42,365,326,39,Europe,22,2218.78
a6e6e4ddd20640a3a48361e45fb5a39b,72,26,46,Asia,23,496.77
a6e86e67452e4cbf9574de20954ba617,365,333,32,North America,20,2021.52
a6e90288c2d5414085b2da00d036fede,269,251,18,North America,20,2362.94
a6eeec78a4b14e6d83f61230927fdeac,172,124,48,Oceania,22,936.15
a6ef6109ec794b3bbc294230dcf279d1,308,279,29,Oceania,27,2341.8
a6efedebed7f463aa067cd21e7744a05,261,232,29,Asia,21,1912.89
a6f0ebcf1fc44ab88c1ad7a2f14abb55,340,285,55,Oceania,20,2258.06
a6f1f706f32245ac9537daa84874168d,363,317,46,Africa,21,1776.06
a6f2ce8cfb1349cda74fa3a98c3b27d3,244,220,24,Europe,21,1762.78
a6f543f4224349b2964251f0c12d9a21,364,335,29,Asia,27,2325.11
a6f63cd8e9c7431e82d57de88f2c4e8b,31,5,26,Oceania,24,149.02
a6f91eaacc184a5991a110ee0fe1ad38,322,296,26,Oceania,18,2787.43
a6f9b3e444a0453eb7c000fd618024d7,69,15,54,North America,21,652.98
a6fa9b5b3d034ce485c7a24fe49fef54,331,305,26,Oceania,22,2612.59
a6fcd3b0d62b4dd48b6a1d30fea4379d,193,146,47,Africa,16,1063.54
a6fd80cf64c449aa8052ebdb98deb5f4,107,71,36,Europe,19,255.89
a6ffcf34126749f7b9b504ae9851ff56,267,237,30,Oceania,21,1835.66
a700e30e476b4928a0e065e600b6ee30,349,325,24,Africa,18,2483.15
a7014477773e444d947533dbf24ffa9e,356,307,49,Africa,19,1432.11
a701ad207c2b4dcf94a56ee4d0b4f605,235,195,40,Africa,23,1527.77
a7055a84e96d4cd590dce1f000f41a56,119,82,37,Oceania,22,896.33
a70588ef9fcf4d3fae3e53312573e8d6,254,207,47,Asia,18,1317.23
a70699440ac44abbb8471298bbd1a979,365,359,6,Asia,19,2737.69
a70a59469e294c94969b20ff639c6f45,276,243,33,Africa,17,2160.19
a70ae0ad508f4ae2b610eba8d87d419d,365,318,47,Oceania,20,1422.72
a70c01733fa0464c90e668e64ea8f96e,136,106,30,Oceania,19,1130.01
a70c15e03b0742aa81e8ec8e336ef20e,144,118,26,North America,24,1142.69
a70c361691144c0e9e4e4a5c75d424cd,215,175,40,North America,20,1769.43
a70ed9efed754075aa91c7b4e7d46d00,324,281,43,North America,22,1735.96
a70fe31a225e455eb50c5a8cbcbb258e,364,352,12,Africa,19,2184.99
a71234f71ddb4cc69a9728629c712566,357,356,1,Oceania,20,2656.26
a71342cd40e044d8a9ac4f53a15aef02,308,259,49,Africa,19,1580.49
a713886326ab41589b82380602280733,255,195,60,Oceania,24,1544.99
a7157740bf3a4a1b95e0c9d6e2051014,170,133,37,North America,24,1400.43
a716507954294260a041954199c862fd,109,58,51,Europe,20,792.62
a717939949bd4a1db0db2169da969c1d,71,40,31,North America,19,529.06
a717b49b0a9e4463bcb7021e4563d5a3,174,146,28,Africa,17,1787.27
a718892a806747bdb93027f438d8711a,54,1,53,Asia,21,183.64
a71a34f74b494bf4a20bd5160d6ee416,190,153,37,South America,21,1726.97
a71bd321f5344195a244ccdb12a63ce1,75,24,51,Europe,24,417.84
a71dc856d8d74db19f5491ef3bdf4a8d,281,232,49,Europe,23,1809.84
a71f73ad3ed146a0ae987a0192106a66,325,295,30,Europe,17,2270.96
a71f998086b740de9718d2f775b18d5b,242,207,35,Europe,14,2344.18
a7217121eccb4fb19db7d2db7fc79083,253,200,53,Africa,23,669.89
a72209c96bc04a489aca4acd0df4cd4e,63,27,36,Oceania,17,384.87
a724810219a541a8915bf27733e0124f,151,117,34,Europe,20,904.34
a725384e226147cf8bdff5418de67278,224,192,32,South America,18,1616.31
a725683345f547ab9197497dfd1e93e2,130,92,38,South America,21,961.41
a725fc58fe9b44f58318e949851c1673,320,277,43,Oceania,20,2212.05
a729f8f60e314441be0c32f129b27c25,342,291,51,Africa,22,1819.92
a730e37665974ba4906a02cfff95e694,365,345,20,Oceania,19,2912.28
a73216fd846c4ec5a856727e8c31ef48,360,346,14,South America,18,2611.24
a733992bedd14f9d882057eefaf58901,153,115,38,South America,18,849.51
a73481f8e73748a6bae07dec07150a84,204,151,53,Asia,22,964.61
a73676720034460b964370a6c12a8bb7,364,345,19,North America,19,2855.49
a739f9632ad843b0abf44b3914068579,303,256,47,North America,19,1307.23
a73c97f698d144f1a010ccb4d47ef96e,123,103,20,South America,16,1384.71
a73d217e49ad4ab8b5770cbdd7040e81,285,244,41,South America,17,1789.15
a73de7305d724a9e9a6a7ad23435fb8d,94,67,27,Africa,19,671.95
a73f5839bdb14790bb30b462267dbd5f,274,240,34,Europe,20,2033.24
a742389d1c8e4fa9b3ba2a3a089f6657,285,240,45,Oceania,20,1269.23
a744f66035fa45f786714f5f0b16e771,121,85,36,Asia,20,536.91
a7482781c12b4c898e6ca20a12c58922,284,243,41,Oceania,24,2068.83
a749d3c8209849daa820368fd8fa0df6,164,143,21,Oceania,21,1251.56
a74aa738864341939aee2d736780f8f5,65,35,30,Asia,21,744.94
a74d6dcd3f184fc7964f981a2b3cdffc,253,208,45,Asia,21,1284.19
a74f015a029d44df8deffce3b55d0810,359,310,49,Asia,24,1547.45
a75051cbc6514a519f3028c386db18da,309,278,31,Asia,24,1933.11
a751b09f573748e8877c399a8df4849b,85,37,48,Europe,21,541.37
a751b9ba50ad49dea6e1e644ebe3d2b2,329,271,58,North America,12,1373.68
a751e19dea2a4b5cabad2e0fe5483ec5,220,182,38,North America,15,1100.8
a751fa508caa474889fef9bfeae5eb21,177,156,21,Europe,19,1548.37
a75213399d174845ae02f0a89ccea9ca,309,275,34,Africa,23,1783.48
a7523e6f32af4085a72289bb5ccc9cf6,328,306,22,South America,22,2666.61
a75264cffe0449eb8bbbfdc6f3f68328,291,258,33,Africa,22,1828.08
a752a491f9b54f33a812330fafc45412,365,350,15,North America,16,1739.9
a75397a87fb54634aeda6f98d2d69dc9,276,235,41,Europe,19,1902.59
a753f7fde2f64432b7d19159b8c1c6fc,281,258,23,Asia,25,2288.51
a754fc9b8178437dbd1772c378d83652,365,349,16,Asia,18,2121.95
a75559b9b4db4da0913df54a1ced40f4,101,64,37,Europe,23,789.58
a75877b914fb41a2819d0c9058c5c71c,328,284,44,South America,24,2301.32
a75a70974f754c9b93cb7b6f20dcb946,43,9,34,Europe,18,350.71
a75ceee2abf24adb9fef4ca0cf9f3394,211,182,29,South America,16,1880.53
a75ede28454a4087acec672c0e5cd8b2,115,68,47,South America,20,1051.55
a7607cca48c140a29f3282ba0efc3841,144,99,45,South America,20,1011.54
a760f78814274819a32d6c96c3c9650b,353,318,35,North America,25,2137.81
a7615424f63d4e4895e08e87363e73dc,89,37,52,North America,26,618.63
a76238a1188045d58bdcd233da5852eb,71,36,35,South America,23,311.55
a7632745653e452bb60bb335e43e07bb,76,31,45,Asia,17,556.87
a76372ff023c421cb79ee2ad40d62458,70,52,18,Oceania,20,732.14
a765464c862f4a7fbe3ef1a1f5fe7bfb,57,42,15,Africa,22,243.81
a76a0bd3ef5c4713a801161df23fa849,365,332,33,Africa,19,2325.98
a76ab97832ff49059a2f2a2b9a2fa6a0,207,184,23,Europe,24,1659.83
a77047a9ed9a4f4cbb5fc29cfa2c6aa2,116,82,34,Europe,22,634.66
a772419b5e2947de909ee5e2e4d28392,195,149,46,North America,22,1063.38
a773d36bd5e5417480f33452026c3bea,164,141,23,Africa,20,1185.85
a77580d470584efbbf32c45dbf8aca75,160,132,28,North America,24,1835.11
a776ab01242d48188a347fe3b08a070e,236,206,30,Europe,24,1562.21
a77c613457f9429ca44e668386d0a257,347,293,54,Europe,17,1169.09
a77c70852bda4fe5b47ad340896e5534,106,61,45,Oceania,23,658.15
a780a3c3e9e74046abbbc2e327f4967d,78,23,55,Europe,17,520.5
a782a1ab62974b9c9fa2fb34ddfeb916,263,225,38,North America,31,1709.99
a783211ee8da470483b8adce7b1afe40,39,14,25,South America,19,280.25
a7837fc9f7b74577a404088a4bd12d55,87,51,36,South America,24,883.77
a7853803d19a4c0f8f9dadab0589f8b9,175,137,38,Europe,25,1134.97
a7861d4104804ecdb262d746b6aa3492,53,28,25,Oceania,17,634.09
a78620bfa1a54d5f901d60d98e8edea2,365,314,51,Asia,22,1825.96
a78679cdd4b64d42a9aef1a70af052dd,297,247,50,Europe,19,1331.34
a786bdda813f4ce49c28b0f78352cd39,121,91,30,Oceania,19,1046.24
a7882dcc30a1400c84d536615ab0a21d,251,209,42,North America,19,1228.44
a789d10d67fa42309d98f00fa9f306ac,141,106,35,Asia,23,1068.57
a789da2cf5f54329bc19cda631b110d6,273,220,53,Asia,21,1322.38
a789f1a2a7d446b8a61edfb6f5e3353b,364,335,29,Africa,22,1906.21
a78e17a421414983aaefbc05cb09802c,337,315,22,Europe,24,2640.85
a78e9310bbb24e9bbe1761ce63fcf623,287,254,33,Africa,17,1460.06
a7901672f0b24128b9c065510d61da9c,294,263,31,Europe,16,1989.27
a79193806e554ee9ac91f3deba6e412c,185,143,42,Africa,21,786.68
a7924456ddb84f2abe5829b12680401f,338,321,17,South America,17,2375.27
a79506d581d94c15b6eaa59bfac27084,318,268,50,South America,19,1804.5
a79645caa35242c28db679b3009f18a6,319,301,18,North America,15,1406.31
a796e423fda2488ebc7b7bff8343493e,228,201,27,North America,17,1903.59
a797f22cb6994bcab459c32790188332,139,100,39,North America,21,430.08
a79a3e95ba764f4f84a261274fce3c59,335,313,22,North America,19,1992.76
a79b042210e64e199b27b6ff90adafae,206,165,41,Europe,16,1773.77
a7a1b1a5af1e41248a0aa0b590ed54a9,130,102,28,North America,19,676.45
a7a2682f707d4c3bb893e50b876c35aa,365,359,6,Oceania,21,2169.34
a7a28bcff7d74c74915c8f1b348a40a2,144,105,39,Africa,17,514.93
a7a70395e997424081797838a08e21d4,135,85,50,North America,26,588.21
a7a77b6b21524f6ca100950bd247336a,202,148,54,North America,20,851.4
a7a804cb6cbf410db622a5eb3dd06ce6,259,219,40,Africa,16,2121.06
a7a95b6dcaf24390bdc1d8643b57d9b5,365,321,44,Asia,20,1616.35
a7ab6cc23a4046be9de36f53e8f7662f,45,21,24,Africa,17,504.04
a7ad19faf32a48859042f93830e40199,113,62,51,Oceania,21,770.57
a7ad3e6e190d495a8dd7433e23c3eecc,365,316,49,Asia,24,2013.83
a7ad494ede3644b48c5d85ff6f21b846,306,261,45,Africa,16,2081.75
a7b0bf7c77b4415db5235fa0d8abfbf8,328,308,20,Europe,22,2589.82
a7b2ebf9a4e34b0ea9eeb4d0116f30d0,142,94,48,South America,16,695.76
a7b375ae9e7146c7b577b1ff9eafd65f,80,57,23,Europe,18,631.53
a7b45a86fb0e4185806e2d9398eef936,198,172,26,North America,20,1062.09
a7b610467d10496cb5fd9e720a6ae492,242,202,40,North America,19,1331.79
a7b807ccd433430a87ebb4bc119604f8,94,44,50,South America,24,365.95
a7b80ed087fd457cb9cf0954edcd8d51,138,110,28,South America,21,1436.05
a7b96d93d2c8428fbfe6ac1d66a28826,353,307,46,Africa,18,1588.35
a7bc2ce65b7046eabcbedfacc18f2a3d,194,142,52,Africa,27,975.1
a7bfe6e35d534129bc3fbb300aed0964,350,324,26,South America,17,3548.06
a7c114f30fb843ac8ad6164dc9456ca2,166,114,52,North America,14,991.38
a7c15ddb4fd041499fbbd808c1f223a2,46,11,35,Europe,19,414.11
a7c6a9216cb34bfaa27ed57c260499f3,162,97,65,Asia,20,621.88
a7c981b5a4d146449c3ee6fdddc5c205,220,180,40,Europe,20,1469.85
a7c99d7f1ea046aeab30c0870e181e81,219,200,19,North America,18,1667
a7ca5c2c30dd408191d5477b80b5d5c1,166,142,24,Oceania,22,736.79
a7cb373024c9457a83ee7ef6794004a3,151,103,48,Europe,26,959.04
a7cb5bb815c44fc191e466db3612e0fb,240,207,33,North America,28,1802.8
a7ccba08629a4c128e15478dc0a361ec,59,10,49,Africa,21,93.67
a7ccde6e7e054017af2ed5526cf16fa4,96,68,28,Africa,17,637.28
a7d3772c1145428098da515c2ca90dac,206,181,25,Oceania,20,1241.57
a7d5c9b1cd6146e7be54eafb366126bb,53,16,37,North America,17,418.83
a7d74bacd6a545c38524fe6242bec1b1,151,111,40,Asia,23,1207.23
a7d905400faf472c9efc6d2762a64007,170,132,38,Europe,14,989.22
a7d981fd5cf546f080a1b482537a513a,152,119,33,Africa,17,1005.4
a7da3909e04749948e07eb990916733e,365,330,35,Africa,25,3165.35
a7da3cc3184549c48e2211bb1871be9c,70,11,59,Oceania,16,564.47
a7daaf8ddf084445a1013b311740ba7e,344,289,55,North America,20,1363.62
a7dbf235c6214ca2ab3f28255eaf28d2,176,161,15,North America,23,1021.69
a7dd84fcae374301ba0d9046f078c69e,363,361,2,Oceania,20,2559.18
a7dde2cef582418dabc9cb074d9ebde2,220,186,34,Europe,17,2308.64
a7dee18dace94b61a933d72dd2155270,265,223,42,North America,27,1195.51
a7dfa25b0d5749d28eee3c84bc08e578,244,202,42,Europe,20,919.61
a7e024811ebf4dbf9851eed3e2e4b6be,365,353,12,Asia,23,2208.1
a7e02edf08a549b0806644f8afba4668,364,336,28,South America,15,2289.82
a7e1b43ae0404f1ba4c84b93ffa1718b,331,297,34,Europe,19,2588.44
a7e3e30bdd61433c9343d4c25f7c855b,362,355,7,North America,22,3630.09
a7e407686d46426a90a961705eb44980,195,175,20,Africa,18,1536.2
a7e60bc9dbe1467daade939520db0032,323,273,50,South America,17,1711.1
a7e80a06c7ab4cc8ab5048d258755931,111,73,38,Asia,25,477.24
a7e97f5371fb43cfb4eff48a2014b805,223,189,34,Europe,15,1514.71
a7e9dc71390147d99a547b0c035a9e78,329,291,38,Europe,14,2596.43
a7ea986a828344faa5736210e3c8ff61,93,74,19,South America,13,466.78
a7ea9f16ddd14cce8fdd70ce2cebd2a2,365,338,27,Oceania,20,1908.48
a7eb3e84dd6d4254850f97d88b34c83e,307,254,53,Asia,17,2046.26
a7eb45285530420abd826415031177be,365,351,14,South America,22,2477.31
a7efb4a8b74b42d0a8cb3ab7fcd47920,176,129,47,Africa,24,1100.62
a7f1cad109c74f08ad9871bcbe52bc0f,165,142,23,Africa,14,1262.8
a7f31e44090f43588d80777523df5be1,365,344,21,Europe,21,1776.92
a7f37c5555b54a518afa668a2cbcfd8d,105,55,50,North America,22,622.59
a7f410f9e59f43ca9e410c75c833eac9,118,71,47,Oceania,22,567.92
a7f469bdd60e469b97ee7ac5b8e6c4d7,47,23,24,Asia,18,465.82
a7f6b1251ea1481b87fb2a834234fe61,316,263,53,South America,14,1947.17
a7f8204f67f84930b2fec454599c71f4,79,23,56,Oceania,17,266.01
a7f8288411c64af5afd77612b3ef605c,162,125,37,Asia,28,1082.8
a7f84ace97ec4045a3c5d4adf9717df4,111,86,25,North America,16,760.42
a7f8dec58a714c8d83c2adb0d961030b,340,304,36,Africa,21,2809.37
a7f9b3c24eff423fa8d7d71b89777b75,91,38,53,Europe,24,297.44
a7fa1c1046aa4eed9f6eb4491f6d59d2,356,311,45,North America,16,1824.78
a8011277f4f34566ab6cbbb2d9cb4b2b,97,71,26,Oceania,16,850.16
a802e5b2638b4701a0d9f1addc575844,99,47,52,Africa,14,845.57
a803a9b8520a428c88a523954cca7f5c,285,246,39,Europe,22,2500.62
a805b28242d3477888c0baa3b739e29d,283,246,37,South America,21,2062.79
a806dd5de41d40f5a721d7662905a986,295,265,30,Europe,25,1769.26
a806ddbcdbb04bbea1aa799c1de91578,347,309,38,Africa,22,2358.18
a8073752c310488b87636330585316a2,88,60,28,North America,14,815.96
a8080568065148c48317d310fb39b2e6,361,322,39,Oceania,17,2783.17
a80ace76e03d4de0a06008e3f2760001,338,293,45,Asia,21,1324.79
a80ae3c398094efcac9718859db95e8c,163,134,29,North America,17,1050.25
a80c43c2b4c7461bbc30f2d30474384f,77,47,30,Europe,20,533.65
a80c48e1c9e4401697be00cea873a43f,286,240,46,North America,22,1223.93
a80ee19204324265a72af684914673e0,154,115,39,South America,15,1072.49
a80ef846882f4654926a30078ca81752,144,94,50,South America,16,438.2
a8108adae76a40469c0e07c8800399f2,326,264,62,South America,18,1481.48
a810b53a82234bec98a27543f6607762,197,168,29,Oceania,21,1628.75
a811ec2a5228480883320873ad5ff49f,43,15,28,Asia,22,240.04
a811f14e2908499abf462a6dc82bdfce,309,286,23,Oceania,20,2270.31
a8125d13fee9456fafc058a0cbcfae3f,253,202,51,South America,18,1263.07
a8160d0cb19b4900ba9af189efdfda06,214,180,34,North America,19,1955.8
a8175c796d144c1da5b523d93176aa3f,124,89,35,Oceania,19,823.92
a8188bac458a41e2a49eeb8f6b2c785c,365,329,36,Europe,13,2343.1
a8193004c4d140b693f9784c57062b51,365,316,49,Africa,24,1889.42
a81a217863644ae4824c4d8dd5d6c623,364,359,5,Africa,27,1656.78
a81af3a48f3b4f7f85c5fd702c15cf19,43,7,36,North America,26,375
a81b8529ca3c4664a793af70d9d1ed18,101,76,25,South America,18,912.76
a81d08753d394a008f6f7f7daf112d06,189,145,44,North America,21,1298.41
a81d12e259e842febce836cf8a54e0c0,72,38,34,Africa,17,868.67
a81d50c67d5349c6aa6b4730baffab7d,167,116,51,Europe,24,787.36
a81e114a20c245c58a325472fa86c4ef,239,204,35,Europe,20,1738.23
a81e6abc36c54f449066bd5876ac2e5f,121,85,36,Europe,19,1058.49
a81f39f159fa4beaba88e71a64458d08,232,201,31,South America,20,1907.43
a81f9e1f83cf4cc7a6d167c951b03de2,106,81,25,South America,19,883.38
a820ae4f57d14f39a22fdb3b8c69325c,315,280,35,Asia,24,1608.76
a823816a82af48e8bfd6dd0684246050,133,82,51,Asia,16,762.02
a826f12e5c854bbb8bd5c1a128d5150b,106,78,28,Oceania,16,1021.94
a827004c7e0d4b2ca99fd09c2c3ff37d,109,86,23,Europe,19,686.39
a8274ccc671c49fc87199bab70dbffbe,268,232,36,Africa,21,1603.01
a829263642f64250920c2d86b8c5d49c,58,2,56,Oceania,21,209.94
a8299a8dcfd24518b67b72333f6fe53f,311,280,31,Europe,14,1893.38
a82c149f3865420dbdcac8e54cbca2cc,191,140,51,North America,21,642.79
a82c3c0ed4414380afdc346c614709c2,209,172,37,South America,19,1103.92
a82c9d6c928e40e0afbedf8cdd90b0a3,348,305,43,Asia,21,2119.53
a82cd6cce7324a2a85fc140e501655fb,179,151,28,Oceania,21,1637.5
a8346032887348b5a5079e43823bfe5d,225,190,35,Africa,22,1679.82
a8353a39bcf242f180de5bff007a0732,241,189,52,North America,27,1194.51
a83633a18d2b47d888143ca0a6ced27d,182,160,22,Africa,23,1491.82
a83945705abf452585c20e03a397bb16,272,252,20,Oceania,20,2672.88
a839ba0542474b5f86d265b57d784b34,365,362,3,Asia,21,2664.86
a83a4fec6d804191a33ec75459e1d5f4,310,259,51,South America,22,1946.35
a83bd65156804be495d87ac51db2547b,268,225,43,Europe,18,1893.61
a83c3c7303ad43c997880e7181952ab7,99,74,25,Africa,20,644.66
a83c8d1108304f5090d974001394728a,213,181,32,Asia,18,1215.18
a83ccb4aadbd4501abf1dea4937cda23,258,231,27,Africa,20,1728.07
a83d110cbc1e4e8a8c4cc42e0c378906,172,133,39,North America,19,1478.33
a83d4d84d0fc464e9d6251410399958c,365,347,18,Oceania,16,3095.66
a83fd1733cd3420db0398841502b99d4,347,303,44,South America,19,2328.81
a83fef18a9d24cfab4ea4047bab79d09,282,248,34,Europe,18,2108.74
a841c4052a7649719d1a9f6e016a1576,153,95,58,North America,18,665.06
a842ca0b2dcc463388cdda5522a0caa6,365,363,2,Oceania,24,2457.57
a842d31e6fe94a4cb0f5a1aea83b117e,230,190,40,North America,23,1155.98
a844f7ea123347888c49e10aa9731cc0,68,26,42,South America,18,377.95
a846bab780d64aa6b48c5c8f14e527a1,57,4,53,Asia,19,247.92
a847922238c14e4fa8a8d3ca5b6998c7,100,63,37,North America,20,1018.08
a847bf836e994d18a217f2d060ba1b86,142,97,45,Oceania,18,1215.98
a847bfb3298b4b8fab31f4f829f2a9bd,195,172,23,Europe,20,1799.23
a849207b53b54e7f9c9f9755718399d5,69,15,54,Asia,17,494.89
a849ab0f6bb64d9f8d14db92a130f52e,296,256,40,Oceania,15,1409.29
a84ddd90b1e74b019d1e83fea2202054,238,186,52,Oceania,20,1158.75
a84e363d3a3c4dcfba8a98c0a01699ab,205,189,16,Europe,24,1263.66
a84f0b2f200f4b58a254d9598981f82d,314,290,24,Asia,14,2274.77
a8508f7acf24461bbb8632da61d99d9f,365,323,42,Europe,17,1772.57
a8524a2b9a2341aa9a539bdc0a632301,208,192,16,Oceania,19,1655.56
a85346ecba014bd4b029c3eba5c7849a,127,89,38,Asia,21,500.2
a855a8257f074815a265ad8b5c7080dd,365,359,6,North America,22,3434.65
a856a02f4e964fa09d158eaf5bb20b27,236,201,35,North America,21,1685.51
a8573c7d69ba4948b814978d1948e81d,84,46,38,South America,21,659.16
a85809d484894b3a806ccaa8f2d587f0,55,18,37,South America,20,616.55
a858c94077bd4e0a924bb38f415493e3,365,358,7,North America,21,2487.3
a85d5e097f92493b8ed6218c0d8286d6,166,143,23,South America,21,1098.71
a85e981c8dcf4bab851489860e61a386,85,50,35,Asia,20,459.65
a85f4a305a7c4c0b8678b6ba2b919200,146,100,46,Asia,22,937.06
a85fe051a9f34eb4865a14036462a873,67,34,33,Europe,19,727.29
a861ba12c32f4ff0864affedc5464236,279,236,43,Oceania,21,1765.24
a863a55b52db4eba94df1f8c47fc4867,156,134,22,Africa,17,880.78
a86b2895f2f5435a85afe3e5e9fb0e74,363,363,0,South America,26,1841.46
a86b4b2ddeaf43a5bf086f3c1197adbe,340,292,48,North America,18,1624.79
a86b4ea9ca2e4c699d954f200e38b398,352,306,46,South America,17,1766.29
a86bde2beda144d58fd1925776c3a135,103,68,35,South America,19,560.42
a86fd2bcfebf47fc9c9377639e33a432,123,76,47,North America,17,724.91
a870967b825246e8be1eb33ccc691481,186,138,48,Africa,16,997.96
a8730bdecfe64b5e8f57cefdd027b958,262,218,44,Africa,23,1202.93
a873e0959d404f5abacdb1532179c3a7,130,104,26,North America,20,729.43
a875538f65d34409a48b85ebdd90d04c,151,110,41,South America,15,1140.23
a8756c4d74ef476789571257032b5696,283,230,53,Africa,17,1078.59
a875fb6f32b3408b9495ac0f3fe0cb50,365,311,54,Africa,14,2157.76
a87642aeef524fb0bdc209b9e1ab0cd0,116,82,34,Europe,19,912.41
a878b1a8c264430db1512595c47ecf5e,67,15,52,South America,24,159.56
a87b4fc3e55b435fa7c4dbf9954a6960,124,88,36,Europe,22,646.7
a87beeba495f4da4ac8920eca7d8c2cc,365,339,26,Africa,17,2442.21
a87e16ece22244f6805559ce99f03bee,106,79,27,South America,19,662.57
a87f83f3baf14e408501de85c15fe267,31,7,24,Asia,19,369.97
a8827e846594422b9a1c2dd77d43ed54,280,250,30,North America,18,1407.41
a8855f7487f44b4f895c389f257c2803,162,141,21,Asia,18,1245.86
a88679d4ef0041668ad0d7022868931c,212,157,55,Oceania,17,1486.25
a886f9a7137f46b4b71e825aafc25e93,278,238,40,Asia,20,1320.55
a889762e34ce4ae48ed98a53dd2999f7,362,329,33,Africa,23,3045.6
a88c6d1d2ae44d0d841d79dba37a818b,233,178,55,Europe,21,926.27
a88d8110cc23471c95df56b1e296c155,204,162,42,South America,18,1404.86
a8915698a9eb4d709145edcfb0f84d76,130,84,46,Oceania,20,879.12
a89574fc14db434794f3c0b221acbe65,346,316,30,Oceania,21,3340.56
a896709fec964558a873486bbaf1126a,278,260,18,Europe,20,2116.61
a899b9f8cb7842b2a4f41de8fb65f771,240,190,50,Asia,21,1145.74
a89a1f381d3546e2ab593091e41a8c6f,364,358,6,Asia,20,2839.12
a89b9a5cee384b8c9cd735362a0e3322,35,10,25,Africa,24,146.9
a89b9b643329421588875a25f9279b63,364,333,31,Asia,23,1721.91
a89bc7ef91e04db7899370b30a16efcc,329,283,46,Oceania,19,1603.01
a89bc8c686d240769e249372909669f4,361,323,38,Oceania,16,1899.97
a89ca4edb9c24313bd5d6953f6946ae1,364,316,48,Oceania,21,1294.63
a89cb2c4a6264190ad9ecfe1cba871ea,262,235,27,Europe,20,1894.96
a89e428ddb0646e39d7079bb5759ab9d,331,303,28,Asia,19,1948.67
a8a003d4cc424a4e9dd8bb41c8b547e6,256,219,37,Oceania,19,1559.18
a8a185f7ec5146c18d99dd711a713c4a,256,200,56,North America,23,995.98
a8a2d1c4204a468a983684d260b5da9e,338,288,50,North America,21,1229.89
a8a4a4881d0e4f499bdaf810b3704686,59,25,34,South America,17,500.4
a8a89d7d480a48c883fa9507827e711c,145,97,48,South America,29,1515.31
a8a96ae447ab4a538ba1f6cf9e9dc6ca,86,40,46,Asia,18,611.83
a8aa1a08f48b41d6b29e74c328d643bd,349,328,21,Asia,22,2339.07
a8ac6ac081894c91a02ceb841d24ad20,114,88,26,Europe,11,809.64
a8acfba460a547788f43dd8897e25cf1,188,157,31,North America,21,1761.95
a8ad6df32c864bab934175b5caf6859b,70,46,24,Asia,23,711.54
a8ae5574334741628225afa28cb53ba2,362,358,4,South America,18,3261.86
a8ae6f8da495421794ef9c4cf862d144,187,161,26,Africa,17,1156.9
a8af1f0c42634b4594c16c634d15df08,125,111,14,Africa,20,780.71
a8b4122fe90a4cd7b6b54df47d54a428,45,28,17,Africa,23,249.73
a8b56e7f57fb452ca3b2c0210269aeb2,365,340,25,Asia,21,2819.97
a8b61537abec4c72ad9b4c40fc294c0d,87,33,54,Africa,20,324.43
a8b850a6a53b471e83faccec4ca3dffd,327,278,49,South America,18,2158.63
a8bbb946c0b242a49c897a0f79e8ccc1,57,31,26,Europe,15,621
a8bdd465a71043488ec084ad9abe6a89,170,132,38,Africa,17,1248.5
a8c0d19cd6b643e1a7be66fe41267420,112,74,38,Europe,17,1110.76
a8c1563f25c44dfc9458eaf09a685644,149,98,51,Europe,18,1037.43
a8c1a04c8b7d47af84e475e88b0eb3c0,49,28,21,Oceania,16,388.46
a8c33b9303c74ace9c36bc8e46d3e396,341,300,41,Europe,17,3115.9
a8c625a45154436e9c5a8f4b4cb14a44,61,13,48,Oceania,18,301.71
a8c71f81b799490ab44b069fb4b7a4f5,71,30,41,Oceania,12,323.34
a8c7ba3281bd43fd8b6939671b1e4d97,170,143,27,South America,16,827.61
a8c86757ae0d458b9b0d0e6395f9cb94,128,88,40,Oceania,15,809.15
a8c8e91e6fbb4ea0a320e9705eee6c3b,78,29,49,Asia,18,500.13
a8ca7dc82ce941a69071c209dec5740a,154,116,38,Europe,22,1152.39
a8cb5d3175f34246a1bf1725be085ab9,365,345,20,Africa,14,2357.32
a8d0737708294bd3a0068325bacddafb,215,194,21,Africa,28,1559.45
a8d19ad762ba44b9847fd1471dd67a03,365,323,42,Asia,20,2200.01
a8d372bf8acc4f42a794b10d47f2be7d,163,118,45,Europe,15,985.58
a8d40d1ce1fd4736a64b060936b2d7f1,70,14,56,North America,17,666.42
a8d491db16f948e2b3f2932075362718,161,123,38,North America,20,801.06
a8d4d0efd54f44b8ad0e466971a0898a,328,312,16,North America,19,2870.47
a8d552b7e61447d4b210b99597e173d9,49,16,33,Europe,18,225.21
a8d6eddf906e4b60ab3beed6bc730f25,336,287,49,South America,23,1787.26
a8d8aa33200b43efa7706d98199fbf2a,258,235,23,Europe,24,1765.97
a8d8ae102aff40dda9969e4baa48d21c,63,18,45,South America,19,403.94
a8d9ad888ff84a52b73ecd8a22c77d15,285,230,55,Oceania,25,1253.37
a8db9298242249629164bb9305520eac,294,266,28,Africa,20,1877.56
a8dcab225566446abf8a9381d66b5d3d,315,274,41,Oceania,21,2077.97
a8deb23805084f40937296cdb8ee201b,269,248,21,North America,24,2230.29
a8e14862b505486b83e6517927c91924,210,168,42,Asia,18,1199.36
a8e1545928454b428cc775b896530b6a,310,270,40,Oceania,16,1854.87
a8e1dc41a367474ab3baec51b66ff80b,264,218,46,South America,21,1706.41
a8e29ec4650c44b582e6b1024c8de9de,121,102,19,North America,20,735.46
a8e5aa7744ae4c3aba7fbb7d7a486643,88,45,43,Africa,26,314.53
a8e6753942154a398382311a1abcb931,321,273,48,Oceania,18,1844.27
a8e86743c2cc422badc863946d680061,261,207,54,North America,22,1691.26
a8ea794fd21042b8baed9b44276f8428,80,42,38,Africa,19,284.02
a8ecc0f9005e45e0aab6831af017aa63,365,358,7,Oceania,18,1989.18
a8efa6fa19b64c8e9ecb21b18f15de36,310,279,31,North America,21,1900.78
a8f1ace6014342a29765a4898c477ac2,63,26,37,Europe,21,328.17
a8f2776a5d3a4a6caa6c773418af0c8e,277,226,51,Europe,23,1159.27
a8f53c7eae29482985b51e94815d3ea0,253,213,40,Africa,23,1779.63
a8f5984b806549a1876d2b45d8182599,364,321,43,South America,18,1544.44
a8f615209c794b9aa65e5361d54fb3d8,160,132,28,Oceania,18,1316.8
a8f87abc175c4373a0236975ca80bfe6,348,295,53,Europe,19,1755.55
a8f88ab8f98f404e8d78d82806e7e2a1,317,281,36,Oceania,19,1801.2
a8f8bb31f39d4c17980d5b16bd7843f8,190,163,27,Africa,19,1925.97
a8fd3b7f6f604c86989a42f772c037a5,233,202,31,Oceania,19,1626.61
a8ff24efda6b4473a00df4dc286f717c,75,52,23,Europe,19,309.21
a8ff43f78a3a46bf9560a698abdba755,138,110,28,South America,25,1205.81
a8ff6bc9572847ccb065aff1ccb8204c,283,253,30,Asia,14,1953.63
a8ff8161adbb487f968df7a3f1a5f3b5,309,256,53,Africa,22,1801.02
a901f3dd53f24b038a14696421b238f3,111,91,20,Oceania,18,1009.96
a906d042e36449a3855dd461c335f6cf,164,115,49,Europe,24,684.5
a90720a1ab9a467faac5d7b8c34bc71b,353,339,14,South America,23,2881.96
a908ee91d51d470d8ca648d8b662e9bc,344,293,51,Oceania,18,2181.27
a90b7aed32de45cf9162f16b7c910ba1,237,191,46,Europe,15,1273.65
a90ccd39261a48769b4e17c40583a577,179,121,58,North America,23,898.28
a90cf7da073a4615b88584f212d99b5d,363,360,3,North America,14,1901.17
a90d0f32afec41f0963dbcce6676a828,40,2,38,North America,17,295.17
a91038225f95445098bdfbb2045bfe5b,203,171,32,Europe,15,1383.08
a9105e7862674563b03323a2a274102f,291,275,16,North America,14,2402.18
a91183ddf48b445384ac480a57fc9193,318,299,19,North America,23,3038.66
a9161b6f8c3a4ff0ad98172dec9715fe,166,141,25,North America,19,1069.74
a9162f4cc0c04b4c87ba45108df9dd61,173,148,25,Africa,27,1240.33
a91b3514ac574f08aeafebfe7693e3cb,74,34,40,South America,21,419.55
a91be12412ba4aa1b4ae29a5380abe06,309,276,33,Africa,21,2262.97
a91cfddebc294a3c8da4068a3376c7b9,317,290,27,South America,22,2605.96
a91ec7371e1c468db6ee9310972156ee,211,155,56,Oceania,20,961.24
a920dbbcd57747678f5591216982c9fb,88,67,21,Oceania,20,911.09
a92174cbd5184ac091edfb767adbb3df,85,46,39,Europe,25,681.12
a921f61f943a4dd5b132aed0e251c576,173,158,15,Africa,21,1597
a922f7c4adb54a3eb90d67bb58790ee8,211,189,22,North America,21,1169.42
a926e1a5061949768d83b5eb876e35bb,277,242,35,South America,24,1544.6
a9275ccc14a0435d82875607344a91f0,297,255,42,South America,23,1711.77
a9275fdb62f94d26a228abec57573ff1,341,304,37,Asia,23,2829.38
a92789aa930d4aaa87a11b283ada77fc,253,225,28,Africa,19,2143
a928b4c05b714025a67e033f3c173d3e,154,112,42,Europe,20,1661.42
a92dc134d2064ee6bd2fca21a2ca3caf,139,89,50,Europe,24,635.88
a92fcb6e20e84dc7bc001ab47388cb60,365,323,42,Oceania,18,1709.15
a93023131eea4222b3c283d444b2dc31,268,224,44,Europe,17,2235.05
a931afd39cb143e69143e9de9cd06a8d,245,216,29,Europe,21,1976.62
a936f3aa21114368be4f605852bd5bf4,333,291,42,Asia,18,1616.57
a93b8bd6e4324d248b1b5c4eaf909d75,318,261,57,Asia,20,1437.8
a93bcd4d34c24998ae568b74a2a73b20,262,237,25,Africa,20,2121.32
a93c46b821714ed5993b23d0d58198be,112,81,31,Africa,19,679.92
a93cfd0e743a4cfeb2015d40b33a6c8f,319,291,28,Africa,18,2256.43
a93e1290c940497f8799d9628d91e6bc,63,25,38,Africa,19,272.31
a93ffd8989014bd6be2a1088654d5247,104,78,26,Asia,17,793.71
a9408baef6004bd2b36a7851d9d44a82,328,302,26,Oceania,18,2179.72
a941b3004c6249c7b0b2dc4654f4704e,170,140,30,Africa,20,1053.52
a941c15282284ef8bf4d3e2c0cbc7b99,207,182,25,North America,19,1248.11
a9437447caab4478b2e99c9042bedcf6,257,216,41,Oceania,25,1055.7
a946abaab0b24ab78feb3bfe73c88325,248,212,36,Oceania,18,1759.45
a946f89452e744138bf49ac35b7c1f3d,157,111,46,Africa,23,601.9
a949f8d192404c61b467e873d11addd2,253,200,53,North America,24,1880.31
a94a7700dc704dee8d68823c27bd35f5,328,285,43,Asia,22,1366.77
a94a8e543e5c46e4923ac2c76daa3789,217,184,33,Europe,20,1922.29
a94b15a7f784471fb839dba06b8d1759,283,233,50,Africa,21,1006.61
a94bdf55d39b41c3810fa2adb993f2ab,152,113,39,North America,18,1506.06
a94c1fb0d8c94ed9ab08696cf5ef76d1,105,62,43,South America,24,1150.49
a94ce4854fad448999483e01f21d7d39,135,105,30,North America,22,909.01
a94e6a19176a4d5d97c792421c3c7c3b,305,275,30,South America,21,2391.69
a9510c04980545478a9ed065c9965b92,280,262,18,Oceania,18,1556.67
a951c556c8394b6987f76b508b73c169,238,202,36,North America,17,2116.66
a95561408be84a7c8cfcd4976ab7b349,286,254,32,Europe,21,2342.67
a957b1b7b5c1415489f56a04b8dba2c4,110,89,21,North America,23,609.04
a95a18b6b2f642ba820d0188234b85a6,142,106,36,Asia,19,1348.36
a95c3813cdfc4c138cb5e5bd171dd274,364,344,20,Oceania,17,1620.18
a95d3b17c2df46a3a8467fc46d186fa7,46,19,27,Europe,18,116.07
a95fd027dfa74e998a57eb76d624a8e0,346,313,33,Africa,24,2382.01
a9603c0f5eb54c9cb44e9f58a75aa09a,153,99,54,South America,16,633.11
a9607ba6efe34e20bf69f663aa9889fa,267,241,26,Africa,20,2184.64
a9616fa1c4b74f9a9ed86b8d5f5f138e,165,119,46,Oceania,22,945.23
a962ec769cdb4fe9a9eafe0290f4e444,363,357,6,Europe,20,1666.67
a964cb412c774691b160f5f60e683c01,339,285,54,South America,17,1888.96
a964ccf35c01424990608e23db9477e7,132,103,29,Europe,18,1731.53
a965e3d520da41a08bfc0125e797286e,310,264,46,South America,23,1547.88
a966163d318a47aa857c14ac735334e9,72,40,32,South America,20,539.49
a966a863e48e43d29ebcb0267b4fc45a,208,167,41,South America,22,1422.43
a966d4a069034e5ab079248f868ace40,203,150,53,Africa,18,1014.18
a96844b8f06a41e58851797d829411fa,289,245,44,Africa,23,2450.19
a9685f1379514d43b88df169c1282024,301,257,44,Europe,19,1618.16
a9687f33ab6749d98d1a69e9a73824f4,128,92,36,Asia,21,731.25
a96b766fdbaa416099ab9b73260f101d,256,212,44,Europe,22,1896.36
a96cc160c2f04e1c85b79b5ae2407cb9,364,364,0,Africa,21,2348.12
a96f99c3ac984f47aa737e5f0c17b507,243,191,52,Oceania,17,907.72
a971e4899da14f8d9799438030c972cb,185,158,27,Africa,23,1662.5
a97578f2ce8b47909a7c264451c9647f,196,168,28,Asia,21,1303.24
a977042b34c34032a4217df578970fba,41,15,26,Africa,20,481.08
a977c0173e0846adae9d45b7e8684a8b,365,332,33,Europe,20,2539.04
a97c94ab13d34b87a7af87ed6c1ec60a,129,107,22,South America,26,970.8
a97d5b552aeb44cda0445a260f69f3b0,294,246,48,Oceania,16,732.67
a97e59cd12cb40b1886c120cf43e1992,272,232,40,Africa,20,1838.78
a97eaa34689146fbb5de93979f787c2e,185,164,21,Europe,26,2005.53
a97ee9e5c45043219fe6fc373ba98e9e,67,16,51,Africa,20,234.16
a981ee9c08864c2f8a868d7060d75258,187,159,28,Africa,20,1732.33
a982b164573c43cf9a05cc715e05f084,305,257,48,Oceania,24,1513.55
a983065650b34a5496f6cbee65face03,180,122,58,South America,17,916.41
a983ee26b66346ccb5fb1a170ec3c99e,134,99,35,Africa,21,458.45
a984bee1590b4b98a426ad8b53d9224c,160,144,16,North America,23,491.27
a9858520fa674c71a96535c6c41cbe43,342,297,45,Europe,19,1980.35
a985b8451a86482288780df582de3e42,132,81,51,Asia,22,617.15
a9874ce75a5f455e9c044e3557f60544,34,13,21,South America,21,258.95
a98901cae5dd4c51bb72033dc519dc28,310,279,31,Oceania,24,2483.58
a98aa6f32c73492bb7aade99c1a92122,87,45,42,Oceania,18,379.4
a98cbf4e78994b17a66e86a368228be3,74,57,17,Asia,20,663.15
a98d319af0ef4a9ab220784b271bad01,241,217,24,Asia,20,2222.54
a98ddd88fd0e4472b7ebfe7a0ae943aa,321,292,29,North America,22,2999.01
a98ed5d5865a4572acb86bf0d32e429b,56,18,38,North America,20,276.41
a98ff538207043d5bc5f4d1522112f12,43,16,27,Europe,23,374.74
a9910ce2a5734050bf2d1ceb4d9f2e86,127,80,47,South America,21,831.85
a99387ff355547aa8ebd68114e1c7fde,363,354,9,South America,18,2014.85
a996962452654736b9098deee363bcc4,175,138,37,Africa,24,1526.39
a998fd7bc7234f12b5e678af11ae8d80,329,273,56,North America,15,1448.91
a999994478484f57bbf0feb2d6cf5474,365,349,16,Africa,19,1336.83
a99a5766dffa49fba96f77ff4d84943e,78,34,44,South America,19,449.41
a99a97788ce44d099c9c627eb15278e9,88,65,23,Asia,19,701.66
a99fb67cbb1f4ce5a1a508ca02f539e6,365,354,11,South America,18,1921.72
a9a2ab53258543a984d8baeaed0e3102,76,58,18,North America,22,619.04
a9a484a12aaf4ea1971c81b750835221,276,227,49,Oceania,20,1079.23
a9a65428ca664764b94a93bc35ab3a82,267,254,13,North America,19,2153.26
a9abfb268d64471ba1a8161cdfce946a,87,63,24,South America,22,722.69
a9ae4602010947508185dd3013950534,265,234,31,Asia,24,2411.88
a9b1469362d344f49b063cd4f1425b59,345,301,44,Asia,18,1400.87
a9b1edba9d5b4f9cb060f22c0a4b112d,361,314,47,Africa,20,1809.13
a9b269e14e1743d49f8aaf4fe2fa3889,189,165,24,Oceania,19,2011.2
a9b8c824846d427b9a6193302794e071,69,32,37,Europe,20,697.05
a9b9cd089f6b4351af5cf8e7b4a00be7,170,117,53,Asia,21,844.89
a9be3f56bc454e5997dfa5f13adddea2,365,326,39,South America,23,2429.55
a9bed47de67c492f8f09067f3a7ae29b,237,198,39,North America,16,1385.18
a9bf76302dca43cf93da2d48ae3909e9,245,191,54,Europe,27,1706.49
a9bfaa1511c544c8a496ef930408e621,241,217,24,Europe,22,1982.9
a9bfbe5899c643a69574e772391e3f28,277,226,51,Asia,23,1367.21
a9bfeaa87c6f480cb9b63a7baec226da,69,29,40,Oceania,21,410.27
a9c0cdf978df46b5a2a70673144f97df,365,342,23,North America,13,2362.89
a9c3fb08717144d3b8d6e9a8c1f4d8b2,182,152,30,Europe,21,1357.28
a9c5ea854f964f7a932befeb11ec2493,156,107,49,Europe,18,587.77
a9c60b2986744effa3b6464e577779c3,70,40,30,Africa,18,389.56
a9c6144e3a1042dabd7cf537dc6ef94f,263,229,34,North America,25,1291.16
a9c658f7310847e49bf77aeb54413fa0,245,196,49,Africa,20,1223.44
a9c6cd3d751b41cab225436424398035,224,175,49,Africa,19,1407.36
a9c72b7ff7894f0f98e4583067aacb57,53,38,15,Africa,17,755.74
a9c86ecf64654898a886a258133b601b,184,133,51,South America,16,1154.96
a9ca905380c94b4bb602f8df4437399f,56,14,42,Africa,16,223.7
a9ca9ac9ce3a4f3aaed62e3f9c23cd2e,361,357,4,Asia,21,1629.35
a9cafeb020dc43d7baf173cfbc20ab0f,218,171,47,South America,27,748.49
a9cbd0541d294b7e830f0d1ca438a0a9,147,105,42,Oceania,21,948.02
a9cca8aebec04511b8eb45664e8a0004,198,156,42,Asia,24,1033.16
a9cd1f8bb9124c15a14ecadb48e2a8f3,53,28,25,Asia,17,623.51
a9ce301f06bd4c4cbc486a028c4e8d15,362,337,25,Asia,19,1427.86
a9d1b1c02c094bd9868013513b72cb1f,108,87,21,South America,21,1070.66
a9d1f232c1cf4501ac3e1536863c49f7,183,132,51,South America,22,694.29
a9d22dfd23d34a69980b3338bcc5442e,60,30,30,Africa,17,343.17
a9d4bec18bfd4ae2912616c261bf37b5,270,235,35,Asia,20,1763.31
a9d50e55d6254261a99a95bfb8867f63,91,65,26,South America,17,758.38
a9d66477b8024602bdda54d10c1698fd,37,20,17,Asia,21,273.22
a9d6977d9f2447e0a4d4f583b89328c4,131,103,28,Oceania,21,793.58
a9d87735914441b3973fdef1a72ae14c,188,173,15,Oceania,20,1616.31
a9d884647848480d8aecb62212ffe4bb,364,333,31,Africa,19,2311.49
a9d8d78abfd4401ab5e645dcc3259a30,243,191,52,South America,18,1205.61
a9d8df386ca44cfb81bb24d2097bb855,146,96,50,North America,18,938.07
a9d9ead742f64c07a0d9b4a5ae0329bf,139,85,54,Oceania,25,845.53
a9db456327a14039b9830e87ff755408,111,68,43,North America,21,433.19
a9de82c6fda141999f0d9c6bd75a8eae,98,59,39,Oceania,18,743.63
a9df271b9d6f4a11a9e9dc9a911ae619,365,327,38,Africa,21,1998.1
a9e030c8c7e04432b3ffe667dc73a5cb,358,315,43,Africa,18,1732.72
a9e1272ac0c345cba7249525d3d7c5ed,73,47,26,Oceania,18,402.78
a9e586cbb73b40159102ebf43b098f6b,55,3,52,Europe,24,161.28
a9e61be08de548debc4e325b6ffcbb3f,147,124,23,Oceania,21,1312.11
a9e802118cb448d9a0b0d7dc39651e82,177,151,26,Asia,18,1387.73
a9e919ce26c848ca89caa568431e6be1,185,129,56,Asia,17,687.94
a9ed4585ce1b4a599f6ca58726db53cd,315,264,51,Oceania,15,1652.52
a9f1ed6168414db086e905db38a791d9,67,11,56,Europe,18,243.61
a9f21cda875440b78b88034053631ced,47,4,43,Europe,19,272.85
a9f2f43a384d49cbb0fa63f745e834d3,98,66,32,Asia,19,668.01
a9f62086d9f547918a1263f2570cfe17,216,178,38,North America,21,1252.65
a9f931f1609e459599904b4f365ed5c7,363,345,18,Oceania,17,1607.47
a9fc4ba01eee4a3eb9533ed89944c655,261,213,48,Europe,23,1106.31
a9fd4bcf4e4b4f518ecf0e5daf600b72,331,282,49,Asia,18,1957.97
a9fd6e6b0f4b49a9a71ba04f90b9f744,245,233,12,South America,22,1445.29
a9fdad86858b437580f76e36f6724325,231,181,50,North America,20,813.56
a9fe60ea9d7440fcbb76abd13125713e,162,143,19,North America,19,1294.96
aa04691316ef43b5870eaaf546bb7990,335,290,45,North America,23,1656.42
aa06ad735e1d45b3875959043097e465,92,65,27,Oceania,11,472.16
aa072b6d051441fc9a7892070a30f1be,93,42,51,Oceania,16,381.83
aa080bb4c43a4bfd9ed5a0c7e65e0d09,186,142,44,Oceania,13,1495.72
aa08130d13284bf8988d1df5020c0646,72,45,27,North America,18,805.23
aa0815f68a3a4212abb1faec60df687e,364,353,11,Europe,18,1977.17
aa091178ba284011aa6214b74a9d2ec6,87,50,37,Oceania,19,482.68
aa0aaf445d14412a9cc389936571995e,280,248,32,Asia,25,1336.13
aa0e76e29ba9424da5bb8458e12f60a3,120,84,36,Asia,15,799.06
aa13e470d65e4efb92cea9cdacb7853b,364,338,26,North America,21,2623.45
aa141a2684c64dc8873da6704b7749aa,365,339,26,North America,26,2105.52
aa14799f5a314c84b29e653ac45a5dff,289,247,42,North America,24,1522.87
aa16b3a501784620b3cc32462431b24e,156,107,49,North America,23,466.62
aa173514ca124785a3b6e3311b354076,152,113,39,Asia,21,1007.91
aa17c3587a9147fdb7fa1ccac357e4d1,322,270,52,South America,20,1906.6
aa182e7db8bb4b968cebf5e165c18142,63,34,29,Europe,22,641.11
aa1a6d2de9b44c77b495be7fe9116954,41,2,39,Africa,16,161.47
aa1bfd42d4b547aca031c43999bc1462,328,274,54,Europe,27,1740.51
aa1d5903f9a94c5c852640ad77189cea,60,24,36,Europe,18,347.56
aa1d8e822ab34d1990bdba623ebf08ee,33,13,20,South America,17,228.67
aa1eb840edfa4ad8b26720411b1d80c2,89,41,48,Oceania,21,740.75
aa1fd876b1ab4e13b8e62c6e1fb92c1d,95,74,21,North America,21,497.44
aa2022ecb148486f954b22866f06c72d,330,309,21,South America,16,2496.65
aa203cbc1ea94de5a1f3e1624c48bf03,279,248,31,Oceania,21,1695.65
aa2112913b9f4bd0ac5f42b9c4678455,52,16,36,Asia,15,521.52
aa229e0c70e44dba990f325e165620ba,347,296,51,Oceania,16,1421.15
aa232cc6aae74c598380026b5d45faae,89,50,39,Africa,19,633.44
aa276731b7ed4494bc57e7a8e3c6f16a,67,25,42,Africa,25,480.64
aa276bf8b251456ca3c8af80dc09ff36,95,65,30,South America,20,810.27
aa2881301d2542a18658d4d15d182a0b,159,135,24,South America,18,1506.35
aa28c41d3ab343838dfe92e1f00fa169,275,216,59,Asia,22,1676.27
aa29ff72f9b84cf7ae43dc4ab7206c64,324,297,27,Africa,18,2317.9
aa2cb49287764e51b3e4b388b88f1114,136,88,48,Europe,16,795.72
aa2e464d5d85408583af1913b50285c1,357,302,55,Oceania,22,1890.97
aa2f6ed461b34c479b51de1345c1bf3e,362,340,22,Asia,21,2558.74
aa301ee1ddc245bbabaa3733810db1c8,167,111,56,Europe,21,1073.79
aa3068fb6b0b4d7abadd19de8407b64b,298,263,35,Oceania,21,1965.27
aa30e2c5c6a3410b8fee2aa3a8047f20,342,329,13,Oceania,27,2942.56
aa313b8a05e5458380b4dfbfbb79239a,180,161,19,Europe,16,1571.72
aa318fc7fde0408e95e773c2a2f27ccc,278,232,46,Asia,23,1996.94
aa31de18bdb04db4a23926c37544458c,295,270,25,South America,19,2056.97
aa381982e0ec4206a78a285844709b14,185,146,39,Europe,21,1108.46
aa3b85f514ac4e2daa7128d0eab91dde,223,188,35,Asia,21,1628.53
aa3e37bab6a84e70810ebb4fb318312c,90,51,39,Asia,24,649.69
aa3e3b5ebf624ed2b5e759ec50e21408,365,312,53,Asia,21,1722.43
aa3e41ae2fdc4301a88a2a5b599f8e1c,289,268,21,Oceania,21,2224.95
aa3e7e5ba14d4b2392f688570669f56f,164,115,49,North America,24,389.93
aa3f7bb168f84f159b12525f7dae57c6,114,86,28,Asia,25,592.19
aa404b2251104587a516ae9e9e1601b3,102,55,47,Oceania,20,496.33
aa404d7be98b4d288c9e29441e32f8e4,99,70,29,Oceania,16,837.65
aa40ad9147974fe7a563e56d43749990,166,134,32,North America,23,1145.01
aa4443bcf83e4b1ba6fa4ff40740874b,84,35,49,South America,23,805.29
aa45d426038e4a02a814fa2643136aff,283,242,41,North America,22,1527.33
aa478be5e93f4e579d4ead5e5966bc3e,349,303,46,Asia,19,1144.72
aa479e3d936545afad58741b4d493555,194,157,37,South America,20,928.49
aa4850db714740d1ab089162a6bed2b8,340,288,52,Oceania,16,1493.83
aa4950ca3e2044138f24db150cb944f4,295,273,22,Africa,22,2084.54
aa4a330f8134407fa1485bc081380eb8,334,274,60,Oceania,20,1599.05
aa4acc7e873d4d8886fdac9f2c9005ba,259,234,25,North America,18,2013.41
aa4b59c636924049815b3825b68b691f,283,233,50,South America,19,1605.1
aa50e021f47e4a66a37ac233ba6cb7ef,55,14,41,Oceania,20,440.21
aa5131e828474eb7a59ba094e8997c9f,107,82,25,Africa,18,1210.04
aa520879d8e546279d4e61201adf339e,114,82,32,Asia,17,751.12
aa53574e18d341b2ab89f290ce8bdd1e,333,316,17,Oceania,17,2992.55
aa56ccd75e8948938d86cf4f9cf9826d,188,157,31,Oceania,18,1778.15
aa5752e6eae44c43a3d2f6e50cd60254,203,191,12,South America,14,1729.32
aa57e574e7d44579afa0d91a47917e97,128,92,36,Asia,25,981.83
aa58992f054249e7a5df79680a4f69d6,149,122,27,Oceania,22,1307.91
aa5915e0d2304e0e81fa6872bd5091a8,315,275,40,Oceania,22,1443.17
aa5dde895ac247b9a6067dc7952700d0,107,43,64,Asia,19,515.81
aa618855c8714692bf8c0399a4afe9e1,187,151,36,Europe,20,2186.55
aa61aa99fa32414abb9e5eecf0ab988e,349,319,30,Europe,26,2247.74
aa642743a8894d3b963cb32a8fe0f3de,186,150,36,Oceania,20,1623.94
aa6719e3b9194a2bab7b346da2a7d34f,57,17,40,Asia,24,295.85
aa67c71ab6284f4f84169c15a9af9106,306,275,31,North America,19,2138.28
aa6a1d430fdc45e1b6f2144d1a81ca4e,237,213,24,Oceania,18,1570.66
aa6ba6ba7f67423cbff96467fb5fe273,179,135,44,Oceania,15,1065.28
aa6d376a04a949a8b4a5fedfd91b0c88,283,257,26,South America,19,2568.22
aa6eed32c99549c1ab6e8e25197005cd,54,37,17,Europe,19,331.16
aa6f03b03c2d4c2e95ea2e1dc1aa5bd3,331,287,44,Oceania,20,1371.64
aa7161a35ef641ecbef7b66ad85c94ca,100,56,44,North America,19,522.05
aa721f5834e849a09bb1e289ac677ea9,133,81,52,North America,23,438.88
aa7226e3506e47d48f01a82b5fcfa416,196,161,35,South America,16,1317.86
aa72553e831344a395fe3067a1e35c07,163,123,40,Oceania,26,946.39
aa7277fde25b4c129d8f07c831f7ef2b,308,287,21,South America,18,2282.67
aa733b51e4154352a139dba96a647687,92,38,54,Oceania,23,559.86
aa73e6dc77454c05b828ff9d59f59ab7,365,337,28,Africa,22,1871.45
aa780ca3b6764f84a5941b282634ce71,319,298,21,Europe,21,2464.49
aa78573d37c74553bad8c1e62bf69054,74,54,20,South America,22,337.83
aa785e16bce843c98a67557e1a7f0370,192,138,54,Oceania,18,1353.5
aa786c498775497781c39fcd74d687c5,246,216,30,North America,23,1503.84
aa791b6062484ef2b9754c3e9f732a37,149,111,38,Oceania,14,840.48
aa79cd3ddae54022b40f3438a1de7b82,225,196,29,North America,29,1956.65
aa7f246f75a241cea97fc271bded92fe,77,31,46,Asia,20,402.51
aa817f04aed546d9849b606a78a84513,31,3,28,Oceania,21,233.62
aa81cb9e6fb14698a6a1d3c3c6628c8c,344,292,52,North America,16,1835.39
aa821f92e77f43fa8601c468910ebc44,340,297,43,North America,24,1623.67
aa847b2df85b4dc698d928e1a2d4cd44,72,24,48,North America,26,492.93
aa868dbf8df2449aac8b8e535b84fc72,356,333,23,Europe,20,2404.19
aa87a98554cc494d9d47c0b94d2f64f8,45,18,27,Africa,22,226.77
aa88ec140472440e8681161f899d82dc,177,146,31,Europe,21,1656.7
aa89354543474639b1b4ba7596aa33a8,365,338,27,Europe,25,3206.69
aa8a29aa6e83411aa97f92b9eab7811b,364,315,49,Oceania,23,2307.35
aa8c59bfcdda45eba3cc7a82e9a271a1,92,65,27,Europe,22,831.49
aa9089ba1d07481f9068d80f8b09ec86,71,22,49,South America,16,290.5
aa90d04970184b9fbb69d3863a739126,154,122,32,Oceania,17,928
aa913908de4241a0a90fc1270bb36e62,197,169,28,North America,22,1329.26
aa91705cd8c949e7b21bdaf8a721bb3f,198,171,27,North America,21,1253.15
aa92b3508f61414d97da0443ca98f19c,111,78,33,Oceania,22,1285.14
aa978f0acbfa4001b360ce88a3e586ab,225,167,58,Asia,19,980.21
aa97a654f6ee427a8ca374a1ef2724fc,183,163,20,South America,22,1059.21
aa9826235888469aa9b9d0e7912f959d,197,161,36,Oceania,23,1335.03
aa9919d2e2d14bccb678702c3898a92f,273,229,44,South America,20,1149.4
aa9cef164eb149ddb1f38d2faafb0c09,182,155,27,Oceania,20,1275.38
aa9e8b0204174346be4c29765ecce719,101,74,27,Europe,21,751.48
aa9ea55cec9f4d59986488df14d12f14,317,280,37,Europe,14,2375.02
aa9f06c4bbaf4090b89b4a54b99a920c,151,107,44,South America,21,826.09
aa9f311f33e6472c8690bd99f4697cd1,71,43,28,Africa,19,580.36
aaa093da7c3e47c888bc3ed4a9332e7c,105,77,28,South America,22,921.18
aaa14eded6e34fd5a60eeadf2fd35618,250,220,30,Oceania,19,2268.53
aaa23aaa5d9747b3b03069cffa994ee0,193,151,42,North America,21,1315.39
aaa2aa339de14c1bb107fc0e17d95ff1,365,348,17,Africa,25,2038.96
aaa32d19b4454509bb15c9a5bd1414a8,118,99,19,North America,18,963.86
aaa515f947fa4ba8845f06b852ff288d,116,79,37,Asia,16,438.92
aaa75402dd8e4297bf7b771970f3441e,306,279,27,Asia,23,1962.08
aaa83e8eeba844fe97c69533cae07598,123,82,41,North America,21,752.99
aaaa01e038fc4a0a8976a5478b751ef9,162,142,20,Asia,22,939.26
aaab32c103c64802bf5c83c2a6d077a1,205,171,34,Europe,25,1020.5
aaabfbf1796d4a2a8842566cc292f8fe,342,307,35,South America,21,1735.21
aaaeacc7b9cb478b9e58d9b39427bd59,174,129,45,Africa,19,1049.44
aaafd43be7b34851b444ec8df441833d,76,56,20,South America,17,656.64
aab0ca2a1bdc452fa454e4dedf61af18,82,28,54,North America,23,192.43
aab0e66e56e04bf7af41f4bcc3c51cb4,194,145,49,South America,17,1447.71
aab1a42afec54df98f77051bd45a5545,75,26,49,North America,15,154.78
aab1de5620ba45909940346e23830053,168,129,39,Oceania,19,1221.51
aab353dae1734ea890c8c4777fce3300,161,109,52,Europe,16,952.24
aab580fbcc72446c89c4cc78ebc3834f,225,194,31,North America,19,1275.38
aab6fc2635d64bb6a362a68541264c4a,237,214,23,North America,18,1990.49
aab9da7116344b8c9154681729ddb4d7,186,132,54,Asia,20,982.58
aaba0ad03e9a46c9a073dda2abc9785c,353,307,46,Asia,22,1640.33
aabd090022a6401ea7a2d2d06af1df2b,197,147,50,North America,23,916.35
aac1962bb0344aaa8eea6fd858635fe1,36,21,15,Europe,21,284.31
aac30b904ac94f57b6bc7503a6d6dadf,124,75,49,Oceania,16,541.51
aac31c475766499f8ff0ba00dcf27943,94,42,52,Oceania,24,578.09
aac36f402ee54d13913253efe7047eaf,269,209,60,Oceania,17,1226.67
aac38931854b4c35a4e599a929fd6231,218,194,24,Asia,20,1492.37
aac638c260574890a418f52c2ee795f5,365,351,14,Asia,18,3375.84
aacae54b460e48d3b26efad4d76a0646,318,279,39,North America,20,2246.05
aacb41ec97d046358786d92f8f5a0f75,318,287,31,North America,16,2975.51
aace01a8b669402f928df59850c7312d,252,206,46,Africa,20,1215.22
aacf61b89e0e44b8a6eb431478b3e584,273,220,53,Europe,18,1603.64
aad0a7acb58d4f01a565734f3fa0319d,81,53,28,South America,23,563.68
aad300c4c9b74d248307d79f7d571683,176,128,48,South America,23,1036.93
aad324acbdea493c9a9b62c8e0d5e68e,274,247,27,North America,21,1438.67
aad4a5e925724391b94d5fd39624a806,365,338,27,Asia,21,1551.78
aad5ae40e6114c76ab53c06c4639f164,118,62,56,Oceania,21,848.38
aad688eaaf6b40a29e12731f2f4ab586,278,231,47,Oceania,22,1366.28
aad691bd4f0944fcaf61f6cdf1b58542,364,363,1,Africa,22,2307.85
aadb7a0c20844cfcb0ff2d1cb4a315e8,43,12,31,Asia,19,398.07
aadb99257605455ba2d949f3559e08e3,351,327,24,North America,20,3146.71
aadc8a08e3c8429581cfc87878cb0aab,220,187,33,South America,23,2268.38
aadcd33e8f25430fa05dc941c1f33a4e,274,228,46,Oceania,19,843.83
aade976dbebb46c78b76c3356549d5ed,362,336,26,Europe,21,1705.89
aadeb7efdb074fd58259799b6976e16c,227,176,51,Oceania,20,1470.74
aae055c0a65d4f0cb59bf433cd67a0f3,133,103,30,Africa,16,1368.47
aae1b63faa40483e89214f06c34c974a,184,135,49,North America,22,1124.09
aae74f397d604ff08a667504c9b267d1,70,44,26,North America,19,671.39
aaeeeaf0e5a74b8b9bb5d194396f2728,97,67,30,Europe,20,609.07
aaeeef6673a3489d9078ef22d3c10691,80,21,59,Africa,24,326.53
aaf0cf83ce6c408e9e76d5c2a599498f,319,271,48,Africa,18,1159.05
aaf127d728e5475fbd88d926fbb9bb6a,107,72,35,South America,19,771.1
aaf1e3ece3a14ca1a0d963bf03f32f7c,311,270,41,Africa,21,1375.46
aaf37aaeac9e404587b57bcefc80312e,124,79,45,Oceania,21,710.76
aaf417036d834333b038b8303368effa,364,340,24,Africa,19,2343.12
aaf4b008be1e460e8cd8d0e1736fed60,174,134,40,Africa,17,1094.15
aaf51b4dc24046af8f91d27f39b49d43,102,54,48,Europe,21,638.58
aaf677cda2c04b459fca4ae0e83be9cf,363,327,36,South America,23,2855.1
aaf788a1d5aa4df6b61323b9e617598a,211,166,45,Oceania,27,813.76
aaf7d9736a13414dbdae91483386810b,333,285,48,Oceania,16,1578.48
aaf8c44ffb294843b7f1840f8eb3bc6f,351,330,21,Europe,15,3380.68
aaf97f7d3b954b1cb7fb0d9c78cb03cb,312,278,34,South America,19,1697.78
aafc3449f26249bb886b2611b44c95cd,180,146,34,South America,24,906.65
aafcac9cf6574b21a15ff6683d5615bb,351,329,22,Africa,19,3283.16
aafdac09c2ce4888ae73239a23922ce2,72,51,21,South America,26,883.54
aafef412c9ce46f3ae87fb142cefaffb,149,98,51,Oceania,24,752.44
ab0075fcf87f4b6d8b9a6a1908e69592,250,232,18,North America,15,1740.06
ab0232094f7a4279b293306393821366,363,338,25,South America,27,3061.53
ab0474f317f447bfbcf5dd11bc2a7cb7,364,342,22,Oceania,20,3590.55
ab07298e9f314445832d9d4aded7f5eb,109,94,15,South America,22,435.67
ab095fc8e2444efbad93df8a4b78ed4c,59,10,49,Europe,20,332.29
ab0afba4af3f486886683da95a1175ae,253,208,45,Oceania,19,680
ab0b9bccbf24475aaa9ed0b3a388819e,63,36,27,Europe,24,697.6
ab0f288b621f4b308f61fc0ffcb1249d,329,278,51,Europe,19,1757.89
ab0f7c5cb06b4bc89135a04f1b23d67b,202,136,66,Africa,13,1102.93
ab1396c155a04b53b0fde0ebeb38e726,56,29,27,Oceania,18,375.16
ab14fedb86c548c0ac052e2f864556f0,124,72,52,Asia,19,586.15
ab187f3281de4caa9d2e264577fe522c,137,107,30,North America,24,768.89
ab1985acb7894567b904cf3eb68ec531,114,58,56,Asia,20,246.76
ab1a87e4e4f74e46bd3695ebe4e537b2,56,30,26,Oceania,21,512.08
ab1cb1eaee1147f1948d100e2dfd0f70,330,307,23,Europe,17,3079.43
ab1eba1420944668903939b3470fa931,237,213,24,Europe,16,2565.97
ab1ff7a62864408998f8e65ad3539d1a,142,99,43,Africa,20,882.75
ab20d9329155492ab7cb7e6fcdad8515,228,191,37,Africa,22,1882.29
ab21912bbe51482d8c4f7b264af3d2be,56,28,28,Asia,20,476.83
ab225ac433654359923ab37dc19e72ab,58,17,41,Africa,19,151.87
ab24156878174d3a80ef7cd2e04c9841,364,332,32,Asia,19,2283.28
ab245d57f6c54e159670cc43fbd88cc8,213,170,43,Asia,27,1178.73
ab24ced15ddd4dcabcc63341fdf590fb,92,57,35,Europe,24,511.76
ab26957d50d3464d8dcc63dbd6ed1633,25,7,18,Africa,17,238.76
ab26ec48bf114d979efc161a2de613ae,92,41,51,Africa,23,651.91
ab2a25b66f444af5a1c4dabc246345fd,31,5,26,North America,21,145.38
ab2cf395d9d040ca8b222f6b76134ed0,57,6,51,Oceania,17,45.4
ab2ecbf13e40493eadbfc82245acee8a,128,114,14,Europe,21,1486.98
ab2edfe1975f4e678a7c7d3ffc6f8a30,209,170,39,Asia,17,2121.23
ab2fb749d64645f9a47ae9969dc04aa9,262,219,43,Africa,23,1968.71
ab2ffc6e042d43ebaf8d8bcd1d9dad81,181,149,32,North America,21,1232.07
ab326052b976400594e655f4401baaa1,307,271,36,North America,19,2422.02
ab328d59b25b44b0aad9b429e7856ed6,259,224,35,Africa,17,1672.78
ab332eb3ad5242f1adf0a075dc041f03,224,190,34,Asia,19,1275.14
ab33ef70b39149cdac49e64f0df6ae98,278,243,35,South America,18,2280.18
ab34ef3d358e408992b5f28c88dc9c90,234,181,53,Oceania,24,1338.54
ab34f05e80fa4991975f039f7c5055c4,112,84,28,Oceania,21,1106.06
ab35075b80d243f495c1dbfbd244452d,56,5,51,Asia,19,189.56
ab35f2e928b14626af46b26313f71eaf,97,61,36,South America,21,963.02
ab37ee301dfe481587201d4a154eb82d,348,328,20,North America,15,2708.08
ab3acdaf546d43ddbc7006d784b7da80,160,124,36,Asia,19,1124.21
ab3cdce96aa64888adee2ded06101e6a,175,125,50,North America,23,498.73
ab3e2677a09849b3a03ce64383151c1b,170,128,42,North America,21,1139.28
ab3f24ca68f4425bb7a1eba9ec0587e5,363,354,9,North America,17,3013.08
ab407c9f502e434bbe54444f2a922c1b,303,255,48,Africa,26,1510.72
ab448c4aa17b4178bd75435fd50ec1ac,222,178,44,North America,20,1834.06
ab45721e254e48dea0858b14eeece268,166,140,26,Asia,24,1320.03
ab457da28178493582eee93714f188ea,253,219,34,Oceania,22,2143.43
ab47841edba04e3aafd90b6ae191adb4,332,278,54,Oceania,25,1871.44
ab49b846f9d8464a973187c0ad25e065,365,326,39,Asia,24,1424.87
ab4b2af697354b9eb3080cefaa77936c,288,264,24,Oceania,20,2338.67
ab4e08102a81403b93d72ec2eb6555f8,161,133,28,Africa,23,1460.27
ab4eb14549384f858106614ed87a1e32,364,330,34,Africa,23,1991.59
ab4f10f389e84bf8ae188335cfc929bb,38,14,24,North America,18,376.61
ab51ad6bf4904adda3ee62cc4a14b963,365,348,17,Oceania,20,3735.39
ab522751967c417e819e8654946a78bf,211,191,20,Africa,24,1753.77
ab52b7164bed4ed6bbaf17485052e5a9,295,247,48,Asia,23,1380.8
ab533681d89448bf8bc8a02fc3e13633,243,218,25,North America,24,1991.48
ab5417ce3073482f86614f0e8152db69,309,262,47,Africa,24,2297.27
ab5802f9bd654aadae225d4280ecbeef,163,119,44,North America,22,1203.78
ab58bcd4885a4dd4aa72b6a8badb8476,363,317,46,South America,21,2254.81
ab5c1fff2f864a55a5e7d6bdbcbfee40,165,137,28,Europe,21,1346.97
ab5d1b730a6a4ba88536a9fe06c2b1d7,351,301,50,South America,25,1703.52
ab636eefdefe449b85cd704218be8207,216,162,54,Europe,21,807.93
ab6529b8ce7c4298b048db416af86620,237,188,49,Africa,23,850.09
ab6631bc9bf74a55bd36768cf27e87a6,361,332,29,Asia,23,2719.41
ab66d2426db445ca87334f3e0fbd3dd3,310,279,31,South America,21,1954.26
ab6909cc0c554cc9a1f09b90c282c737,301,246,55,South America,17,1264.93
ab6915b756b24bfcb04dd00f4d9f93a0,90,46,44,Oceania,20,318.92
ab6a56a53a1143c8af5d1c13beeca46b,365,334,31,North America,22,1519.79
ab6adf713bff44459decf1ba94c78364,252,203,49,Asia,18,1653.87
ab6c8591398f4ab2bd9e842c01262712,332,305,27,Africa,19,2987.83
ab6e8a1947d14c4eb9365cdfb883e947,365,365,0,North America,20,1838.73
ab6f4819aadd458f9b90fc1d1691b1dd,211,157,54,Europe,22,1014.14
ab6f9d2eb86b48bd9af73743e2dcf60f,218,166,52,Europe,18,1214.56
ab701b0d19cb419882847663917baf86,143,96,47,Africa,19,548.28
ab70f3e133ea470ba89f0e306509df5e,335,284,51,Africa,21,1941.54
ab726c0b61fc4cac8581d3a24b191446,54,30,24,North America,21,592.46
ab73c219a76c49b0b074451e6771da7d,331,283,48,North America,18,1516.86
ab740e8693144e409e3dfadfcee5d0ca,271,248,23,Europe,17,2111.8
ab7906dc11c045ecbaf85d00016d43d7,364,339,25,Europe,21,4018.52
ab7b00a25c1b4b56b4c31987124f3ebf,106,54,52,North America,23,674.66
ab7c73b062a449daadf7225a9f0617c4,317,276,41,Europe,18,1724.07
ab7d920ac22141a6892e3fbf55afba31,111,55,56,Europe,20,632.57
ab802a94f1f54738b8eb806a7d05eadb,330,287,43,Africa,21,2445.76
ab83547a2cab489286b1e4418ba81962,296,231,65,Oceania,25,1601.22
ab8ae8f89492474c81d6fd0287eac41a,235,179,56,North America,21,1530.06
ab8bf495672d40bab7b006948339d7c7,365,334,31,North America,15,2360.06
ab8c2e937ff149b78c3da7127414ce9d,151,96,55,Oceania,23,515.07
ab8c841fdc8a4f8bbeecb22979e03bc1,32,8,24,Europe,19,281.29
ab8d1952673d4cddbd7ec0ce831bc69f,309,259,50,North America,21,1317.41
ab8df88e9c59410ea4a2912b7480fd93,91,51,40,Africa,20,781.26
ab911f4afdc2410994e9fd5327330265,202,147,55,North America,14,1028.3
ab91b0566a874e2a9ad8bf2807592012,179,158,21,South America,18,927.49
ab9300ee65de468bb2b0ab5b91b633fe,348,311,37,Africa,19,2050.08
ab94803dcfec4b179806845d1e8535cd,194,149,45,Europe,20,836.23
ab954364f9bc424c89418b5f3543f2a6,365,355,10,Europe,14,3495.99
ab95834a3771432b82940cc670fbdea0,294,259,35,Oceania,20,1578.24
ab9649ba2b804c80b7b84f6034ee2df4,187,153,34,Asia,21,1473.05
ab9a543992964701bf047d584c7423b1,99,82,17,Oceania,20,833.33
ab9ae839c8464114a24509e01e892873,211,169,42,South America,23,1304.43
ab9c794cb3df4bb48681896e6a76ee94,86,42,44,Europe,20,747.41
ab9d0f188a0946649c08447de594d1c9,362,350,12,North America,18,1840.62
ab9e28b016694f3d930c3c4da46b03d3,363,328,35,Africa,24,2238.98
ab9e95ac56994efab32f324909391e3f,230,180,50,South America,18,1074.6
ab9f8ee764a942c58201372dc8cacd87,212,194,18,Asia,19,1978.32
aba00c6fea69473397681a8d1018fce9,227,178,49,Europe,19,1333.05
aba0f5b094c64653b1ad143ac938b94c,228,190,38,North America,20,2132.62
aba102425ddd464099ad7f72263a7ed2,258,241,17,Europe,22,1595.89
aba1af5e306142ef897206de2597f0d4,314,283,31,Oceania,20,1624.74
aba29d9b88d2475f84b11115064a81ea,280,232,48,Asia,23,1379.3
aba33277d7b246838f44f237b077a909,60,16,44,South America,22,182.29
aba407828fb64ffdb8762d51ab4ddb58,260,208,52,Europe,21,1169.7
aba46eed8099467d916a92573c5483d5,299,276,23,Europe,22,2223.14
aba4856b22594b1b9d6244fa3bec0e24,203,176,27,Africa,26,1248.83
aba6ceb5aa45489cbcef6144ad32e77c,319,273,46,Oceania,22,1522.6
aba991490cc046629e86b37eb5eb7c5e,363,328,35,Asia,18,3027.81
abad8a07f5f54945b9b077e09797f78e,113,80,33,Africa,18,848.53
abadbd7f88e444eeac9e4e6e03d76ec5,236,216,20,South America,22,1636.15
abae68b292a54de7942a4f6893343beb,84,61,23,North America,18,816.03
abae8f9ac4054a419fa23a837215832f,138,110,28,North America,21,877.3
abaf14e4d7684ba98dbf619045cec9e9,116,90,26,South America,23,587.59
abb0c4bf7bff43d8becde19f48eba511,180,135,45,Asia,16,1866.76
abb48c6632244cb08588dfc2dcd85800,132,73,59,South America,21,712.98
abb7481f1ea04e66879a1adca88c3b55,185,161,24,Oceania,22,1643.45
abb85c21e0aa4dea92c187041ba65ddd,342,293,49,South America,17,2145.97
abb8c95af49442b4b4d403d6a3232a16,219,189,30,Oceania,21,1547.46
abb9aac5eac14085afae44bf21aed28b,365,365,0,South America,19,2123.64
abbbec736dcd495387126d5fbd58de45,278,231,47,Africa,23,2094.82
abbf1d7950f144bca117e60dd42a7462,100,55,45,Africa,20,623.44
abc00dc5d2be46b99d5d1e874e12480f,218,168,50,South America,21,1008.47
abc0a7e9667941d68a733ce79080dc44,241,200,41,Asia,24,937.21
abc3d1deaf824c56933548aa85695e50,84,57,27,North America,16,715.39
abc4ad516f0946aeb916d402c3e2362f,161,122,39,South America,20,1330.21
abc54fa673a145aa8116cd6307ae876d,146,100,46,Africa,23,857.6
abc5533ebdfc43419ff5600aef7d3f62,274,218,56,North America,23,1656.75
abc99aaf78424346bf4e5fbabbbc08e1,272,210,62,Asia,19,1288.89
abca18ab04e84eef9840fb28ae05634a,347,315,32,Europe,19,2046.1
abcc6525fad84905a146b0fa9216a9e2,351,328,23,Africa,21,2391.39
abce3d1a0e744862bcee073c6c598fc0,105,63,42,Oceania,20,455.64
abd0eea0a0644aa3bc8371ed31a408c7,180,136,44,South America,22,658.82
abd23d4b217848939ae62567565a0477,70,20,50,Europe,17,360.01
abd7fb260c8c415a947c7896626f8586,170,139,31,Europe,25,1025.53
abda208a81e64806b8876fc6277d5c17,364,351,13,South America,22,2557.54
abda36adca3742b9aeaf5d0c7f19cd82,67,29,38,Europe,17,550.7
abde8a4db1e54c0b93a73921af532072,267,238,29,North America,25,1846.07
abe041b2df0f4fa79866f0833e94aae8,365,325,40,North America,19,2269.88
abe3b3d454c94e5987dd4022abb752a2,199,170,29,North America,21,1834.72
abe4278334c54654945a9221236dafd6,203,161,42,North America,22,1123.69
abe5c2a2f9df4c11a632b2c1773bcc1c,266,220,46,Africa,18,2031.38
abe6351318ec47edbbff35a25c4834b5,340,318,22,Oceania,14,2335.44
abe71a9b6bdc4695a60b28cd6f975a9d,261,229,32,Africa,20,1049.75
abe805944cd14c07911ee1a56e1fba87,157,136,21,South America,17,1058.51
abe8df38e4c643afae3d0cc13bc80cb5,235,195,40,Oceania,15,1272.38
abed11fc96f4471285762c5cfa51ea68,36,21,15,North America,16,353.76
abf003d1b3e7403794a16734c477a5a4,362,345,17,Europe,24,1567.84
abf2d0dfe94c4c0ab10d6da7d58fedc6,359,328,31,Europe,13,3206.48
abf45681d08148e1bb643164e7ac4d6c,213,178,35,Africa,27,1813.74
abf66d20c28e43099dfb6f133a28a8b9,139,91,48,South America,17,1127
abf6773895614e35980ed638faa4edbb,188,153,35,South America,21,942.27
abfb7e70c0ff42b4b50878c6904a62b6,320,288,32,Africa,17,2174.31
abfb8402ec4f4e67ba2acd2fbc03f896,203,154,49,Asia,20,1158.91
abff6b12c91a41538feeabc84ed70f89,276,252,24,Europe,16,2135.04
ac044647a53246f083e0c14011ce2c03,365,342,23,Europe,19,3055.02
ac04753e4b134f6f84210c67cc6b6926,54,19,35,South America,18,288.4
ac09ea51fb19423d9be0e80fa700a2cd,62,38,24,Asia,23,614.93
ac0a404b826241f8b9c272418f15b25a,123,74,49,South America,17,1186.46
ac0b887000c14878a9170276316ac4c5,192,162,30,North America,26,1227.41
ac0bee80931f41a5b0a2e1d9f39794b8,133,108,25,Europe,17,760.1
ac0d5488fd6f4ccdb0f1b7a0d44b72bf,109,73,36,North America,17,546.01
ac0d8f64369a486f8a6a8314ae7b5017,170,143,27,Africa,20,1015.74
ac0d9ff7b8fb46a78bda087c6e839734,252,209,43,Oceania,17,1437.1
ac0ee582b837428fbda7207461aa1203,83,55,28,South America,21,530.7
ac0fbf6a37f94071ab8086616c37b554,365,351,14,South America,21,2513.93
ac0fc3583ad54793a4c7e05271d601bb,351,307,44,Oceania,18,2598.57
ac108de9a5bd4976a6aa65dfe7379b1c,198,145,53,Europe,20,949.18
ac12d8a08ef041c99e0434542cece864,72,23,49,Africa,17,330.49
ac13a3e44784402aba10d838eb6ff401,71,37,34,South America,20,733.76
ac13cf14ce0e4bd3be8fc0d4ea0bce26,365,345,20,Oceania,22,2008.05
ac16e41119f140febd06cdf0b8532a12,220,203,17,Africa,18,1745.88
ac18b39fb26e42bfbf5b25585404a6da,356,297,59,Asia,20,1734.25
ac1bf6ac80394083aa31b8f919095f0b,362,337,25,Oceania,25,1716.59
ac1e3a31cb93455a845e10cf1a2a9e2e,329,297,32,North America,17,2755.81
ac1faa2a928a4c1487cddf22798bcb47,129,111,18,Oceania,18,660.31
ac21e091072d4b9180456afee52f8023,282,233,49,Europe,22,1886.68
ac21f75e7f86453bb5bf011975b29f08,119,90,29,Africa,22,586.87
ac2349a36e3449a0b1dea72d0af6f116,142,112,30,North America,20,1160.7
ac263ecdbac04415b8c0b1f397c34c72,209,175,34,South America,22,1274.78
ac28ea4bd2024487942a98ce3bffa59e,122,80,42,Africa,20,511.9
ac2ce3f5ee9d474f921e4897fc959a66,114,95,19,North America,25,692.48
ac2da1d0eda543a5a9539357f460ec99,81,29,52,Europe,22,614.05
ac2db5d2357a47c684977495eea8a3c1,155,112,43,North America,18,558.83
ac2e5b044db44d84b1e8e21a566f382d,362,352,10,South America,20,1462.47
ac2e7f8da50047b88c8fc7f089cfd744,122,80,42,Africa,26,493.99
ac2f34055ee54e77bdedba47b3479775,361,343,18,Oceania,19,2808.99
ac325b69d5fa4983bab879e49edde35b,127,83,44,Oceania,20,736.78
ac35570a680945789dcf4e3dd3cfff46,344,311,33,South America,17,2683.84
ac3593fdd873472482504df9173a4823,164,126,38,Africa,16,1008.69
ac35b5e7d0a940ce8f3df9aa5c6d6bef,267,231,36,Asia,22,1718.1
ac36078c15ce48b5a3e39e63cef215a6,260,203,57,Oceania,24,1328.3
ac37707ed9604af193f6ba054b9f6a3c,280,225,55,North America,23,1585.4
ac377210205f40b8b4994e6e5023d6ef,270,234,36,South America,18,2394.85
ac381450f7da490e98ba588bc2f2d76e,334,280,54,North America,17,1965.43
ac39285ea7634d198e091f300473a9a7,236,208,28,Oceania,19,1553.34
ac3ac78892ba49e993fa77038676ab20,201,177,24,Oceania,20,1439.24
ac3d4651e26940a4b63301d52d079cf8,128,97,31,Europe,22,1336.81
ac3e8b96e33b4350b100a6c63021a371,365,348,17,Asia,19,1773.34
ac43cace63fc43f9ab41624f51082f66,54,18,36,Oceania,21,457.99
ac44cbe0e7854c75a8cf187f8743f723,349,296,53,North America,25,1554.17
ac48e11a313b453599483576189736a3,152,113,39,Oceania,20,956.07
ac4bb00b5f204e20a0ef231dbd546374,177,151,26,Europe,24,1207.96
ac4c08afb47d4538aac50f0ed971ac44,365,365,0,North America,16,3157.02
ac4c456f414c4d76a6fd98d513621f10,363,342,21,North America,17,1841.95
ac4da4aa1a034c85b38d168c9586c591,270,223,47,North America,27,2169.03
ac4dbe7469024818b3c3f8e141ae72d2,64,32,32,Oceania,19,198.3
ac4faaf274054ba4b187a8003d92d623,97,63,34,South America,19,600.5
ac511d5d7f1246fba89dea5e27f1e8b7,169,146,23,Oceania,19,1086.19
ac561ca6a23f4f0ca50fe90978947089,271,225,46,South America,18,1992.51
ac5739fe24f641588c45aeee1567b653,362,356,6,Oceania,18,3334.25
ac57759bc5b849dab75ccaaf17e02b82,51,30,21,Europe,20,197.63
ac5af43ab27c48fc851849b732bdf066,315,265,50,North America,20,1739.18
ac5df55623b543fea1582e10741eed30,365,339,26,North America,20,2317.34
ac5f47f0277f4f449ca99c0baeacb7ca,228,197,31,Europe,19,1855.06
ac6041b7927543a090f3da5537c5e1ae,168,129,39,Asia,22,1363.92
ac608893bb83471f9945482a31fd4ce1,147,108,39,South America,16,1060.69
ac6318df5eb346f48ef31423e2ee7850,323,277,46,Africa,17,2004.7
ac64ee3f81fa43a8b7eb0bbaca8bcc64,365,362,3,North America,18,2555.34
ac66d5daae0a422085da49129420ce86,344,290,54,Oceania,19,1501.8
ac68312ab851440ab33af5473b44342b,205,168,37,South America,20,1709.39
ac69b4bcbfac4509903c35c9e2a4ead7,215,186,29,Asia,26,1317.22
ac6a2eacfa104dd6aba1a8f30a3f3ff0,156,112,44,Oceania,22,675.76
ac6a8831d208419d97cc1adbabe5623d,71,29,42,Oceania,26,294.85
ac6b98b09c2c493e95c7f5f52d84b2a4,334,292,42,Africa,20,1993.82
ac6c483b959949aaa40d49d2a0bbcb2b,290,248,42,North America,18,1975.88
ac6cdb8687cd4b3c9d9cdabfe920f605,167,109,58,Africa,21,737.36
ac6e27cfb68648bbb8a21d492e67ce65,171,133,38,Europe,20,1210.18
ac71b57f8790482ab1df2aa9f8f911e1,310,273,37,Asia,17,2259
ac721aa57eb54d42a512085adf4eac57,224,182,42,Asia,25,1095.05
ac7335d979b04ec5870fdca33fa301c9,139,121,18,South America,21,1383.89
ac741255dd214e9b8d56bf9a56a1a9c3,364,363,1,Europe,25,2006.4
ac749f3020334deaafd3d8f806a44ade,325,274,51,Europe,21,2261.67
ac74de71930446109a6c7044c56e6894,274,236,38,Europe,23,1015.04
ac7536cd76544512b58d8882ad022b58,328,278,50,North America,17,1589.94
ac754a8b4eb84d1c92c41cacc8809dcb,234,200,34,Oceania,21,1410.24
ac78441088264108bfb1028a72a32cbb,298,253,45,North America,20,1689.37
ac791a1ec43a4adbb319ce722622aca9,252,216,36,North America,19,1442.13
ac79a8a50f2f42e593bd20717747738d,365,343,22,North America,17,2348.85
ac7d054015774896adebf15c1e4d9e12,357,331,26,Oceania,21,3161.94
ac7e39d3aef94827a89728c23a84cd31,137,91,46,Asia,21,947.4
ac7ead813d504c4499695fd870b7890d,224,171,53,Africa,21,1138.21
ac8350638dd54b19adc1f6818b58fb5d,240,206,34,Asia,27,1267.37
ac83a3a22fee4665974d3057ff87bb71,189,158,31,Oceania,19,1166.98
ac83fdf18bdd4e04915f8d98d1c0fcc3,106,70,36,Asia,21,570.17
ac85b3e1996e4e27a1c21f028db8ae47,286,245,41,Asia,18,2294.64
ac85fba128d849d8b20f17ac50876721,361,323,38,Europe,22,2517.63
ac88e827cb624c1aa07c0ae292a57214,131,76,55,Europe,18,456.1
ac89339de02c419d954716e6bc98e527,67,38,29,Asia,23,274.07
ac89d9db39fa4ea0874328b62dc4ec23,275,234,41,Oceania,22,1537.13
ac8d886eb9684bec9d89e01c26b35604,105,82,23,Oceania,22,760.26
ac8d9789783745229fa749eebcf15878,68,31,37,Africa,21,136.78
ac8dccaa4ac74eaba41414c302914d2f,167,140,27,South America,17,1701.93
ac900cbc91254eb3bd8e034e0467539a,203,157,46,Asia,20,799.45
ac94353e6fff4738abe58e6fb3cd1e71,87,37,50,South America,16,300.99
ac95de0e82394c379372e91e3b448945,128,107,21,Oceania,24,943.64
ac97319f44274a6f9a23128cb42082dc,101,54,47,North America,20,653.85
ac99c181c9694b8a9997e35ca818f543,189,163,26,Africa,22,1621.64
ac9aca0a735b4c908335f7a648326fc2,57,4,53,Europe,20,363.71
ac9adb074c92482a83ef733ec177c34e,97,55,42,Asia,22,820.89
ac9c0ad11a46446ebe9d0fe071e82e96,85,43,42,Oceania,23,723.48
ac9c0c5d8a4a4b41aa78ed4451dfd99c,43,10,33,Oceania,17,586.9
ac9d89b036924db99df87c230e42f390,249,221,28,Europe,20,1583.47
aca0933da97041da9d43473300395373,364,325,39,North America,22,2423.26
aca3aef0c39f41ff9e20ac846d1e1079,192,163,29,North America,20,1717.71
aca4d878ddea400484113e4c1c66b350,74,36,38,Oceania,14,378.95
aca4dc2ee7224d5a88b39f6692912936,137,100,37,Europe,20,800.82
aca60d10022845ad9e3e105af0275b34,365,360,5,Europe,21,3430.8
aca6543f97a24f6ab3694217747537b2,163,113,50,Africa,21,878.15
aca655c795054e71b7c31cd3f4d702c0,221,188,33,Africa,20,1679.03
aca6aaef12864373a3e1e8ea98eecabe,263,214,49,South America,15,1192.49
aca8a21aed9c47858de57d9bfb073a40,132,102,30,Europe,23,1034.59
acaa2ecc6c5f4faeb7ddfc2cf3cc4e95,337,299,38,Europe,27,2706.22
acaeafaec9ae498bbb37519ec68e88cd,161,133,28,Europe,16,771.34
acb1fd90c2d54d9695e50723d2cc7f89,92,59,33,Europe,22,657.05
acb25d3e3ef54f60a39efce8bc801eef,126,70,56,South America,22,594.93
acb3306139ce41418e00b82e3a036254,324,277,47,Africa,14,2443.66
acb745096400463e94634bcf74b2be7f,46,13,33,Europe,21,177.84
acb7dd825a484fefa490d17ba20741eb,266,242,24,Oceania,18,1931.4
acb7ed2141b14c07afac9d87ad9a34f3,341,297,44,North America,23,2586.96
acb80819b0654804945b5683d98ed9a6,317,271,46,North America,19,1308.49
acb8dbfcdd944424ada7fb29b61d1c0c,353,327,26,Africa,17,2277.57
acb9bee418b14eb48363bd16ab56efb1,247,191,56,Europe,23,1396.63
acbb72f5fcb446bd891923585af690f2,232,189,43,Africa,19,2284.41
acbd5592941342238764ca71f1e78ab6,125,68,57,Africa,18,458.06
acbdc854f6ae44838c3634f5e4038bec,365,345,20,North America,21,1973.9
acc2fd3660ee4f328de42b2c55901ef0,135,96,39,Oceania,15,669.77
acc58b2d628a493ebae8ea62eaf82efe,102,64,38,Africa,20,626.49
acc8cae026f44abc9872bc7edafc8b6a,365,315,50,Europe,15,1714.48
accad38033844174b07678931fe0914d,92,38,54,North America,20,703.52
accb39c712264f05a844ca4e3edae8ff,106,55,51,Asia,28,630.53
accb612ea8284f7084cac7a06cf19843,105,69,36,Oceania,22,389.19
accd0029096841cdb576fe1f9f3ea1c1,262,226,36,Europe,22,1885.93
accdcd57cd4d40f6a332b68bef4befa9,365,328,37,Africa,20,1803.58
acce26e248e34aa3a6f2b15c7d40f222,95,41,54,Oceania,17,284.82
acce37c379654a64b2b502dd76d9d263,363,352,11,North America,22,2452.14
accfa3ed217e467b9e1b5694ff735807,365,344,21,Asia,17,2926.4
acd251a7e34c4899b949c190a26dd89d,138,98,40,Oceania,23,996.93
acd36bba615548238f81dbee04256063,143,105,38,Oceania,20,849.02
acd4c60ce4f5474ab0280a95b384ded5,331,295,36,North America,23,2156.71
acd8115d4851428dadd9868a06eaa6e9,271,227,44,North America,24,1665.15
acd87d968eaf47179ab37556b7bd347d,261,225,36,Europe,16,1194.59
acda2440e9d3491582757d728af1bce1,105,57,48,Oceania,26,454.84
acdb9b39ea8842c888da4a8abf96e3f2,326,295,31,Africa,20,1990.6
acdbb69a0d9542b2a944ac815ffbbbab,50,21,29,Asia,18,505.6
acdc45f729ba4f69b26083db6d2fd89d,108,65,43,South America,16,790.3
acdcfe9a0a1f4bed8831071d6e57169a,227,203,24,Asia,17,1937.72
acddff7bb60b487ba582987e7e635614,224,199,25,Africa,22,1721.19
acde2f7bfac644748be96aa644d64bac,122,71,51,North America,16,705.13
acdfe07f77f94bc594b1493b929d7bf7,193,170,23,South America,18,1785.24
ace00faa77ef49baa7e3a3ee0199fba7,171,128,43,Oceania,18,1110.66
ace09f17346f447ba7302b6a7ea49883,332,306,26,Asia,20,3219.23
ace0dd669c5740929a189c296fecf403,58,21,37,South America,25,357.51
ace20d20a85a4335a2688414f82d2cc4,365,358,7,Oceania,15,2995.85
ace216b4d5774a57985583f2e94f6706,139,103,36,Africa,21,1154.93
ace28fe5dcd248ea80149de2eb8c6e77,52,29,23,Asia,20,212.51
ace2eee73edf4e6295bb055e7f93182b,75,41,34,Europe,20,560.72
ace40371de294a639168ff9f83345b85,245,194,51,North America,24,1659.74
ace4b954d4ad4b669353a71c28db5259,158,121,37,Europe,27,849.45
ace4d4fd0d2843028a7273a855ea3e7d,136,89,47,North America,21,857.61
ace7d84bf870414abda26c67fb0548c0,323,297,26,Asia,25,2694.15
ace83ba7de544ed1b733f2cc4251ae7d,207,157,50,Europe,22,1541.69
ace87592463e41a6b7e9c2902f81204b,285,234,51,North America,19,1754.87
ace984138abd4cb1939771dd989b3122,252,200,52,Oceania,22,1344.4
ace99b00ea344648a4cde0ec3b918fe3,266,224,42,North America,18,1204.04
aced984001de482ca11c332ffd3a1545,87,47,40,Europe,21,201.73
acee97ad282f42bba172fe08ebe5ff0b,128,86,42,Asia,14,988.32
acefd1df1d2d40c4bbb6cf700986e359,365,363,2,Africa,19,1358.11
aceff0b8013147d88ea6e6039e1ab597,364,337,27,North America,20,3488.65
acf08d00810b4a0a9040a685328d6d8d,218,186,32,Europe,17,1838.42
acf0aeee1b1b4856aada496db472e170,322,291,31,Oceania,20,1722.48
acf23c9ece4c429a82a3157d5906d1e8,296,266,30,North America,19,1509.91
acf6145df0df46fd902bbdd2c4d56994,353,316,37,Oceania,20,2949.18
acf643206a6142f4a6a1615327184213,365,351,14,South America,25,3895.56
acf657c0aaf943bc9e851e8201aca053,364,356,8,Europe,22,2100.62
acf6efd8ad57413383860133a66079d5,131,83,48,Europe,15,464.91
acf77bc56b5246abbe605178b834766c,89,41,48,Africa,20,494.94
acf82684a2114b228bd6b88965ee5db5,118,66,52,South America,25,665.13
acf9456e234a4192b53631e9645a703c,50,29,21,Europe,18,417.68
acfc7fdb6437449d91d4ceb699695be6,279,234,45,North America,15,1620.2
acfe63a9813744eab114746b5fb3f4d0,327,288,39,Oceania,22,1909.24
acff3e041f154d91b2d64d22e6cdc807,137,102,35,Africa,25,829.62
ad001fab0e0344cbb79e95c44c752c76,363,323,40,Oceania,20,1609.86
ad008535f4b14f449de9843ec0c4ae61,152,126,26,Europe,23,1358.23
ad03cedb78b049fbad148483a2cc16e6,310,287,23,Asia,20,1825.15
ad052d9e718342f78dd666ac09cdec4a,100,63,37,South America,24,924.39
ad0850d5ea134c1a9fd4eb054197bffc,169,149,20,Africa,19,1526.36
ad08c406e7d641539f992f6ff7fb2a80,223,185,38,Asia,22,1128.3
ad0a875b885141cf8ecddb022d9bd6ca,365,352,13,North America,22,2293.43
ad0b303f6a8648fe9661597871927336,119,78,41,Oceania,17,484.23
ad0ceec30f0c432181403ba8be65c125,362,339,23,South America,20,2839.1
ad105fc8edac4b0a9215cb4bfcc08412,334,304,30,North America,19,2111.29
ad1096f77a9249bfa51de6b058722c1c,104,64,40,Oceania,13,788.32
ad126d94cde44583a235a5fc6af37cb6,176,151,25,Africa,15,1720.43
ad1377767a8a458483bee23f173fac3d,65,36,29,Oceania,23,483.35
ad14c207b42443f2a0da2bf6d448e3f8,93,40,53,North America,22,165.23
ad14d3e5db3f4503afe9f4382b3d35ec,152,121,31,North America,21,1055.58
ad16081d7bb4401588cab58be566ea3d,105,90,15,Oceania,23,634.16
ad1897bd0fe74f46a8c752e583d3bd45,116,71,45,North America,21,897.94
ad1b4ac6579a4b6187fde8f0955e759a,204,169,35,Africa,21,1837.73
ad1bb581397c4bf2a8faea1a5f2924fd,363,352,11,Africa,21,2887.28
ad1bd1d7dcac4dc984ac996453f0b4a3,299,252,47,South America,18,1232.67
ad2137f5abca43369d1f8eb33904a6b0,185,157,28,Oceania,17,1433.07
ad22f34d394e486b8036ead06c13bb14,322,269,53,North America,19,2072.7
ad238ebdc50c48bcbf7c48d36ba91a29,48,5,43,Asia,20,110.66
ad2469b831174c56943ae4f15a30f1a4,52,24,28,North America,18,623.94
ad24c8ca55b54cc097f51499b6fd6d08,199,144,55,Oceania,21,1330.92
ad25972f8c1f45cca89e9f13391a7586,193,144,49,North America,21,1199.64
ad28d200935e4d02bf4fb3d0d7b58469,62,17,45,Asia,14,175.83
ad2a0db9ecff4d9a98760b595e3767b7,364,344,20,Europe,24,2452.36
ad2b8880d6344e82892c9e3de37e4df2,357,332,25,Europe,21,3000.7
ad2cc588ac114303af0026f059d71a21,147,115,32,South America,17,1119.62
ad2e8d13ee5f4a96be942166c3a0e266,176,145,31,Europe,23,1276.23
ad31915139504b74a89c2857de1e4751,274,235,39,North America,23,1950.18
ad3261f103bf4a7388d5eda7629d5bdd,62,15,47,Oceania,20,321.82
ad33cd82be10476b974af43cc6307da1,326,286,40,Oceania,22,2547.12
ad3599fe682a41e88f5ae7500cc30654,102,58,44,North America,17,1009.99
ad35ad9b42c641a69985a7c68858d6d2,205,160,45,North America,18,1282.44
ad35f67e246c454faef87c7dc679b56e,341,294,47,North America,25,1893.64
ad364a05c18442bda949b85c29452076,120,67,53,South America,18,583.86
ad3791e845a04f6a89dc13166f076e5a,180,120,60,South America,24,1323.03
ad3a2365dfda43a09f913921293bba2e,365,313,52,Africa,19,1488.16
ad3ba6eeb62a47f18adadabd77a5c700,262,212,50,Asia,18,1274.65
ad3d544e4b4c4d96ac02d36ce3c2603b,197,138,59,South America,20,1619.03
ad3e6f6becf449f3a3099f2af27f7894,190,154,36,South America,24,1314.07
ad3e79e2cefc4682a71c37512a611b4e,99,65,34,Oceania,19,660.07
ad415a34a6084527ab2cf63a2da36a1e,172,128,44,South America,24,946.96
ad419da8a194448a93c53a8b0c2bde14,365,356,9,Africa,22,2118.27
ad41c692f6f94601b533225de8e1abb8,115,89,26,South America,23,816.84
ad457596052d49e2afd28b6dc1300ee4,59,11,48,North America,18,348.06
ad459a2f2fe84e7aa3a02ffccecb79ee,139,101,38,Europe,21,1105.98
ad45ee3a2f114415830571d74261583f,242,191,51,Oceania,19,1399.57
ad46a69657474b60bfcb1e0679bf09a5,78,52,26,Asia,21,563.39
ad46c74317a94f56904675d6a1da5ac5,292,263,29,Africa,15,2143.4
ad48e03d3ab345e18dd050d9481bdcf2,281,250,31,North America,22,1929.86
ad492d49d2274e22b82cb0f9ab83afa3,274,257,17,South America,18,1739.61
ad55e734d7294202b656995dba9673a5,89,63,26,Asia,20,633.73
ad560062bc4a48009f4e924df73c9898,218,164,54,Europe,20,1303.23
ad57575ec963436bb96322257c416dfa,365,350,15,Africa,19,2824.58
ad577219ff364253ad8672d0ae9b0682,262,212,50,North America,15,1257.68
ad5ab44d32e94776b5478aad24879f39,364,329,35,North America,24,1629.47
ad5b7b1ac7384c19a9900ac74cdfe63a,64,26,38,South America,18,482.28
ad5bfa6540a24c779672598583bb7a50,44,1,43,South America,20,235.94
ad5d50c18d94413a9339937ff4e15e51,363,352,11,Europe,20,2325.16
ad5dc6ebd14247518dfb413ec2d4d49c,365,357,8,Africa,20,2154.26
ad5e745ca21e4a64bdea633e87d13828,284,262,22,Africa,18,2543.6
ad60adf0f245413b8c649427a61ea368,309,286,23,Africa,17,2138.6
ad62540b72844bf4a80347add73f391d,41,3,38,Oceania,19,258.28
ad634bbbd9e84ccd8dfaf2f5d43416ed,277,248,29,Africa,19,2349.76
ad65143f41164939b7df9f47a79cd576,160,129,31,North America,21,1164.78
ad65c710fe7d4dc2ab26e0396f07cc83,101,57,44,South America,23,624.79
ad65f5852c9c49faaab5d24f640f9534,58,38,20,Europe,21,813.12
ad67783b6f824e419836891180184b92,198,155,43,Asia,18,1321.75
ad68892eb5ba4e80815231dc828ce792,365,337,28,Africa,18,3029.29
ad6b3811e26e49ccb431aa4750a0ab33,319,265,54,Oceania,21,1418.54
ad6b40d9f1d340988b75a73c47b720d7,332,291,41,North America,21,1672.32
ad6cfca41eb647fdbce7faf276a92b2c,294,254,40,Europe,17,1775.44
ad6d85141a8247bcb2cb69d5f99be874,284,228,56,North America,20,1358.27
ad6f7cbb36f7429eb13b87e2d5154d78,341,302,39,North America,18,1723.51
ad72ad4a02e74f05b1659d54adafe7d9,331,270,61,South America,21,1620.02
ad75bed03cab4e8d8aa85189716ce0ee,327,288,39,Asia,20,2182.47
ad7658af365745ea902c574dc22d1664,50,5,45,Oceania,17,409.19
ad78baea2854475cbefcb4d6ed53213b,194,157,37,Oceania,23,1398.17
ad79814525144032838cd98d6149b198,177,118,59,Europe,14,817.1
ad7a17c9bd924cb88bf7c40a09a3c8b0,314,275,39,Europe,22,2271.78
ad7e261b7ed4457cac2ececc733046b6,229,203,26,Africa,16,1572.64
ad7fd7e4915f4af4bee602e340cd5bd9,48,10,38,South America,21,231.85
ad805a142c7045e9a9c9939d4cd4c4a0,206,177,29,North America,19,1672.3
ad81eb4819e442eabcb951033a27e7f5,175,128,47,Asia,20,524.43
ad81f4d94ab0497197a491950bb3139a,294,278,16,Africa,20,1899.57
ad821764faf849428c8f889805111d25,335,311,24,Europe,21,2312.35
ad85104ee9694748a1adc2b7479c2608,242,205,37,South America,21,1014.16
ad868110816f4606a8aa1edc8d7d64a7,121,98,23,South America,21,509.45
ad86db4c2d864a10b2f4f3fd7e6b90e0,165,133,32,Asia,17,1326.26
ad8a21d490c241939c393b98df3244f2,363,337,26,North America,26,2421.3
ad8a414fd229409b9331f416d1280669,94,46,48,Asia,21,546.93
ad8b7cca580f4170a6a1d35247e4865d,255,213,42,Asia,19,1930.16
ad8bd2d43d0b409da3d47216f2770e74,253,220,33,South America,17,1446.06
ad8d4819c9c84e11ac10e40899667fe2,81,59,22,South America,15,658.57
ad8dddfc57ec46209f225acc5484df29,354,342,12,Africa,20,2142.69
ad8f3c2f5ca74e2b91b6f3c21a4ae3e9,201,154,47,Africa,25,964.47
ad915478b3124b34a43a6225483b7692,217,187,30,Africa,26,1545.91
ad9c2d40a9404509b10ae59740d9b683,55,26,29,South America,23,200.45
ad9c8db39c58410caf1673c31b32d715,86,53,33,South America,18,560
ad9f383865304ca984259ddaa6eb74fd,219,172,47,Asia,19,1732.65
ada023ec12e6441a9362b4e6ea8b5322,132,106,26,Africa,23,1170.76
ada20161a6c9444aaec42a9436cf6b54,179,135,44,Oceania,22,1636.97
ada32a1260d04d1990dbc7709a7c5053,98,57,41,Europe,18,712.18
ada5f4d48a554b6f9a1e1936820228f7,339,314,25,Europe,16,2877.3
ada61ba9c853415ca77182bbfb22fabc,161,145,16,Oceania,21,1516.92
ada8e9d0cb4443a9988b0b951109b1f1,305,265,40,Africa,27,2121.6
ada947507d3a42d49e4014fa7b5562ad,361,326,35,North America,19,2213.89
adac4b1545e84030b45400c0c1bed84e,250,207,43,South America,20,1507.24
adac61b652db4c4dade40554e511e3ff,115,81,34,Oceania,17,411.17
adacf307575b409f8085ac4342e6a813,303,278,25,Europe,19,2427.99
adaf69becc0b40b49af8d61d393dc169,130,107,23,North America,19,1032.69
adb10f861d8e437db27335efae6082ec,43,18,25,Africa,15,502.39
adb21d3f54ea4f71a73aac2c1b30911c,155,112,43,South America,23,426.48
adb72324067340fe933ee0bc47544f80,197,171,26,Asia,17,2080.72
adb8f20c016c489ba41b22ce91ee6db7,121,99,22,Africa,15,883.02
adb9fcdbd64648999a51eb7aeefca199,329,299,30,Africa,22,2519.57
adbb4456be824704a31361d3ed1c649e,144,109,35,Africa,21,715.81
adbbf4f249a749b08ab859a884d70c92,160,126,34,North America,25,1716.19
adbc5f424f3443069d13d768963d6b0f,114,67,47,Europe,22,464.23
adbca7a63bfc4eceb84901ff691ceb3b,348,308,40,Oceania,19,2369.11
adbd5705de6448c7b81b343a44bcb71f,150,124,26,Asia,17,1113.91
adbeb0844d6d4ca6b767a43e5123c6f6,120,108,12,Asia,28,633.15
adc2288976754a239b44929b1f3550f5,116,58,58,Europe,18,793.77
adc25c30ec214753b1f159650855c2c5,256,217,39,North America,22,1865.64
adc26bde3f6c4ddf9507e1c9af76abbd,362,359,3,South America,17,3151.33
adc2ec1060ec4fd9afa295a41b823ee4,89,37,52,Asia,13,573.3
adc74f29cd574777a7efde3604530a42,218,194,24,Asia,13,1470.04
adc77c4c29f542a6b15f15004160937a,318,294,24,South America,19,2663.29
adc7a13a123c4fc794efeb7f0cd4bc48,189,161,28,Asia,18,1102.51
adc884c29c19407ba909daca65cc58fe,207,174,33,North America,20,1758
adc8d2a373d94a63a9a36f220fca06ee,50,12,38,Asia,15,370.8
adc9655271c244f98353abc100c8e5cd,199,163,36,Africa,21,1213.63
adc9df3bec4d4adcad2ddec8985c7c3d,71,32,39,Europe,22,86.93
adca1d8dd3de42689bf94465a2c2532c,275,236,39,South America,18,2332.43
adcb2af13cd84c929e8a259c7fac1330,67,41,26,Asia,20,710.59
adcbaa68cf5942f79ce66999f154855d,365,333,32,North America,16,2467.64
adcc0b79ce9b4e6694d92364beff8c4f,142,99,43,Oceania,23,1090.65
add651c9be4141819355b54a0268aaeb,217,177,40,Asia,25,626.23
add69aab986d4050b728c147ea7d0a6e,321,289,32,South America,23,2153.71
add955e577d14751955c216b676a243e,263,223,40,North America,25,1940.47
addaaaeb837843538c98fb5e57343e42,79,48,31,Asia,18,690.55
addbb6539a084f139e917e77b0844d68,123,81,42,North America,20,590.53
ade13bd94421474ebacf5f8095e270f8,49,11,38,Oceania,19,233.36
ade1e032ec0141f19a938c022b25b5e2,188,160,28,South America,17,1179.53
ade426fb93794c39b46d4deda2534083,119,92,27,Europe,18,818
ade6066762a74b29bf94bab73a52c06d,300,254,46,Oceania,21,1636.96
ade863040a2e4915bcd522a5e5356b34,172,117,55,Africa,18,718.24
ade86fae6c454b019c50d02349133dad,231,199,32,Europe,19,1624.09
ade8c7c0e193495ca967dc46678dad1a,362,340,22,Europe,10,3141
adeaf834f744416787111fa8288229fe,176,162,14,South America,12,1332.66
adeb80250321412ba7cd0cf37984ade3,287,253,34,Europe,20,2388.21
adecc147eec542b7a49e62a050ad7c7d,89,34,55,Europe,21,736.7
adeda7eacef548838b684e6556d3441d,335,283,52,Africa,24,2134.61
adeddc21cf884976a4b7a3c2140d1728,364,345,19,Europe,20,2390.46
adeedf9474204e2cb78226ef8225300c,249,224,25,Europe,20,1549.9
adf01db101ad45c59874f99cbc278a91,105,47,58,North America,21,419.66
adf0d3d8650046f6b9486aac434a7d1e,244,206,38,North America,18,1731.47
adf16c75536747c98b016d86761e5b98,332,286,46,North America,24,1548.75
adf23709088d45f3924317883fb3d186,73,41,32,Asia,18,538.7
adf27e546d3c4148a5b99d51d0801a02,220,181,39,Oceania,22,831.57
adf2a3dc5f5245858b73d0e36e0087ce,67,52,15,Africa,18,581.7
adf3ea75114442e893ddf0ee87b70368,246,199,47,Africa,21,985.76
adf43754bc0d462c832d42f09475a30e,160,135,25,South America,21,1525.16
adf6e5f95f87467c9410c2e2bb89e5be,271,223,48,Oceania,18,1442.35
adf791a4cd0f405cbaad2694691ef87f,358,328,30,Europe,17,2797.5
adf950e0233d4040888d1eb8f02bb07e,248,201,47,North America,18,1511.21
adfbf02b297b4e89928984d08554317b,66,35,31,North America,17,438.29
adfcab5d5afe4dd2a57d095267d8457e,109,82,27,Europe,18,611.37
adfd8dab727442b48abdfa35e8a0bad3,322,290,32,Africa,18,2954.57
adfe33434aae44cab3ad748d5dbc180c,363,343,20,Oceania,15,2050.41
adfee7bffdb14b8187291f7362113fb0,342,298,44,South America,22,871.47
ae0037922fcf46f0b7e959fdf1447b7c,230,176,54,South America,17,900.54
ae0485f22edd46b191dd39a84e9db0fa,140,89,51,Asia,20,772.13
ae08bfc7abc24d6baf1ad4df04904462,299,274,25,Africa,19,2202.43
ae0a6758ed494512a05103323500436d,258,237,21,South America,23,1833.74
ae0acd10f7384ae8bc4c34abd1bbccfc,306,264,42,North America,19,1915.07
ae0e3e3e9bf442be8c1d65146da626a8,182,145,37,North America,20,2098.07
ae0eff946ac44d98a1c33a84fa7245c9,289,262,27,Africa,18,1845.33
ae10b7ba11f145fda766f04903bddef1,261,212,49,South America,18,1619.78
ae11e0d73e1d480b94958cc45dd0c922,330,293,37,Oceania,25,2195.39
ae12433061ad41d0a35ab8b19832acdf,363,321,42,South America,20,2482.5
ae14bc5a856648eba548f8376b26e833,236,203,33,South America,20,2112.37
ae19893697e8479f81089febd74c6b73,176,135,41,Africa,21,1754.49
ae19f66b173949a8a88a8af8c91d9c6c,162,124,38,Oceania,20,1327.96
ae1c7a7c111c4173acb30b8a64132678,309,281,28,South America,26,1819.53
ae1d06e1402143f6945022ca78fa8228,118,80,38,Asia,22,900.22
ae1d6d1bc3494b7485377babd0116821,70,33,37,Europe,22,218.21
ae1f6205d30643519baf8b1a71690cb4,351,308,43,South America,21,2035.03
ae1ffc1f52b64f43b6036d0e26b88fe7,98,71,27,Europe,18,589.65
ae2022bcbd2b4a8bb94c862e6f828e20,298,261,37,Europe,20,1694.02
ae23691f88b34cfc92766989d52fe8ac,295,255,40,Africa,22,1941.15
ae29c2ff897f4eafb03919a484075a96,92,63,29,Africa,18,700.72
ae2ad357c83e435abcefcaf12cacc748,358,302,56,Oceania,26,1528.05
ae2ba3034f48402fa22f5849dcf1ce55,166,121,45,North America,24,811.94
ae2ca4c0a0204e5da3d2b9bed5e26e2a,134,117,17,Europe,23,1291.7
ae2dcdf202d842e39b0e680b8ddec0e1,325,298,27,South America,19,2522.29
ae3205f002a3484385d9f68df1bca33e,365,353,12,North America,19,2370.41
ae32e086a1d84422a42e7d4edeab074d,87,42,45,South America,24,324.65
ae33623f48f64a1eaeb7c656077c74de,363,309,54,Africa,22,1248.03
ae34d829f0fe4fe7be004ebbefcba7fa,72,16,56,Asia,16,537.93
ae34f009b4d84c35a84ee9a051b85fc2,327,299,28,Asia,14,3247.59
ae35ce5904854b55bd4bae7fa86a1016,338,287,51,Asia,14,1685.08
ae37e7949fb64256afe7d68c6b675986,111,67,44,South America,22,676.72
ae3842254c3248578bad9476177c9f54,92,45,47,Africa,18,369.44
ae39fa77b8d54f4b904137637cda7235,343,320,23,Europe,20,2612.44
ae3aaab418c8443db35837038fbccba0,363,346,17,North America,22,2413.4
ae3ae6f5314a426094e4adc184474120,256,232,24,Europe,20,1583.51
ae3ae8415cd24e5b83780bf04b2729f6,303,257,46,Asia,20,1666.86
ae3d024449964d63a6938913425877d4,182,142,40,Europe,21,1243.94
ae3e12c458304510a3c970fc0672f909,230,209,21,Africa,23,2310.92
ae3e8b37df6c4636b28c634162587581,98,75,23,Africa,21,521.84
ae402922fd64469991f5424b87062071,197,141,56,Oceania,22,522.38
ae4056be1c4443f8a5f4f2b96c6350bb,312,257,55,Africa,22,1192.31
ae41b2b8fe1d4ad9bd60d7e294dd5f35,355,308,47,North America,17,2227.26
ae46f6e7b800484fa3fbd8082d54841e,303,262,41,South America,17,1528.03
ae495feaba6948ab80c108580a6d7004,110,83,27,Europe,24,790.91
ae49c11185314b85a067bc881e39e0bf,158,132,26,South America,19,978
ae4a7188c07341dd81e45b82afe529d0,272,224,48,Oceania,18,1418.38
ae4aa6bbae4a4011a1a2d26d057af1a6,133,89,44,Europe,23,925.84
ae4d4ccc4d924b8bb72ee8f5a4f5a6d2,302,254,48,North America,22,1516.17
ae4da7a165014838bb90c6ed38f21545,173,153,20,North America,19,1996.46
ae51df6caa7245b89d8ad21704445256,313,279,34,North America,24,2031.06
ae52de3dee244545ad781bd5fae950d4,309,289,20,South America,21,2427.29
ae54358ef3274d55aa1022fcb01f5752,364,358,6,South America,13,1989.89
ae54cf491edc45d38666915c2256cf08,233,214,19,North America,14,1814.64
ae5613e899ae4247b9f6a61f4aebe410,104,85,19,Oceania,19,516.04
ae574e69aa7d4021a2ab2f6cfed2097b,235,186,49,South America,17,1925.58
ae57fa69d03d4397b836f6c6ee5e2501,38,7,31,Europe,21,591.25
ae5a293a4a6e4bdd81918e37db650476,112,91,21,Asia,25,870.11
ae5ea4f9c9c448c7b08e46f5fd250177,364,339,25,South America,15,3549.11
ae6319eb161540dea97c23df1067436d,365,339,26,Africa,20,3050.96
ae64518717e44c3298b7544592ca9cbd,151,94,57,Asia,23,889.24
ae657de59b7144eb8c7cf0a48de5d5ae,138,99,39,North America,23,777.79
ae666e0a8a66487099c9edd6c206119f,352,326,26,North America,20,3267.99
ae690fc7d0de418dac1479bc80b2f33f,152,102,50,North America,20,974.25
ae69bc698d69435bae62201d3a0b8a39,104,71,33,North America,22,904.75
ae69d9ad8e40485f9c7171b5acf3ce44,193,139,54,Oceania,25,793.48
ae6a5912ee76478790a2bf4a8cc48de8,145,96,49,Africa,20,484.46
ae6b90edf77f4e83b552eca863840a12,139,107,32,Asia,18,682.27
ae6e1562216b49eea3a0867afb410e8e,60,24,36,Oceania,20,435.37
ae6ea92e2be745ba83335450e94157d7,125,100,25,Oceania,16,1375.73
ae6edcb94c9642edb5b2f04f14f286f0,290,265,25,Oceania,24,2385.58
ae71d5b223ad456a8abc71d8d04c2bf2,109,64,45,Oceania,20,695
ae73139d0a1749a5ab59ef78ed058a24,38,6,32,North America,20,282.5
ae74f16eaccc4825b9e329ec4940747a,230,191,39,Oceania,22,1546.62
ae75302fadcf4fd28cd79894503ca160,91,71,20,Asia,22,474.94
ae76f0242726426bb38b8cc07f7f5f97,295,257,38,Africa,21,1723.84
ae77270a2f794d6c8fd1719fcea6f4d4,365,359,6,Europe,23,2806.24
ae777072472b4db7b3af34cec28dc270,269,234,35,Africa,23,1737.97
ae791e523598433b97659907685a6d94,84,38,46,Europe,21,658.92
ae795924b47f498cb0d7d05cd4827e90,135,86,49,Africa,18,1126.58
ae7a4d067e8b45368aa3fb5c336be2f0,146,112,34,Africa,22,601.91
ae7a7e105bbd4d46918a8b8e2556fc52,213,183,30,North America,18,1396.98
ae7c1ad3d3c14eca8b4e10e8e8915654,361,325,36,Africa,19,2506.56
ae7ccb71a3fa40069f3f8d02a1cb0df5,193,147,46,South America,23,961.33
ae7e79037a54463ab7ecf5c6471f001e,78,24,54,Africa,23,554.88
ae7eb38a3bd0433e95a9d2f0aa21a61e,228,201,27,Asia,20,1259.4
ae80bd7c074c4cd0a108c77e3dc5f5de,312,290,22,South America,17,2545.87
ae82d14fa0b74530bb85bdf6538ce134,309,277,32,North America,23,1963.1
ae83388ad1664e4cb5d74b363af41424,305,254,51,South America,20,1002.24
ae88d92e47584a5abe0fa9dacb58e62b,219,176,43,North America,25,1728.55
ae893193f0e9450dbb80b71e323d80cb,84,32,52,South America,16,303.72
ae8a5d0379894fa2aaf6010857828676,365,350,15,Asia,27,2987.05
ae8bc03a326f4a53a6cb664a62653c1f,315,278,37,Africa,24,2881.89
ae8cbce59e374d8db5ec19e55687b4c3,364,333,31,North America,18,1901.47
ae8cc6036b6140d6800e60ecd06ffe1c,344,297,47,Europe,18,1656.71
ae8cfb5b24be4ca192dfa025d86d4403,225,169,56,South America,19,943.08
ae8e43f87bf24a9e9c97d4a1126521ce,207,159,48,South America,18,889.52
ae8eb0bf21d94f4c985e26553ae7566d,309,286,23,Oceania,23,2395.87
ae90678bc40e4766bd104d81cd8bfd66,37,10,27,South America,20,266.58
ae90769930e54dcc9de61fbf412e44c6,188,151,37,Oceania,18,1182.43
ae9115343eef481f8a43173127cd9240,328,291,37,Europe,20,2038.36
ae92aff1101146369302f4de9a28c9bc,48,17,31,Oceania,24,424.75
ae934f26d7cb45879bc047e06d3f72a1,205,158,47,South America,15,1772.17
ae9bf12d6edf4d5f856a459c2ae5e69f,365,361,4,Africa,23,2142.94
ae9d75511b534d438003718c8bb74c8e,174,135,39,Africa,17,1200.35
ae9e0d0a8cf049698fa2334c14dd5e38,365,332,33,Africa,22,2214.07
ae9ea268ac374644a630a7e9cfd9c7f2,235,215,20,Oceania,22,2212.66
ae9f0d8facd54dac9de56c37982ab417,160,105,55,Europe,17,1293.51
ae9f708fb24a4d8e9beefb37b19c35f7,365,362,3,North America,15,1986.12
aea06aed8f84412fa6a5b3202ab63371,167,126,41,South America,21,913.06
aea0eb0d14bb4521a84ec5885c1d9cd4,365,313,52,South America,19,2115.42
aea1fa4104254e89ab8d73f9b7909ec3,225,168,57,Europe,17,1833.18
aea25ab77a134614a6ffe6471481d881,358,313,45,Africa,23,2560.89
aea3080df17d4826b85422ebdf93e98e,364,318,46,Oceania,20,1512.74
aea3b55aa0c848b7a1f4cd3b26f6ddd0,58,36,22,Africa,22,362.12
aea46436d842479a96187da5b0974807,34,5,29,South America,21,569.21
aea4a253e4b14f59a364b078ac98c708,296,263,33,Africa,25,1784.66
aea5afe927bd4d859e94fde1e4156b52,277,249,28,South America,14,1985.48
aea5fcb6b57a46368cd0e270b552f694,86,61,25,Asia,24,666.28
aea5fe74b66b4913bf097e0081de23a3,274,232,42,Oceania,19,1678.71
aea8d3c45bc8436b894f7f9098168589,230,184,46,Asia,17,796.7
aea8ec9552674033963d6402bcfe2fd0,274,244,30,Asia,21,2424.36
aeaa0c97367f4b04b17af15c0f7d7358,122,103,19,Africa,20,998.85
aeaaa003b25743c3b2045d103da7db4a,363,339,24,Africa,23,2899.56
aeab9506bf4f4609bdcc146c49fea402,72,39,33,Oceania,24,469.39
aeab9ef3bd584b319de36418b8ca40dd,339,302,37,North America,22,2327.69
aeacd2b696624dd9bd3d718c09754740,89,58,31,North America,20,677.86
aeb06dfa43914baf95a09718e0a64e04,84,33,51,Africa,23,699.41
aeb1a898f13d484487a1574ce63f3cdc,226,177,49,North America,21,1268.49
aeb4bb6a44fd405c9520e86c023f47d7,189,173,16,Africa,20,1831.04
aeb6677b035241a0b9d46a8f9c6cd48b,72,51,21,Asia,17,305.42
aeb6b0733c1f40fa9bbde9cb4a758c78,329,305,24,Africa,23,1974.51
aeb8e677c8394acfa0e7ea063482b854,198,172,26,South America,19,1456.14
aeb92050721b47c59137cc0c60925cf4,356,321,35,Africa,19,2574.78
aebb221990d54465908336586fabd53f,66,24,42,Asia,19,373.76
aebc05ade0b343e2b0ac5e4d37592d1c,365,339,26,Europe,21,3298.68
aebe2572cacd4d0086d7ea544554aaec,334,279,55,Africa,20,2047.63
aebea8805bad402f87a1438c7128f0d9,365,360,5,Oceania,16,3621.42
aec169bbc9b0425c91d4d7e4a5498d29,189,139,50,Africa,23,1168.64
aec49497fab04fd1bfe2b52559563e05,164,125,39,Oceania,25,841.99
aec638b0942b4c64bb3527f41955d3f2,76,21,55,South America,13,424.26
aec795e209544156bf94c0e5c7061603,232,177,55,Africa,17,1287.64
aec7b6c7df8941148cc722f628c2ee2e,363,311,52,North America,17,2261.67
aec8b127266245c19e3dc99ac60ff9c1,305,273,32,Africa,21,2956.92
aecc5e8849a34888838e83d1070b85e8,365,319,46,Asia,22,1558.83
aeccdeab9f3a4d2a9cd1c61fb67a5c5e,182,158,24,Europe,18,1105.04
aecd8215f8414f25ab42fa552ad880ad,106,52,54,Africa,16,828.35
aeced6aa63ae43e4828c309b7a21795f,364,347,17,Europe,20,2506.51
aed14f2fa75244568f9ec4834b04bd9d,151,102,49,North America,26,630.96
aed21255350e49d7a0f1ea5fe7a384f7,363,358,5,Oceania,18,2139.43
aed4a10136f446db940d9e7df1b0c3de,249,214,35,North America,23,1444.68
aed4c892eab94528bbadf556cdf79bfb,71,17,54,North America,20,255.92
aed4fcd018704ebfb4ff800d0435d06e,218,177,41,Oceania,23,872.82
aed5512d2418403681ba872e76ac91ba,252,215,37,North America,13,1811.56
aed7964800b149999f91dce197a9b42b,66,8,58,Africa,21,313.84
aed79cfefdba4c029f96c946307643dc,294,275,19,Africa,19,1752.95
aed7a7c0ceac4103b0efdc7464cead16,335,283,52,Oceania,19,2209.63
aed7abe46f8547748d1f6d02403aab2c,204,165,39,South America,17,1176.34
aedb885837a8460bbb6c311068a01aba,100,57,43,Europe,22,535.98
aedd017c3f224201ade887377f0e4937,190,138,52,Asia,24,999.43
aedf3e0e8b4e4ef0b9a0794c29a33e3b,120,74,46,North America,21,874.68
aedf3f4879d543f8883c3d190a5a4c6a,231,210,21,South America,13,2027.45
aedf942876194dcfb221e1a22204c0fe,253,213,40,South America,17,1265.44
aee8d6a0d1964aa48ccd019710965e82,262,233,29,Europe,16,1521.71
aee9691a200d45c3b74ad35f9747a852,226,179,47,Oceania,20,1265.35
aeea34ef4d3242908f381d1a83c726ed,100,81,19,Europe,21,676.89
aeef988e61c645aaa6edf1540a566e61,142,115,27,South America,20,855.1
aeefc8b5a1ce4207ba5fc34d2bf4f29f,218,173,45,South America,21,1247.41
aef1d4f6db3b4de2a07feb2f906cf759,152,124,28,Europe,22,1286.52
aef2894b3ccd4fc2880c654727137e77,238,192,46,North America,19,976.33
aef68f52aae04e829e06c83f4c6b5f58,319,262,57,Europe,21,1663.19
aef6a69b2bff435bbf2f1facdaa3f72d,154,126,28,Asia,17,1113.14
aef7ce2d0fbd4fbeb695205f0538e6c2,364,359,5,Asia,23,3183.79
aef825644ce944749356e671ff2c7507,67,33,34,Asia,21,532.21
aefb3ae70cb8413cbdc7163d05bcb32c,46,19,27,North America,24,179.91
aefd71812e114a3a9de973832c17cf57,364,344,20,Africa,16,1757.73
aefe102672dc482fa62c123b8c723e12,239,201,38,South America,19,2360.89
af0247e43fca428498404c68e605f45f,53,3,50,Africa,23,417.97
af030153c38d45148538cea4d27eb726,269,244,25,Asia,20,1754.52
af04002a938e449586a6050d6cb77399,351,336,15,Asia,18,3135.03
af051e93865747089aa9f8dbdcc0596d,202,162,40,North America,16,1365
af067f8fc3e64981908196a0de31dd1e,363,345,18,North America,19,2576.64
af07021262c54e75991e89537fffb9da,176,155,21,Oceania,20,1253.7
af0752f6b2954abc9295a9b245d9fd4e,211,161,50,South America,23,961.23
af07dac4946b47acb6c4f7e3c2abef37,308,267,41,North America,21,2263.16
af07fbc60b8544b5b86a7b04fd689e3d,161,148,13,North America,19,1848.21
af0abaf1ba34478187e70e318b7cfb50,220,185,35,South America,21,1552.42
af0ad353c71f4da6b4ca06778a167be8,130,84,46,South America,23,819.21
af0b8a2b7ad1415a83a47360d484b9ce,60,32,28,Oceania,23,244.76
af0e559cc1f0451282b29bf28d75e235,330,306,24,South America,19,3721.83
af0f406448b64ac3891a9c064faad535,212,196,16,Asia,25,1330.37
af137d315b4a456eae2a0c033bef6c9a,170,134,36,South America,23,1114.57
af13853a213144f6833ae8cdba20b2cc,361,326,35,Europe,17,2629.52
af140b6aa0cb436faf3575adffa7069f,350,297,53,Europe,21,1960.49
af1490b7c4fd48ff8d89fa719205421a,330,293,37,North America,18,2107.28
af17b38530f8414daf5c32cf005cc63f,362,356,6,Asia,18,2117.2
af1910665fd84712b425811ad81ce84d,363,347,16,Europe,15,1982.68
af19ac8e8fcb4783acd995bbfcba62af,308,257,51,Europe,16,1575.75
af1b7041d9fc428187c02154c4d1974c,270,244,26,Oceania,20,2437.56
af1ea107b9e9400fbbb8bc298daeb732,308,263,45,Africa,19,1284.19
af21ccca6a354a5b91feb18d71a0661f,323,276,47,Oceania,18,1347.38
af227fb4c8294eb8a5c217f9ebfdf4d8,82,51,31,North America,16,530.08
af23ad8acfe54b54a99904c21506fa30,209,175,34,Africa,19,1391.97
af24e9476ecf4a6292db3c836d4e318e,122,98,24,Oceania,17,735.04
af2976fb54c2403eac1d6e1ff267a23b,147,99,48,Europe,21,1081.52
af29cf67463048fdb2eee32da70d6b39,364,351,13,Africa,20,1738.39
af29f80ff58c49199225edb40f1f9fdc,365,352,13,Africa,15,2178.83
af2f8cc1f80b4c25a2d0fa6b82241e46,147,96,51,North America,21,718.07
af2ffc3cbb514e05b22e694021e3c77c,273,229,44,Europe,18,1943.37
af31647d19da4178a0892d38d9d74a9d,153,114,39,South America,21,1003.73
af31e4bc28b04eeca93dee13a3ad157f,365,352,13,South America,19,3057.34
af36f1dc574e49269d85dd0dd3aacd86,243,220,23,Asia,16,2447.2
af3760f606c640f58c97656f760021d4,239,192,47,Oceania,18,908.78
af383a370dcd4f57bc22fd30c2074b7d,130,91,39,South America,20,747.57
af39fd6fb70940789c4177ccff2103b9,83,44,39,Asia,20,916.52
af3abc216b4a45e5bb1b5f81fcb89a5f,164,117,47,Africa,25,1068.13
af3f036af2e34189a0a7ad995377bbd2,365,351,14,Europe,26,1567.17
af40c30330e24900b7668d33c5091233,364,321,43,Oceania,23,2115.11
af4144cb2539442e98a6d1a0ea2d46f1,154,103,51,South America,20,323.15
af41b91d745f4b32a2417fb5ab994fd4,186,173,13,Asia,31,1458.16
af41f9d90a5742fca3f6faecf04519db,123,77,46,Africa,21,719.02
af42dc6652c944feaefc867a5d475560,365,361,4,Africa,16,2640.12
af433a0e6ed3493f84afcb60b709bb96,298,274,24,Africa,24,2161.35
af4620306e054924acfe979fbc0b756a,141,114,27,Europe,18,782.21
af48cb1df77c47b486ca56f323dfaf53,104,57,47,Oceania,19,349.21
af493c4977184846811b29084cc8a7fb,195,156,39,North America,20,1455.02
af49919e3df34e1dbb2856f82a543052,133,107,26,Africa,22,1351.67
af4db47e8c504ad88e917d5fecc47a95,178,131,47,Asia,25,1240.02
af50376770524931999ab4af4a625208,143,122,21,North America,18,1096.29
af529a2f7b484895ba9d0d66fed3a33b,362,338,24,North America,16,2294.41
af5615ebbaec42a688acf8d1b00b67d8,108,55,53,Africa,18,392.17
af5974bc7cfc4abbada506239cea8489,177,151,26,Asia,24,892.63
af59dabbec814edb9edea14a41311c40,166,129,37,South America,21,955.53
af5bad6735db4e0ebb6d6e7402b35d10,332,271,61,South America,12,1635.81
af5eb9beff0f4b388c193e234c1d9f60,291,252,39,Oceania,26,1740.96
af5f223a03a24adf9f784490d246fe42,213,186,27,Africa,20,1763.75
af5ffb21a2524c54a8d548318a4dfdee,364,340,24,North America,26,2793.45
af62369b1ae24bcf978b5dbbf56f27af,233,194,39,South America,18,1299.32
af6287f3bcb64e01aff13747b7b05666,113,73,40,South America,19,1024.14
af6289a89aec4dda98d7c35573d09c81,91,40,51,Oceania,25,293.19
af64d874dfd54e4793a9ad7b04c90992,120,71,49,Africa,21,799.96
af64fbd391924c06bb0c008bdf1f7df8,296,259,37,Europe,16,2184.53
af66a019169c40a29783a94e43d89033,280,257,23,North America,19,1909.69
af6950e0c8bc41c7bb6a552827df204c,322,302,20,Africa,17,2592.5
af6abff210234742983a9e458735d56d,266,243,23,Oceania,16,2338.07
af6bf724b88f41d6b53609370552b800,193,170,23,Oceania,22,1656.75
af6c9b71e0f242198d3f4d1568bb969a,205,160,45,Oceania,18,1589.59
af6e206b90264670bc1250f90beff242,34,6,28,South America,19,279.96
af6f12f51c97479892e5b209392bd9da,228,185,43,South America,18,1120.87
af6fc8a0d32340f7af75a151458bb006,363,350,13,Oceania,21,1723.18
af717abda0ef4c978b00d33c5025dfe9,178,127,51,Europe,14,1413.78
af7244790ad34e76abe7b712589fb87c,273,246,27,South America,21,1857.72
af72f4f3a7ae4837b10a264bde9dcb8b,207,178,29,Asia,23,1172.36
af7304c9d9ed4aada97b86893c503d95,51,26,25,Europe,17,300.35
af74155ee5fd489ca01d16956413903a,365,358,7,Oceania,17,1871.4
af74544a5fe540269b9e356a50f776c3,125,67,58,Asia,19,750.47
af749d1f3d5b4b018cde980f9a62cccb,107,56,51,Oceania,22,264.37
af75281747a2436dbc8b6fbaa429cb36,225,184,41,Asia,23,1249.04
af7635ae8f3b4fddac819ad3348b54c9,125,71,54,Oceania,22,564.83
af769dfef648491a8c4062608c14cb54,56,29,27,Europe,16,587.67
af783a08b26a4c379e4070c9d668eb9e,362,350,12,Asia,15,2686.39
af79630c2946442082322a4cf64157ce,256,219,37,North America,23,1493.59
af7cdcd58e874de99fa6ccfadae52874,341,312,29,Europe,16,2151.3
af7dd1d90908475d8ed118f6c1c13ce6,269,219,50,Oceania,19,1600.71
af7fc129e44d461197ca7ab1b5932623,147,95,52,Africa,18,425.33
af81a259f4674ba2bcb8e623ac0f4269,320,279,41,Asia,23,2366.72
af839c4d346d42cbb64d50a826ae3762,334,291,43,Asia,21,1682.41
af85f62f2d754b6fa385be0499760e8a,178,157,21,Europe,15,1064.69
af87095c86434561a84faea148f1f5a3,60,11,49,South America,15,132.35
af8cdcb1f10e4bdf95d378aa233a24a2,88,42,46,Africa,20,435.56
af8ceb89ffea42b0beccce33dfb134f4,198,153,45,Africa,19,778.74
af8d879913cf457b8f68b78e0c8a4acb,207,183,24,Asia,24,1709.01
af8e53a36b4f4644a6b0e9035dbd171b,147,100,47,Africa,20,1098.43
af8e7c4d412e4921ba8439812b7ff15f,228,199,29,Asia,20,1380.86
af8ecaa8f1cc4675a126e4bd145f00d0,358,321,37,Asia,26,3149
af8ecbbd902648a2a8c3ce7fe8067cda,145,105,40,Africa,19,833.18
af9096cb230b47fab8fcb45f99b559ab,286,248,38,South America,19,1871.19
af90d6ff5077448494656810ecf08522,318,292,26,Europe,19,2172.78
af92d43c6fac4a4db68aeab7e818324b,101,75,26,South America,17,522.64
af93eba5f4db4b798e8e214c664ba31b,226,194,32,Oceania,18,1562
af93fb016d424be4a9c4b2535ad099a7,317,290,27,Oceania,20,2538.87
af95bc84760b4047b0a8bc09e0bde027,64,26,38,Asia,26,330.96
af97bf0cbe8d462ab3f37efe806730d9,364,352,12,Oceania,21,3111.84
af992c8ecfe449888b914b10116bbd4a,268,220,48,Asia,20,1650.65
af99d479f23f4985a4b8879228b16e6f,82,32,50,Asia,24,317.84
af9b3b074dc84d92b6c4dd176fda44a2,346,304,42,South America,23,1928.54
af9bc00ea7a446e3b503073e647f294e,363,324,39,Africa,18,1465.83
af9d7a97be9f48589551506710859736,182,158,24,Africa,22,1210.72
af9f8aba5d3c42eda9d3ec5ba20a436c,359,335,24,Africa,18,1867.87
afa0924876524c24ac5b860c62b6b66c,365,346,19,South America,17,2332.88
afa125a21c284867b47a8c202d5488c6,237,201,36,Africa,19,1465.38
afa1ddca99224799aeb72e40f79fc3b9,172,119,53,Africa,17,1428.52
afa1f7312b0d449aa07b309259fe1385,200,168,32,Europe,18,1162.44
afa4368a26ee4e64883d9329d3193567,337,302,35,South America,22,2472.74
afa51c1504c2429eade9ac27bbf473e2,170,131,39,North America,18,646.48
afa6892b4e0b4535a998e760f0abc7f2,104,80,24,Asia,18,1074
afa778266be54670b0f2d1954a6fd1c0,311,264,47,Africa,26,2186.04
afa83196784b45088f2d644d8ad9742e,259,224,35,Oceania,20,1511.09
afade583906a4f9c89314e40c08cdf8d,202,143,59,Asia,22,951.54
afae6f024f1f4a87932e74e7103d8ab0,268,223,45,Oceania,17,1156.31
afb2bae0127945058dadbc0768085aea,305,250,55,North America,21,2010.12
afb3b830908c4524a3e099b4a6155f5d,149,126,23,Oceania,24,1716.6
afb4069c0d304d5cb68e5a80e898e9e5,280,244,36,Asia,15,2033.07
afb4ed4ac0b24588954b49be76ce735e,229,219,10,Oceania,20,1472.85
afb53a8a63374021b4a26163e881842b,341,316,25,Europe,17,1579.5
afb5673d26104268a99449458c07cbef,317,276,41,Oceania,23,1896.5
afb5c5dcd77647bc874ae699aa647905,244,195,49,Oceania,14,1648.03
afb8102f71f3457ea30a3579f9f90a21,193,160,33,North America,15,1760.61
afb867a3947c40ca84b98256906beb59,365,342,23,Europe,21,2131.4
afb89c62327f4bad8554c05983e12d1a,271,228,43,Europe,19,1223.21
afbcc5dbddcb425daeaa247353868e9c,73,24,49,Africa,20,320.21
afbdfece866d49f8abd3b3aa156e441b,193,143,50,Asia,20,941.47
afbe364972e64b66a1fccb4e6b98b4e1,149,117,32,North America,18,1107.73
afbece10cd234ee1a89c9dbc9da10617,52,23,29,Asia,21,293.13
afbfe879c7794ef2808627149b5ea56f,91,47,44,Asia,22,471.89
afc27b162d8742cbb1c0e8a7e067e32b,269,225,44,North America,25,1326.9
afc2d516e6d144b39b8c11c954330edc,166,142,24,Africa,19,846.25
afc45b48681044db86fc8b793dca2688,107,70,37,South America,22,817.25
afc5c176df06448b90833c68fb6553ac,223,182,41,Oceania,22,601.23
afc8c880f982401fbde9b46326f8edaa,172,134,38,North America,17,664.64
afc8e915de6841798ebb7f42a5691f5e,138,102,36,Oceania,20,805.13
afcba97436df43c6886986fc0d446171,229,182,47,Europe,17,1448.76
afcbecdb09b34e349f31135b69b62eb2,134,83,51,Oceania,20,798.02
afcc032d54744a45b48cbea915b95373,320,277,43,Oceania,22,1115.43
afceadc7ead34bef9f48cae26b1095fb,263,219,44,North America,17,1374.72
afcff8459bd24435912b8665d6bd3ad1,163,121,42,Africa,22,804
afd144e4a0464d4b8e8848b0eaa9db7a,362,331,31,North America,18,1983.42
afd3f67280a045699805bb82c9a18539,130,104,26,Africa,25,1276.96
afd4001c4771480f91b1d0ba2af532d1,312,292,20,North America,18,2266.01
afd41baa29514e268b76abb9c908996c,365,363,2,Oceania,25,2454.91
afd6c2409e1f412bb0319e980679ee94,288,247,41,Asia,20,2258.48
afd8ce17c9f94ec499dcb5821ed962bd,199,171,28,Europe,23,1233.06
afdb25f3a94d4d259868a443f5a46a76,301,282,19,Oceania,23,2496.87
afdcb31ecfe44027b45eeeaca4d6dc4b,108,82,26,South America,23,1051.67
afdd38cb3c97485e94e8cc1fd69c0e62,59,11,48,North America,24,259.09
afe01a64c4b441b397a566497cc17fb3,232,193,39,Africa,17,844.79
afe0653f126e460bbc530ff56c4093fd,109,70,39,North America,17,597.51
afe30ff6226b44f2a67c1a05dcc24e62,98,40,58,Oceania,23,362.97
afe377faa6b7406385b4aa008cb35b4d,275,255,20,Africa,20,2557.03
afe4071335e342f098f4e1585a5f3469,146,120,26,Asia,19,856.97
afe64ac24efd49508f6c3b3a20c86463,269,245,24,Africa,28,1551.85
aff0194c26944b8c9022daaaae17e5c2,83,46,37,Oceania,20,478.99
aff045890bf44c0aa9c0cfce497d77db,170,134,36,Europe,23,1244.7
aff06ce33aa746758f680d22bb0644b6,217,173,44,Asia,19,1174.88
aff13758f3a74940ba94bc554bd95653,252,216,36,Oceania,23,1645.44
aff347a603414644b0eb03840d7413e8,304,270,34,Oceania,18,2473.2
aff3a5387f9f42b4b78a5696238ae7a7,271,236,35,Oceania,19,2032.44
aff4040d94684adabc63dd0e397e1b30,125,89,36,Oceania,23,506.5
aff4a8966ecf480c9def0706ec8890ad,170,128,42,North America,21,802.68
affa4e8cc9234253a11618874d4e0afd,161,109,52,South America,18,908.4
affa98b17fdc4d4d8495c58c99f80b2a,356,307,49,Africa,20,1675.52
affb2a4b176e4887b6e955adb4fa1ccd,247,212,35,Oceania,22,1995.51
b001955e149d45a2b487a6c41f6e3ede,344,298,46,Africa,23,1372.59
b002515e45414d6fbb38699fe795096a,160,137,23,South America,19,914.24
b003a023b7034e3fba782b9f2ee8ada6,143,80,63,South America,24,527.13
b007549ac23f476b8904054c0f45917a,192,138,54,Oceania,17,736.58
b008418470a14b6f9d84ceae716fa4cc,136,91,45,Oceania,17,555.88
b00b12b1817445dd943c0284b780d696,110,81,29,South America,18,600.96
b00cec6677144171aac36ab532430b9d,262,247,15,Oceania,23,2067.14
b010e2a23e60466e894cdd19515ee1dc,363,350,13,Africa,20,2474.15
b0110965185b4c56b5ec7f94aae36b0a,223,175,48,North America,18,1358.04
b01182e8cb7b4539a59bcde1e962cffd,328,285,43,North America,20,1315.46
b011b767fde64541b1930ec03f35390a,67,22,45,South America,17,451.42
b011c1e1392d4bd7a9ba040af5344caa,250,222,28,Europe,21,1712.81
b0128cc906f94f8b9f216ccf5754dcbf,56,17,39,Europe,17,500.33
b013df33c27748c69b857981ba68cade,137,105,32,Asia,20,1184.64
b01407e4f72a4b37a55e344dff8403f4,223,198,25,South America,26,1574.49
b01465c8edf946c1ba39289db0beb1cf,51,4,47,Oceania,17,123.91
b0177096a37b4937aa6f33e507d19dab,347,320,27,South America,20,2111.76
b017ce4bfeac47bbb681a334ab49cfc0,336,292,44,Africa,20,2679.84
b01b41ea343047c8aa784bbe54e7bc23,77,30,47,South America,19,292.35
b01e50bf40544411b3fe6c26fe6c78cc,226,187,39,Europe,19,1165.41
b01e61efe8ca479e8bb998e2bbdc84a1,185,147,38,Oceania,18,1158.68
b01ee14f5f95419da85a96ebe46fb52f,351,302,49,Asia,21,1936.37
b01f5793567e465081aa359fe199acbc,245,210,35,Oceania,18,1297.01
b01fb9eeeff74e79b285a42400caceeb,194,177,17,Africa,16,1382.45
b01fba1d058b413ead2940a2d56173cb,220,163,57,South America,17,1163.19
b0209385a3d74beea2b94647c5c2a3fe,108,55,53,Africa,18,538.88
b021c7c6c2154adcbeeb74b2023023aa,330,307,23,Africa,22,2816.95
b0226a8b70524623ae2dd7685a2507da,352,306,46,Europe,23,1706.58
b023bcd08c44416a90a855aa5c4e2b43,314,294,20,Africa,18,2149.76
b0254e7d0fa04175ad07ff48ba9b66d9,250,199,51,Europe,22,1671.23
b02572b781d34442b91f5dd7dd1000e0,363,351,12,North America,23,1927.55
b028c1e261a14b1f833bc2ae64d7fdb7,303,280,23,Asia,18,2513.89
b02a1d10a6404859b23bffebeddca5dd,254,206,48,South America,19,1031.38
b02dc8ed25624f41b42dc9afe20b5bed,186,162,24,Africa,16,1522.6
b02eb7ead77a491aba509be454b5aee2,327,286,41,North America,21,2334.46
b02fca02ace8485c8213cab2adf5988e,44,26,18,South America,19,367.9
b031f19a450f4d7eb631f70b978ba9ba,338,318,20,South America,19,2694.52
b037dc8b8d6d4ad38481540011dc4813,278,254,24,North America,18,2616.05
b03824a46a6e4e8497c75a925af534f8,188,167,21,North America,18,1537.21
b03bc2dc0dc645c78893f8955af794fc,52,25,27,Europe,18,322.87
b03f00cc6a2346b68be5d2486657be11,189,146,43,North America,23,1401.76
b03f3e069b53405dbafe4c09009cb6b2,203,182,21,Europe,19,1610.89
b0425133f0ce4f398d72d3d15251d826,248,215,33,Africa,18,1082.18
b0439748a2a74dc4b0e64cc054d882b7,260,204,56,South America,16,958.37
b047489597e24955adbc26739dc2983a,238,203,35,Asia,20,1594.77
b047b88d84124efb85cf1d46d5667468,259,230,29,Europe,20,1997.55
b047e9c3252d42cb9c92dfaecd016bd6,319,270,49,Asia,22,1429.67
b048f4da2a9f4acc9377e3126e3b59af,232,206,26,Oceania,22,1539.3
b04ade3e11a649fda9fed4ac9cead4fa,243,203,40,Europe,23,1395.25
b04c2689aa1d4c8987ce5e8a20c84181,245,218,27,Oceania,20,2521.51
b04cd9497fea4ebfac6ef51639b7e875,364,326,38,Oceania,18,2519.12
b04f89012cff4c09b7468b16e97b1cb2,113,61,52,North America,21,512.26
b0506d9b3bcb4aae84a7cf06c66a329c,159,124,35,Europe,20,1410.78
b050b8bc50dc403c91f41ae7c23f6296,348,300,48,Asia,20,2133.76
b051752e2c604a3591a253d9f51d8347,304,275,29,Africa,18,2344.98
b05347770c054178842bff9bb8ff5ba0,292,243,49,North America,17,1235.6
b0557689914a49ef8881647b276f0f88,97,68,29,Africa,20,306.45
b0560716b58a4b45a65837ef4a45c771,317,298,19,Oceania,17,2358.56
b057368857004974bb2fcf51cffd6313,137,87,50,Asia,19,736.86
b057f580a46842c3beefe08f03d80063,330,285,45,North America,24,2098.76
b0585d4b8c694cd2af0c22db9b52b9ba,160,138,22,Europe,24,1330.06
b0586cb6eb51444887d251b5d1de1501,106,75,31,North America,17,690.08
b058b57f1ae741f184ed36d075fc72c9,326,300,26,Africa,19,2218.89
b05a8ceca77543b688c11c8e46972d61,241,203,38,Africa,16,1606.95
b05c0ea2b1004a5c8b2fafd922d9381d,215,191,24,North America,18,1658.18
b05c9cda0f1a48608323d72494b496b2,105,65,40,North America,23,724.3
b05cbad8c96a4882a45fdf3596a91fc7,77,38,39,Asia,20,447.42
b05da42e99ae459db028c1de799d1876,271,250,21,Asia,23,2069.1
b05fb927d091415faf49b2d4cd40b629,302,271,31,Africa,17,2576.34
b0604decc4804ce188aff8f732c41269,54,15,39,North America,22,456.67
b060d82a0261400baae137fe9abd7728,331,314,17,North America,22,2254.7
b061771c356f445184958e7936c70e10,135,105,30,North America,27,1168.47
b061f88245f54e2e8d1503e8018a2cdf,36,1,35,North America,22,126.94
b062283ac52545939671993b14588cbb,224,172,52,Oceania,22,713.49
b06374a7469643169730cb11a651ba19,244,214,30,South America,20,2077.17
b0671d81ca9549308743cb8332318589,318,263,55,Asia,23,1546.92
b06b0ed7441c477a9e139b852b3aef25,275,249,26,Asia,24,2195.67
b06ce2accd264fb5ab9110f8561e13ac,273,252,21,Oceania,16,2181.03
b070cb317cf6421da014188a5ab29642,204,178,26,Oceania,23,1378.91
b071a591a57d4d79b45a8a1c21af1888,114,76,38,North America,17,711.92
b071aab09a75484482a63e08d8be14c0,153,112,41,Oceania,21,810.43
b0722be9946d43c28c68fea740c60197,142,118,24,Europe,24,1264.37
b0722f77274c416fa35fa54d91dbe11f,171,148,23,North America,24,1311.16
b07352125c2b42f48cd861a3c450a61e,166,117,49,Europe,19,806.24
b07428819a12407399739afc855750f5,227,179,48,Asia,20,698.81
b0754c28511f4d2f88bcd8b5d2c4d9d7,258,211,47,Europe,24,1406.9
b076c1fe9d804874b8e3577e46f9f49f,27,2,25,North America,22,244.78
b077174f49c94f73bcd92083d368be70,60,19,41,South America,21,509.52
b079354641bb4595b5f0182176093d30,151,112,39,Europe,27,1237.76
b07ad6cb70f5433193e5f92c63614bcb,236,212,24,Oceania,21,1422.71
b07d185a3c984e0088606279708d2d89,343,295,48,Africa,22,3211.03
b07d871af5564d45a96cc13ab8a8878b,194,152,42,Oceania,22,1498.55
b07f4cbff4ae48fd9264d822ac8f90b9,145,118,27,North America,22,1308.85
b08049d5341f4174b2d9f6b0656bdac7,99,60,39,Oceania,22,570.97
b083ad5fdbd948bb8620eaf2066d17aa,365,316,49,North America,18,1701.59
b084bdf73c374e378430b89127ede978,91,71,20,Africa,22,704.95
b085b2295cb54991a64fae50a38acf1c,242,194,48,Africa,23,853.68
b0866de2690c43728181f6c8e21e07fa,363,314,49,Europe,18,2058.42
b088124ce254453d930657faa56de45a,146,120,26,Oceania,17,985.34
b08818412a5b43b9a66cbc0e333e3145,228,200,28,Europe,15,1272.71
b08f5d12c10742e08ed23de56e5471a6,223,174,49,Asia,19,854.04
b090439395e64765ae66f20301fccdbf,132,99,33,North America,19,681.57
b092dc05557240678a57d26a461c54fa,197,172,25,Oceania,24,2246.19
b093d1470bc941caa4cf0acad1ccacd1,74,40,34,Asia,21,644.24
b094292ae5494da1a2e7e8c208efbd3c,251,212,39,Oceania,21,1434.83
b0949bf97ad74f7185681526c7b10c81,270,229,41,Europe,19,1725.7
b09585b285c242ad83cd7fa6f48b9d2e,363,340,23,Africa,17,3036.51
b096303f9c884555b6d32a488bf5ba84,151,114,37,Asia,23,851.73
b096db0bcf5f424ea5512e4b7a27dc9e,132,108,24,Europe,22,806.76
b09798c096e345dc813a599e3b003a5c,361,317,44,Oceania,25,2370.94
b0993421f76f45ff8f02c55d802ebff1,259,241,18,Oceania,21,2007.98
b09d0210ffbd43518964a6b4c6f4f5f9,57,18,39,Oceania,21,528.64
b09d4c338c5345338d9e0cec710bee17,60,34,26,Asia,21,378.88
b09e149b6f7443a8900ade7af040c8e3,124,68,56,South America,21,694.31
b09e82c76bb144eda2c30acc1940cb69,314,275,39,Africa,19,3102.2
b0a09bd09e994b95ab6f2e1448a51040,364,328,36,Oceania,21,1717.16
b0a0d2c43922457985e2aa4e0e04d872,255,208,47,Asia,19,1109.92
b0a0d5b5cfd54902842a60bf2dfbb74b,80,24,56,North America,20,406.26
b0a14b0340c34a6db8e9c6ad86584c39,190,167,23,Oceania,27,1217.43
b0a1ac532134417fb9e1e3caba40fc66,82,37,45,Oceania,19,637.38
b0a209d2b53e4a8e8247a8b72d95b05c,193,169,24,Africa,18,2349.86
b0a4e0dca77d41bfaa0b5a1ee5a85b5b,279,240,39,Asia,19,1948.5
b0a4e35a11f34d9192019475fc8e4bf3,338,297,41,Asia,19,2114.52
b0a79d969f0d4c709af15e254e757037,30,6,24,Africa,24,308.37
b0a7a6b92c4445d497844d905e085520,212,172,40,Asia,21,1518.23
b0a82d1bfbed46ddb7edb171fd6ced71,54,3,51,Oceania,19,505.38
b0af4b7a5a08440d9db7232ff7009791,138,115,23,South America,22,921.88
b0af4bbde8b645e18a89ac00a6ecc080,342,304,38,South America,25,2260.18
b0b070026e78416bac1c85977b024327,365,324,41,Oceania,22,2018.08
b0b0e028ecf748dd9024502904e65676,119,95,24,Asia,22,752.61
b0b26118e0d94ab1b4fddaee26b0209a,110,70,40,Europe,19,780.12
b0b2e1c820ca4867bb562cd7f9303809,214,186,28,South America,24,1433.33
b0b31d0522894e3da6828d13da3c3d76,196,153,43,South America,18,992.12
b0b55fc68721439993bd887e4b8973e5,231,188,43,Oceania,19,1142.2
b0b6322351634823bb6f6bea1fd35fad,145,122,23,Africa,18,1048.06
b0b92119f9194e7f89668bd3b155c031,60,9,51,Africa,17,313.77
b0be5322fa8c49e4baf9ce4435191f2d,44,20,24,North America,20,488.92
b0be7ee88bbf41d1a82eb4bbcb25b715,247,206,41,Africa,17,1243.39
b0bed088c6994ed0816f8fb805cfc7d7,94,66,28,Africa,17,705.37
b0c00444979543829295587afd14dee8,176,155,21,Europe,17,1278.82
b0c5e750ebef42bfada49bffa8a1ed9c,222,172,50,Asia,22,1221.74
b0c6f164bcc4465192af6925aebe5436,75,43,32,Oceania,14,269.53
b0c79c05585e4ac985d982033fc8d879,315,286,29,North America,23,2351.41
b0c9a192eea0401eb7a330a833912d25,220,177,43,Asia,20,1775.69
b0cc1c79c11e4ffc821c080f7b561483,365,317,48,Oceania,25,1816.79
b0ce5013dc06466aab445724a8b37aac,101,52,49,South America,19,583.65
b0cf3728f8404204a527e65e3c6f265c,270,212,58,Asia,23,797.89
b0d0d133b5ee4adf93f640cc2de6bf0e,298,262,36,Oceania,20,2503.6
b0d51f6d85ad4850b90f4657c7511ec3,364,358,6,North America,17,2247.17
b0d56b99521b47f5ae42a0614e47756e,203,181,22,South America,19,1606.07
b0d8a3b74bb84f3ea1d0c054379f41cf,305,271,34,Africa,14,2277.71
b0da748eda2a43a5a0c2d09e6b3a59f0,120,80,40,North America,25,497.56
b0dac545ab454986a6f58a7dcacd0ccc,365,355,10,Asia,27,2502.32
b0db37c63c6742b1982e2196207ab827,188,159,29,North America,18,1403.39
b0dd236f66904c94a7724dc0137fb554,267,220,47,Oceania,18,1275.41
b0df62c4d4844420b5b00c3b3c906f41,173,129,44,Oceania,13,1233.56
b0e007ece5ed4a609073c10346be1504,49,8,41,Africa,22,422.7
b0e11cf050e94f97bd3812b722d948b4,167,143,24,Asia,25,1909.61
b0e1803a54b04abd8e752c8791e0482e,338,288,50,Asia,16,2295.71
b0e354d9334e4895aedd34ad327d5350,236,195,41,North America,14,1162.4
b0e5d48f8b314f6998b0edce0bdc5cbd,297,245,52,North America,24,1143.73
b0e735b8930c48b28a4e33572dd73850,127,82,45,Africa,18,794.38
b0e8960db5614939a58837cf7a5dbde7,345,314,31,Africa,20,1729.51
b0e8e7b7230f4d8381d4aff60137873b,42,14,28,Oceania,21,445.31
b0eac96fb04d4112a70d171e556c962d,262,244,18,Africa,19,2099.78
b0eb0a8da2824a0cb321bd83b1748205,256,212,44,Oceania,24,2095.98
b0ecd6d8878f4250857c0f63b64defca,147,88,59,Europe,21,702.84
b0f0bf6867ea4709bf51f21756924e82,338,296,42,Europe,21,1636.85
b0f8ff8d8b1246a6905d28bf7f3107cd,57,33,24,Africa,16,447.48
b0fc131eecdf46d0a05456a3ac439fb0,94,42,52,Africa,24,228.33
b0fc59fa4b92436dad554831d79fa7ee,32,2,30,Asia,20,309.38
b0fdeaf88efa4084bc0db375f94f5389,278,263,15,Oceania,17,2096.44
b100a95777994426b59f20ef18ae9e9e,280,239,41,Africa,18,1028.25
b1015c0697934372ba48a71bd6a59133,365,360,5,Europe,14,2010.71
b102d7e454224475b9f9558834030401,136,86,50,Oceania,17,623.22
b103d7ce52aa4e2697ac2cadb46c8475,66,32,34,Africa,22,513.27
b104e8e2443a43398589c4d684860a02,192,167,25,South America,19,1376.3
b10574c39e674ab085aebb882b0b9a5f,273,220,53,South America,20,1547.52
b106a65feebf4e54b1079805235deedc,221,207,14,North America,20,1608.41
b10f5c0b8a4d4234a0470e446866bf89,322,295,27,Asia,26,2493.52
b11089c68735478a9984397e51029062,66,33,33,Asia,19,657.89
b112812746bf43cda5d014af087508d6,55,28,27,Africa,15,169.82
b1145acb62d4492785c9d93a88ff5b53,244,209,35,North America,21,2166.43
b115204a16d64668a32ef8b76297b7f0,322,272,50,Asia,19,1726.96
b1154ab071764f11b03f2cb1d92d15a6,161,107,54,Europe,22,615.19
b115e484135044e59c541c4d11a26e96,36,10,26,Africa,20,177.27
b117d74609a043349d2884927cb75ec4,30,2,28,Asia,20,234.19
b11d0bae350f4b81925086bc0cd61969,105,74,31,North America,21,787.7
b11d5cf5ed504c3ca06663cb3e7ecaa6,271,245,26,Europe,24,2239.26
b11f0269172c4f53b42f15cb85ce08c0,234,180,54,South America,21,1775.38
b121fe862c6a4c658397d6d2885cbd93,40,7,33,Oceania,28,202.03
b1230ca91aa24510b3d65794a517c524,217,181,36,Oceania,21,1249.82
b125ae8881f44fd7b39926ab6e8a958e,106,57,49,South America,19,467.02
b12713c21f3b45d4906896064c923893,256,204,52,North America,14,1178.36
b1296551d7bb4a26b709f348c32a27ae,299,250,49,Africa,21,1049.15
b1297b0ef8b54857b349fef6ea13ca4e,200,148,52,Oceania,24,656.91
b12dd42cd24c492e91b7c57bb8788cad,140,112,28,Europe,19,890.87
b12ecc856a124262b28270557b128f2e,133,103,30,Oceania,17,1435.06
b1329097c34c4fb6892e465752d6f6d8,335,302,33,Africa,19,2114.68
b134c3cdd4a84eddb2bfd53b6c30db88,268,221,47,North America,25,1334.06
b1387faedc724c6d91e05fcd6db64f45,261,217,44,Africa,22,1432.69
b138cc7399214014864dd0d167a92c7b,350,305,45,Oceania,19,1615.55
b13b35f518ec45fa9023b901e9da70f6,195,165,30,Europe,18,1268.54
b13b4540de0e499284a823fd7a757178,248,193,55,Asia,20,955.83
b13c4a41d639425ab676317dd26c02a6,242,215,27,South America,17,1374.89
b13cca705ba14d708a4f63ba155e3ca8,129,84,45,Europe,18,513.27
b13d070f19004f3e97560ac49e3cf8f8,222,207,15,North America,19,1464.94
b13d66cd434f4718bf0a844607a79a94,364,336,28,South America,17,2210.7
b140f890edb24872b4e7cec7acf390f2,169,122,47,Oceania,20,500.17
b144a70290964ffd8680f744d884ca27,186,159,27,Asia,18,890.13
b14d351091514e049552a238d121eae9,76,49,27,Oceania,19,943.32
b14d4b800de74cca94e3c285faef984a,61,18,43,Europe,24,456.48
b14d4de2327b4cf6938c97d436fb4b9a,336,298,38,Oceania,20,2379.26
b14eea9f0fc7472faf2a074c3d553140,164,151,13,South America,23,995.69
b14febcd14704eefacb8e1f4886826e9,84,63,21,Africa,16,698.59
b15227b7245e4c2a9a1808b8d4344e1c,100,76,24,Oceania,26,1127.79
b152316745054cf0a672a3692d09ca4b,137,91,46,Europe,16,580.92
b15258e64bd14c768b21a4ea1279e47b,229,183,46,Asia,17,1341.17
b1536b29024f4aedb0de3cea64d14543,135,92,43,South America,20,820.25
b154593a83604bbeac71cf38533a39c5,299,264,35,Africa,18,2408.18
b15745dd836748ccb790b7a5e567a3b3,69,29,40,North America,23,492.86
b157a54fc56d45b98b31ea98753de951,177,133,44,South America,21,599.38
b15b0254b8cf4fc6bb46d0569e7631f2,364,340,24,Asia,20,1346.82
b15b4239771544d392187f3b66491920,226,172,54,South America,19,1134.5
b15d2eb27fe144a7a0d209f2d43a56af,89,41,48,Africa,24,568.86
b15d639bf8c5412caadfcf6b5965e407,51,23,28,Europe,20,303.09
b15e89c441f5400e89ecbb43e62c7dec,265,234,31,Europe,22,1994.27
b15ecbdb25d042bbb63da272ef5eb783,321,274,47,Africa,12,1359.53
b15ef039e9474da2919f605f1055d08f,283,253,30,North America,21,2413.99
b16141f929834ac6bc621614e3025a1c,180,148,32,Oceania,17,1710.39
b1622a34a2ee47068ae636af17aa895b,249,228,21,Europe,18,2114.31
b1635c9ec29747949a46d737e00909f9,364,334,30,Oceania,19,2776.61
b1695ae2c43f48fd93b129c3917bd047,259,225,34,Africa,21,1745.66
b16998db001344ada48ecaa8bdcb6f85,126,77,49,Oceania,23,1150.51
b16f03f828c3417297a55ada6d6ff53b,269,232,37,South America,22,1701.86
b17061d2c69747dd80d683f91ac3649c,176,144,32,Asia,19,1258.15
b1723abf377c40dbb1ffd9ef8448e5eb,357,345,12,Asia,19,2625.49
b1727df82c1249e4a19a1d80310b11f2,92,48,44,Africa,22,670.37
b17444de49b344a591b68587234c51a4,215,195,20,Oceania,18,2294.72
b1761104df32440283f3a5f9dc40bf58,125,81,44,Europe,24,616.56
b176280ce597462f8b1f2bcefecee50a,353,324,29,Oceania,21,2590.37
b17ad7dc888f481d94aa3d45461208a1,59,34,25,Africa,14,372.1
b17bf3d4045442c28b22af218909d55c,38,16,22,Asia,19,311.96
b17cc19cabe64025997922d4b0415811,152,126,26,South America,19,1265.64
b17f643d25124150b9f3b3566c47edd2,267,231,36,Asia,19,1875.91
b17f877d21a44c4bb8a7f04069f5ff62,222,186,36,Africa,18,1464.33
b17fb92fb54348d59682db685e0e9b1a,353,307,46,Europe,21,1912.68
b1820a3f11304b51bc376cd587214851,269,224,45,North America,22,2179.83
b1842a2b86a9425c9889390a812ae045,74,49,25,South America,20,344.29
b1849bb8fbb54735a1ed1494cbeb1299,55,19,36,Europe,25,510.89
b18751dab03f43768fb3fc67faac1e9c,364,331,33,South America,24,2852.16
b188e462e82c4830b648fbdf3141b7ab,313,289,24,Asia,17,1967.67
b1897d698f7f401ba42435fa1e7f6e8e,95,41,54,Oceania,17,457.19
b18c54adcbb34dedb9f2f094802303d5,349,319,30,Europe,21,2146.64
b191346523cf40dc9534cb13b34358f5,279,235,44,Africa,21,2451.71
b192ecf984c949adbab9a17231678357,362,343,19,Asia,25,1816.94
b1941a2896f94931bc42bbaf15b19617,130,92,38,Europe,21,1183.26
b1960069833d4312856189ad0692f353,333,292,41,North America,19,2599.49
b19744b3324c43fb978dcfbed12e7bbf,133,97,36,South America,19,1242
b19a6326f7a84054ba85c93f45aca116,126,100,26,Oceania,19,854.98
b19b9c1101e641ed8715d08341967100,182,159,23,Asia,16,1086.2
b19cecde71fe40068d7e0c0f15425045,201,164,37,Europe,19,1202.65
b19dfee04b6d4320a06b2db3d259703f,137,81,56,Europe,23,675.37
b19f019782c34404a39fe6e6aade9981,357,337,20,North America,18,2762.53
b1a042e38a8749a58958929f92558045,358,320,38,Oceania,19,2664.75
b1a1ada7a4b04749bb6bdf6ee80c0c97,158,107,51,Asia,17,589.42
b1a23a8650054bd68534f91932ca559c,356,306,50,North America,18,1574.16
b1a574676a3c42048dfff8cefd0c5413,309,270,39,North America,20,2780.25
b1a63dcf9e6545258748acefa9807973,197,137,60,South America,21,1112.9
b1a99b33ab9846f5b256408515be9204,326,300,26,Asia,22,1778.57
b1aa4809a8dd4d709fc172304fbe00f7,126,72,54,South America,21,290.62
b1ab9228bdb74cc1ae3fff938a0c25b1,186,143,43,South America,21,943.19
b1ab9ff6634b4f7997fe43ebabf880fa,22,5,17,Europe,17,157.89
b1ac18a20c154b05a65bec42f1ef37b1,206,186,20,Africa,27,1383.33
b1ad252cbe5e4b219544b5e9aa55d313,365,354,11,Oceania,21,2506.95
b1aec947ee174a7cb73379f4156b21c1,155,115,40,Asia,16,934.05
b1b3bd375b24445d95746437e71c1208,52,17,35,Africa,26,338.44
b1b3e43daafa4e4ba91f694442aa4395,365,365,0,North America,17,2996.04
b1b5ad403cae4a7caa63ee1db0a06a8d,322,289,33,Africa,22,2364.02
b1b5f195ce64495ca7bd1b32e5478635,244,220,24,North America,21,1666.88
b1b6f7728920442b931cd93976fa8bf7,323,283,40,Oceania,18,2308.25
b1b74984d32340aca452573637c73b40,90,50,40,Europe,19,562.63
b1b764939db043bba1b41c8f6af990c7,67,13,54,Africa,25,324.4
b1b773a37b0d4f45a19505e06f5a5b1c,259,220,39,North America,19,1575.84
b1b776a5f3df4d5f8f19a5449350fe1e,360,334,26,South America,19,2197.73
b1b99a19dce94f7fb5770df8d424154a,93,48,45,Europe,20,221.3
b1bb9188b8864c49bd73734b2024df57,135,120,15,North America,25,904.34
b1bc6aeec2fc40d19f7aa7788d28eeee,365,343,22,Asia,22,1703.95
b1bdfff68e59406395203d2ca05c41b0,342,297,45,North America,22,1440.48
b1be55c5ad3c44f8b62d95afe4aef0e2,157,141,16,Oceania,24,922.33
b1bec85e4e81421283b97d2fb8fe7913,270,250,20,Africa,13,1826.15
b1bf97afc73b4fc4823b859b470af174,162,141,21,Asia,14,1149.21
b1c097ab9f2742c9a2c384a55cbfe630,174,151,23,Africa,24,1265.02
b1c0bb24953e46ab8798ee36265064f1,125,78,47,Asia,21,292.83
b1c0e3d65e954f8980b681e7acf34ab5,155,99,56,Oceania,19,1120.97
b1c12af5e87445449b7b58d1fd0bdba9,120,99,21,Asia,17,895.87
b1c1e4d7325d4ff2a4082bfec187ce55,171,145,26,Asia,13,1272.57
b1c332d648c24435833dfb8d3c2c8a30,166,145,21,Oceania,20,1341.86
b1c3486473204ce6ab7aceee2b8a9838,184,140,44,Asia,23,620.59
b1c4687616d74e83b27bb5bec65e3dda,62,44,18,Asia,20,891.03
b1c64d6a8a8d4755a4d05c276cd0fa6f,333,305,28,Europe,20,2454.83
b1c795689a0d4263afe8123bc7e9a75c,271,246,25,Oceania,24,1832.01
b1c8057a2dce4b10809f1bc3a60a52ad,267,216,51,Europe,18,2146.15
b1c87ce8468e4acb869c6a1bf7a45f12,202,177,25,Oceania,20,1567.13
b1c8f6c767ed40f7869f4ca7675b9de2,161,113,48,South America,21,1059.06
b1cb22b2b7004f80a8cf0fc0ed9a73c1,87,46,41,South America,23,571.71
b1cd5995b93743288781f80580ef8437,304,251,53,Africa,22,1475.59
b1d0cb9ee24945ab96be99fa2c131623,79,64,15,North America,21,553.25
b1d1474e80814b5380b33eaa2813a25e,221,198,23,Oceania,20,2086.88
b1d2889ac7a343f988658a93718be855,335,300,35,Oceania,20,2615.49
b1d371467790434d813c7194fe3855b8,244,207,37,Asia,19,1043.83
b1d71f63a4fc4f1d804fa2f8f3090ffb,168,114,54,Europe,20,456.04
b1d72f8077d74c18895a091021de23d5,61,9,52,South America,16,356.32
b1d78633e8174f97aa4c2e3d5e555104,255,223,32,Asia,26,1886.61
b1d915df2f2f4993bd7d9f646f6eae50,208,180,28,Europe,22,1577.82
b1dbf09bcf794e1e8102dc2687e715f5,75,24,51,Africa,22,651.51
b1dedcd308e142dba2298992897574da,321,274,47,Europe,14,1463.73
b1e135708ef646f59100ae7766305bb3,174,134,40,South America,21,722.97
b1e19e7bd67c4f9b9c275c27688129c7,97,68,29,Europe,24,1309.03
b1e2f0f519ba4873966be09975d55618,89,64,25,Asia,18,550.26
b1e33d583b694d3b8181de51a923425b,315,289,26,Africa,24,2657.04
b1e3e571ef004c0db5c310618061ec20,133,114,19,Asia,19,1129.09
b1e7136aedae40999393896066a1f604,190,154,36,Oceania,22,1216.6
b1e74e6f2bb54ee5a2f5a19b70e31faf,54,7,47,Oceania,18,341.32
b1e819fdc09e45b09facb43bbcff4dc4,285,266,19,Oceania,19,2383.42
b1e8f73468374d21a94bc521e1ed6538,365,358,7,Africa,24,2196.14
b1e987ed88d249c9a4f7df8083e33e15,109,80,29,North America,17,877.39
b1ea56f24b6440bbb4e42936d97ca9ca,72,37,35,Europe,15,594.81
b1ed33ea567a47e6a99b8d3f28632599,341,315,26,Africa,20,2393.74
b1eea989bd634420ab6f7c8d12a02171,197,158,39,North America,18,687.12
b1f2cdececaa435b99a180a4989b4efb,228,192,36,Asia,19,1137.84
b1f3ceca5b0c44cf92ad93ce51ba2ca8,350,321,29,South America,18,3005.12
b1f3dba89d1d424b8081f5d9dc89a510,201,168,33,South America,20,1221.8
b1f41b55f0264425ad23f044f3aed39d,359,332,27,Africa,21,3049.61
b1f4ad49dbdc4e1dac4181848e032a71,110,61,49,North America,19,419.67
b1f579e9bbad489996857bf27fbf5184,143,113,30,Europe,18,956.05
b1f5b5b98b864a8f8ff74dbcfdfd3cb9,336,280,56,South America,19,1500.28
b1f8644a7ebc4db2841b59db5b783801,81,47,34,North America,17,862.21
b1f909d6874a491f88e29e5f285ca4d7,107,65,42,Africa,17,742.2
b1fe28029cb2472a8dae97f13d4de660,364,354,10,Europe,22,2777.81
b1febecd42b543048ff823fa6737e4e3,147,110,37,Africa,18,771
b1ff926673794b28a367ed3ae03781f3,365,359,6,South America,19,2785.26
b2009035fc1d4184b99d03cd2db2ef10,108,64,44,Africa,23,1005.02
b2088da61f8843bcbc6b454fdf273721,325,307,18,Africa,20,2568.77
b20955eea0f94b058e886b68f7ca4882,221,174,47,South America,22,1209.41
b20ced2d634942a684c468d010b4d74b,341,279,62,Oceania,19,1390.24
b20d2edb2f2e4e02b51b75b78a55b6b9,205,156,49,Oceania,14,1113.33
b20d874f23424c38856cee6b41bcb534,198,160,38,North America,23,1462.61
b20f9cb429874f549c42aa6666370f1e,312,268,44,Africa,20,1823.85
b210c5d5cfb445a88ba8780aa427628e,186,158,28,Oceania,22,1708.58
b2111b49e2fe406e88d915bd2c3311fa,208,166,42,Europe,17,624.65
b211c6c2661c410fa2756bdc26aa9b3a,210,187,23,Africa,19,1362.68
b216b08c458c414981dd9746e294bc74,200,169,31,Oceania,18,1578.51
b21a99dfcbfc48bc8476727f6792dcf1,204,156,48,Oceania,18,1266.83
b21ad2d364e048cbbe10e227ae40d9db,231,196,35,South America,23,1858.59
b21b5ec30bab4da2aec59557302ba9b0,365,313,52,South America,17,1648.43
b21b7dcd7f2344399807844ad77d5f7b,311,290,21,Europe,24,2112.4
b21b83c0ffad4cc8a73ed5ae53524aa7,247,219,28,South America,22,1697.31
b21bc73d389e4a0ea734bce03d520205,325,295,30,South America,23,2169.49
b21e19ea3f4345ab9bf817d6070e72a4,46,8,38,Asia,24,467.3
b21f76c0b299495a9d09b7c75c2aae4f,115,71,44,Africa,20,641.69
b22024884f37490d8acdfe88a67ea5aa,350,328,22,Europe,16,2786.03
b221eb1ad32246db8e22bd41acacc730,364,342,22,Asia,15,2231.1
b223aeb7100943ebb92cee4735518a20,269,247,22,Africa,18,1830.03
b223c8349078460981660853a0de6bf4,184,144,40,Asia,23,1692.9
b227e7f0a5a242b4972b11e44f32d170,308,269,39,Asia,19,2638.26
b227eb6fcc224cfeb96c0910c0e97885,263,239,24,South America,22,2032.62
b22bc986a4b4426795fc50e0ab60daeb,341,306,35,South America,15,1973.64
b22ff0a8d4df4674a0721387a4e0043a,347,300,47,South America,21,1556.19
b230bca4fc6a4019ac25270266c904ff,364,326,38,North America,16,1775.41
b23138b2a05f4e2b9270bd071f454181,365,351,14,Africa,15,3200.1
b232154802124e768acafa97ed95525c,150,98,52,South America,19,542.07
b2325dad119444f58f47069252ec92e0,236,189,47,North America,21,1171.46
b234de5daad14ed5bbde9ebd03f43b21,120,61,59,Asia,21,928.42
b235fc39563e4104b13953d3f8ef4226,365,344,21,Europe,22,1871.69
b237435ec11c40e481185b5a6dd2abd2,239,196,43,Europe,27,875.32
b23aa2fce4c54b31851fcfc146ed70b1,165,139,26,Europe,21,901.62
b23b3a57213648128e079502c9e52c31,79,33,46,Africa,24,562.43
b23b5c73a18449eea9f299be11fefaba,364,346,18,South America,23,2555.02
b23c5eaf89144d46956578758d7f5d9e,316,286,30,North America,22,2141.08
b23d2e0493ef48a6b0bd465056081744,50,1,49,Africa,29,196.78
b23dde9fe0a148fe8a049f8bce69f667,189,139,50,North America,24,843.55
b23ec510b92e45ba9c9670c2058661c4,320,300,20,South America,21,2999.45
b23f5731738f46508d5cb1be4575fe79,345,309,36,North America,17,2302.54
b23f9606783a4c8e9c5d1afbbb525e0c,213,196,17,Oceania,22,1555.04
b2419705bf1b4c9089f69ff8634597b6,62,9,53,South America,23,334.74
b242451a04b8498b8a32bdea09f60828,56,24,32,Europe,19,214.52
b243fcd963184418944fa34ed7fdaf4c,276,222,54,Asia,15,890.48
b2442748455047aab360c4f8554e693b,117,83,34,North America,20,1044.58
b245a560089e44febbe3fa52f08b8ec5,167,138,29,Europe,22,1593.85
b2460ca6e3bd448fb6727e89fe63747c,58,12,46,South America,20,156.23
b246519a7bcc400aa12af3a5e5ad32b3,361,314,47,Africa,20,1821.2
b246ca0d12834dc0b461f512a292d845,353,321,32,South America,22,2020.9
b248137385b242679bdc100e1cce8eb5,217,194,23,Oceania,22,1548.44
b248885aeeb2488295d00a821fd82171,163,119,44,South America,22,1118.98
b248de2ef89e466bad9de69140afc781,262,225,37,North America,21,1964.95
b24af534166d4fd8a947f8907e439807,108,63,45,Asia,22,457.35
b24b64a690c54d298ba3e3781c76e0d5,215,181,34,Asia,18,1966.33
b24bf7d67f404088af05136c0fc5e9ef,140,105,35,Europe,28,827.21
b24c59ceeced45af9c91b08eb319794f,83,44,39,Europe,17,619.61
b24c7fed08ac41e897ad0d5a5406beb0,355,330,25,Europe,20,2606.27
b252b6c74084414cadff58ce7233afcd,83,59,24,Europe,18,546.23
b2531c2a8d5d460aa3bc780b2e95e935,93,49,44,Europe,17,334.07
b2562ab243234f9dac825ee8dc09d74a,194,142,52,Europe,18,968.44
b2567769a6e84bf3bfd3e393d97adc08,159,142,17,Asia,16,1588.39
b256b279b9f749cdb9f9bfff42a784ba,255,231,24,Africa,20,2046.98
b25a3443b8bb4ce8aa046e680c740182,28,8,20,South America,20,126.03
b25c23f7a9ea459ab92f56275c61bf2a,129,93,36,Oceania,17,1126.67
b25de3c7feb24639afb032431ff25b2f,158,128,30,Africa,15,1511.82
b25e067c3917446998af34765d3aec2d,113,62,51,Asia,20,406.03
b261af7f6b5e473fb44e610a03e0079f,356,325,31,Oceania,16,2042.4
b261bb44f99f4404ab4c501416181da5,297,244,53,Europe,23,1264.88
b26256997f9e406eadca06a2a3940d67,84,42,42,North America,21,231.67
b262e4348b4f4751b1eeea027ed31964,338,284,54,Africa,20,1920.39
b263546bbe0f4119a38e4620cb895942,351,322,29,Europe,20,2415.8
b263c9302f4a40a3b2b98309bab9edf6,187,133,54,South America,22,799.22
b2643737574d4606a345d9df2f96b0ef,143,105,38,Oceania,20,1153.32
b268875744574f7098b0948bdef53ae6,110,69,41,North America,20,521.84
b2691bd9a1b745819ddd6107f7d66652,258,220,38,South America,23,2239.35
b2692008dfe64b05967319e5c5959548,56,48,8,South America,22,398.99
b2696638f1584b73a7e7f48ddfd8909d,350,298,52,Oceania,21,2053.42
b26aa37f28dc4a27820788c7d8e40fac,277,234,43,Oceania,19,1377.36
b26ac82e033a461ab8240475bc6458d2,178,132,46,North America,18,1050.76
b26b75122f454c248672ec252eced07e,69,34,35,Asia,19,402.18
b26c098467d64bd599f649175447c53d,83,58,25,Europe,21,504.05
b26c62a5e9014a7389a066be18262ede,184,131,53,Europe,22,1370.68
b26ca6bf023e4b15bbe9d85c4800d21c,64,40,24,Africa,20,730.09
b26e846f9f2d453fb5308dd40754e441,33,8,25,South America,18,208.27
b2719acc596047beb4e1c22d610cd4da,357,305,52,Africa,18,1996.37
b276b79b0d4f4012ab125feb9702ece1,321,266,55,Europe,15,1521.71
b277aa93dfdb4b208a6a8086b1e14367,182,153,29,Asia,19,1346.81
b277fdfdd0aa465aa1bdda980bad9db1,365,357,8,Asia,23,1558.36
b27c5d359d2f4f0f8caef543d489d4da,238,199,39,Asia,23,1575.49
b27da11a48a44406965673d08286f2df,152,100,52,Africa,22,1145.32
b28344e2dcdc4793af1c6100c95c7a41,115,70,45,South America,22,771.54
b287890e50684ea7b22403733fc42f80,307,250,57,South America,16,1451.74
b28969fcbc9047d39b6f219d2c63b70e,122,83,39,Europe,23,376.99
b289c64d1ffd485c863aa252dbfe4992,214,195,19,North America,25,1742.13
b28c3e6c249c4217bfe026c7ee206227,337,303,34,Europe,21,2528.1
b28c52987b9743feaeedc605f734affa,223,181,42,Africa,24,854.22
b28e2254e59643899ab52617323c3e2f,343,326,17,North America,19,2515.15
b2908aeaa4314b9c817f3b6ff60ba4ab,365,323,42,North America,18,2298.31
b2956ff176c245cf9ea6de7df52fa569,345,311,34,Europe,20,2654.43
b2965a5d2b0d433c9b2b86261e91de04,361,354,7,Africa,21,3289.79
b296a0097c444889a8744944142c2b4a,359,308,51,Europe,19,1902.16
b2974d8dd01446ed91a7ccb6e6d19f81,244,217,27,South America,16,1502.09
b2976cca6baf46efa39b47f42527994c,86,50,36,Asia,24,831.13
b29e932e1e894a3ab87cc9abc7238cd0,74,48,26,North America,18,461.48
b29ec99c40284a21bc28072d7228194c,139,121,18,South America,16,1100.79
b2a0c71478164e65bda1c679a3791525,343,299,44,North America,25,2622.71
b2a21b047c4a448d907f99164e57bafa,364,355,9,Asia,16,2927.74
b2a63cfe7d9844ee8e1029b1d74489a2,182,142,40,Africa,18,1242.72
b2a6b230352046da973c7ccc6841e6b5,344,289,55,Africa,23,1886.92
b2a863acf16d4a5d9b1c5a3028e4ba3a,54,3,51,North America,20,141.49
b2aa9c4352594f299fbfd2de30e6eb77,85,29,56,Africa,13,221.93
b2ac7185764643d0b0e1f8e5565fac58,126,81,45,North America,20,715.38
b2ad20d2944d49aea38bc6c879644875,297,268,29,South America,24,1916.48
b2af36d52e2e4ff48294bd21db907541,78,30,48,Oceania,23,534.79
b2af800684534bd1839530e0b04037df,207,180,27,Europe,18,1530.38
b2af9c2e65cf49f0988641ba7b66fa18,171,129,42,Asia,21,992.47
b2b2b25c1eb94d73a15e8248a08524ce,277,242,35,Africa,25,2198.06
b2b4df5cbaaf49659146d80a8c8bedfc,235,209,26,Oceania,22,1688.96
b2b876f371c649bd934db03a562ea01e,95,69,26,North America,23,544.37
b2b8d63ec7df4b849fe3eb7cef1a818c,158,115,43,Oceania,21,772.09
b2b9a8d7f342480aa10116bbcf749e93,62,2,60,Oceania,21,242.71
b2bafb6f50e243fba18024356e3bfa8f,357,301,56,Europe,22,1858.95
b2bea4dc27e84189b73cb799d57ce456,357,314,43,Africa,22,2893.65
b2bf736b92b54b2d9ac0fd1cdb224365,332,296,36,North America,22,2502.32
b2c232a580f34dd9943f40f641cb5112,309,273,36,South America,23,1555.01
b2c2c500da29413e83b2bca3aff8e3dd,347,297,50,Asia,21,2410.22
b2c3878b242d4354b8033843870ee61d,365,355,10,Europe,24,1254.34
b2c5de3e40654399a7f6919b7d563d8d,57,42,15,South America,17,247.45
b2c8bcfbd9bf4984b4779d920c372d20,95,64,31,Oceania,16,623.23
b2ca4e58360644eb861b6120b57dea48,149,100,49,Africa,23,894.95
b2cb7b2ccad9495dbf00ab7db7badc86,345,292,53,Asia,19,1428.42
b2d01a1997a04c88a6f196612976d975,363,327,36,Europe,19,1669.07
b2d0a79dd83349b099acf4b65dfb57f4,207,171,36,Oceania,20,1149.95
b2d20e7b791347f1805df8ee0db2650c,88,54,34,North America,18,270.06
b2d687972cfb430aada32dae0ae5071a,247,206,41,Europe,18,1554.83
b2d84ce93f2b4c2ab6ae0c767d26745d,180,131,49,South America,25,1300.69
b2d8af40fa86411fa3d456aca7498593,264,223,41,Oceania,19,1924.59
b2d95fafcef24ac5a6cd69d8c62c3d7e,172,130,42,Asia,23,665.51
b2d9a4317a3741aea4ddd55f2b32811f,365,350,15,Oceania,13,3112.21
b2db4f1a0205464d93dd0a66184ea5c7,129,88,41,North America,21,823.47
b2debb316abd4885b278cd6f8bdf8303,297,266,31,North America,20,2249.73
b2e01eb0a170494d8caa107f48bdb304,278,245,33,North America,15,2651.37
b2e08350b340430e9e78ff772c6e4303,285,249,36,Africa,22,2029.36
b2e141a5eae5450ca9e30e3d57411510,217,189,28,South America,13,1961.12
b2e159ad649044a6864e047ccb168669,28,6,22,Africa,18,118.16
b2e2a743901a40c1ae32f42e3ed8151a,243,218,25,Asia,18,1612.64
b2e69cda876e46faa49127c54543d0de,294,256,38,North America,18,2639.86
b2e7a5175b0e4788b6c121f714b7938c,84,59,25,Africa,20,758.79
b2e7de2efadd4c63b658a799e5f556b8,176,126,50,Oceania,16,1237.05
b2e80ff2decd491ba155f799f4174309,134,116,18,Europe,20,689.31
b2ea5638339a42d18daf39029bb64da7,52,20,32,Asia,25,277.04
b2eae672833e425f9cf48950e292aac0,365,345,20,Oceania,21,2234.52
b2ed8c786abe425b98e31c2a795dbb20,128,78,50,South America,17,641.14
b2ee0777a2fb4f7da5d3d1ad7bb89056,245,200,45,Africa,17,1287.79
b2ef8230ffd34b13ad4238132bd23d66,176,129,47,Oceania,18,695.72
b2f07b6cbaa14895b1382d4f69b64aff,346,309,37,South America,21,2213.9
b2f1d65ecbc647e2b2b09ea17f0adc1f,208,185,23,Oceania,14,1231.14
b2f28aff7e7a4246a59ccc4b4b2d5563,316,288,28,Africa,20,2109.28
b2f309ab283e403c9f0ba07589444156,161,113,48,Africa,19,560.14
b2f30f85b83a4f2e9526f169a344972e,93,43,50,Asia,18,478.97
b2f3d0491bd54dfeba4b21fee9af9105,299,276,23,Oceania,22,2234.72
b2f60311167240f7bc8596012cbfc340,110,81,29,South America,15,735.06
b2f62730a47c4f69bc71ff0272a1770e,194,171,23,Asia,18,1532.02
b2f7b5db1f8d4289a586d45ba88522af,148,124,24,Africa,23,819.27
b2f8342f8a2f455db5729605ea3fce63,105,58,47,Africa,17,408.19
b2f8d81b7de84e2d94e7ba44da0d0194,306,256,50,Africa,19,1296.58
b2fbd0c90c2f4003b6b7c11579fda214,313,271,42,North America,19,2276.31
b2fc4bf1c51545a7bd864356f569a3a3,96,55,41,Europe,22,617.22
b2fdf8ddedd74b678647fc794bb6e402,165,131,34,North America,20,1107.39
b2fe39230d2e46b7920adc331290b82a,187,168,19,Oceania,20,1091.66
b2ff94ba260a43be827e3c05c3e5da15,285,241,44,South America,17,1986.86
b30190828d134d7fbd5a09490317e416,362,307,55,North America,23,2008.25
b301951ec02141ce9696ac7a55632d44,116,94,22,Europe,27,773.59
b3033ec77f7d4a289245068f0e9afb7f,45,17,28,Europe,13,375.36
b30386ecc24245e38065a8b06405788c,58,32,26,South America,21,403.91
b3042cfa37d8428aa51a09cc0455d141,51,27,24,North America,19,218.28
b305f2afeb8b4effb07aeba601c38be7,355,310,45,Oceania,18,2666.37
b30676a7f53b4de3b10291872c613844,240,202,38,Europe,22,1204.05
b306811f6e9f440794dd24f39ffd4d6a,75,46,29,Oceania,18,309.11
b3076d6f36c44c4487f5e6207d5c78dd,60,10,50,Asia,18,320.27
b307b7b272f24196a0abc50f06c4ae0e,140,89,51,South America,19,1218.62
b3081b666645436b8bdb9054f3b2e5c3,107,55,52,South America,21,521.97
b30869147ff84ce496d1fac9571ba9cc,168,118,50,Europe,25,453.25
b308b902d4984fdb9e47e0528438e4fe,71,44,27,South America,21,342.4
b30ac7e69b1641ed8a0d8dd86adbd561,362,325,37,Asia,27,1922.49
b30c257bc9f34d24a29cf325557d050a,175,143,32,North America,18,983.44
b30c428d226e4042b5c158f074feb264,243,193,50,Europe,18,1147.97
b30e77060dda4c599bf98f9b64806770,168,129,39,Africa,15,886.06
b30f5997492d4ceab8032f04ea5859e3,288,248,40,Africa,21,1949.62
b311d449842f4023a326863979a891bf,99,56,43,Oceania,18,659.61
b311d82b94c049dfa7676eb0f604489b,269,218,51,North America,15,1702.49
b3127707f6304cfb940d90dcbd46b662,184,140,44,Oceania,20,1565.23
b313ed3b7829437ab32af181ffd56d85,162,109,53,North America,22,920.91
b31468927c0d41e6a410020f10c87496,208,171,37,South America,21,1050.6
b314be8b97494aba8f3414c42dbae4b1,313,276,37,Africa,21,2024.63
b315cea6f6a74e19809e9279156adc9f,215,167,48,Europe,19,1305.09
b316b72db0524134a944d3980148ca0e,198,172,26,Oceania,20,1443.21
b3170fee69684a93b53b9bd0e8c8af66,119,89,30,Africa,21,183.31
b31852cccde54d009f2d61ae241821ee,327,269,58,South America,24,1079.14
b318b19372bf46428c87649a0b3a9e35,101,70,31,North America,18,688.58
b31b21c23d854eda98a3566189146fec,150,119,31,Asia,14,972.59
b31b7600c58c4db0ab830a0122eaac27,122,69,53,Asia,20,749.93
b31bb01b130f4edaa8d8d19e6291018f,191,160,31,Europe,20,2066.09
b31c9b84f67041bdaff699eadee2ad96,225,173,52,Oceania,15,877.73
b31cc87871f744afbb279a6526268ba6,282,253,29,South America,20,2095.87
b32016e95c034e9f97a84e2d5fb61bf0,229,183,46,Africa,17,1033.88
b320df10eac444bebc31d924635fa191,217,182,35,Africa,19,1153.89
b320f76cdda343728c3ce70d8398845d,248,223,25,Asia,19,1565.78
b32141046ab8466b963ed791b1edfd5e,364,327,37,Oceania,21,1444.38
b3228b2fca284f8a8721962a975540ec,257,216,41,North America,19,978.84
b323bf8d722740d487f5c01fb9bb2d64,365,341,24,Oceania,23,2263.65
b324a36f07394245aa6465df88cc27e1,42,17,25,Europe,19,118.19
b324c3b80cf942d5976678b745830ec3,47,10,37,Africa,22,273.99
b332a8eafb694fcca58e049d9158f962,144,88,56,North America,16,1213.04
b33448b273f84470bfdfd17876936001,73,25,48,South America,19,581.23
b3398939080b4e559e8792fe7055a497,185,131,54,Oceania,19,1109.53
b33c021103234d06aab4afd41ce9c955,292,272,20,Asia,19,2402.78
b33c9a71876f475c9112c86c28ef5bda,292,265,27,Asia,23,3170.29
b33ed18dd45543feb9ce642e694a289d,331,299,32,Europe,21,1982.95
b33fc198604148eaa3f1f15976e0c23c,312,295,17,Europe,21,2704.53
b3421ee103974559bec22c6b1d1ebcbc,93,73,20,Oceania,21,645.62
b342b031362c493cad8647ad4794028e,179,152,27,Europe,21,899.94
b3430ae1a02a4dc8a41592185b9721fa,282,261,21,Africa,20,2289.07
b3457381503240c88c6496fdee73a361,283,253,30,South America,13,1990.91
b345fc538bef4150ae053688407490eb,149,118,31,South America,17,1116.25
b3460e0ecd0e4b70919e9e953208a675,135,93,42,North America,23,931.39
b346227345134fd1b1f2e5300a77e360,279,229,50,South America,18,1385.33
b3463138c1214082a3e34e148e246996,365,322,43,Oceania,18,2221.02
b34685419407474fb38d02ed44fc9d8c,286,248,38,Africa,17,2145.73
b3475f24d75448c7bf48aa0350db4089,237,203,34,South America,20,987.4
b3488a8c85754168bfc6c7e11180db0c,292,242,50,Europe,21,1213.11
b3493a9ab9ab4151b56811ba6a593be1,194,150,44,South America,17,724.39
b349feaffbba4763a54e189c8128d456,161,116,45,Africa,21,886.96
b34a08e5d0de4cb998debe1d531178d1,319,301,18,North America,15,2617.92
b34bd1c99d624e329103488c2a2a1501,269,218,51,Asia,16,1280.15
b34e7f5ffa18451d9cd422e6b7a25386,364,346,18,South America,20,1519.26
b34f3b1e24e34d9fa9ac1e9eae15ef9f,217,163,54,North America,17,1082.47
b34f563a5f1244e58bcc6b35df07a4f4,77,18,59,Oceania,20,342.11
b350508975da447fb6a40f247ddbcd8e,140,96,44,South America,20,925.49
b3529d1a04b54f43ae92415d031e0bb5,109,80,29,Oceania,21,970.19
b352b5e982b94cbf94b1f21b9a49b7f2,134,89,45,Asia,16,1216.08
b353535100aa4f078f71b76d7f28ca56,208,175,33,Europe,20,1540.09
b355662f48774dae9a604827c8651d2a,315,287,28,Africa,22,1953.41
b3579b4a663b4d019f095de9ff8fdaf0,239,209,30,South America,21,1183.76
b35b7b4003884afc868bb29d69bf714f,364,331,33,North America,13,1396.71
b360e06a7797402f88657c4b9406ee47,203,167,36,Africa,15,1072.28
b363583712db4f8784b33d05f51c3d7d,93,66,27,Africa,19,554.14
b36ca2463c0045118a6f55fdac6da733,254,195,59,Asia,19,730.72
b371a1979dbc456299b1f5ddae400dfa,207,176,31,Asia,19,1546.9
b371b7b967334a59bcc319ba0d60c1f3,365,353,12,Asia,28,1692.05
b372a384c59c4fc6908ff92ea616aeb5,172,150,22,Europe,22,1381.19
b3733eafef5049e8b1a9dab126ec2aa6,71,47,24,South America,21,630.08
b373b31474c84b98963adbfb3bf03d1b,359,341,18,South America,27,3200.09
b3791246d79546649c5ac0595fac1a76,86,55,31,South America,19,905.7
b37a0a5bb10d4c8aae94a035b423ade7,59,7,52,Oceania,20,321.73
b37ae06dc0a8425caac4bd9a115032ed,167,135,32,Asia,18,1215.03
b37b763dbd5b46bfa9abd0ebfb43a702,263,227,36,Europe,18,1520.62
b37b9aa070c84dfc8025bad9b0ffb29b,186,155,31,Oceania,19,1210.44
b37eb2b607164ecb8ede052149eff816,218,193,25,South America,22,1342.49
b380cd14aef74070a10ae284ef2eb1c1,267,251,16,North America,16,1792.09
b383d010deb74a1fb3179262836cbf3b,74,46,28,Asia,23,633.21
b38556e5154d4413b90672f51410350b,365,365,0,Africa,18,1834.99
b38786e8d40f47c5b57a8c8e5f050a4e,300,248,52,North America,20,1463.2
b3886174d1474476bc9918aaf07d367e,110,76,34,North America,23,611.73
b38971dd266f44379770ad214d98f78d,83,55,28,Europe,23,547.09
b38c8cfa876d4961bdb1991e3579df8c,109,61,48,Asia,21,701.02
b38eca6cca7542c1a717459bb0102118,212,167,45,Asia,22,1992.26
b38f949126684f709d66de41583ae5f8,211,156,55,Africa,17,903.32
b3900b1cf7514d2ab561ef8c6bbf6fc5,136,99,37,South America,22,1144.66
b390a417f0c64d9db535b0ad0292da11,298,254,44,Africa,21,1676.98
b3913451e4d044449898d1ed5d87441d,206,172,34,Europe,19,1273.8
b3937d4421154012b499a99f583e81eb,270,223,47,North America,16,1636.66
b394667cd5d6490ab9e4c5990ce96c33,316,284,32,North America,22,2480.55
b395d1a099714edf970e5f7f567e83e3,229,175,54,Asia,22,1147.52
b396cde6764a47f2a6a1cd81226a76a5,339,289,50,Oceania,20,1440.33
b39b9cc745ec484c9af4992ef81decd4,76,37,39,Europe,18,434.99
b3a16b4fd68f4e0991ac52ea19f15447,290,238,52,South America,17,1286.99
b3a284f0e6ab42e98e83505f2d06f369,365,353,12,North America,17,2944.13
b3a47c979afc418e9bb6ec5d0a889b3f,225,197,28,Africa,20,1324.67
b3a55fcee7b64423a8f37641403969b2,361,343,18,North America,16,2206.59
b3a6d33fb29a4f939eaded8c1f2e71bd,126,88,38,Europe,15,767.98
b3a6f48251f742c4a863fd21295624b8,195,145,50,South America,21,991.45
b3a7e1fe469a48faae56ee3f2835b68f,354,313,41,Europe,21,2043.7
b3aa0e33388f4dc0881a3e194073b07f,364,351,13,South America,21,2151.61
b3aba02eb0434fcab5bf3fb914c5b2be,185,138,47,North America,20,896.56
b3acdd60a7f544beb9778a45bad088de,136,98,38,North America,17,1360.4
b3ae2d2584fc41bba3546a409ac97aa9,79,55,24,Asia,14,791.84
b3b29a074618433cb5c934af4743044d,197,158,39,South America,18,1335.17
b3b3a161b94d45c7b4087d4006bfe136,257,233,24,Africa,20,2532.21
b3b3e01b261645849f2d8f6f6028fe85,55,12,43,Europe,19,262.77
b3b72c11d5244fb292a52f5d15ca8886,207,173,34,Africa,21,1602.24
b3b7ed8a82d248fbb71844eb12b61e3d,242,207,35,Oceania,15,1576.33
b3b8f652c0d64ed8bf5fbd692eb18cc2,211,156,55,Oceania,19,1387.44
b3ba4bdd12b748b8aff74c4c5e9bba78,193,167,26,Oceania,17,1623.88
b3bb29f51f58451e9e01c66715de670b,294,266,28,South America,23,2316.65
b3bcc10e8dad4f798ec6d7402a8567f9,358,332,26,Europe,21,2993.33
b3be6187bee049258ad1b562fed1d78a,188,158,30,North America,15,1963.73
b3bfa06480ef464c9b0bedb949fab8c4,224,182,42,Oceania,27,1634.81
b3c5b69d90e142429b1fd7b4938e86f1,216,163,53,North America,22,908.97
b3c7bd0856e74f5fba470412a1c19717,146,106,40,Oceania,22,1165.88
b3cd1953f3b04a06bd287d03a37ae187,365,334,31,Asia,19,2273.13
b3cd8bcb3d62417f82ae3ec10fb42ac5,157,134,23,North America,17,943.91
b3d071f5f3c1458296fcf5b5ca972e38,250,228,22,North America,24,2316.42
b3d31e52e52b46718f0d5abcfb21dd1c,49,20,29,Asia,18,612.74
b3d3b306168646d48feaea91df170072,200,145,55,North America,22,864.93
b3d459f91f6c4b329bb5fbbf39326ee9,109,59,50,North America,19,623.89
b3d4702de3664de093396996c0097f35,170,131,39,Asia,16,1079.6
b3d5574751924ed6add5f40642c31669,178,128,50,Europe,22,1161.55
b3d566ec269045bb8a24341280476a5c,214,162,52,North America,22,575.63
b3d8651c1d0845d280250990036e2fea,311,269,42,Africa,20,2821.28
b3da8fa170ac40fc8145434c54788dd7,72,40,32,Asia,21,601.62
b3e0f78e09424e88b9b184b44c48eb4c,220,185,35,Asia,16,1052.87
b3e10e94aa3547fba1f97880a4d491ae,160,135,25,North America,20,1116.93
b3e26fc84a0546d097a9c646507966d5,34,24,10,Africa,21,291.51
b3e4568a0c8242e8ad2a5724eaeac724,168,132,36,Asia,20,1517.58
b3e474fa2bed4857baf11295f09f966f,179,148,31,Oceania,20,876.71
b3e47776dcfa4df7854845f45813fecd,177,150,27,South America,20,1326.55
b3e49911364b43fbbc7eef06f3c5c0b0,365,344,21,Europe,22,2742.2
b3e57ab98ec5436eba752e35bfe24967,233,190,43,Africa,17,1171.19
b3e5d15c36874c6197863ad7bed2b534,69,23,46,Europe,24,243.12
b3e7fa8fd65c4e339b70f854245edb91,295,243,52,Europe,18,1373
b3e8e4df230e46398ee7720b21e654be,351,314,37,Asia,24,2922.74
b3e9a80b623b4a0e9bad80d2e62d37ab,183,139,44,North America,24,657.19
b3e9f50cf90f45d2ad0429f27a300bfe,274,223,51,Asia,21,1319.89
b3ea7fb0bd024b1ba8aa6cd7267942dd,363,321,42,Africa,23,1161.49
b3ecc1e5e4f54bec8d8346848fddd14c,170,113,57,Europe,20,886.99
b3f4ffe98fbc40aea3d3b7d8f67f3030,250,208,42,Oceania,16,1833.13
b3f5204f652b4ff88c8293e543aa1a8c,335,295,40,Oceania,20,2258.05
b3f63c3d00124ef8ba96c3beac923b64,287,239,48,Africa,16,1610.26
b3f81aa6c1ee42bda8528b052860aaab,271,223,48,Africa,12,1424.66
b3fa8e9655f74fcfb98a679908f10554,297,269,28,Europe,21,2348.82
b3fbc7ea94cc4cdcaeafdd03f5c5096c,166,132,34,North America,22,1310.73
b3fbf45afc78497faea85d1792646f80,172,121,51,Asia,20,764.24
b3fd619fe3444b0894eba4c1f1491ff6,73,41,32,Africa,17,412.02
b3fe0ca276e14600952056ebdcff028d,111,59,52,Oceania,21,512.42
b3ff7b2334a24bdebd2590c7079376e3,304,250,54,North America,15,1238.42
b40425f9ef584b92a7187b968a14dd52,38,6,32,Oceania,27,277.9
b4045551c6a348869189f3ae2bb13bde,32,12,20,Africa,18,449.47
b404e1a19389408aac554de9d7f683de,110,70,40,South America,23,901.89
b4058c11cf8c4890a197b8ec883dc2f0,47,12,35,Oceania,23,213.52
b4082de46b344f2da46cd552f13ff4d8,208,159,49,North America,24,641.08
b40870c7b0984ebe8aa10322b644ec97,359,337,22,Asia,20,2040.83
b409ca3fd87442a6ac5589ddac3bed17,104,76,28,South America,17,911.53
b40c61ae44e3463a9f3add08181fc199,127,75,52,Africa,20,618.31
b40d8130283a4da6952b6e3ffd717f0a,71,19,52,Asia,22,134.55
b4135b030d114c2dabd3b8a00a4a0737,73,44,29,North America,23,545.24
b4144c1fac094c90a9b6698498981e04,254,222,32,Africa,22,1828.42
b4144efd52e74ba6862a2a00366f4043,365,324,41,Europe,18,1841.7
b41562a1ec514f0d8a1cd2ff9eb6d01c,273,217,56,Africa,19,1156.16
b415865e9f5b475aa2ce841566d06052,188,151,37,South America,18,1763
b416185c50d84fae95df7109793f1eaa,86,59,27,North America,21,462.03
b4179482ecb94995bda938573202335f,351,290,61,South America,17,1902.27
b417aa56901841c9a9409a30aff07e2c,198,172,26,North America,20,1844.65
b41d2a88038a491e848313ea91a0ff7f,23,1,22,South America,20,74.23
b41da549820b46d8aaee06a7d90c0db5,308,283,25,Europe,26,2613.35
b41e5ead6ea84399ab6a42fb537a386e,154,123,31,Asia,20,1267.38
b42195c4de3a42e5b895ac021c34b3cb,139,104,35,South America,13,882.53
b422337bc2084af18e18ea404dc95917,358,327,31,Europe,22,1792.59
b4226722af004efcb5de89d00be2496b,352,298,54,Europe,18,1768.77
b42430c86d3d469fa482f0fb3c3bbd10,217,192,25,Europe,15,1785.9
b425dc6f638f45c9833e148de5ba7a34,93,47,46,Africa,21,670.71
b42788c12b0841b68ee3ea7c71573283,185,132,53,Europe,20,1032.46
b42862d047c740a39a9335c77340d7bc,327,298,29,South America,21,1979.05
b428d54ddd6541fbb58bbfe9ed4cc430,323,291,32,Africa,22,2247.87
b42bbfac47aa4a76b076009d3dd13d47,124,81,43,North America,15,986.09
b42e132177604aff9f76415f0cde33b8,326,281,45,South America,21,3075.41
b42ebdb40fb9489ea266d317121cef4b,145,117,28,Africa,22,1473.35
b42f13a348644e858b76e258b2461b53,295,247,48,North America,22,1543.33
b430a7c810d044df921c11e248100abd,325,301,24,North America,19,2714.82
b4318a3f938348a38935cac68c784ad1,326,294,32,Africa,16,2166.22
b4326ec3db8c4b159052fa0dc96c17ae,164,115,49,North America,19,656.89
b4353b4517e94c03903e174dbb54155f,214,177,37,Europe,17,1796.1
b435d7d63b314ff2a43f22a627d0b057,105,81,24,South America,17,878.62
b4373d0f18bd40089f75e7384ca4f02f,335,307,28,Asia,18,2985.49
b43842f315d44e0ba375058b9d4fad82,320,275,45,North America,21,1570.37
b43b8fec4d664537b252cf7f31b7d20a,234,192,42,Asia,20,1134.21
b43e3e243ae2405a88a3cd4b38b9d047,217,191,26,North America,17,1501.86
b4426a8436f0432e97b5eee79439a38b,157,116,41,Oceania,22,1675.08
b4429e19ae274babba89ff3174750fd8,193,155,38,Africa,17,1271.08
b443a9bd33914918a684d07584846556,269,214,55,North America,20,1271.66
b4448cf6865b434cb0ee96ee8e9ce196,55,30,25,Africa,19,322.03
b4454364de77442db67cbf75de5312e9,362,327,35,Asia,19,2135.84
b449bee8099a45c997bb0df08f8c7fbd,265,242,23,South America,19,2677.89
b44a7753c6344e83811bfe8ab9c87616,323,289,34,Europe,21,1871.29
b44d9f503796449b8c8637991890754b,343,292,51,Asia,20,1289.82
b44eb51c68fb4baa860045017aa87e58,298,252,46,South America,24,1358.37
b44f25e3d98040bdaffe6afb5c3b1bb4,365,331,34,Oceania,17,2102.57
b45157f2010a4f048139f6c94ec76588,73,36,37,South America,17,753.77
b452bd661ced460a93daa43a77b1f2c7,362,343,19,Oceania,25,2945.57
b453ce0b0c01463fa3afec57a49e3358,363,354,9,Europe,14,3587.49
b454fe4aac534092aad8876e2d3e1f4a,355,339,16,Asia,20,2595.44
b455083e0cec4d15b6540f8b1c807647,200,165,35,Oceania,22,1264.39
b455608b971a4b04b8d4d5e0585335d1,33,20,13,Oceania,20,296.77
b4559b737b3548f9b89a87c33e9731fd,104,66,38,Europe,23,405.84
b4561b2bebff4647bde9a1040f88a27d,365,362,3,North America,18,2015.72
b4599e10514e40eaab98bd177ea1a491,254,228,26,Europe,25,1986.17
b45af68e13d9402b8eb8e80cfd5bd847,286,243,43,Europe,18,2039.59
b45d33898407412ca0d4b6ccaaa91c62,358,313,45,Europe,20,2636.1
b45d405800ae420d90db53d2ca1708a4,235,185,50,North America,20,1312.6
b45dd70f6e8041328a085cfb636b8b26,125,98,27,North America,23,1320.5
b45e08923f5742c39c9b5c66292afd7a,172,138,34,Europe,20,1244.95
b4603ca4ceb944b0a386e9056bf6e4ac,215,188,27,South America,21,1520.97
b4609072b4244c719b20294c06c035c4,300,268,32,Asia,20,2819.62
b4617ad346504b5c8594168e08442e79,270,247,23,Europe,23,1649.29
b4639a371f9944ea8311b1b1f0710953,362,318,44,South America,22,1728.53
b463ad7fd8b140a984fbf3725ccd7a8f,54,23,31,North America,21,341.99
b4660a4055214f8b809d1a0cae3be318,78,32,46,Oceania,24,378.51
b4662895752a401db36a2f4bd8e7bbae,285,260,25,North America,18,1605.33
b46b3f041f4d4494b3b102ae0c0615b4,262,227,35,Europe,24,1823.41
b46cc0bda58a4259bb5bfedc6cb64725,73,49,24,Oceania,24,367.46
b46d9d9f1cc441bc952cd1ccf4b896ca,246,218,28,Europe,20,1601.46
b46e31b2fbe54869b218e7f596988dad,50,20,30,North America,21,267.81
b46e85e6313d4d7eabc96e9c437111a1,54,17,37,North America,18,651.84
b46ebcf3a7db47499bbb204af9efb2b0,295,274,21,Oceania,20,2026.92
b46f39b7b30d4f21a33d75257fcaca6e,122,91,31,North America,26,816.84
b46f5d68be334aaca9f02a9628f683dc,73,39,34,Africa,19,525.32
b46fc0e3209847f4a52b4c6f5f0a4466,365,342,23,South America,18,2020.94
b4737602b6d7482bb789af362fa4f103,56,21,35,Africa,24,222.96
b475560cf96e4096a50aded1750957ab,259,211,48,Europe,18,1889.74
b4761e89d89e4a05a2d04ee01a57bf97,112,64,48,North America,18,503.22
b476e6e2be3f47dcafd785f29687b465,51,15,36,North America,22,506.71
b477cc1c1828494abe89fc7f41b92e6a,143,94,49,North America,25,799.47
b477eb6572174be3b1e147fd48080ec7,273,220,53,South America,19,1532.84
b478ae88ed884631bb2f57355b6ac4c4,347,312,35,Europe,16,2338.96
b4827b6b59b748c88c83eeabb5ae9261,151,106,45,Oceania,21,1105.23
b48357087a614637b7b7acf704a1e5b4,141,100,41,North America,16,1155.29
b48383da3f9245b697dc730f9326e12a,346,309,37,South America,21,2552.66
b484df34d5df491389c5f5e5d973c0da,178,126,52,Asia,17,613.93
b4857d3091cf46f3afe5c05dff614db2,261,225,36,Africa,20,1171.26
b4863eaf611c4d9eb770bb85007bd6e9,365,352,13,Europe,21,1794.12
b4864d1aed0c44ffb58f0708b9958620,53,34,19,South America,20,401.27
b48815307574447d9037538f6de43a3c,165,117,48,South America,22,827.62
b48976c2919949bca533f616d56c4aa3,159,131,28,North America,18,881.63
b489925b36324bbeb64f495f53e2241c,257,236,21,Asia,20,1929.75
b48abd61e98f44e2982312f284914820,202,175,27,Asia,20,1268.96
b48b41fd0551452fbb09fb411121ff9a,64,42,22,Africa,20,437.6
b48c763d0d934288a7eb5e4099f339e9,209,176,33,Oceania,18,842.14
b48cd788aeca4ae28e06cf3e664d7202,128,104,24,Asia,23,1874.59
b48db5aee363426d800fdd119312a27e,125,91,34,Asia,21,874.09
b48df72fb45b47b9b3f18d3348ffb276,213,186,27,Africa,21,2077.43
b48f8e2945d3479191e7a2b09a347f0e,186,164,22,Africa,24,1245.35
b4900f8257474fa58df50f41935900c2,68,35,33,Africa,22,424.86
b491e9c73a844a1f9af45ca1690059b9,124,107,17,Oceania,15,873.66
b4932f5d8e0442dd873b50fe67c35635,365,350,15,Africa,20,2716.46
b494c227b77a47bb8bd09f3f13e99ee4,365,341,24,South America,18,1166.35
b4954040cdba4e999e2ce99de20c5f91,251,207,44,Asia,17,1397.19
b496a11ff02b42adb64f2a7bd8a66e8a,122,81,41,Africa,21,1003.3
b496a220a6314eebbebbbb8c66da9387,288,254,34,Asia,18,1727.3
b49a4e1c94064ac0a3a508679e2cd21b,331,308,23,Oceania,14,2654.01
b49d3781360e43a7846db02a800d24d0,365,363,2,North America,18,1501.1
b49dd2b9e3db48d7a0082fa548b75294,107,85,22,Oceania,14,823.36
b49e22663cad45378a191391e589eb4c,259,224,35,North America,21,1821.52
b49e25cde7e0447d96d84a7cc941bc71,55,23,32,Asia,18,590.15
b49ed76fe9bb46fb878db7ce175bb46c,168,113,55,South America,21,934.6
b49fa8ec682e4ef1be04726f407eba71,364,316,48,North America,19,2205.22
b4a0c731b76042b7b1e5a6ebd52bba94,122,89,33,Africa,19,978.35
b4a2737c256e43fdac5a5033f11cdc54,201,179,22,Africa,20,1683.33
b4a3d6c6bba9401694875bd175f948f6,276,234,42,North America,17,1760.66
b4a4569330a74f238fe625936db56034,303,273,30,Asia,20,2094.15
b4a5ca565e4d4342a0f160f7bcf5efd1,231,207,24,South America,20,1776.59
b4a6f4482c7d46819bbe2ca449a701cf,168,139,29,South America,21,1367.02
b4aa3d497c1546319caad38d74b17934,284,239,45,Asia,20,1333.75
b4ae219d42834ecfa487178cb226f72a,90,51,39,South America,22,856.21
b4afb256f535482da8602a111492ba22,111,79,32,Oceania,22,964.61
b4b3037e437a481fbcd24ed9cc2b3f31,299,247,52,Europe,23,1523.5
b4b3f96eb5484126ac02880f10556cbb,307,279,28,Asia,23,3004.26
b4b5df41f04041749d49ec5385164246,226,189,37,North America,13,1633.46
b4b81839f7974e288ec623e6b5311ebb,209,158,51,Asia,18,1176.69
b4b88e7576f54075a118080dcd9eb1b3,211,156,55,Oceania,21,1290.55
b4b890b67fe54edc963d3aac486c26da,200,177,23,Asia,18,1899.7
b4b986fe8e1b465b838d0afef27f2716,315,283,32,Europe,16,2374.14
b4ba5ff25fc64c3ca1f9cba2b78b0156,150,107,43,Asia,20,772.73
b4be2d0b663246d69113dc322befac06,172,148,24,Asia,19,1124.14
b4bff9f3c0804e8187896ff6eb9587d1,54,15,39,Africa,20,170.94
b4c258f1057e4d589b9258b8c71b9c78,79,34,45,Europe,17,329.03
b4c46b4624ad42329b1b0a819fce8959,111,80,31,Europe,18,1200.07
b4c85e0383874f48b9702201a87703a6,231,185,46,Oceania,20,1151.39
b4c9131ef0e1402a8c40f1e399624c37,313,269,44,Asia,22,1706.85
b4c9962a597446dca9b01b92297776f4,342,305,37,South America,19,1908.47
b4cbbe2ca6b6465194609894140f7d18,127,112,15,North America,22,726.17
b4cbde3d0db949a9913daaaa67410b8a,160,148,12,Africa,15,1530.45
b4ce3646979746ddaf6f4bc80fc51ace,161,115,46,South America,21,593.69
b4cf0e21fb484fe69409e6745692e2ff,264,230,34,Africa,16,2386.35
b4cf909038b34aca9cd5f70265ceb3a0,68,32,36,Asia,20,336.47
b4cff362307c436aa2112b26b02104be,362,338,24,North America,21,1937.6
b4d0005c046c42c89622dd3c97ffbb5a,134,111,23,Africa,24,1157.2
b4d014aded6141c0a3c63c3f8b666e49,281,252,29,South America,21,2204.17
b4d3f2a054f6499e9ebacd68c226dcad,290,234,56,Europe,20,1050.5
b4d4a10f9d714634bae1e2e5ac1a5b9b,280,248,32,Africa,22,2462.02
b4d59289dde340f5a45d9388ac070e05,314,290,24,Africa,18,1890.59
b4d70170efa043fbb1af68ccf9d96cc0,293,245,48,Oceania,26,2336.91
b4d7f3f48ed34498aec2c2b185711ad1,49,27,22,Africa,16,650.5
b4d91b3ccd8941c0b41f1d9a62767a8d,363,354,9,Africa,14,1493.86
b4d93a1131eb4acea8a6a22caaaf9831,31,5,26,South America,22,279.82
b4db3f30128b4228b7353c8c739587d7,250,198,52,South America,20,1150.06
b4dc1daed969430daa38921605c82633,270,224,46,South America,21,1471
b4dd4a1537314298bd89eff8678301bd,92,46,46,Asia,22,192.46
b4e1986405fa48498885a0f76fd1c496,67,11,56,Oceania,20,164.3
b4e1d513a5734a0197958f0d37359141,216,186,30,Europe,20,1117.17
b4e2aa39ace0417b8860e0d8b5075f3e,364,361,3,Europe,17,1684.22
b4e39d017a70427ca40a3dee48ed7035,359,355,4,Africa,12,3320.59
b4e50a8000f344ddba9b75d8efe50c25,181,151,30,Europe,14,1815.01
b4e590757f534c1fad0992a572810ca9,316,291,25,North America,18,2523.12
b4e5de5090ab441e88d0ca75f0d5ca24,319,270,49,Asia,20,1425.6
b4e8da46aabe436ba46393fa6a9892fd,344,319,25,Africa,18,1865.84
b4eb317e05774b8486a058019d9c0739,187,129,58,Asia,17,1270.87
b4ecb8efbff646599d4d45f454939941,147,129,18,Oceania,21,1155.06
b4ed62d31cfb43528531d5f933bcb7b6,174,135,39,Asia,20,747.97
b4ee69818ad448cd827f8b17cd22b371,365,323,42,Oceania,25,1767.67
b4f14d5e1da549a6abc5da4ede8fe2a8,116,64,52,Europe,17,605.26
b4f2bf0cd4664db1843c73f921dbf0ec,165,144,21,Asia,18,1487.4
b4f2ceaf244a4bcd9feeee76f774ffd4,141,104,37,Oceania,27,904.61
b4f65a9f63664e29b819b7452c41fb3a,116,89,27,Europe,17,867.22
b4f7de047b154919884853b7afafd3b7,163,134,29,Europe,22,752.42
b4f87c8d443a40439ff8b7806ec8a3f4,38,17,21,Africa,17,726.26
b4f8fdf57ae44e71b213e0db49bab2ea,59,21,38,Europe,23,419.6
b4fc0d28cc4041a3b82ce856978e075e,363,328,35,Asia,20,1693.11
b4fd7709614f4d1681199a50fe10d3ae,60,9,51,Europe,20,144.64
b4feaf1868c44f778d4c75d95d615a62,191,163,28,Asia,20,1507.66
b4ff452a2a6c4278a5f6723a369f1120,236,179,57,North America,19,1414.7
b5028f3d8f10452eb525e0ca0b27bd32,233,206,27,South America,24,1452.72
b503943240844d91b6b3c73ff07c0141,313,287,26,Africa,21,2149.4
b504caa476d142a2b77d46208196fe7e,364,358,6,Asia,22,2641.5
b505d49b5a1140338ad60f8cdf2636c0,319,286,33,Africa,18,2294.11
b506375a81ce4927a837c814b720d947,63,31,32,Asia,19,662.1
b506e2e7c25b4a93bc51e4025c362caa,154,99,55,Europe,21,466.44
b507c2b322a44dc3ac864d6b2020170d,309,277,32,Europe,21,2286.98
b508bd58974b4e47a383ecc749fbb7d7,94,48,46,North America,19,180.57
b508efddad1c4718b4fc5de516883368,188,136,52,South America,24,1003.77
b50a4a83942e4e05938fbeb645ef72b9,365,353,12,North America,21,3286.36
b50bb7476cf14368b3d8781297a5889d,245,230,15,North America,22,1646.8
b50c30dfef3842e89cca6a674440fa27,257,219,38,South America,26,2068.19
b50d45c098dc4957a91a93c9b4077e61,149,103,46,Africa,25,853.08
b5106a7145c248fb963681ad841343a8,297,250,47,South America,26,1621.92
b513994ecb1544609515919ec1cf7c76,158,134,24,South America,17,937.3
b51428d3496e4e48ae9eb60437ecbf77,277,226,51,Asia,17,982.36
b51717eba4804572a1dc7da7681aa045,332,282,50,Asia,22,1334.81
b51947f11b5b437e916cb555a027cc3f,364,345,19,South America,15,3276.04
b51a19f137bc4bee86e6b1ddda3b3324,304,276,28,South America,20,1782.62
b51b057e08f344f78791a48d8f18e70c,215,174,41,South America,21,1062.11
b51c91d8543a4166bf8322c74080e016,167,126,41,South America,21,1201.06
b51e09ad2a8f44638b138842fdfa8612,343,309,34,Africa,23,2682.88
b521058465644eccbf64ddbcc24cf0b9,267,231,36,Europe,21,1703.1
b521edbf1270432b84a9c79001ade6fd,277,239,38,Africa,24,1881.29
b522751089aa41d9b07c9ba3a157a43d,283,248,35,North America,14,2028.35
b52380e032414c9c8ec1fa9cc10828c5,83,27,56,Oceania,21,1077.87
b524a0cf01da42cb88443a57efbcdcba,96,45,51,Asia,20,586.42
b5250f421cf44a74a63011c2c7fe7f40,175,132,43,Oceania,22,854.86
b5253d2ef06146dfbe610e053ed5538b,285,237,48,Africa,21,1469.66
b525aaccb77d4037a3e1e346a65e68f9,214,180,34,Asia,23,1766.71
b526233c68344d0c8e99db1747f22a36,189,158,31,Asia,21,1047.62
b5295a48ee9f492899add604a83ae202,86,63,23,Oceania,19,958.09
b529d025e2614acd8a40ed8f60d8cf6d,98,59,39,North America,20,581.9
b52daf25b0314ae1ae5d1d9e6f2ee742,200,163,37,Europe,18,1761.54
b52fa252368347cca1d333379163a89f,167,144,23,South America,18,1745.37
b530d56fc65b41a0a64ea504252f3ebe,213,180,33,Europe,20,1470.11
b533dd7d59d9429cb5d295d12586b26a,313,292,21,Asia,22,2210.89
b5355987cca04c7f83a551d3e366513c,257,207,50,Oceania,24,1475.76
b5382bbd29394c73877cff884ceffda4,77,49,28,North America,19,299.42
b5390654fc634b6ab487fe52d01ea990,294,258,36,South America,20,2253.23
b539a055acf8453aa1a5741b7732b7ed,361,321,40,Africa,26,1787.2
b53a4efb48d343ddaf3edda025e96b19,230,210,20,South America,23,1442.31
b53c758297c8473bbdb25d7f3408dfc7,175,150,25,Africa,17,1066.05
b53cc46ce4ac4ce282d4bf2a02d42629,236,208,28,Asia,18,1173.45
b53d23c1f704484ea5503c43b735ec3a,112,74,38,Oceania,24,926.35
b53f0c2923f34c7288b14ee6788d3674,225,193,32,Oceania,17,1475.12
b53fbfb1fa2547d694924cc3e4175170,258,197,61,Europe,22,1332.36
b54044eee1c845e6be9d14095bd2a59d,365,348,17,Africa,15,1659.02
b542089be16c4874b49da164e61bfa8a,157,116,41,North America,20,1022.89
b5429a131aea4e45a153055230332d3e,353,309,44,Oceania,21,2542.06
b5478827c20d4a48b91c1a60d014c3a9,211,193,18,Asia,19,1286.7
b5487d9c29744e8589ad6d77fcfee288,235,204,31,Africa,21,1625.08
b54c75211085498192aab3905ab6fc29,347,322,25,South America,18,3364.16
b54e61bc7ce4481e88f0d277a6160f1d,243,218,25,Europe,18,1420.63
b54e6407d48449349df6747e9ef347cc,243,217,26,South America,16,1751.28
b551a3fe89304f04974d767e301a3897,189,144,45,North America,18,1369.25
b55200dece8a4b69bae80d9b0c0bad8d,45,21,24,Asia,19,606.68
b5526055ae1f4d439b12eb66fcbab1ac,246,213,33,Europe,21,1589.47
b55278ea994549e581c177b4ffd767ac,359,342,17,Europe,19,2273.44
b552a86cb33548fda4136576112e2d07,82,37,45,Oceania,14,342.42
b553fb652bcf4feea0a3f0ee9bcdff7f,315,291,24,Asia,20,2196.46
b5586576c09b45c68d9097d7845296ab,184,138,46,Asia,21,558.87
b558865a7be442b595a7e922b278d2f7,362,311,51,South America,25,2273.72
b55bb4ce50dd464ab90e1fa17941cda2,127,96,31,Oceania,17,546.5
b55c7499c5dc42909cf8f27e0144fc34,360,328,32,North America,20,2936.61
b55e3f1fa5484e1d8448338193cdb615,226,177,49,Asia,14,1013.56
b5603819787c4c5fb979613e910c044b,50,3,47,Africa,26,294.64
b563dbd397094551aecd59f82f8d3903,259,238,21,Oceania,15,1707.75
b563e834a59d401eb267fd35efbe9c41,226,197,29,Africa,18,1624.4
b5650c382579438dab2e145127c1e225,202,180,22,Europe,22,1957.08
b5666cb0ca164c5d8b6013b54dc3ebbf,218,195,23,Asia,20,1664.06
b56a98a99adc4357911a224135050f4f,157,107,50,Oceania,15,878.19
b56d57a0fb634812b3773e77553cd0e5,239,194,45,South America,19,1310.21
b56f6397f2ba4182b235ec7882a971f7,39,15,24,Oceania,22,524.31
b571ccb4909143a684da02c7476cdc1f,333,310,23,Asia,23,2494.63
b572a02b336e48e5a71a5590ca5fa039,365,326,39,North America,23,1665.55
b573faed61fe4faab9bf54c5d1d25004,118,72,46,Asia,22,559.02
b5748f5dfa9642c2af4c0e64db14a848,99,52,47,Africa,24,689.81
b57593b6758d4ea6b83d9f7180629ce1,348,325,23,Europe,20,2688.11
b575c82f3ba44e0ab07a70c5c3b4a121,166,126,40,North America,21,1176.86
b576d5288b60446d9ccb8a78c58828dd,330,281,49,Oceania,18,1435.56
b576ffaae8dc47c7a1d2987cf3d10e6b,364,328,36,Asia,20,2456.23
b5770d07a71b4a258a4148bd87f45dd6,82,45,37,Asia,22,785.09
b57a3a643a064009b4603a282957b9bf,333,317,16,North America,22,2656.57
b57b662e16de40fe9fdf58746ea355ca,301,242,59,Europe,19,1322.67
b57bd820ed9549fc993582325a863a7f,351,328,23,Asia,23,2907.32
b57e433ef9fe49a1ab3796a62bab8160,254,217,37,South America,21,1812.04
b57eecc573ee4398af04d52a2d3f131f,209,171,38,Oceania,21,1727.76
b5821985571147d08d5dc9a2ec996684,139,115,24,North America,20,1150.5
b58543be698f467bbe1e08b22d6f3ce1,186,152,34,Oceania,17,1288.06
b5854fb0f0f4447a82a63dddd3973a66,261,219,42,North America,17,2026.6
b5863121f67b46f3a6f5982c4001c27b,38,11,27,North America,19,310.39
b58668ec8f5b4cb2b0e2164d59191bb8,290,265,25,North America,14,2821.85
b58a18f1a7a94ed2ab1872a98c4bce8e,306,263,43,Africa,25,2222.52
b58adfa9dc2a4c2b98485c6e44d65a1b,288,263,25,Asia,21,1998.83
b58afc912d3a4574bbc86ba3444623ac,240,195,45,North America,18,1066.12
b58ca903d30a4675bfb28d80c02ed720,236,198,38,Asia,17,1528.31
b58ce073e5294657aa9004a8e78b5f09,121,70,51,Africa,23,855.94
b5913dfddba2401e942e0e3774cacf9f,245,223,22,Europe,21,1716.2
b592f0a3c5cf4c7c8fbbd6d0722548d0,55,6,49,North America,21,462.68
b593157bc5c749feb40e9326dfae6130,359,316,43,Oceania,17,939.04
b5932457e83a4874b347bc2027e772a0,365,355,10,South America,14,2619.11
b593390fca6c4aa68ba33fb2cce95f46,169,121,48,Europe,20,521.98
b594d97f347e4d90842f3dde79d326b1,342,283,59,Oceania,13,1959.85
b59663f3d31d4e98b4ce0e37c3f0772d,364,353,11,Asia,26,2179.3
b59741cce888424f9fc34f4a134a6722,160,122,38,South America,24,627.97
b599ce7f97f0469a9ab5d116a01e388d,159,137,22,Asia,19,876.22
b59c6527e7f94833aab10d40f44c4c75,284,239,45,North America,22,1949.06
b59e35af8c1a4d4c82dd1e020ebbf38d,86,55,31,Europe,22,832.5
b59fb16d0b154530bfdbacc391562095,177,151,26,Europe,16,1303.33
b59fea394afb46778b9eda55fe6aef2c,290,265,25,South America,17,2112.82
b5a24fb58d4a4fd3b25e7c832d9546b8,43,5,38,Africa,15,256.47
b5a3290cd47347b3b5119d7bc5959ee8,80,54,26,South America,27,708.31
b5a3d2187a8b4eb4b7f39510bc5563c0,365,353,12,South America,17,2655.11
b5a4873195024ee6a733345d976f2001,29,4,25,Africa,19,198.36
b5a4acd6971d469b9f3f1edd3fbd1b1f,364,325,39,Europe,17,1871.97
b5a4b48c6f344727a690595096e9e78c,208,178,30,Oceania,21,1086.29
b5a7060ef6154c0ea5ce7eef50cc9f41,337,322,15,Asia,21,2236.06
b5a9a76347c6421083b8397980bbfa1e,350,332,18,Europe,17,2372.2
b5aa4cd6d37b404ba61564fb00183d2d,202,152,50,Oceania,30,845.62
b5adeee44b9e47159bc314774d843309,67,28,39,Asia,19,636.8
b5b0da7ae1fa4f7485cfbab03ffe69a7,269,230,39,North America,16,1042.31
b5b14b7e41484930a6a6681df1dea00a,365,356,9,North America,20,2253.19
b5b199075b614c529ae2abe1426710af,361,316,45,South America,19,1716.95
b5b559de05ec454bb127566bbc37b4fe,26,3,23,Africa,14,350.85
b5b88092850c4eaf9cfe41997db0c3b1,364,337,27,Europe,21,2889.69
b5c1926e74f64645b51df4d979dfb8e5,277,245,32,Africa,20,1779.23
b5c325be496c47a78f32f94efde879f0,364,327,37,South America,18,2279.83
b5c35038265c43f7890063d6e364736c,123,91,32,North America,17,1111.09
b5c4888f8f474443865cd762469cf17f,364,355,9,Oceania,16,2051.74
b5c5564de3ca4b26a0320eb08b16e6c0,77,27,50,Europe,19,334.28
b5c709efc2d24df3b80387e98c37ad03,365,328,37,Asia,19,1517.98
b5ce849508dc45368a285ae6f4da8e01,67,29,38,Oceania,18,420.37
b5d06ec254ca45088a7a2da602d39780,327,265,62,Europe,22,1744.9
b5d1a40ff1c242a890bbeab5d6f0e346,246,197,49,North America,18,1541.89
b5d404a5eb054ff59d9a17736f3c8827,91,73,18,Europe,26,908.62
b5d5b7b58a604aca8583a2c39b7b2431,281,263,18,Asia,22,2271.99
b5d68ec87e3e4ac68af0376d78f455d4,365,355,10,Asia,22,1212.28
b5d734ee825f4a4e9a0cafb1dcf2cb81,363,317,46,Asia,20,2276.3
b5da166cf88d47289ad72e47378c7286,109,80,29,South America,20,1135.6
b5dc145dc4ab43e1bbeff3472c421ed9,57,12,45,Asia,20,204.47
b5dc46beecd44440b6788c278484838d,365,365,0,North America,17,1489.63
b5dd1735aecb4c5c807fb713ba9b2150,79,47,32,Africa,20,837.6
b5decc0392384b9996606a347556cf77,365,344,21,North America,20,2932.01
b5df7076be774aa49930cc7a8f1b1704,275,225,50,North America,14,1227.91
b5dfc613a95742f3b8d03c9a18333c26,218,198,20,Africa,21,1997.37
b5dfe38d25a345a4b9f2e9313c3fdaa7,353,309,44,Europe,28,1968.92
b5e01736f703490ca97d73c9b15ca08f,364,331,33,South America,17,1844.21
b5e1fd8ea99242e493450dfe337b4077,210,172,38,South America,18,843.09
b5e24ac87402434d8950cd7cf62c582f,37,14,23,Europe,18,243.33
b5e26e5620454faab6a097ae9d20d581,365,332,33,Europe,22,2915.89
b5e39620ab104406b90f8f9175824f91,257,208,49,Oceania,27,962.88
b5e7d0913bb04f4986e1d3ed8f85a186,136,85,51,Oceania,26,482.31
b5e822712ea04520a25814c9eefb5a44,293,232,61,Europe,17,1329.19
b5e8b4db3af2443e8dda37f01c29d461,120,75,45,Oceania,21,1041.51
b5e94514f9e64435abee8f5b056ea789,226,179,47,Africa,19,919.83
b5e972450b9f42d59b48a81bfe56f815,318,291,27,Oceania,19,2473.71
b5eafe39ef53463f89f812ca528a1b35,229,199,30,Asia,18,1922.17
b5eb5669eeb643099d63e82cd112b04f,178,144,34,Asia,17,983.79
b5eb61b3f944420fbcb767ec78f2128c,66,11,55,Africa,19,627.34
b5edf6c9c1fc490e9a65ca675a397465,156,134,22,Europe,25,1257.04
b5ee7f2923014b3693ce254c10c62d11,365,347,18,Africa,20,1598.77
b5ef3a20b45e4a8eba100027a33305bf,312,277,35,North America,23,2352.17
b5f0badf0cb9448eb96a37888017a01b,350,312,38,Europe,20,2137.42
b5f2db42256e470e94b03a48d79fa3a0,363,335,28,South America,22,2028.52
b5f732350dbb49d1b93c01a48ab2e629,288,261,27,South America,21,2266.68
b5f787398c3244fb800970d816e4cbd7,338,317,21,North America,20,2789.14
b5f8f8f5c7f64ef28fcd43d87394e3b9,184,158,26,South America,19,1629.4
b5f99710725f4fa6a434b9f34383da28,294,240,54,South America,25,1385.52
b5fcb7863525481483630dfb502118fc,362,332,30,Africa,15,2229.64
b5fcf4b5f5824e918858f494ec0bad0a,365,358,7,South America,23,1854.89
b5fda70f358b4b3c9df5343d22fe5541,51,19,32,South America,20,300.99
b5fe11f68d2e4dedb96a28f4ded0305b,96,50,46,Oceania,19,719.25
b6011ad66f694b33a4c259d60b079814,364,329,35,South America,23,2543.04
b601359f0bee4073aeb7792abafa3423,128,100,28,North America,23,705.45
b601c47346f54412b3edf5c786091a4d,101,51,50,Africa,22,334.67
b602c3425b9a401694f4eae06ef1ab0b,66,20,46,Africa,21,293.79
b602e827f6f0407c8e3c706bf5d9f49e,365,330,35,Oceania,18,1973.98
b6084e253f0b4e97af8e439f466c3e55,136,86,50,Asia,24,778.5
b609bbd4fa0b46aba185c60ac4534216,54,21,33,Europe,22,431.01
b609bf070ea1425c88be4d17e7e1bce2,143,103,40,South America,25,1119.69
b60f2be246e3496799030ce3458de7a6,187,160,27,South America,18,1811.15
b60f381004104d68bfca10f51930a0e7,131,107,24,Europe,23,1136.35
b610bfcecb3140548f43dce3ab039b46,87,63,24,North America,15,705.4
b6156166e81d4bd0b51ba63d8b324684,145,105,40,Europe,24,986.13
b61a3d6584f147e8aa6a3ee86e49d463,109,83,26,Africa,16,834.37
b61a59528a894bbab72dad2f04dcd0ca,125,73,52,Africa,17,724.96
b621200a9e754a7e9962559f95b15057,45,6,39,North America,19,64.82
b6217c469de74d38ab4f9a2b167e6051,365,332,33,South America,23,1930.79
b625a7360fd84381bd2a911325afd7da,364,353,11,Oceania,24,2553.29
b626d29a737f462ea05582e83fa09367,262,210,52,Europe,23,914.06
b627cb38c06844e79bb860ddc260e53a,287,260,27,North America,14,1841.9
b628f5cb922248929b7f22b6a42d309d,276,224,52,South America,20,1777.17
b629ffd74bcd4381bbeb3efe10b85e83,146,106,40,Oceania,20,728
b62a2c2454244faab99dde02fa3ef1d3,354,310,44,North America,18,2452.37
b62a55127e0c4aae91e651e56802d943,118,81,37,Europe,20,797.12
b62c6504a29b404581b363635039dc7a,66,22,44,North America,15,303.07
b62d777d971044558bf936aca424db86,196,155,41,Oceania,23,1445.55
b62fe8a780bc4d9596a575d60a9939dc,255,213,42,North America,17,985.79
b63199462f774c0d86be07d109e011e0,261,233,28,Africa,21,1944.86
b631c8fc3ef04712b8ba9f6ce5468a28,216,174,42,South America,23,1074.66
b6329f9739b44d82b3b5172bce8a207a,364,342,22,Oceania,19,1964.85
b6338afc66894ab9918462a1a09f1253,300,272,28,Africa,20,2348.01
b633a3704b77470a9143c0fb24a1b148,363,319,44,Oceania,28,1938.56
b634ce63bcd44325ada197a4589e9edd,365,333,32,Asia,23,1425.49
b63742d21db54ce2be6b7c1d11566bd4,346,310,36,North America,14,1832.32
b6397fa9c1894f7fb088b83904542986,280,251,29,Oceania,15,2108.68
b63f4631e33c4329944173b04b2e3873,131,78,53,South America,17,745.01
b64363252e204e88999634aa2ddc9a60,290,256,34,Europe,21,1634.51
b6438d89ab1a47c691afc37dffaa4d4a,336,310,26,Oceania,20,2250.19
b6443d23ab9e4ca48463e47547283e06,243,213,30,South America,23,2322.27
b644ae14f197428b8e4695801c415375,365,354,11,Oceania,21,2048.72
b64632f2b35c424a97f02f0d1faa0278,304,281,23,South America,18,1915.44
b648cd86ce2340c8b25a1fe19347903f,144,107,37,Asia,17,642.29
b650719b3ea949eba41fa47baa4358e0,365,329,36,North America,17,2696.47
b6561b462c5b4f3f8761b6fe14b2e385,230,191,39,North America,19,1842.33
b656da647c624675a6dbc9c0b4bab148,162,140,22,Asia,20,977.21
b657f40722ab4e91a5dbd005c3f735db,41,16,25,Europe,26,189.19
b659d48d7d8b4436bca88c73c91ca8f6,190,150,40,Africa,19,1327.54
b65b35c09ed84c149365ef5bafad8a09,253,227,26,South America,21,1854.14
b65eeec52a094a819de7aadafc356147,356,316,40,South America,19,2405.74
b6618c8dad9c4cc9b275e8cffee56c4b,291,265,26,North America,21,1766.34
b662ea507d8446a2a8de236b3e1d26fe,282,245,37,North America,20,2031.12
b6666106e2704c5da78d0d441f41d14a,196,145,51,Africa,15,1130.83
b666b375c24c43ff8ba73d584333e993,325,274,51,Oceania,24,1262.23
b666dc33f5e24b75b024d1a12027520c,330,297,33,Europe,23,1931.9
b66756c1513b48b9acdce765f8203180,59,18,41,Africa,23,322.33
b668305053c64a279e88d694bb6adf5c,296,263,33,Africa,19,1676.53
b6684de988a849e6a7f711fb995b96a4,348,306,42,South America,26,2245.26
b669a9e4216c4503bd44626df8b25898,263,220,43,Oceania,21,1107.42
b66b7f57b7b4402b818b701a34526067,193,136,57,South America,19,1069.3
b66d1f6da09d430d8ea349998c73af7d,365,355,10,South America,17,2488.9
b671d0edc4d6469c8094e6a73980aec8,182,136,46,South America,21,996.41
b6737f7005274d4c99b9264ac75829ce,52,5,47,South America,24,375.95
b677af254ea34e6f9d211f36c0dbbfd6,334,301,33,South America,22,1964.02
b67d02db50234097b3c7a7381a96fdc1,157,111,46,Oceania,18,1267.46
b67d230acacb4ee7a96ba3d56d6546d1,243,201,42,Europe,18,1945.48
b67e2434b6b641719c3a2950d93b5e0e,187,134,53,Europe,14,915.4
b67e7bea9b6048cbbcbf09ee73103b0d,139,103,36,North America,15,1333.26
b67eb9a3c3be410e8219a05d47d8e766,239,187,52,Africa,24,1608.59
b681379182ca406492f9ec40629742a7,281,254,27,Asia,22,1940.84
b6826ed41daa4a58bfbf746f375263b1,113,64,49,North America,20,814.23
b6849dd4664541b4bc8591210d96cadb,213,168,45,Asia,24,1332.25
b6864497825e460ba62177ef6a77a9e8,147,113,34,Africa,21,1469.15
b686748f598b45658a6d2a89533733b9,350,306,44,South America,16,1747.25
b687992172564de082a1c3184ba9e7cf,142,104,38,Africa,21,925.83
b6889bbb8ca447a9ab101ce1573033a3,145,102,43,Asia,15,459.45
b68b0452b5664c13b1ed33c6c7926fa9,175,120,55,Oceania,22,1088.72
b68b2e854a6e43528e0595aa21d62cf1,188,136,52,Europe,23,900.27
b68dd803c4cc4875b39b34fef6d8cee5,301,254,47,Oceania,19,1087
b68f4e412e4e4ef599f473269c3b5ba7,202,150,52,North America,20,1117.77
b69248a1a9e345e78e923f351c4a1ad9,248,218,30,Europe,19,2262.82
b6969c6e74744ed0a2af58d87a773cbb,32,8,24,Europe,22,383.67
b696cde921b94e788f5dd2e18ddce975,148,102,46,Africa,26,1154.9
b69f604c08a5416c890305c4f0458ceb,361,348,13,South America,24,2821.15
b6a0106f45494169967fcf1f76ac6139,238,190,48,North America,14,1513.78
b6a03e2d532c4c0799813b14be8cea4a,99,73,26,Oceania,19,264.68
b6a04bf6262642a285bb467a7d3c34f8,194,138,56,Africa,18,821.02
b6a176fb403d4bda96c5d958fdc061fb,341,282,59,Europe,18,1951.78
b6a6e096d3d04953946b53eb94602b6c,365,355,10,Africa,18,3140.61
b6a7b5bb96574500993e7867c1889eed,200,174,26,Oceania,28,1434.15
b6a9b3a7d2b441fe8abd7c5b2fcb68b6,363,351,12,Asia,18,1795.07
b6aa5113bff1481b896898d50da40ab4,16,1,15,South America,22,49.39
b6ade865dfe048f6a4577b50af3cc63f,352,320,32,Asia,16,2356.21
b6ae570e6b55404a8830e17192fcb5bb,72,23,49,Europe,23,411.58
b6aeb8da6a79419f9298236f486302b4,131,102,29,Europe,15,623.54
b6aec30c70c64728889799dcd831d289,134,121,13,Asia,18,1004.21
b6aecfb5eb344ccba5f669d6351117fc,183,132,51,Europe,25,680.58
b6aed0f832cb433086bd30dfa9e44b13,275,232,43,Africa,25,1627.28
b6b7abdfa1a74cb691c4ed5ce4df036b,365,364,1,Africa,20,3028.89
b6b870b638794f23876eb827b691aea3,234,188,46,Europe,17,974.08
b6b870cb201f404abb40f73796ca6adb,285,262,23,Oceania,21,2467.11
b6ba6ef0b4bc4e86bbfeedbf734332f8,343,291,52,Africa,22,1805.33
b6bc1f6602244de585468976281928f9,365,361,4,Asia,20,2252.97
b6bc2aaad4eb4e14bee2fda5ce3198fe,78,55,23,South America,24,961.56
b6bdaa8da64d4969b0c398f217375ade,143,90,53,Oceania,26,815.03
b6bf07d2cc46463aa3271323f3be460b,107,52,55,Africa,19,668.79
b6bf5e1b46ab4138921cf568aadaed5b,217,169,48,Europe,17,1251.3
b6c07654efe441c2b40471c091637f40,266,243,23,Europe,13,2135.28
b6c0fb23c27941dfbe5222f056f5f91c,355,328,27,Europe,21,2746.17
b6c248eda91c42cdb6e616c583a740a7,103,48,55,Europe,20,702.99
b6c44731454f43d18366a6d61ba962f8,251,207,44,Asia,18,1959.58
b6c5ffa02b2948ef9bf32a1f9a0771cb,334,290,44,Oceania,24,2453.55
b6c90dd07eb34bdb8099229d5b887e62,202,138,64,Africa,21,659.61
b6c9136f129041bbbd0a090d31775ee6,324,279,45,Africa,21,1637.4
b6cb083dd0914be4b62273e5a5d4dabd,346,293,53,Africa,20,2036.83
b6cbe6b37e424e7e9e6d68796d7ce020,36,9,27,Oceania,14,240.9
b6ccaa85ef0b4058a7d600009ccaa829,109,51,58,Asia,17,868.15
b6cd3acde68c4ef399055e965b4cb3a9,111,67,44,Asia,18,727.76
b6d0fb1f1686423f86d42f42da103f48,298,268,30,South America,22,2658.32
b6d162634a3643c39a80fe7b1c94c075,300,242,58,North America,18,1566.47
b6d3a9e8f77b415a85f17edc692e0d5e,85,49,36,Oceania,26,661.32
b6d4d2cf8d624bec9730203c67fc32a2,262,213,49,South America,29,1265.93
b6d54879046b418e89919b8d0ce2b41b,107,64,43,Oceania,21,348.73
b6d5930709504aeb95c3d91068ecb5ec,245,227,18,Asia,18,1562.38
b6db6868fb6641c3bdcb8443b8f897d7,84,32,52,Asia,21,409.43
b6db69c7947e45d7aebeaeb16900210f,350,312,38,Europe,23,3231.6
b6db91a7369d4e03bb51ea42e1c7f750,363,360,3,Europe,19,1731.58
b6dbe41bb04b42899781803b543f66a3,231,193,38,South America,16,1977.55
b6dbf32fa35648c3888dec4265d990cb,244,200,44,Africa,18,2016.5
b6dc816e7808490d8adb2ac9efc5104a,259,233,26,Oceania,22,1921.75
b6de1fd34b914dcda02d9c03fe0a0f22,217,154,63,North America,22,694.57
b6df536f706a4d44abe4372d8a5b18ca,71,21,50,South America,17,525.82
b6e03e6d66444a16a74357f9d76cc8bb,209,153,56,Europe,25,1348.78
b6e061b0333847bda78e573050f5e365,356,333,23,Oceania,21,3615.3
b6e069526e0d4bbca61c3cfe6dd2dc1c,279,262,17,Asia,24,1834.87
b6e1f96316ec40c99eec50fc81c68996,202,161,41,Asia,21,1654.98
b6e2d58137ce4696921dadb923ec0a88,365,343,22,Africa,25,3166.41
b6e4d872ff8b4d6992b2c9f3f8428ced,334,310,24,North America,16,2700.42
b6e594d5dbd247ffa0012010c79123fb,283,235,48,Asia,20,1317.4
b6e5c954bee64e29b783e3bf68a58e6c,129,99,30,Africa,16,1040.53
b6e62be45d964978b2cdb99de2ead3f8,282,227,55,North America,23,1313.66
b6e7f465f60b430b9b5611806102a837,250,216,34,North America,21,1817.85
b6e9ba4becf34d1c81588443bf45b116,102,52,50,Oceania,18,461.6
b6ea44cf944f4fc58f6a2ad9c8692137,335,279,56,Africa,29,1656.59
b6eccb0dc1bb4e69bdafb7826cb5fedc,105,56,49,Asia,18,827.44
b6ece711faa4493ab02bc3954b290a50,64,19,45,Europe,24,391.92
b6ed1167c5ea44eea90212bd9b05ed08,170,136,34,Oceania,25,909.01
b6eda680641f4888aa1acd8271b4c1f6,265,216,49,Asia,27,969.82
b6f4098bd7f549f3be7722380cef58b2,353,308,45,Asia,20,2041.64
b6f4722501614e0ca65620c41a51dd65,62,41,21,Europe,19,213.24
b6f658ca3f3f4a1d9e39404e4cda1ffd,289,257,32,Europe,17,2475.48
b6f8aecf69714c7f8ec19159f13ac9ab,301,245,56,Africa,16,1326.28
b6fa4f41e1b643c989508a4e3b768c4a,161,123,38,Oceania,20,721.96
b6fafd204afb44609404d1748cabf697,98,63,35,South America,23,726.09
b6fb456bc08f4f149120b6887f13587b,363,359,4,Oceania,19,2591.14
b6fc669c93e34851806a9f138304ee66,305,267,38,Asia,23,1974.02
b6fdbba0561a444fb981e46a9501f38e,214,176,38,Asia,17,1726.4
b6fdbdf9c71b48bdacb4013a52e4ef73,332,303,29,Oceania,18,2485.54
b6ff346fa9a84b8c82624f5cffdbbc2b,199,147,52,North America,17,830.52
b6ffb3b3031d4f19bc2b6586539606e2,242,199,43,Oceania,15,1443.82
b70454d770ce425d88df1c3681552959,101,51,50,Africa,25,228.47
b70542d8df3f400faa0d0ae6f4fcbeda,365,346,19,Africa,17,2905.17
b709374f2c784e6eb3b5eb8eda5ba1e2,170,135,35,Africa,18,1171.5
b70f877a22384ed780571778fea05056,361,344,17,Africa,28,2926.95
b71073967ab64dc98d25cbff90293321,317,261,56,South America,17,1192.08
b710ad10c7284b7a80caf8a27f5d040b,282,225,57,North America,19,1449.16
b711536bfd6645a48ca4a57a1119c061,365,336,29,Asia,22,2966.6
b712086174d7466f8f816a8ccb988304,288,236,52,Europe,18,1095.36
b7125459033a43bc890c3cf26f9e2c9f,194,152,42,South America,19,1123.27
b7127d8119d944d6a74ee7395f43d7e9,85,52,33,Asia,22,572.18
b713eba7b5a54ce29098570804ca1b76,175,138,37,Europe,19,1152.47
b7141620c3094ca18eb5429134e2fa77,300,243,57,Africa,16,1904.53
b71462f0dd25466ea2041064b6a597d0,363,349,14,North America,22,1109.15
b71671be789140e89d2dd571479bd28a,125,92,33,South America,24,1164.14
b716edfc485f43959a63f11c59d6f174,61,30,31,Africa,21,378.61
b71725106a084cd98b817bdc6228592f,239,189,50,Oceania,19,1398.87
b7185103dacb4b7e842254020ec12946,347,307,40,Oceania,15,2004.76
b71af0c8f00c4ffc81d26438a061af78,364,358,6,Asia,17,1988.55
b71bd287e40540b586eb33f640e6e464,183,146,37,North America,17,941.23
b71c1d3451a04f9e9aafc00a42b68488,217,173,44,Asia,20,902.55
b71d0cabe06842f7bf59f44c71756177,50,8,42,Asia,24,368.42
b71fcc2c05844fc8b50fa27d5f5aaf3d,175,123,52,Africa,22,1210.55
b7211ba5c4804e9bac9e7f8e9e53fd33,133,78,55,North America,20,385.52
b722c72337704a8fa92e12c2f65d27b0,76,24,52,South America,14,262.88
b72353afb9ac47feaa2fbead1155a952,314,268,46,South America,20,2209
b726a7fd5bb54e1e972c67b7476fa703,182,124,58,Oceania,23,675.19
b72ba5a75f8d4969b2fea54a07332849,348,294,54,North America,23,1992
b72c77ba9b3d49928f226a73bb9e49e2,195,176,19,North America,15,2021.61
b72f06d1c3ed472e9eba47cc218ab108,232,177,55,Oceania,20,1258.53
b730e7c5c1fe4ff6bf18f685827ff63d,282,253,29,Europe,22,1444.66
b730f25f5ae64aafbb65eaadb6e32fa2,214,171,43,Oceania,24,1722.89
b73513b4ea434ed48a88b4de3a17911c,199,145,54,Oceania,21,1497.26
b73600cc71df4ebc96a76505a303c860,365,350,15,Africa,18,1682.22
b737fb8aeb8a44f693204ae7e795b0c8,252,219,33,Europe,16,1236.7
b73889a753b64ff49aa1b9b7d4bb3eef,171,129,42,Europe,25,903.06
b738bc2b51bd4c7eb991de05a2425772,364,364,0,Africa,19,2959.73
b738e17cf01a4c8e9b9936cd49444e53,284,229,55,South America,15,1062.97
b739d8b6e71f4448a1e9cdf09d4fb62c,82,41,41,Africa,21,487.46
b73a83ffa9084c1f9442ebcc4a9584b9,214,175,39,North America,23,1528.76
b73aa216e7144b0095b102d53e695d88,197,171,26,Europe,17,1340.1
b73ad61cb9834344b3f96699010e776b,69,44,25,Africa,15,312.85
b73b19f32ec849eea0536c1065336a14,100,68,32,Africa,20,872.19
b73cd894ca8e40d798173becdc10fbfc,256,215,41,Oceania,22,1875.6
b73db5be290c49efad8883030d81d5c1,256,209,47,North America,19,1121.98
b742165f298c41ee89a96267749cffa8,225,192,33,South America,20,2021.13
b742a496a69d425c9b31c153d78428c5,339,308,31,Africa,18,1895.03
b7449eb9968b4c4ca9acc2baea07df59,276,247,29,South America,18,2442.38
b74692abeeea4554be01841c2bd6a481,217,188,29,South America,18,1655.55
b749771e017a4ea0820b1c3da55d5922,233,176,57,Europe,22,1064.33
b74adb94f9fe424687290dd47571a9c1,317,290,27,South America,24,2689.26
b74ba08d31de48df82f0602819da175e,319,300,19,Europe,27,2418.1
b751170a7efb41ed89191bda868e54ca,143,119,24,Europe,16,1178.67
b7525a66a3944744876c4279c8dd2b82,358,325,33,South America,20,2197.79
b754cae51b064e26a879570ccbe94d13,328,281,47,Europe,23,1196.56
b757ad8a397d494eaf713a1520f658ab,272,232,40,Europe,20,2014.64
b757b0f6f9da48bc84677e63f243829b,296,245,51,Oceania,20,1319.33
b757dedffc5b4149a4fb23dbd982211a,108,76,32,North America,18,915.99
b75803d2763f4553836285ca86dbc286,365,357,8,Oceania,21,2230.2
b7587a5ed485462691fcff379545d4e5,363,357,6,North America,16,1945.59
b75bceb44bf44007b04b8f0ba389ca8e,101,66,35,North America,22,897.74
b75c2df8f14248b7bba427614dfb7509,78,32,46,Africa,21,489.15
b75d6dfdd99146e2a1eef9806a3610c0,31,7,24,South America,20,489.55
b75d94bbcf3e41d891e3d4d5377b3139,364,361,3,Oceania,20,2271.78
b75f5e472ecb49539d82aa07728bd35b,312,278,34,Oceania,21,2390.2
b760c61a9a7e4bd7843ce09f4561531d,266,214,52,Asia,19,1459.87
b76120aa77bc433585f2ea625a619e66,78,42,36,Africa,26,489.82
b761fefc93b24b3982307a11bc5fc810,62,42,20,North America,21,391.11
b762dd3b64ff4811a51b232cfc95a131,365,337,28,Oceania,18,2027.58
b76303b811aa4e5a9a5abc547332d40d,148,111,37,Asia,22,1177.31
b76415f7d8434cd8a1b895ca147bbb97,237,199,38,North America,18,1403.52
b7690a208d554d6f956c0c26139a17f4,286,259,27,North America,18,2401.22
b76923beaab7479d8f89aab0f5204e74,202,149,53,Asia,15,814.14
b76a8f38a3ab48bda02cdf4b42fd305e,96,49,47,South America,16,532.38
b76b9b591344461184c27c5e4091dffa,157,141,16,South America,20,1326.8
b76f6d12871847eca68aedb86bf3dcf3,358,316,42,Europe,19,2308.87
b7718bae67094a16871b7dea31a0ba5d,181,159,22,Europe,20,1319.8
b7736a9946a44c2d868a19d39b685ba5,159,113,46,North America,19,978.65
b773f9f1a4ed4cc8b69a3c2062dd7bee,229,182,47,Europe,16,1706.79
b7743835d8c642ebbf107cb630f31739,308,283,25,Europe,25,2662.38
b775ccb8c87d494c8d0651a6b9361755,45,18,27,North America,25,367.38
b77870d580eb4a729ff7467f988390b3,238,199,39,Africa,21,1237.87
b778f356ecc34b619bbb30cde4a6e8d7,312,259,53,Africa,23,1750.7
b77948690a11414bac1c6a5f529771c7,38,13,25,Oceania,18,565.76
b77983989a7f402292015ce016d7a2db,361,338,23,Oceania,18,2129.47
b77b8d8b9b744f499f2bc9fee6b7e0b5,327,273,54,Asia,19,1662.37
b77c313f60fa47be87bb669216276868,41,6,35,Oceania,17,37.19
b77cc09c30a04def95de5b343e8ff24e,286,235,51,Oceania,22,1824.95
b77f0ce327b5469d8543bdefe1102ffa,147,125,22,Europe,22,1316.63
b77fe11c07f24f289474b8f9358e5c51,365,339,26,South America,18,3734.28
b78020c4b29f43fc9023dc959ccff557,312,261,51,Asia,26,2262.26
b780b811d9064542a6db7239e7e0736f,51,24,27,North America,21,405.43
b78349c51b24406786ea84b949b7b922,109,81,28,South America,26,622.03
b783ce06af48421fbda97d7e7adaea2c,140,82,58,Asia,21,694.13
b783dc7ce50f4446a1c5f39d65892694,321,294,27,Europe,19,2905.6
b7847368979b40e691e32299c92c17e8,248,212,36,North America,18,2402.76
b785a09a91104d83b213886cf2acd433,329,270,59,South America,21,2339.83
b785c85f90d24bf2ae324747e2b08299,333,283,50,Asia,25,1766.02
b786d75e38474c61b7480072757f65be,329,283,46,Asia,23,1652.07
b78ae2d137194bd4abe4894028112730,264,242,22,South America,19,1878.13
b78c9c1d7ea74162b8bbf6d4b8f7edef,66,35,31,Asia,23,310.46
b78e2adb9bbf418b9869c744f4a6315d,256,224,32,North America,23,1653.52
b7906de56f604238bb6512859e921452,42,22,20,North America,24,556.86
b790bc5f19644507be4c57e7608d93f1,296,241,55,Europe,25,1193.28
b792dbecbb3b4433bc1d242fed754f3d,218,178,40,North America,18,1503.27
b794d3acc0fe4f5490a4964eb9551d47,296,263,33,Europe,21,1714.07
b79743a168a94a3fbc5dcd43d58339b7,187,158,29,Asia,18,1368.77
b79c53ed45b34cd4b02588b3426836e8,250,216,34,Asia,20,1295.06
b79ddfd7e5f3443a9b49d1c1ce2f1826,223,170,53,North America,24,1721.3
b79e315c98a24ca4ab0c93420c196cf1,169,125,44,Europe,16,384.74
b79e59a119ba4ed98fdd276ec068d8ce,352,323,29,Oceania,25,2763.19
b7a0c059c2f347e7b16eabdf05a28b1c,253,214,39,South America,22,2280.17
b7a14c45b5374dae92a0a5540f1692bd,365,345,20,South America,22,2416.03
b7a24ed1564b4fa6bcd3bacbbb14617c,99,42,57,Europe,19,187.82
b7a2e5803c0e45cbb549d014d766fb7e,98,72,26,Asia,19,735.49
b7a58bec218b43f7b53e542530ef3b95,123,97,26,Europe,23,819.36
b7a8fb46ce7943859f155da7687bcd52,227,201,26,Africa,22,1400.05
b7a9771ca08b44a291b6791b0e530141,337,311,26,Oceania,21,2617.81
b7aa0e200d3642a9add74ff5a0d75179,77,23,54,Europe,20,288.06
b7ad178238b54c12b1f423ff63c8f058,247,235,12,South America,19,1894.36
b7ae469f0c464592af248ff0bbd30b73,115,76,39,Asia,16,858.7
b7ae7047227b486c8065711c78b4b9d6,100,47,53,Asia,19,263.24
b7af20752f604d79ac4560b98bad87c1,319,284,35,Asia,17,2518.99
b7af2abde5d84fd096048ceca740c79a,77,36,41,South America,18,558.74
b7b2f0f45ace418caccfa0f97843c88f,127,81,46,Africa,20,704.78
b7b4ca684e884fada4bf36c4362cbda6,365,340,25,South America,11,2335.83
b7b54f388a864ff8a6b6463789e05e62,331,296,35,Asia,19,2471.83
b7b5fc1b7cad4c9d9554d604363585c1,68,13,55,Oceania,23,357.25
b7b6a88530e9460594ec81ff89e09e89,91,68,23,North America,23,267.75
b7b8a2e1fd0f4992b5befd53440a909b,131,92,39,North America,20,1233.79
b7be046e5f284c818790aa04eb07b4ad,93,71,22,Europe,21,472.88
b7beb2d51ac9488ea67e0bd7dcef0b40,65,36,29,North America,19,439.38
b7c04f0fda47412390921616f0c4953a,47,15,32,Oceania,19,316.63
b7c3cf90eb7848fca43c12e360f33448,137,92,45,Asia,19,543.42
b7c85af4c07b4acca04cc9c2d2ceac9a,78,38,40,Europe,22,975.31
b7cdcf75593c4ec1845a7b818334327f,194,168,26,North America,16,1484.24
b7cdcfe0ac5a493eb72be89555ffc874,338,317,21,Asia,18,2090.28
b7cdffaf9dac425c84683286aa7df0a2,247,225,22,South America,18,2076.24
b7d098a5e1bf4750bd05fdcc248c8d18,254,228,26,South America,20,1525.57
b7d212695bfe4429af62cb3387fc4481,179,129,50,Africa,16,883.59
b7d40a48da5f45e29991bf0ba5cfc04e,190,138,52,Africa,16,813.16
b7d455fb65134046808d7f109d13f682,83,37,46,North America,15,212.94
b7d52f31d2884f50bede3616cc404f2b,353,319,34,Oceania,15,2305.56
b7d5dab38ebd4a63bc37698924f68148,345,329,16,Oceania,20,2527.16
b7d68974274945bbab56c5a177f62fd0,158,114,44,Oceania,21,1071.84
b7d689def7ce4a7dac2476a2bef58ea0,309,265,44,Africa,21,1874.75
b7d9dbcae96a441b83751de5cc54452b,140,96,44,Europe,28,1282.35
b7da0c51e38d4c0ba2fa01d69726ae61,141,97,44,Asia,21,716.96
b7dbe50b08b54a249c12439232e8d33c,258,221,37,Europe,27,1908.48
b7dc88c8d10f4c2ca6ad8324a8ed114e,103,60,43,Africa,21,618.61
b7dd56360283484b9a62f9cb852ed6d9,215,178,37,South America,19,1345.98
b7ddf8cacb994148bb75924c041acd3d,99,48,51,Asia,25,363.55
b7e068da427f497aa788f2a60023c19b,314,271,43,North America,14,1958.39
b7e079fd34c342e8b093978404f4c659,315,265,50,Europe,18,1201.54
b7e1975405c04f859546af40b647cf0b,59,30,29,Oceania,18,522.61
b7e1976f95244ab19e89b7a71d81b527,146,104,42,South America,24,1340.1
b7e38a3ee59645c0b8f5e04f652f2de0,354,331,23,Europe,18,2235.02
b7e47c445482435695efba3473d7aa54,334,277,57,South America,16,2152.18
b7e4fc2bb89442ddb44ab14db9f223f1,233,193,40,South America,20,1903.54
b7e812fd37a64ee3a3fbbc34a64130e4,245,216,29,North America,23,2545.1
b7e97b2911e44103a53b73f9198790fc,309,283,26,Oceania,20,2472.52
b7e9b12e61dc444a9879f874508783c3,279,242,37,Europe,22,1490.06
b7e9f03dc40f49f8ae3d04bb288490cb,320,278,42,North America,23,2395.93
b7ec400068014a66bcb4c0b8128550cd,212,172,40,North America,18,1491.72
b7ee0b5f7d3247578fa2abc49a92b222,365,359,6,Africa,18,1996.98
b7f2745cde7b4dd18b36a9f9637b84ef,312,286,26,South America,19,2426.72
b7f29813d94f4b92bb2ed6cc05b394ea,281,254,27,Oceania,21,2240.11
b7f4407fa084436389e0e70dd95807f1,203,173,30,Oceania,19,1375.94
b7f4e897557144e8acb99ea09c3c72bd,315,289,26,Oceania,16,2422.18
b7f593b59d594d1d835cc94d7efa2278,355,325,30,Oceania,21,2661.01
b7f5f5f5639b4c97b9a4b1f111023184,62,40,22,North America,17,778
b7f7362a9ac04e1992d703e31b9886c5,277,232,45,Africa,16,1509.98
b7f76f493a6d46e1938145a6edac29fc,297,253,44,South America,22,1766.74
b7fa27cb9e694f11a1fdaeb954c95558,265,212,53,Oceania,22,1760.87
b7fc287af9ec4af3be27e5bd01be0728,238,182,56,Africa,24,1119.7
b7fc5907b65a4bd38dcc039c886ae56e,365,357,8,Asia,23,2223.63
b7fd7dc5e21d4a7e86157126e86c9af1,120,76,44,South America,22,638.89
b7fd9b78fe64458bacfe5b14b00f09a1,175,121,54,South America,19,987.82
b7fe2f17a31041938d1f9e71ac47ad2a,143,117,26,South America,20,799.83
b7ff6f1a8e264ae997872b8f1c33c4bc,338,299,39,Africa,21,1923.67
b800160f83234853a5e2a00a1bbc385f,198,157,41,Asia,23,887.5
b80306c1cde14f69ae6eca1c53321fd5,206,155,51,Asia,19,1243.35
b804d011d4794e169425cd0a723693ae,96,52,44,Europe,24,150.11
b80b8025d68f45dc9b46c7d412b0d7b9,98,65,33,Asia,18,851.49
b80d0ad7372c4ff9b61619369a111f42,251,225,26,South America,21,1321.33
b80d547a217b44d98087bb001ea32e12,264,212,52,Asia,24,938.35
b80e263d15554d1b99174388b49444f2,152,119,33,Oceania,16,554.03
b80e61c8fa7846dd9a49216fcd268d67,114,59,55,Europe,17,591.98
b80ede0c01004ec390cf80fd6a19b2e9,115,69,46,South America,23,630.07
b8115c1a077847f3b1d49d6e30c9c1cf,311,280,31,Asia,17,1294.04
b81383e6ae314988905dbff22c38d581,81,51,30,Africa,22,293.09
b81a0c01fe864644af30ad5f87723d05,350,334,16,South America,16,2827.52
b81a358ad6a44b22b9959f1f179b6a48,247,218,29,Europe,20,1446.49
b81ad546d76d49bf85aacd6dd52c3a59,231,184,47,Asia,21,1202.48
b81b68253e334f0a9d3d52b9597fa494,127,74,53,Africa,16,410.34
b81c47a43ff64faba8aeacdc0caeecd3,64,49,15,Europe,19,670.65
b81f00d77bd94792bcb7d9e2cf2c4690,58,23,35,Europe,21,256.42
b82123f33eed4739b64ac13d293a576d,365,359,6,Europe,16,1775.82
b821995bea0145c8867b4fdc954fc4db,51,22,29,South America,20,457.26
b821adb3871f46b88d0e47377c7f42c2,178,147,31,Oceania,20,1228.24
b822de362a88426496c3331221bc7a6a,257,231,26,North America,17,1496.76
b8232f1ac881498c812762cd3f4e8220,217,187,30,Europe,18,2232.94
b823aebc77cd474cb0b8e0c94e69cd6c,85,43,42,North America,20,810.42
b8247c87d8f04bde8615e40acf6507fc,205,176,29,North America,16,1468.87
b8270a2e5a9f4fa3bfb401d8629b324e,140,101,39,South America,18,887.87
b8283e2db3764d13bb9150ac867b9dd7,123,73,50,South America,26,861.21
b82dbc8dd3f2463da9cc1b1fb9c17411,230,190,40,Oceania,23,1017.31
b82e9e96d1c549a2896b359caad9cee6,219,166,53,South America,20,1209.12
b82eb5367cf541ad971e5cd9ee2e96a6,188,136,52,North America,21,1003.53
b830480f56074a78b515171cd2381d31,80,34,46,Africa,18,487.14
b830d933639f40648a629e0d3cc6b423,56,28,28,Oceania,21,548.66
b83196ae0f5541a5b9ef9291caee3215,157,109,48,Europe,19,804.4
b8323633c7fd4a6fa14c5bddb9777a5d,84,37,47,Africa,18,490.38
b833246728c94988ad8f13af73377a94,358,311,47,Europe,22,2047.59
b833ec38b40b4243bd1f2219a1c432be,257,222,35,Europe,22,1693.45
b83679dcd2594e75acffd9ab85079cfa,363,339,24,Oceania,19,2972.52
b836c96552764804bd43063928881d40,280,247,33,North America,23,1868.15
b837bb5326824a849e47613bdeccac5b,74,23,51,Oceania,22,445.34
b83aa815768047fd9c86304f01ba2980,177,117,60,South America,19,977.83
b83c7beafc3341e093547083e16c8b06,132,96,36,North America,20,638.39
b83cb571f8ae431295cfee38e48c9906,342,319,23,Oceania,20,1971.16
b83cea1d70d7464696d984ab94081aba,322,298,24,Africa,20,2695.25
b83d2f2b36434b98a4692325a53fe317,197,168,29,Africa,22,1213.89
b83e41352b744db4b28b33f18e9e6ee7,116,70,46,North America,21,819.42
b83ec99a17604c25aff95a7189aa785d,295,274,21,Europe,19,1994.72
b83f6a98fe5c40caa00b31d637b206e9,159,112,47,North America,24,1661.59
b8411440025c45f9a070853b31a4a7e4,338,287,51,Africa,24,2228.43
b84347590c704c3bbee7e9eb21923225,221,189,32,Europe,18,1325.11
b84674610a7b426584c70b0445b192d9,360,308,52,Oceania,17,1386.79
b8472769cc454d4abe085518edabd52b,172,123,49,Asia,20,973.9
b848a92b3f554202b9f23e7e28fb6cce,222,181,41,North America,22,1729.32
b849152f4d09400eb26a6169241911cb,365,330,35,Africa,20,2207.68
b849e8b070bc49aba16daaa4cf4e7411,38,1,37,Asia,22,178.11
b84c51bde9de45ae823cbbc5a3be774f,267,242,25,Europe,23,2350.03
b84dbb78330b461c8331c0f2686f5684,159,134,25,North America,21,1285.45
b84f3481863341bda9cfc137b8b5873b,365,365,0,North America,17,1829.22
b85429a9bf644d0c8143dc01b148b0d9,95,78,17,North America,22,686.37
b854b1e289b84b16a705b6e9ff648cde,329,283,46,Africa,19,2312.31
b854bfb514a645bbbae562e86c9c3289,314,290,24,Oceania,21,2295.42
b8589e99fab3425a972ce67fadcaf3a5,136,105,31,South America,21,1222.96
b8595fd1191c45608a4d07e0b29eb127,287,241,46,South America,23,1769.36
b85a3714ceee4ff88d0816f3a60e079b,34,8,26,Asia,21,501.48
b85c98d2d14646308ee24a858ef5c5b4,226,187,39,North America,16,1057.98
b85cb5110ab4496cbd39e5043a16b814,201,150,51,North America,27,1102.55
b85da838298345caa8f8a9d1cd6508bd,323,285,38,Oceania,17,2529.58
b85fb192956b443aa538765424253e09,135,84,51,Asia,24,558.6
b860c93725024a7b9bb9b22e284e232c,76,19,57,Asia,16,229.37
b8612f4c5eb04fd38f5529e708e3e6e7,246,196,50,Asia,21,1408.97
b8629134a2144da4b9f086c35c2c4244,328,300,28,Oceania,17,3147.63
b863316c3c6e40709dc0ff02f558be7e,359,337,22,Oceania,21,2680.31
b864cce654424a2a98c3dc72d2735ada,250,224,26,Asia,14,2334.29
b865cdc145e24a899f46c481e0644d08,350,318,32,Asia,22,2457.09
b865d87604d3449a8f87b90eab2dcc1e,86,70,16,North America,18,521.78
b86653ecd83f4a66a8ea3d7a852ec60f,94,66,28,South America,22,996.33
b86986366bd241e78a7e1598f5013fc5,137,118,19,Asia,18,926.32
b86a68f356a84ff9b131153b5b7ddb21,244,188,56,Africa,18,958.14
b86e3e154947492b8fbeacd84ee456c8,143,92,51,North America,15,320.14
b8700c8659104048934bd901e5060e0d,246,195,51,Oceania,15,1191.65
b8708fdf39d045ef9e9e2bd7d8e61fcf,63,28,35,Oceania,18,386.93
b87126cac98046e1912935b5b8c14c7e,153,132,21,Oceania,22,1291
b87218df438e49e5969de2415b2dcec8,124,84,40,Europe,20,672.35
b87458cb3108421ab6ceb6fb57cccd34,144,93,51,South America,19,660.63
b87498cbf4384159b6587ce3a56cd454,60,36,24,Europe,18,298.61
b8785d7f625444dfb6b1e5dfcfb2c995,120,104,16,Asia,20,1161.32
b87ae7ddce3d499d8830632c1f2e51a5,343,321,22,Europe,18,2982.64
b87b4548fe5b481ca2e3c84b694b6438,182,145,37,South America,29,1642.6
b87e77361c44423897c5e697037e1395,65,21,44,Africa,17,130.04
b87f671bc026457b98c260a34471a8ef,103,81,22,South America,17,611.85
b8810b5a36014000bfc317852dab221b,113,85,28,Africa,24,923.58
b8814e841bd6465b8b85270f36aaaa5a,163,124,39,South America,16,715
b88279791115452babeb8cc3cf7765fe,244,216,28,Europe,19,2119.3
b882c091ac344d4bb0cea5af75bbb8f3,339,303,36,Europe,17,2651.76
b883696e7bb3405aab24aa96cfd699c1,362,328,34,Asia,16,1553.51
b884698beaee429795d060ff2c6ef66f,353,315,38,Asia,17,1242.23
b886511e50b84e4c8353268d865f662b,146,106,40,Europe,21,1243.13
b8873ab4a06f401bbdab77551c562efe,292,247,45,Europe,24,1856.1
b887ddb195784810869ab1038ad20996,90,73,17,Oceania,20,885.33
b8885bd1171b4b1fba83d8219e229eb5,362,356,6,South America,22,2007.52
b889d283f491498fbadbc2ba38a0f06c,365,340,25,Africa,25,1818.46
b88a11915af54212ab2668698ea6e264,99,51,48,South America,20,317.13
b88a433f666040e5b082669c12fa51a6,82,42,40,Asia,19,223.44
b88bc2443ec54fe7b14a79cbb71b3a56,200,153,47,South America,18,990.57
b88cdbfc760043d5af8d409bd29bcb45,249,213,36,Oceania,18,1889.48
b88ea9cb8f51481997dede78f96701b6,115,78,37,Oceania,20,842.71
b88feb058a0c462cae3e868e906ef21f,230,191,39,North America,22,2077.84
b890840f1a8b4ce496a7f7feddc9569f,192,144,48,Asia,26,982.61
b892f1d6f2df40f2812d3ad078c70df9,293,243,50,Europe,18,1224.91
b899668b3e21409cbd69265390d33ba7,121,79,42,Africa,20,631.21
b89d4b6f2ba44b618d9512e8f88d7a8f,74,37,37,North America,21,324.67
b89d7db484eb43f3a0dfcd3f589a90ec,316,290,26,North America,17,3120.21
b89e39a6907a4e979d09c118d6f49e73,103,63,40,North America,17,607.93
b89fbdc4caa64374a717b61fc012c921,364,311,53,North America,19,1436.3
b8a196e89d5e45059b86de90acbc7be7,176,155,21,Oceania,19,1247.44
b8a32dcaaf4743698e263a82118f2cf8,248,212,36,Asia,15,2041.08
b8a5192dd136493ea19cf2f9370cd41f,211,165,46,Oceania,21,1092.67
b8a57b75684e464db5a04ae7d19791ed,164,136,28,South America,17,777.61
b8a7371e49c74efe9da0815e068eb322,287,240,47,South America,15,1559.03
b8a8ee36065c4ba2bb5a908f296dff52,68,40,28,Oceania,23,616.77
b8aa532d56204972a0c49705191a4ea9,97,42,55,North America,15,492.75
b8ad4dc8fcf14ff68091df7026dfdf99,93,70,23,Africa,18,895.87
b8ada8cae63c40fe8c436f6bf7644edb,163,120,43,Africa,20,702.22
b8afbdf4bec7407088945c6927a1cebb,178,157,21,Europe,19,1323.69
b8b12c3989d74c8d85e169ae3f63d6b9,254,223,31,Oceania,16,2195.99
b8b2ab6595234322b5c3389073c56df3,70,20,50,Europe,22,743.49
b8b3459df3794b33bc1ff6fc716645e1,336,314,22,Asia,22,2290.38
b8b633d6a1b548099e69c35ef36f6e40,300,247,53,Africa,20,2598.29
b8b683ee5f4b42238ba1bc74bd56a2c9,228,189,39,Europe,24,1620.51
b8b8e49750d6430690afda433a06b101,185,161,24,Oceania,18,1282.61
b8ba262bd8724b8796e826f1aacbf032,126,87,39,Oceania,21,694.58
b8bbbad696d240ad967de596c8b29796,218,195,23,Europe,21,2199.37
b8bd051cef4d48de9ba81bd594ff7fcd,333,302,31,North America,19,2845.99
b8be5ca39de94b0da2adc33714e2d8af,322,283,39,South America,23,2645.42
b8c3d388454f492eb516f59440bc4d92,349,301,48,Oceania,16,1283.3
b8c3eeec4f2c4b5796fcd09e036166b3,126,98,28,South America,24,917.25
b8c5292537b043e1b6b6b2544e8e3bd0,362,322,40,Oceania,19,1766.05
b8c6674f972244e5bd90c76031a7a588,365,338,27,South America,18,2567.02
b8c6cb67c1c2473db1166358d5c5ca8b,282,248,34,Oceania,25,1470.21
b8c8611561ab460d85f997399bf3a97f,199,164,35,South America,16,1204.72
b8cb083645af4fa68684ceb8936621e5,365,344,21,Oceania,24,1487.31
b8cbd48a17f242f89912fa0c9d1a8569,110,70,40,Europe,15,524.75
b8cefbc57b1449e3b7ac468ce9d70dd7,191,172,19,Europe,15,1430.22
b8d38862dea14a8ba42ddcd77ffa1b1c,69,39,30,Africa,20,418.56
b8d3957ce3834007a35df91f2c12a303,75,48,27,South America,19,432.01
b8d41cbee8fa4c689dabc0d5fbdfc3f2,156,100,56,Africa,25,680.23
b8d4b04ec1a94cdca41a8eeaa49b6a7d,363,340,23,Europe,21,2718.69
b8d89c9f7ff144cba312bef26984aa45,244,219,25,South America,21,1564.79
b8da7e5edaf84c188cd33034efe47d13,289,257,32,Asia,19,2549.04
b8e1da09ac1a4a90ac59f3fdbdb8b6b1,305,253,52,Africa,26,1465.26
b8e210db1d744cec9197f020dfad3f06,193,168,25,Oceania,19,1718.69
b8e228feb06c4bd39875461d3d218f1d,219,185,34,Europe,23,1190.23
b8e2f728e48d4a158a88ed9c6a9836d7,364,349,15,Asia,25,1834.7
b8e33389844d4450981e6284bab6f8e6,228,205,23,North America,21,1970.4
b8e4645a17c94a8f897af75e72e7c7ff,89,63,26,Oceania,25,513.74
b8e4c264ccc045469b9782846d84e92b,59,25,34,Asia,22,446.86
b8e51ccc673543adbb9d2b0a21fb9a04,226,180,46,Oceania,22,1328.98
b8e8ab8c2a474aa781b525d327a5c939,363,360,3,Europe,15,2894.7
b8eab5935b474a3db893fd4134ee52e6,349,311,38,North America,17,1571.55
b8ebee9d14cb452b87694458dbf088bf,151,110,41,Oceania,24,1190.98
b8ed5f2a95a74647a239c15dd4e55f5d,248,228,20,Asia,15,1975.95
b8eec79e433044668f8196eff763ef26,86,52,34,North America,18,1019.16
b8f18d04ecac478eb91d08fc3acd783d,329,278,51,North America,19,1864.78
b8f3bc36cee449d19dad1a2e46944ce6,169,131,38,North America,17,1105.05
b8f4097468004fdcbe76130efbe6a370,113,65,48,North America,15,541.99
b8f523ebc7624af38f05bf44ba0173c4,127,106,21,Africa,25,778.86
b8f68de5359c4b8a8d02b56c2f356dd0,321,298,23,South America,18,2390.3
b8f78fc8d4414aa3abc3f403b88360c4,127,94,33,South America,21,868.21
b8fae34080054ac2944336402bf66826,365,343,22,South America,16,2770.23
b8fb5dc8f72e40bab5ba21d2ac5822db,364,359,5,Europe,17,2227.79
b8fc8b98131d4dfbb24e0b63e81456e1,253,213,40,Europe,21,1493.01
b8feab7c5709415487c9636a1cc0fb19,96,41,55,North America,19,606.1
b8fece32f5cb48c48d0fad4b103e032e,194,157,37,Oceania,22,1571.02
b8fed8daf53246159be00d601e7bf37f,238,203,35,Africa,22,1392.14
b900341c16ee494482f9dbb6380f605a,292,230,62,Asia,21,1320.27
b90076f003034b9e8a6b509f008c7868,116,94,22,South America,22,984.21
b9009782c5e748f6b4047a5b8bc6d1f9,365,345,20,South America,18,3330.92
b900f68268a34d92a3c4b15b4d006b6e,365,348,17,South America,22,2510.9
b90155e180bd4ddcafaf1b2cc793db11,157,134,23,Asia,20,1037.12
b901fa7b0908426cba78ef505412f134,364,320,44,Asia,17,1364.14
b90633678cc044e7b938d788c7ac26ea,280,248,32,South America,24,2556.93
b90669e879a040298ead21c25372302b,28,1,27,Africa,20,80.06
b9078e1ca71445998bc2808cce83a494,212,189,23,Oceania,21,1616.08
b909652c15374b8a9bdb42d894ddbad5,216,157,59,Europe,17,656.51
b90ac4a961b94917b7d825b287d81ce2,94,67,27,Africa,23,366.47
b90b6aba9c224dfea01c9b73e52413ea,334,271,63,South America,22,1522.01
b90cfa40e4014e97917fbdeb0d9c15a9,358,318,40,Oceania,19,2096.27
b90e49335a6848dba83e5a07281cad1b,325,278,47,South America,17,2448.89
b90f0d68a678497384b85d9fafd013e3,268,231,37,Africa,18,1700.6
b90f22a86ff442cab584af859b0f9b8e,295,243,52,South America,22,1201.69
b910ce94a1bf4d3eb068f0d9fd3e5456,280,237,43,Asia,18,1629.55
b911b0e3920443cd932700c476fb66ee,363,338,25,Europe,22,3048.29
b91224b22d894e26be8552a83f4fce12,192,157,35,Oceania,17,1237.54
b916949fb1214ad1a1decde44fe41df8,308,282,26,Europe,18,1711.33
b91fb9b3e949463a9f563f03b60435db,331,309,22,South America,19,2007.96
b920e81a846a4a32ace666b872f14f62,246,215,31,Asia,17,1497.81
b92168543f5f40b68675aeec396fc556,363,331,32,North America,21,2574.39
b922878d540c428bb4b9a0ed4c186acf,204,182,22,South America,18,1869.54
b9247c9ba34e40b489b627ed601d4faa,40,19,21,Asia,16,310.41
b924e49c66a24ddead048653bb5894d7,123,86,37,Oceania,24,948.45
b925d431c4cf498aa1994bfae3269b40,283,241,42,North America,10,1751.49
b9280160bf70422e93036b53fba3fe03,324,292,32,Africa,17,2272.56
b9295274710240048c72cef0069a536d,128,83,45,North America,20,954.11
b9298240a02b473dafea291a149a0695,166,129,37,Oceania,18,1467.87
b92a09384aa74458bd48e06bc86de85a,354,301,53,North America,18,1932.25
b92ce42a61d14648b5cc778682b6bf59,164,130,34,North America,18,1347.65
b92dd16cc3634498a23c2aedd56496b7,286,227,59,Africa,16,1495.82
b92ee62a7c2a440db2178e8d702b0d56,318,267,51,Asia,22,1662.1
b92f5bd1b4524c5ba36f031a25d0ead9,109,60,49,Asia,18,970.15
b930d500b9b148679244264107a30ec0,174,141,33,South America,23,1356.63
b931d20ed31041aa9a39246471fe4e93,102,71,31,South America,21,846.98
b9327fd8b5c649e59f4e79fb0a85538b,297,276,21,North America,19,2125.01
b934ae64dca144e28af2b7d88f062ce0,57,12,45,Oceania,24,279.2
b9361f7e703b4faeb4a27f44f1817e63,365,313,52,South America,20,1793.34
b93a510838354a30b9af497b98389064,364,339,25,South America,16,1720.64
b93c3964ef004edd870549529e904aec,175,153,22,Africa,16,1831.42
b93d725244f94b2996cd8e24a89e258f,365,349,16,Africa,19,3166.57
b93db8dfa96b4db99022340a605f23cc,208,158,50,Asia,13,1081.53
b93dfc970ccc4713bd60d3badb86ca25,241,224,17,South America,13,1231.23
b93f9454747c4357b9671bd1292b9fd0,270,218,52,North America,17,1300.82
b940847b54414e01911444ec5060c283,303,261,42,Oceania,23,1649.09
b9417d6aa9d94f42a2c6266ad4ad1555,216,195,21,Africa,22,1618.41
b94268a9f1aa45cb98556000973558ef,364,364,0,Oceania,18,2072.15
b942921ef2b64d7dbf0ae25c6c2eecc5,360,333,27,South America,18,2688.59
b94295f916ff433ba4f35bb22d577a8d,115,76,39,North America,14,788.14
b943342b333649c2981b9d702915c471,331,299,32,North America,26,2545.85
b943e0387d0145e29de50c11f84137c6,92,41,51,Asia,18,285.57
b945482fb0e645e1be0532994df4168d,360,352,8,Europe,19,1880.4
b946e47e9f52473095245b96138584fa,238,205,33,North America,22,1388.1
b9473095df964c418691e4fa74c9a05e,284,250,34,North America,18,2474.99
b9475587756440df8a8474f89a80deb3,365,320,45,Oceania,21,2212.15
b948e67d9a474b5e86755d7d021d1a26,195,151,44,Europe,21,689.29
b949fda77c35466888f5b7829ee3c884,105,70,35,Europe,17,938.84
b94a9da812f749308a4d1f9783147ee3,332,287,45,Oceania,25,2512.52
b950e2b448e14e669299772db149b18d,279,238,41,Africa,22,2163.2
b9518a39a9cc48dc8349210ac624192b,139,113,26,South America,20,1115.52
b954416156e04b5d9420bbaa84be99d5,238,210,28,Oceania,21,1655.11
b9550ed77e1c45249fa34c098bf34ec2,101,55,46,Oceania,24,506.6
b9596a7dd87e4cc9b59c078da31df1db,273,247,26,Oceania,25,1411.62
b95bbdfb156e4071bb0ad3cf5ea154d5,105,61,44,Africa,18,600.01
b95bd2a91df04d54ada9d240f0c43bd0,130,89,41,Asia,26,693.19
b95bf8ed128046b48846e776de81f73a,87,38,49,North America,17,524.53
b95c4a9af1a14cb59cdfd76c2dc5c307,78,30,48,Asia,17,197.76
b95cec670a7f44bca952b0a6ab702098,107,69,38,North America,22,487.22
b95d1afb1488439c82052ec09722acbb,106,77,29,Europe,19,687.65
b960130d9eaa4199959c69a9beabeb94,187,162,25,Europe,23,1348.67
b966a499e8f74a89a148ac000913a3be,71,53,18,Africa,19,600.2
b9724901e2cc415ba5cbc7133606b7b5,111,70,41,South America,17,479.35
b972fa65df9141d8a659cdacbadc51cb,159,141,18,Africa,22,1119.86
b9764fe257af4f798da947de78550fc7,226,188,38,Europe,15,2508.53
b9783c9cce6540cc82da32e9a0879033,145,105,40,Asia,17,588.24
b978813105e84869a0d881ba2457d0b6,263,211,52,South America,18,1226.96
b97c1ae6fc5941cc9ebd0aeba6c6b013,364,326,38,Oceania,22,2414.29
b97cc031eb0b4cbb93519e3844aaba05,361,331,30,Africa,18,2616.6
b982630098e748419aa30ea1f7b4bfe1,226,188,38,Europe,22,1059.13
b982881179df4580824316ac667ddca3,57,15,42,Africa,21,217.25
b9852143cdf34bac80018de0073795b2,129,92,37,South America,25,972.81
b985b8bde33a4779b01eb80b1aba198a,364,345,19,Africa,19,2208.12
b986c9ab3a914065be640c491d1d1f47,108,55,53,South America,20,246.34
b986d47a7bb7419e873171336629627c,59,19,40,North America,19,601.8
b9893d78845b46a480cda58b191d7ded,262,241,21,Oceania,20,2192.74
b98aa4059081459a879b58711e4b2991,160,131,29,Oceania,16,1164.57
b98acb0139274cc8b368acd485dd85fa,57,32,25,Africa,19,542.08
b98bfa6af68f40babec1d2ee7955dff5,298,282,16,North America,25,2242.55
b98d6955f8d645ea96867e463e77b4fc,252,207,45,South America,17,1442.4
b98e9ab3578942f2b4afb390da4d17a2,296,247,49,North America,20,1561.04
b98f503464a841159e3c6634c702d617,204,167,37,Africa,16,1496.76
b99164e82d764dacb9101ff05fbf3ad2,221,200,21,South America,16,1506.03
b99567d40b684ec08ba74ff97f8e3d7c,346,295,51,North America,23,1666.45
b9969f56220c4b6bb991dc7488d0021c,77,53,24,North America,20,690.1
b99ae8b88bdc42c49b5ec2fdc74a4f71,363,337,26,Africa,19,1833.7
b99c25d094984a58a9cfa27e1bb784fa,131,86,45,Europe,17,559.74
b99c3c1bf2084b12a5d53e42ecaf3bf6,46,24,22,South America,23,482
b99d402bf8d74603879cf8bca2ccefe8,356,317,39,Oceania,21,2247.78
b99ea8a6c3e745ca9293b1f7bdce118a,67,39,28,Africa,21,709.67
b99ebb26647e46d197c9e4578aca9fa7,193,171,22,Africa,21,1790.21
b99ed9873f014fed8db13920c2ef4a80,257,225,32,Europe,13,2209.85
b9a2e3017bf7422b88af4c07a597883a,268,235,33,Africa,22,1666.97
b9a34af35b744c1bbeaff5065a0de335,204,174,30,Oceania,15,1673.99
b9a41a032bd441ce8bb7f8114f8bbafb,294,272,22,Oceania,25,2699.23
b9a4c3a54bb04f4fa9fa8572e7b3f6af,39,18,21,Oceania,21,413.98
b9a7915be5854e89a78eba607fc71eec,326,271,55,North America,20,1502.64
b9a7c77d42e243b1938c4d1894816d0c,49,28,21,Oceania,25,337.58
b9a9d373c36347289708ca12d7d82386,290,257,33,Asia,16,1930.36
b9aa8f75b2974cc296d8091cf2b02ef9,306,260,46,Africa,16,2215.79
b9aadc69919348ddba5f3ea5aba6909c,39,4,35,South America,16,585.07
b9ab6c6896e04e3f8525c168eb41f0c3,15,6,9,Asia,25,158.56
b9aff0e922a5444d86fe888982c77d1d,353,293,60,Asia,19,1549.17
b9b0d466119a4b37998d577a8d498a81,311,284,27,Africa,25,2114.98
b9b847ef1a2040fab1b3deeb25193c4e,292,245,47,North America,16,1729.53
b9b96e71d31d4aba9b7db70021f79447,103,89,14,South America,21,1009.95
b9bb47b6e3c2451d934d501a52813ea8,363,355,8,Asia,20,2369.02
b9bc1335504b4d6b9c03a00598d9ca2a,54,27,27,Oceania,16,337.26
b9bc8edb3c4a4bd98d70558dbcc928a8,261,234,27,Africa,13,2195.83
b9bd9ad38f024390bc9b696b223fd6b8,365,333,32,Europe,18,1519.05
b9be796bc1ac4332a75fa8cd7c4370fd,175,132,43,Europe,20,989.59
b9c2cc20fcf54f09847290057e50a151,85,41,44,North America,18,517.72
b9c38c8a68b34d15b78a3fd466c6f6ae,68,18,50,Oceania,17,208.18
b9c3ed9516b24f9e852cd1deb996d1c6,206,167,39,North America,17,1580.1
b9c4dc99265b4349a35a266a97117feb,219,182,37,Asia,17,1360.25
b9c5658b24244ed7b4abc4b0d45f7c3d,157,138,19,Europe,16,1182.97
b9c601787a1f4b528ef34e2dd2df7bc3,362,351,11,Oceania,22,2321.74
b9c64419a6574a5586db82e4b99e5c71,208,193,15,Europe,14,1885.31
b9c74c276af24504af63223b5aa5cd9a,41,20,21,Europe,21,299.03
b9c8130d2a364ca98155ef989cfa1ec5,215,168,47,Asia,18,1175.85
b9c82a1750fb44babbff40d950e1093d,285,259,26,North America,20,2570.52
b9c82bee40ce4831a29ad1841ba6d17d,363,347,16,North America,25,2311.97
b9c8559db0204c79aa9c3f7c76adb019,329,284,45,South America,23,1775.18
b9ca71313cb543ec81a00e70b59278ed,213,166,47,South America,26,790.73
b9cd60ccf0474a5ea1e94b704ce38e2a,59,25,34,Europe,20,658.01
b9ce6a0c77ff4a949b8f1ae8d20107f0,132,105,27,North America,20,843.3
b9cfa5634d81479982192e422733cb67,140,116,24,Asia,19,874.36
b9d0210a4fc943938d9aa4571db9138d,203,154,49,South America,16,819.19
b9d19bea1106466c9758c4e7a595215e,242,201,41,Europe,21,1602.44
b9d37a277a5d4ebf9a64affe3ee4310f,141,93,48,South America,21,277.14
b9d3a906082f440d8e25ba7cd054fceb,105,74,31,North America,18,859.57
b9d41f0d8a73415294e7025154263ed2,276,248,28,Oceania,21,2229.14
b9d786aff2af45119c5d34bdf2fee93c,140,95,45,Europe,23,637.23
b9d8a6f7f2c7402e9a4d4973a3098f57,116,80,36,South America,12,924.81
b9d8fa044fa94191bbc2cfb9799698ae,39,3,36,Europe,23,245.44
b9d94aeee6b24d0f90b968576208be7c,237,213,24,North America,18,2149.42
b9dc5eb2f17042c1acb36848bd52506e,363,334,29,South America,25,1539.17
b9ddf2a1755e4a429dc648b10f0fdb32,312,272,40,Asia,19,2215.59
b9de702ea7b746cab59c67ef74455cd4,334,306,28,Oceania,19,2439.59
b9e008c2a2554becb99443fd5e39cb1e,139,110,29,South America,19,1275.35
b9e02b169e254bc4b00931fc781fcdf4,106,89,17,Asia,21,519.34
b9e05cf7dd644288b14efb2e86efde95,183,147,36,South America,22,1031.67
b9e371ba2f20469b99b1345fa0d24e80,255,226,29,Asia,23,2079.18
b9e61d2d2a90437a9ceafa91cdab8a13,94,44,50,North America,19,367.67
b9e6ba76c35d4b23a678bcbf54207a18,268,227,41,Africa,17,1911.22
b9e70c3900994417ae0109f7cf3505cf,229,185,44,Europe,25,1056.79
b9ea443b35d24590beb2f0448239ec9a,80,62,18,Oceania,21,472.72
b9ea72b5305048f6b46c507b906f3d78,331,309,22,Europe,19,2548.14
b9eb3db0d9484552b30a45e13f75abd7,191,153,38,Asia,19,1371.75
b9ec6a04a1f344d0ad2c083a48d27b76,365,352,13,North America,16,2379.86
b9ec73dbd0c64532bcf7829422988e8e,133,97,36,North America,21,645.96
b9ed16e87c7948408bcef93ffb20e381,183,157,26,North America,18,1071.49
b9f0154810924969ab1be41b42ecc9d3,183,139,44,Europe,20,1452.25
b9f02e189647446fb89b25c3180cbd8e,112,89,23,South America,19,767.56
b9f1fcd5925d458fb67b8a8eed52163f,275,245,30,South America,22,1322.62
b9f2fa757d7b4bac9d6e6d4461a5b45a,309,276,33,Oceania,18,2182.63
b9f3db70eef846ebb23c246233889fbe,258,226,32,South America,18,2016.55
b9f5734ac1724fd3b31546c9c4aae88a,203,169,34,Europe,17,1421.66
b9f81369a4a047afa44dfd806eb1c8d6,279,259,20,Asia,24,1657.52
b9f9c50136f54c37ade45ee923872e91,353,299,54,Asia,18,1783.83
b9f9ce89be324774bb62af497d4d389b,257,204,53,Europe,20,1469.41
b9fac4e515b440f58a91fcc2e025e5b7,323,268,55,Africa,27,2089.16
b9fc222567c1405d8a2a7774fcb4b05b,217,178,39,North America,18,1466.26
b9fc994467c14d46a708fcd27d3a5f91,261,230,31,Oceania,17,1686.48
b9fcdb65b2514968ad390986cb66aac4,169,131,38,Asia,20,1364.64
b9ffd55332f84fb88fbe4ce423549df3,343,307,36,Oceania,20,2720.04
ba012a071c894058888595bc7d37a560,285,248,37,Asia,19,1595.64
ba035adab7d84ccfad48b6188109eb14,219,182,37,Oceania,21,1595.29
ba03711b3f60482aab491db89df6e967,234,180,54,North America,14,1160.89
ba037d87fd09473898460135d646944e,238,213,25,Africa,21,2004.74
ba03ea710cba4d829646d0a7c543b509,211,176,35,South America,20,1218.97
ba0428946f4249e0bf625ac022d7333e,78,57,21,Oceania,23,872.89
ba04f37dd75f479a994bd52b122b89c9,31,12,19,South America,16,365.27
ba0714d5100e42c59d7d56fdd38a57e4,116,59,57,South America,18,502.11
ba075f69ea2b4e69b647e458f546657a,154,108,46,Oceania,16,757.41
ba0bed4bb2ad4c699d37b0c1c03564e0,134,91,43,Oceania,20,1213.89
ba0db20b09ea47d2af3866e808c19543,192,140,52,Oceania,17,647.2
ba0eace01cbc4e4090a95ed6aad4f435,167,115,52,Oceania,18,748.55
ba0fbc8dc6414878ac577eadf8937340,269,240,29,Europe,15,2181.59
ba10af2a628e4a998bb23920085a2283,364,350,14,Africa,17,1919.23
ba116061585a42ff8f835ff407a6ab96,314,263,51,Asia,17,1698.16
ba12917b2bae48249bf3c0927188476f,365,345,20,Oceania,24,2617.89
ba14f9295a4c4350b062b9195d7e8e2d,111,71,40,South America,18,803.05
ba1786389f1648d39f7792fbdc08e430,240,225,15,Africa,24,2072.53
ba19fa95d3bf409cbc12c64bab779b6a,248,200,48,North America,23,1677.8
ba1d27bb09534cf8be9fe9d44f35a109,129,75,54,Europe,17,647.92
ba21f62935e3468fb9017ae19b3fc028,191,133,58,South America,22,561.07
ba22348f59a746bf99b5dccd1c7f6610,213,177,36,North America,21,1403.79
ba232deae6334952a24da76b7cf47c09,108,56,52,Europe,25,737.74
ba23b7b1c9af453fa36b45786aff866f,362,330,32,Africa,17,3176.61
ba24343cb2d741349b24e37ab25bf853,356,315,41,Oceania,25,2132.01
ba24b51b984942cf91278b673a9117aa,330,304,26,Asia,22,2156.6
ba25fbfe333f45d08ce178ccfa634db7,61,38,23,Asia,16,504.18
ba27121d3bfa41a79308a63e084eeb58,275,243,32,Africa,18,2042.45
ba2a25ada60a4c2ea31a0184ba8392b8,307,273,34,Africa,22,2278.35
ba2c413b0686415faec94c9fa39a42c0,231,206,25,Africa,20,1320.62
ba2c5cd4411b49cca3dadeb51676df54,161,119,42,North America,21,623.2
ba2cf8ba49f74a60a62b71b371059a06,362,360,2,Oceania,22,1647.79
ba2f9c5c536448bb8e676d8e71c1e8aa,197,163,34,Europe,23,1235.09
ba33ce8b7f23446b957e9c4bcacac2d7,356,304,52,Europe,21,1407.06
ba352fbc61f34051a03429a1a426ef7e,363,337,26,Africa,15,2697.58
ba37cbedb076435faa682ed675ab39eb,328,306,22,Asia,22,2127.36
ba37da273c174f72bc20412ae106a34c,327,304,23,Europe,23,1910.38
ba397e3267f841bba17c3231cdf460ae,176,134,42,Africa,22,756.42
ba39d41b50df42c39cefa85a7c601b8d,365,365,0,Oceania,26,2864.26
ba39ffc889ba4bc98feb5fb366915ba3,229,195,34,North America,17,1767.99
ba3a1fe8076c41da8c3168515dcb2f62,120,79,41,Oceania,13,914.64
ba3c40b121d04a2d939effd089d31972,129,92,37,Asia,20,911.21
ba3e2d679a5641559f5934f108105503,43,15,28,Africa,23,176.59
ba3e4275fafa413eabc3ad5102e08bb6,244,202,42,Oceania,19,1494.84
ba410a446f8440b6801468ac67c08ab9,352,329,23,Oceania,22,2690.44
ba41dae0f9914863aa6666a79c5a2240,152,103,49,Europe,22,434.75
ba4206e9058c4347ae406028d977a8ff,67,43,24,North America,20,301.37
ba42892d3c01455b91f0207d4e758cbd,214,176,38,South America,19,1267.89
ba437c0eb850405aba8830bcb9efa5a3,261,217,44,Asia,21,1555.11
ba4a158ebd9e4859afc618cf08baa16e,96,64,32,Europe,15,847.22
ba4d8a62792b42e083c6dfc573c7f620,341,277,64,Asia,23,1707.73
ba4eefdaa54d4207b6fb4468d6d90f8d,364,361,3,South America,22,2268.49
ba4fcf678ae4479da1f1175a83e8ee93,185,160,25,North America,18,1561.33
ba5170de559f4eedb0c964a0c64476cd,185,157,28,North America,22,1428.2
ba522a196b9d4db3982caee140cb7719,325,271,54,South America,23,1793.61
ba52ce46dba943c6806c61e2190fdf3f,307,258,49,Europe,15,1667.85
ba53773cc8a941f2b71db6aa98ae2ad3,259,208,51,Oceania,23,917.66
ba548ae9f878478e80c7f3ab4e7b1849,314,261,53,South America,23,1684.71
ba59a97cd5b34789aec6e30fdcc8deb5,305,267,38,Asia,18,2181.16
ba5d2bb5a0da482d9327d90a6b12316f,104,65,39,Europe,21,673.63
ba5fd11f2de341d4a864765634f80aaf,364,356,8,Asia,21,1979.98
ba6069bd8e8a4e4d94aea0336671d658,45,21,24,Asia,25,366.92
ba638ad0f2ae4d4aa8fe7ea9f99a1481,313,286,27,North America,21,2986.44
ba65697e9d024a059a532da6b106d8bf,115,89,26,North America,23,907.78
ba6625d5dd21434bb3ddcef7a9043e93,363,335,28,Oceania,16,3359.69
ba6626ee3a5e4b41ad02d3516d5ae57f,72,34,38,Asia,19,232.73
ba687517cffb43029c19c2179474232f,181,145,36,Africa,12,830.54
ba6a21f587b349049ee02859e138f0e7,364,318,46,Oceania,21,2584.04
ba6f05759b74451cb821ba5b9bb6253b,306,279,27,North America,20,2503.49
ba6fe05e236241308e57c81fb832524f,365,353,12,Oceania,20,2745.16
ba7187ffcc6c4051a25c788c05fd79ba,162,114,48,North America,17,707.49
ba718ab27d424e1f840a5c8a5f7b2a2d,273,242,31,Europe,21,1967.76
ba71df813e234560902b6ef1d561e975,141,105,36,Europe,27,1195.29
ba7274967279485eba1860bfbd7af70c,128,82,46,North America,13,1163.96
ba731228d1e544cabc0e1cdc1a2df83e,193,137,56,Asia,17,1083.59
ba73cffc10184ad59669f20602d34108,251,235,16,Africa,18,2136.91
ba79f10d9c464e9b9ab55ad8386a2572,355,326,29,Africa,16,3131.94
ba8252a70fce48088dd3251321c1eef5,341,322,19,South America,20,2641.2
ba856f24614d45d5bd933b23f40039f3,310,272,38,Asia,22,2054.16
ba8873d8290840e3977b94be2825a1eb,328,295,33,Asia,22,2037.88
ba8bbba71e5c4416bf2f38def0ff44a0,138,103,35,North America,21,894.89
ba8d9f4490c347e6a9e190f57e7610ae,114,68,46,Africa,21,1152.29
ba8e3ba8f85d432caf6fbf962da455b1,180,129,51,Asia,26,928.82
ba90fa6e95cf4ed5a38bda605fcd26fa,270,244,26,Africa,20,2209.47
ba93f8b25ced40739b9e9475a47ac180,195,144,51,Europe,17,1155.1
ba94945298dd4e3eb1fae5a2652a970f,243,187,56,Asia,20,1296.75
ba949c403b9a4d0b9a30217a17ce1243,198,165,33,Africa,18,1234.73
ba953b87b2484fb9b7fcf46cbd730a29,288,252,36,Oceania,21,1629.12
ba9641b84a924861ac4cd20527118105,43,3,40,South America,21,137.62
ba9aec1e80e049b9affc2fa830f6b1d7,42,5,37,Europe,19,435.41
ba9cba2261e04ca4987b6d028825bdb6,363,346,17,Europe,20,3269.53
baa184aec6ad4b4cbe10991f79d3707c,365,354,11,South America,17,1027.86
baa25332f0e04b208535966fc5351846,70,25,45,Asia,20,11.11
baa53dc9d72e43ebb7984cbf164cca64,310,270,40,North America,21,1305.08
baa5426af19749cb979b8dc3889a01c9,241,216,25,Europe,20,2061.59
baa5cc12e0a04c189e823edc9ce3cecc,41,17,24,Oceania,17,427.62
baa6d96be06f4e63939781be214467a1,65,21,44,Asia,20,533.3
baa6e6f50b5a4893b23ca9e16a1d0fd9,64,20,44,South America,20,425.64
baa7c079b81645ff90611930343cbc27,38,18,20,North America,18,251.55
baaa15b58ac040acbef40efeda751a4b,96,61,35,North America,17,482.88
baafb56e326b4999bc46211831e75755,71,16,55,Europe,21,123.68
baafea7ecc724d0a888e19db57e2feb2,151,91,60,Europe,19,598.27
bab154e8b71f4f7d8d52823f2b9f5407,237,201,36,Asia,23,1538.33
bab173d90cb249d695c936f8c27d5ccb,89,37,52,Oceania,23,326.26
bab3283c4a0945598783aa593aa6ee16,146,95,51,Europe,21,909.51
bab53b5ad7a4428fa52f86116312223f,351,332,19,Europe,24,2762.38
bab5ae41f5964a4db008aef34ec98b2c,259,232,27,South America,19,1871.87
bab6061fd4c2438285b476bdc50827bb,62,34,28,Europe,19,405.88
bab9bbc2f83b4df89d513695abbfda4b,87,29,58,North America,20,397.17
baba5663c7ab4dc9b96c4414613cd389,103,59,44,Europe,25,826.37
babb22756569464eaeb32390ecf3b87c,195,150,45,Asia,20,1121.64
babc6e5777ce4cdbb3efc659cb784948,267,243,24,Europe,20,2309.95
babd1741ac3a4b3584b60adf75c6bf48,365,357,8,South America,15,3090.63
babdcf27923a48b3a11d5a314f4cf38e,365,339,26,Africa,21,2229.23
bac16ca4d5fb4441917f87b7f6b78c6a,138,87,51,North America,19,531.33
bac1eee0e8cb4e42b254e877501ffa99,307,275,32,Europe,19,1962.43
bac524aefccb4ab6ac14cf885ca791f7,194,140,54,Asia,25,1239.64
bac62240b1804c598d0c3aeace918e76,120,86,34,Europe,18,798.92
bac627ba0e414e13ae7d1cd2509bc637,152,120,32,Africa,20,1416.89
bac701c2c25b47d388cf531e48e89723,297,248,49,North America,24,1352.01
bac7894e78e547d3a66e6fb45c64070b,256,242,14,Africa,17,1713.35
bac798f338174c06acd8621f378eb045,359,316,43,Africa,19,2860.98
bac84dd11f7349ad80f077d0f93139aa,336,316,20,Asia,24,3057.02
bacc2fac180a4494bc0878ba894854e4,109,69,40,Oceania,17,545.9
baccaa21fa0548a597439ff1036e7f33,279,253,26,Africa,22,2231.32
bacce34bb5194d05b7a288ec6c7920d8,293,259,34,Asia,18,1991.41
bacdc0b509174405a74c89de8f418a76,356,337,19,Europe,15,3086.61
bacdcb2d751c4eec9b55099c77f2e0db,309,276,33,North America,22,2060.77
bad00592021948ba885cc3f915449c0c,248,196,52,South America,20,1566.49
bad303e8543a4562b949260c7001b268,357,319,38,Oceania,21,2884.45
bad3d24d4533409ab5f3feecb5eb5046,179,141,38,North America,24,1396.74
bad3fe0ade534895a4ef2b7dfea71a42,312,272,40,Africa,19,2270.08
bad78dbd5a6e4b989405fdf9a5fc6183,126,83,43,Oceania,21,842.93
badba88835014bf7933303face9edb53,304,285,19,Africa,25,2713.88
badcd7a3516c481881fda30a532680d1,98,67,31,Africa,18,1025.61
badde1f0008b402f80b57fe657418aba,288,240,48,Europe,21,1144.9
bae41cca882242b19294e875c8088980,362,332,30,North America,15,2252.92
bae6aa2ba27f43d09d39ea4b19529e48,365,346,19,Asia,24,2739
bae6e5294cb7446f8ccc0720807f78bf,280,234,46,Oceania,17,1405.86
bae6fdaf6ad448c9991f46967e389337,278,236,42,Asia,17,2219.84
bae82034269c450a82cd6dd0c548e562,174,135,39,North America,22,1082.93
bae9ae888ddd4fefa513bf508aea0805,285,223,62,Africa,18,1695.6
baeb6d2ff71641b5bb439769ecdd38f1,253,210,43,South America,18,1217.5
baebecfc2d204be58a66f7648b6bdc75,31,4,27,Africa,22,418.33
baec624c01004b799a3da3d746bd7ec0,336,308,28,South America,21,2879.58
baecbc37a1ed4b43966912942d6f55de,280,235,45,South America,16,1544.16
baeeb53b43804884931af9c26d6da841,360,325,35,North America,20,2327.46
baef916cfacc495483fdd70f8995b31d,365,343,22,Europe,16,1209.19
baefbe2142b54b8e958c35dfe745537c,203,153,50,Africa,20,932.73
baf04ae20e8d44cd93004ede88c5eb31,158,105,53,Europe,14,633.51
baf05b711ac848a5838569253cbf86f1,133,113,20,North America,13,1228.64
baf6204d752147c08939e868b179552f,257,229,28,North America,23,1571.78
baf9d596685a47428ed74f073b90d665,187,161,26,Oceania,22,1400.81
bafa1257f1e94d3da7b9d47473176426,181,131,50,Oceania,22,883.21
bafc3286389f4e73870c18bdab23fd1a,169,125,44,Europe,24,1336.02
bafd51e87fd143febcf65f5ece969c73,171,147,24,Oceania,18,746.44
bafdbe25ceca4d9ea874c91c79bf172a,365,363,2,Africa,17,1534.63
baff402512604bb7964b70e6b494fcd6,306,257,49,Europe,20,1600.72
bb03451058b143968c231be2f73ce9be,363,327,36,Oceania,20,2733.42
bb038325694640e592339e2b27f90ae3,169,139,30,North America,18,1695.35
bb067bb0d923437991aeae17b069564a,365,329,36,Oceania,17,1811.52
bb0807ccb1b94c55b9bafa3e88ebacea,301,266,35,North America,18,2959.15
bb08450407074ddba1c43670d16e10c1,134,93,41,Europe,17,917.28
bb09f5327855455c847cd6ab0849a50c,314,267,47,Africa,16,1621.94
bb0a35ad5b4f4fc6bd198b3f433839b7,94,46,48,North America,17,382.73
bb0b05a1eed848458e1f3032dede0a73,365,351,14,Africa,24,2456.28
bb0c6ecac3584b4995357b1d2dab0088,365,311,54,Oceania,19,2010.96
bb1292e40cf842a2b9c1e1ce285fa5ab,365,330,35,Europe,22,1737.01
bb15c140339043cebc2f2c633601c4ea,360,305,55,North America,17,1035.35
bb16b1bf7f1e48cfbdb32ca5213be53a,179,153,26,Europe,17,1689.38
bb176c7a73f944d3a5a5028c5143d391,148,123,25,Europe,19,712.21
bb1a625daf8049df952a69937e19d4cd,298,246,52,Asia,18,971.78
bb1bb6d17d654103b13e59a8168cb394,299,259,40,Africa,19,1658.11
bb1cd5a920bd43a69ec46907a678f15f,191,153,38,Europe,17,955.49
bb1e172ce0ae46c39bad9bd0cd502862,228,195,33,Africa,26,1694.11
bb1f7626b47b460bb4aa9bdae709fced,329,280,49,South America,16,1441.58
bb21538fe957442799a0e7bc8bbf9570,307,252,55,South America,20,1324.09
bb229d970b584a9d82f41ff23dcfb10e,299,273,26,Asia,13,2530.81
bb2307f40fb74f87a5980077143ab7b7,365,330,35,Oceania,20,2705.59
bb248ed38b044c82a85623fbf71bdb0b,261,231,30,Africa,13,1986.2
bb24c5f242a44921a471349f1b645350,205,175,30,North America,21,1487.93
bb28ba3b6f4447749fd8cd72165fb969,52,28,24,North America,19,230.16
bb2ae09111924d0aa50975443e630f3b,204,181,23,Africa,20,1472.33
bb2f145a2679483086c4dcc8b47a8954,230,205,25,Asia,23,1667.21
bb2f550a96ac43ab80d07f8ae43159e8,133,82,51,South America,20,387.45
bb305def07ee41c392919df40bb468f0,246,197,49,North America,21,1691.92
bb32124f33194c9d879a6fc1fc74b9e3,205,158,47,Africa,25,673.02
bb329ba15e124ed8a0e1fdbd97f09720,352,304,48,Africa,17,2445.21
bb32bbb74f4c4bfdbed373c8ce01ea02,118,81,37,Oceania,21,605.14
bb331bae27b64db3852f326825d8c37a,335,290,45,Oceania,21,2065.48
bb339c290669462590b3885da628a85f,283,256,27,North America,20,2238.17
bb3b90048d5c484aa78b4f4507d106a9,317,266,51,Oceania,16,1778.66
bb3cb1fecf8b47c390fd222e88c811d8,339,315,24,Europe,20,3221.1
bb3ced4717864877bef272ad698a77ba,48,24,24,North America,16,214.69
bb3e2e3a5332453a921771d555b5a00a,221,180,41,Asia,20,1764.14
bb3e80d397ae4c7bb7a2d24130226b7e,230,212,18,South America,17,2202.09
bb3efed2116a4c0f86679dd58151e5fd,88,60,28,Africa,23,936.98
bb4057b0b18b4cc6b92e7fcb6cc3fc13,174,133,41,South America,20,1061.68
bb40d0fd36804290978e391f40b7455a,101,49,52,Oceania,19,394.15
bb413e604f90471bb0763cd923c77e0f,133,104,29,Africa,24,664.07
bb4166e9704e411ba0e2122f92bc5dc3,363,345,18,North America,18,3015.51
bb43296c463748ed9f70c5202f0e36cf,58,31,27,South America,24,473.62
bb433f8682df41cd9f5e07948f345e40,107,82,25,Europe,22,972.06
bb46661f80d34e6eba4548166b8d1762,241,214,27,Africa,19,2132.27
bb48548db6694411bc3cf47ee437a888,361,360,1,Asia,15,2291.52
bb485e036b3f4425a5e690f786929dd5,130,91,39,South America,16,993.41
bb48835294454a07a13ed1c079f77c5c,59,30,29,Europe,25,540.99
bb4e5b27ebcf4b30a21859544f3f0352,172,151,21,Oceania,21,1261.49
bb4f603cac4f4d188c012ec59ae2c714,285,245,40,South America,24,2338.72
bb5062f2e1fc4be69bd64c57b856646f,208,169,39,South America,21,1537.95
bb545d02a065412081e3384de02c5290,81,47,34,South America,22,643.64
bb559c1a176149b1a77a46c41f933abc,227,186,41,North America,18,1697.84
bb572590c2f447a6b0286463aebbdaee,364,358,6,Africa,17,2786.98
bb5c0ea533d34bc1bd4d3db04c2a0f68,283,267,16,North America,21,2049.6
bb5e1b729d0c41a1949c1e4b773dccc4,317,290,27,Africa,23,2272.65
bb5f21e59ae14af28cce79252e87715a,132,86,46,Europe,23,518.82
bb5f8393ae064e5484f06cb9af39d1aa,361,322,39,Europe,19,1658.1
bb5f9f160c8a485284bcbdbcf0252d85,98,54,44,North America,17,1092.17
bb5ff04c5e434e388b43ca9e8ee5b89d,237,212,25,North America,20,1747.77
bb61ad0295c344bda0b8cc2d290d05a7,309,259,50,Europe,17,968.98
bb61d7498e24421991e4f329dbdb82a4,142,103,39,Africa,25,1000.05
bb6200c2f74147d2a678c151701b9139,232,212,20,North America,21,1664.44
bb6226978e2448a8bd4058bf39ceeb46,137,102,35,Africa,13,779.7
bb62a4d42a694721ad943a540ab65b8c,150,101,49,North America,19,600.02
bb62d9884848413c9c0c23c445d060ea,286,265,21,Asia,24,1832.21
bb65470d246543a9ab44519d5399e6a1,343,299,44,Asia,18,2064.65
bb66c9b5f9b845e8aaffde075f628bd7,357,315,42,Africa,17,1959.39
bb676e7429a84d9db1789a5c8a9d7188,311,285,26,South America,18,2781.51
bb67dfa4b4c44c4a9f734713a7da000b,212,177,35,Africa,21,1531.04
bb687b546ae04a9ba4878e4dc6cac65d,74,25,49,South America,23,324.85
bb699d8c2fef47cfbccd2ae969505aaf,115,76,39,Africa,15,118.45
bb6a5e3503c8486db7a489c532de2cb6,254,230,24,North America,21,2352.6
bb6b4c1190d0417f9a6ede14b8f686a8,66,16,50,North America,16,632.43
bb6c1aee3ee04658b1e6a67e8a33e85b,112,89,23,Europe,16,1170.21
bb6e07e1efd34c01a96d729a42bb5db7,325,304,21,Africa,19,1642.19
bb6f3521e68a40d6901d8e1a47290957,178,152,26,Oceania,17,1682.21
bb71b1ebe6af4fba86c5721f03721163,201,163,38,South America,18,898.2
bb72c8a74a034fa392a014e8aea2bb5f,222,177,45,South America,16,896.33
bb73031935854d4294e2a711e7e84445,323,289,34,Europe,19,2192.71
bb7369bfb47d4d5a8bffa90c57e0d34e,279,246,33,Oceania,16,2254.29
bb74f7c8988c42808bf4f41bef34c859,115,86,29,North America,20,847.14
bb78880a6dc6431a90b858324b156bd0,253,206,47,South America,17,1206.07
bb7b3655bba346c4bd56073bcea8cbd8,150,116,34,Asia,21,1126.51
bb7d75a936fc432c87c00aeba0ca4142,213,165,48,Africa,25,1385.33
bb7db4068aaa4a7d883430412d7358ea,344,318,26,Europe,25,2630.8
bb7eb02976984bed8bc1656d9a39f620,364,351,13,Asia,18,3172.09
bb7f85cc1dde45e9b45e2a4260f25be9,206,161,45,Oceania,19,794.44
bb833233aeef4d5c84bb3a4fd26122f3,352,293,59,Oceania,23,1316.02
bb84655e4f494bc8b30a9319a7f75b36,155,95,60,Asia,21,836.7
bb8880499ce148fea2d75487d14e1659,115,78,37,Oceania,20,577.35
bb88af7e4d734c8cbff45946ed519567,95,69,26,South America,20,834.59
bb894556b81d4b0aa880b570d2281624,96,45,51,Europe,18,504.32
bb8bd2424d624ed9bf239327fb1c5b0f,98,81,17,Africa,21,730.61
bb8c760e7d6842029ae99a6a077b7513,118,101,17,Africa,17,877.2
bb8cc4f8407046f790acefa1be7c8ff9,363,358,5,Africa,23,2306.04
bb903da526b04d18ae85ccb375a39957,107,76,31,Africa,20,724.56
bb908cbc1d5749d6902b13936eae90c5,78,22,56,North America,19,489.21
bb910fd49a0243159d4b60f53e0502f8,192,176,16,Oceania,21,1187.06
bb92d3159aaf4a5bbb04ed3d584759d2,180,135,45,South America,24,1076.6
bb945cb1c5904354a9c6fb0410529462,250,212,38,South America,23,2285.43
bb957fca8f574f9082b194030b81527c,213,159,54,South America,16,924.03
bb97e138d9554e98ae9a19577e03b6e6,155,115,40,South America,19,884.72
bb992f94a9a846cb9b0802929fb0c753,69,28,41,South America,21,389.25
bb995fadab5a400393389bc05b5a7513,145,100,45,Oceania,21,939.47
bb9bfd004ad747b5840dde09339ac9f1,146,92,54,Africa,22,825.34
bb9cfd20c03f4c77a972927628441d91,226,179,47,Africa,22,1032.55
bb9f31966e93447abc4a584cbfaf6dac,178,126,52,Oceania,15,490.28
bb9fdb277aac44fcb51dede9dc46ca9f,305,274,31,Europe,24,2267.98
bb9ff1d6935f429daef5bf5acfa1433c,363,349,14,South America,20,1822.35
bba151f98d344cc4aaa7d7763d1e5c92,341,325,16,South America,20,3115.63
bba2e6340b924105b59edc74787493ee,194,167,27,Africa,20,1954.76
bba3802abb1a497786a938bc20d9e71a,111,60,51,Africa,13,469.25
bba7300cc1ab4c24b618d225fc25eec8,161,138,23,Africa,19,924.7
bba76d42b24c41689b80e0a9f2f938c0,121,91,30,Oceania,16,780.28
bba87cb6fa834e5fa08b931f1f680e72,172,115,57,Europe,15,1098.73
bba8bdd6ef034a1ea3230bb841197ec9,117,72,45,North America,18,498.71
bba962b40dd447ceb0a164f7cc03a44b,208,186,22,South America,17,2157.18
bba9a27738cd4df5a65c0516c3610b67,248,220,28,Asia,26,1721.95
bba9c6287c8a4c0cbfc4225e52a8d652,48,19,29,Asia,16,234.87
bba9fa74558942f7a46cff1f5421f27d,138,97,41,Oceania,22,712.2
bbab3e7edb654ec98de0253ea6189fc0,186,156,30,Europe,18,1273.63
bbad234445ef4a36b128bed4c1e736bf,146,120,26,Africa,16,1035.06
bbb1cb8350034b95ba5a70db81c527b0,310,285,25,Africa,24,2272.4
bbb22e14026f46cc8e01d1eb0be5f05b,143,113,30,Europe,18,783.71
bbb2b5e61ddd4dd782ed92e0b077f468,218,175,43,Oceania,23,1104.02
bbb3a97b19c4479fae5a4f90db60879e,115,82,33,Asia,23,551.15
bbb3cc91837947019596a2576295e607,295,259,36,Africa,20,1895.26
bbb4eee15dd241a7804b608dea8cfbf4,278,239,39,Asia,18,1824.72
bbb68161812640e6aa6ce2d8e0b6a321,365,350,15,South America,21,2743.13
bbb7063718774a848807a706fa9d3fa7,283,263,20,North America,21,2482.56
bbb75d6de0cf47f1b875c862d41359e3,270,219,51,Oceania,17,1449.26
bbb93dd1c9cd47c9918b6421fc60740e,110,55,55,Africa,22,324.27
bbbb28432b0d4f11a01afdc6803098c8,313,271,42,Asia,23,1937.01
bbbc4fcb5ba2496584aecfc1438b91bb,120,67,53,Oceania,15,592.16
bbbc88c3420c4852a31438d3916b2c7c,363,354,9,Oceania,20,1955.64
bbbd7e3b57734be1bc07a3da8a195ba7,312,276,36,North America,19,2277.23
bbbe065867d540c7be0e22b0a60636a5,129,80,49,North America,19,661.97
bbbf74f1dad242eda4419aead39e1e5f,296,284,12,Europe,17,2265.42
bbc0357a84334c318e53a34b9a497edb,365,352,13,North America,23,2159.24
bbc1c0005dda4446a058c4859e459963,128,98,30,Africa,18,469.77
bbc355c2f4794dfd81a070fa13ec1d2b,346,330,16,North America,23,2494.79
bbc462886e3f4b629a6f16ba6d8c3adf,111,64,47,Europe,16,541.74
bbc4ad7073b149d4bd14f5e7a202d308,340,309,31,South America,19,2481.87
bbc7ebd640474643908c8645947a28ef,302,269,33,Oceania,23,2042.36
bbc8f31305104b2e9a869f146a040ddd,46,24,22,Africa,19,258.82
bbc972aa20f642aeae9d734fa6b6682f,83,62,21,Africa,22,544.09
bbcaf0e67cfe4c9e83393a96e53f4c38,62,21,41,Africa,17,465.93
bbce121c0bb243d7ad4e4f3ba4b67fc7,241,187,54,Africa,16,1364.77
bbce55c2a7c94af891713e7110ab5f74,83,45,38,Asia,19,603.41
bbceb4f34c9e4c1594a95b244d6a6a1f,151,117,34,South America,17,1247.82
bbcfbaafbd0c46d888928ba034a0aedb,330,275,55,North America,19,1947.64
bbd028ea067d40f4b2915464cabd52fa,365,358,7,Africa,19,2962.81
bbd03456621e45fd81bd358ab5a334be,234,190,44,Europe,24,1082.24
bbd039d71ddc40008471cbdccad694c2,43,17,26,Africa,17,293.07
bbd0a15d05c74dcba676331f7a648698,337,300,37,Europe,20,1931.25
bbd100b08d954ecebdcf945598e9f044,265,240,25,North America,20,1731.05
bbd1b977ab7049c595dad3aef83336a4,365,356,9,South America,20,2245.3
bbd496bb58ae40a28a62cf2151437fca,151,99,52,Asia,19,607.4
bbd4d5d2e7124a77852f443058df97a2,95,64,31,Asia,21,737.79
bbd4df37d00a4e49b92032a3831ec76c,359,322,37,South America,19,1773.3
bbd5641dc3f0483d9d854c90b1934dc5,161,139,22,North America,21,1777.86
bbd72c5a87dc4488bb3475d4831adadb,91,38,53,Asia,15,437.23
bbdb86eb88f743d6a74c6fedd512ede6,59,7,52,South America,17,216.49
bbdcc7ffa4104080a7a7bc250d65147d,141,123,18,Oceania,21,556
bbdde60032af41348e3ccf2be3e50ff1,365,355,10,Europe,15,1482.8
bbe52dece3154830b8897e03c40e0ac4,318,272,46,Oceania,20,1754.12
bbe5390dac554d9cae95fd6f2b765503,273,228,45,Oceania,19,1473.25
bbe68fdab60e438f84dc20aa0637e277,176,155,21,Asia,15,1531.27
bbe6f5888ef94beba672876fb7518884,361,319,42,Asia,20,2939.76
bbe6f77df8ce4c92822e6fcdf22b9b7b,248,206,42,Oceania,16,1323.11
bbe7db5cc8fa4cdf8659090f9cdb949f,248,222,26,North America,18,2170.15
bbe966c2eee649d986c48bf44d705435,203,165,38,South America,18,1398.74
bbe9d09c531d471fa92206c875d68873,213,154,59,North America,22,881.88
bbeb3977484149bd86c1df8b5ec362ec,308,260,48,Asia,16,1170.52
bbeede2bbb2e450b80a4f99f44b2daea,92,57,35,North America,14,603.54
bbef187e2594465da953e07a96b80ef8,155,121,34,Europe,20,1155.54
bbef5bfbdd9b4681a6eae6c0c7bcea51,337,300,37,South America,21,2546.36
bbf2a6c67c9641bfa636e579b90bc002,166,140,26,Asia,21,1033.16
bbf316de9e6340738f92586b43b529fe,70,22,48,Oceania,19,628.06
bbf62e0130f440b58b0cb3def2e82609,50,18,32,Africa,16,332.49
bbf82aa3f7e9405da2e4c16d056a45fb,295,261,34,Europe,22,2085.24
bbf9b72a0735450f9f038ce064752073,365,351,14,Europe,17,1759.35
bbfa1d16e7834650b3fae87715ebfdb1,360,317,43,South America,18,1631.7
bbfa7dec1782455185df64686e204384,76,64,12,South America,21,343.57
bbfbcae9dcf447aa96148c0851d5cd19,252,217,35,South America,19,1580.37
bbfbce0fce194b52b93f366a22a3a674,86,45,41,Oceania,19,648.33
bbfd713fb3d0483aa3f5a0abf3e0081c,179,128,51,Asia,22,1020.81
bbfd9b0b8fb4483eb7109b77d061d5ea,243,226,17,Oceania,23,1447.43
bbfe84f0505143d79bfb6800999a6018,286,252,34,North America,21,1740.43
bbfeec607d89451c9c4cb80faa107caf,170,145,25,South America,15,1678.98
bc046ffaf6124c88ad3362d28cf54690,85,60,25,North America,19,578.28
bc04e4d3e0634f7a97df40e710759b66,364,358,6,Oceania,19,2778.35
bc0a99c7e6ab446da223bb1d64a55acf,305,248,57,Oceania,20,1561.2
bc0b73d46e6b4c459b94b7ea0a4a6120,150,106,44,South America,19,1144.05
bc0cd3e102b94fc8b1a22b732a6d94a2,344,319,25,Asia,19,2728.55
bc0da9b3ff3d4f878ccb2bdd35ae7d44,245,210,35,North America,15,1376.87
bc0dddae6ade47318b5d033ff2b2d662,245,210,35,Oceania,17,1366.5
bc0ff7f214d8484a84a291492d91881a,55,7,48,Africa,17,366.79
bc106f1132844292bdecf111f85940ab,335,307,28,North America,18,2570.56
bc107d19617e47b1bdf4fba97928be8a,222,196,26,Asia,14,1942.52
bc118d3e585d449ca1fe034793957027,46,18,28,North America,22,290.93
bc127233f99643c987d12094d40e8dfd,61,26,35,Oceania,22,288.71
bc1607f9d3394e17a3cd20690a1026d4,330,298,32,Oceania,22,2794.98
bc16c118ae484922bf16d1f0292d2f79,365,341,24,Oceania,18,1680.51
bc18336352f24852bad7e03830311336,68,16,52,South America,20,288.65
bc18aa1b498842e28e27f066859f1e7a,290,269,21,Oceania,17,1541.5
bc1a95d4a28e4067809d2fd38d8ddd26,365,361,4,Africa,20,3013.98
bc1b845ad4c248368d9b5a3d9aab9c26,277,230,47,Asia,18,1580.22
bc1babc41de24f9b8119458ebfc7dd99,349,301,48,Africa,19,1407.62
bc1ef71a27f748e48b8d391118e89998,356,311,45,Oceania,18,3050.65
bc1fb77bcb224bf7b0ca5a42c6c871aa,73,42,31,Africa,26,350.88
bc217e63570a40809175d71b316d9c4a,38,4,34,Europe,26,251.14
bc249fc73ef847e3a27874d6435bb3cb,212,167,45,Africa,20,1228.73
bc24e54f7d384b4a9a5212e33345bc66,235,200,35,Africa,18,1676.07
bc28ecc69c554ea6b378c5bd47752550,285,247,38,Asia,20,1882.23
bc2977ff057a4127a3009331761ba1c8,229,220,9,Asia,20,2317.79
bc29ef830348425397856cec5f4941c5,344,307,37,Europe,20,1781.1
bc2d2323500d414cb3fd8da97ddae360,254,229,25,North America,17,2139.96
bc2f9648e86047d8aaf8134779a85288,250,232,18,Africa,21,1850.86
bc3070ffa05c405f82d50caa1a406245,321,288,33,South America,20,2289.12
bc31258f96a54950b4962c19c9cbf3b9,222,178,44,Africa,18,1295.38
bc332c9235d84f60b51d0867be1ad436,152,100,52,South America,20,1052.05
bc36b85bc6de4d0f891f1f8cf08b22b2,306,274,32,Europe,17,1891.24
bc3762ca80804aee98996891c9893268,251,207,44,Europe,20,1978.27
bc37e46c521d494f9e6440a53595096f,140,112,28,Europe,25,992.03
bc393f5b72604370a9061c9cf42bfd70,327,298,29,Oceania,21,2877.11
bc399cd3752449b884a797ecf17a4245,350,317,33,Oceania,23,2153.03
bc400a7aa6c2431fb28094cf59f828a7,172,135,37,Europe,19,1590.56
bc4183eae0ce419b9f89cea5dcef6e38,130,81,49,Africa,21,611.83
bc42a085483642e4a7c87a73d7da0bc6,91,37,54,Oceania,17,352.09
bc42eefaab964854baee98dc620f6f4c,236,215,21,Europe,20,2161.62
bc4636b71b5544c9a7a50a08e9cf7a7d,138,115,23,South America,15,568.13
bc48bc511650471cb64c64921346e3dd,187,161,26,Asia,25,1035.93
bc49063646db4d3c9c146df42260fd16,44,19,25,Africa,24,233.71
bc4afbf3abf747d09a1d1892a82c25c1,314,275,39,Africa,22,1620.96
bc4d6b6f51cb49b8baebaf6a39580c5a,66,21,45,Africa,17,95.55
bc4dd417dba24602a7386274eee5f382,121,70,51,North America,24,970.82
bc4e024e35bc4651b32d6c5115dcb378,220,161,59,North America,24,1273.06
bc4e1a291dfc4e61a7b82814d9c5e1e5,196,155,41,Europe,19,918.99
bc51549821c84dbb8f0045327f04e711,365,349,16,Europe,22,2859.87
bc51f2d787d34cdbbb155a83f0ccb4ab,318,291,27,Africa,21,2398.94
bc538a2a237f4762b900c21efae72ed4,180,133,47,North America,18,2057.58
bc56487d81274d86b0cb64ba62e5eaa1,332,283,49,South America,17,1596.72
bc57bb839d724736aee4d6b5c621ecf0,114,80,34,North America,17,1098.53
bc59eb81206c4df5b355d61cc58becba,362,346,16,Oceania,20,937.33
bc5a47467f8b477d87edda9557e66351,127,79,48,Asia,23,516.49
bc5ab7705d4445bcba5da698f76a79a5,67,29,38,Asia,15,328.33
bc5ba1ae5bc94f7fbde76ad0818202c7,257,236,21,Europe,21,1639.62
bc5babbd52db49a889549efece64b0fd,190,162,28,Europe,23,1329.17
bc5d0d3a01a945acb7de63be146abdf8,214,168,46,Oceania,16,617.6
bc5fa9a3f3c4408ca4186008255427dd,278,258,20,Africa,24,2310.89
bc61d2af3dbe4c2da03a92960662d04f,254,207,47,Asia,19,1614.61
bc687821dcbf45c0a7ae42a018048b66,254,209,45,Europe,18,1303.64
bc692751628a4777b4e95d246403552a,210,183,27,South America,18,1558.97
bc6a86c0492f4c1b88a13c07abe7ccd5,331,289,42,South America,13,2436.8
bc6c05a35d124e4e96bf1cefcef45ed0,363,338,25,Oceania,20,1582.8
bc6e113239694431b5c6b0d401887eff,255,218,37,Europe,17,1796.41
bc6e989ab9a74671b9936e230373b0a7,365,362,3,Africa,19,2548.39
bc6f4325d6c5440482301d5caaf2e8af,129,96,33,North America,20,805.29
bc704a2e025b4bc68077f3b251d766cc,74,29,45,Asia,12,435.28
bc7274854c234e56ab57eea55a357642,159,134,25,Europe,16,1077.86
bc7280857bd94151a5d575d966959ef1,47,8,39,Oceania,25,208.82
bc72cf2ca4c9417b9c2f86be64dc5284,95,45,50,Oceania,24,487.19
bc7362dae11c450d9fe48be50bf56f79,59,32,27,Oceania,19,723.57
bc744eeb447f4333aa41ceae97667437,319,274,45,Europe,23,2465.6
bc7525343b36471989009cf171eb779b,285,238,47,Oceania,17,1325.48
bc75983947464931bf1f6a5c48280542,126,92,34,Asia,23,982.15
bc761029e6004a63b869e0abef4e7ca7,86,62,24,Asia,14,421.22
bc7931e0456a4dd9ae09b3a33e8a2f25,224,187,37,Africa,16,1966.14
bc7b2f65cf0641ae92563fd0c96e7713,363,363,0,Africa,21,2785.92
bc7e05167a8c4722b42a51d384691008,40,17,23,Oceania,24,167.59
bc81b72435e64ad0a2ffb6963fe06006,206,156,50,Africa,17,997.72
bc8260b59f1047808be0c615c8df0e1c,71,20,51,Africa,21,525.72
bc82652dbaf74377879e8b60d0b70822,270,245,25,Europe,18,2147.01
bc826995bf14414da80c0b86c0c2d5ad,76,44,32,North America,20,261.57
bc832ee98f6441a79b95355e2c1408ae,316,290,26,North America,21,2563.13
bc83a458372243bf8b0354a394f215ec,326,309,17,South America,22,1806.75
bc84d424abe24100bf695dc6254744a7,363,310,53,Africa,23,1470.91
bc87b55316eb466eb586af4acf774343,348,300,48,Europe,20,1651.14
bc87b5ff40154495809670e05978ce9f,272,237,35,Oceania,24,1762.7
bc8bc9abba194673af11b3e4188280ff,114,89,25,Asia,25,256.11
bc8c4f2286bb402aa9f14ba801d91dd5,317,276,41,Oceania,23,2130.97
bc8c9fc5f0714366b0edd16668980ada,165,144,21,Africa,16,1641.92
bc8dad961987420db9ba28d996352680,364,337,27,Oceania,23,2635.47
bc8f50207af1466abdd2a47603de2b26,291,245,46,South America,21,1926.93
bc90cb740e204684a92e8b5e1d4ddb21,47,15,32,Asia,21,447.66
bc90d4d51ef44d458e66cb200c710b85,127,77,50,Europe,24,992.55
bc9815cbd38e45499dd96680d6741058,216,197,19,South America,17,1542.79
bc986835940742a5b6a00da873d71eaf,144,113,31,Europe,15,1402.93
bc99fe512cde4820a841fcae1f800729,365,358,7,North America,27,2411.1
bc9d8a1c98e44cf9bf99e1ef4adf413a,158,106,52,Europe,24,471.45
bc9e884f9fd4498eb99c7620faac8715,102,60,42,South America,20,689.65
bc9eb3ab67fd4ef283be0c426fda1cde,362,315,47,Europe,14,1779.03
bca1f8ca91db4e7497233ac43907831d,282,235,47,North America,13,990.54
bca4091abaff457d95917647f5d38411,155,108,47,Asia,15,993.16
bca50c4d9bd54e4b9aa1b5a24308e522,106,74,32,South America,18,983.82
bcaa43bdf7404f709ce3114a6b88cd57,200,150,50,Asia,20,1160.01
bcaba50052fb44aabd44503643acab05,98,67,31,Africa,27,734.09
bcacdf47517a4ec6affdeb86e716c923,215,173,42,Asia,18,1607.2
bcafa7b583c744db99e00e9a32f453a6,312,288,24,South America,16,2520.53
bcafb731e0c646249c74cf553d8dc030,365,316,49,Africa,22,1885.53
bcb0580c2f4548cf93479abaa2229311,362,335,27,Africa,21,1771.72
bcb05ae5b4734843bfc81c4f160ca0c6,156,110,46,North America,19,744.85
bcb21f89483e46fc8ad186c833a421b7,97,44,53,Asia,18,642.59
bcb283793d0547ddab2fe472f9aeea2b,357,308,49,Oceania,23,1467.45
bcb3f3a84fd14a289b365982839f63e5,125,74,51,North America,19,587.57
bcb5ec846d89447da92edd197c95299b,223,170,53,North America,20,962.56
bcb91900e74e4b48a720441d2052f941,61,35,26,South America,20,305.61
bcbe55e863dd47e5b4695bd7c063d8ff,28,2,26,Europe,22,286.76
bcc0f49651e0461fb9409d4f3c2b77f7,184,126,58,Asia,21,1170.3
bcc2579c57494b778d1e6d9feaa04fe4,143,111,32,North America,19,1249.51
bcc4407e03b347a9823028397d3f6288,98,61,37,North America,17,350.24
bccae33b73fa4713bc11b814f3f4ed18,178,135,43,South America,15,1133.59
bccb1b73a203443aa41cb4a5fb7d8f23,357,321,36,South America,21,2117.88
bccc15489c824e84b5de8030aeed2aa8,183,147,36,North America,18,1143
bccc32681d4f44439e476509ef8bf110,117,93,24,Asia,21,672.02
bccc9c0f7bbd494da2c85cb7eb96b4bc,214,158,56,South America,14,1095.83
bcccabcd3eb84f968fa4585ce1aa58d3,212,188,24,Europe,22,1671.73
bccea29e76c5496fb3a686715c4931be,26,2,24,North America,17,143.32
bccedf0e471145118978814a8f93af65,353,325,28,Oceania,28,2555.26
bcd2c40c1ea94872aae31d9d1e91dca3,185,151,34,North America,23,1621.5
bcd5d1e0a0ed4708913351bf9913b65d,193,139,54,North America,21,1162.95
bcd839bdd187492eb4624686cd1b2037,126,88,38,North America,19,403.76
bcda2c0599e6411cac518716ae57eef5,149,107,42,Asia,20,1258.65
bcdae854fd05426bb89c119f4118bb95,77,47,30,Asia,23,411.14
bcdb4d0b452748858e2170b4cfba0fa2,148,102,46,Oceania,22,523.95
bcdc4661429a4c97ae1d13646f144b6c,30,1,29,Africa,27,149.14
bcdf69c4ba9e455b8d59b519535e7355,321,298,23,North America,18,2186.77
bce1262a861f4cbe9f15756ff193e561,322,290,32,Asia,22,2065.52
bce407ae235d42499fa451c112625177,226,201,25,Asia,22,1802.15
bce520ff13ad480d8069911f9b88af17,365,352,13,North America,18,1854.87
bce60ac18f4e4ac7aedf5e03cc058643,149,128,21,South America,19,979.25
bce68c7dec5848019302c8a4e233f296,335,311,24,Asia,15,2006.47
bceb2332154942998ca141c5af74dc5c,141,94,47,Europe,22,355.89
bceb696f9be340f2bc5b880edc1995f4,150,129,21,Oceania,15,1014.98
bcec4e8433354d2e99fafaed7095c869,106,83,23,North America,22,940.07
bcecab8599c94ac0b35d2bb59344c820,63,46,17,South America,14,648.79
bcedf820b53d48259bf93c5b59ea43a4,42,19,23,South America,23,349.19
bceffb0478b0475d951ca37f8f93fe7e,158,123,35,Asia,17,1222.64
bcf01859fd274144b901d7ac3519bacd,145,118,27,Oceania,17,1163.09
bcf186c5466e4751b3873a74a3d3e32f,93,51,42,Oceania,22,580.76
bcf1c3b8a9194dc19e64b4ab9922c277,365,351,14,Asia,17,1931.73
bcf1e1a98198455cac3bb76eb9a00fd5,216,173,43,South America,19,940.02
bcf40d66572d454ea4dd4e1072da5c0c,365,347,18,Africa,20,1609.07
bcf4a7c53be5498e89568aff0446490b,264,223,41,North America,24,1247.83
bcf55a115bbd44609dd5715c414d5fe7,137,121,16,South America,22,844.51
bcfc4aecfa984a30aa4cf068229e3689,311,289,22,Oceania,17,2489.89
bcfebd774d524ca19a3e81b590b16f07,214,184,30,Africa,16,1868.49
bcfef966eb7646efae00235b26869439,245,198,47,Africa,18,971.71
bcff26148d564ade9e44b41480938e2d,365,330,35,Europe,19,2389.83
bd035921b2c54ed7bad8458c6ae76130,218,180,38,Asia,17,1325.85
bd04c2bb454e48689508f5de8b4c937b,84,58,26,North America,20,864.71
bd05ced929b74ba5954668dfcc6c3ed0,60,39,21,South America,21,240.38
bd0668e18b114cac9ff61da9d26a9ff6,282,241,41,Europe,21,1396.98
bd085fe2729b4a67b0df71aa87832100,29,9,20,Oceania,24,7.94
bd08c3f2a60e47ddbd5bdacc91243e0e,197,168,29,South America,21,1353.86
bd0a254f3b3d49cd8e42c2d222bf9d66,245,191,54,Asia,18,965.13
bd0a2b07b9454cacac89391a5f2bdf68,342,323,19,Asia,21,2845.8
bd0cba80bf9b4c2ca0703f7df375e6d6,112,56,56,Africa,19,605.41
bd1050734886498e9db5f529ef428883,364,338,26,North America,20,2956.46
bd11c2cfbbaa46b8a972d71480f6824f,365,337,28,North America,18,1520.99
bd121f9e175648c9a4c12047c085343a,69,47,22,Oceania,20,507.11
bd19c6891f12431bb16bf7a9c961e0ba,137,76,61,Europe,21,1061.41
bd1afb9124654b958e0ad60c3ad9d85c,280,225,55,Oceania,21,2046.95
bd1c847dd459470280df4cf9aa229c7d,33,5,28,North America,20,488.68
bd1ff5a65fe64ac598c7c915f79b4cc3,79,57,22,Oceania,22,453.73
bd218cc06c5a48ffbe51c28e1753c3dc,199,172,27,Asia,20,1422.53
bd22942a337e4d42999ec04ec3bf0aa6,120,82,38,Africa,22,748.01
bd25e780fecc48b2a90a1ba4449c3f81,101,65,36,Europe,18,758.53
bd26b60a5cc84537bb535f9f45adced2,99,73,26,Africa,18,479.57
bd27d906402141ffa5a4347e9ee8e7ad,365,356,9,Africa,19,2200.35
bd2c1049856c4882ade36bc176a79231,297,261,36,Africa,22,1389.25
bd2c2573da964e5689bca1bf48c815d2,357,335,22,Oceania,23,2235.9
bd2d208bda9c46938dbfbef298e07a6b,62,34,28,Africa,21,375.55
bd2f6a3be70d48ad8dcf5cd6c8ec38b2,157,128,29,Asia,18,1152.81
bd2f72f5b46c4d169d53ed60a38bd808,183,134,49,South America,24,719.72
bd30fc4007034c998bd520b7a6812f56,349,307,42,North America,18,1685.31
bd321f4a99f442d1b0c712e384050165,61,13,48,Africa,16,688.71
bd338e8220584980a40ccc8b31da9b97,234,197,37,Europe,23,2306.95
bd3572f4165241d499d981c3403e5f6a,68,47,21,South America,26,639.45
bd3720de25f74dde8284dde99a43b476,110,89,21,Oceania,22,878.21
bd381d6a6aa24f12b2254d7b0d570bae,113,67,46,Oceania,21,1024.57
bd395f1a300449b698a775a2d09fb89b,205,157,48,North America,17,1350.32
bd396e1f27a44a89b78e3db935da812b,184,138,46,Africa,18,988.57
bd3a8ff872c940a48151a34cf03c5336,51,19,32,South America,17,210.19
bd3b096ca7bc402c8891591f45940370,285,267,18,Oceania,23,2018.15
bd3c2105ccea4bdf8d1999ebbd46774f,201,172,29,Asia,21,1366
bd3f53b74d5443519088564cb061bb9d,300,265,35,Europe,18,1764.18
bd400892a7764f05ba52f7eaac6fc9c9,323,291,32,Asia,17,2274.58
bd41419d83ce47639ac7699c136d469e,288,228,60,South America,20,1699.43
bd416bdbd1654e5db35a8250130935e5,362,316,46,Asia,19,2138.09
bd41b157a8ed441cbddb4bad72ad9365,40,9,31,South America,20,543.11
bd424902b0ef4e91bdd47437bfe4767c,202,165,37,South America,18,985.85
bd4273542bc74df4b8d616f4decd4a53,155,111,44,Asia,24,1043.03
bd43e824309f43e8abbd44cea9dbd4fe,301,267,34,South America,15,2343.66
bd445946d5dd48778858a32ee5211433,232,180,52,North America,15,1399.14
bd4515b27156492d9c635b9aebf6831f,124,69,55,Africa,20,918.68
bd455ffb5af7411690ce66495ee46b39,304,276,28,Africa,16,1891.18
bd46b75d4ccb44308cd600800d850bd7,262,207,55,South America,16,1260.06
bd49422b23f04b4eba91ae56c642a064,363,327,36,Asia,22,2556.74
bd499d68e3cf42f38ad89613d4733203,264,232,32,South America,24,2138.96
bd4bf1da88a44cb5a0f01abb5158347f,145,109,36,Asia,20,984.87
bd4ebfac9e0e4fa48f04edfe77ed1ab1,360,310,50,North America,14,1640.67
bd5024ae2d7a4af3b1cda4c9f1dc6df5,353,314,39,South America,16,2366.88
bd5083a2bf034b81a326361662c995c7,293,272,21,Asia,20,2300.23
bd52bd250553424398eb0722b3ff1ed5,279,265,14,Africa,24,2578.42
bd53e596c20843b9abd9ce57b12ba9c2,365,365,0,Europe,16,2567.61
bd53ec9afedb4d2b9b7076385fe202a7,156,97,59,Asia,16,516.98
bd55450d24e9470f8d2d2f2c7ebb292f,359,327,32,Europe,24,2796.38
bd57057ea64f43cc9875b8bce5d648cb,359,311,48,North America,21,1740.44
bd59c88c5b9941998450ca8ce861cd5a,68,39,29,Africa,20,486.68
bd5afd3690b94548be1530f9a3a2183e,177,152,25,Oceania,20,1386.93
bd5b606c45b64315bcdec0d0adde096a,365,347,18,Europe,19,2384.56
bd5f1f8752584d6eabdf276ab3af7e9c,153,117,36,Africa,15,1170.42
bd5fb58b61da461f9e490fb416e438e0,170,118,52,North America,19,889.63
bd61bfa32bcb4e32bd66ed68ae32601c,36,18,18,South America,24,435.4
bd625be38b314315b7a8fa88b653228d,196,165,31,North America,22,1593.84
bd63631898fb4bd7a152adde8664b4a2,206,157,49,Asia,25,1313.28
bd63e0511d2043e091a33a3bd01a956c,256,216,40,South America,19,2202.59
bd643abbea5446daaa3c80db8358ca59,75,30,45,Oceania,22,338.65
bd6541a6229d45d1a52056fa08ded41f,247,201,46,Asia,15,1240.94
bd65ab361eb644bc9f0b6054c19d8572,365,332,33,South America,24,2064.87
bd670000732c457d82a9a19c8677c439,308,268,40,North America,22,1433.55
bd679fd3662f4f53a5db21fd3519f08e,244,216,28,Asia,24,2231.22
bd682fde02d3492182b0d1be7aafb17d,324,298,26,North America,22,2883.86
bd69c61aaaec4a4095daf3c06b08f45d,199,145,54,Asia,21,844.07
bd69e8c435e04510bd39cae34de60d53,71,33,38,Africa,19,431.54
bd6a1e7b56ec4c459a0c651606ce9f33,365,365,0,Oceania,13,2830.78
bd6e3f8ae41449c3b4668bdb50fc23ca,317,273,44,Asia,18,1460.21
bd6e9845543640f8888949c65ae9acdd,157,111,46,North America,24,702.23
bd7049a37f2c404ba20fa2b1eb4e7c57,127,94,33,Oceania,16,1152.5
bd75704bac084ede924381fec8160842,337,288,49,Africa,17,1920.95
bd778c76f8d74bad9423d209cfc87f46,364,339,25,Oceania,21,3371.97
bd77ec463c2443d7a0ca807a2f9d137c,245,202,43,Asia,18,1345.85
bd7cb7c3138b44cfb616bf99183ac929,365,339,26,Asia,14,1478.03
bd7e3bce2e374b2896931bd57af5d123,313,266,47,Africa,20,1659.52
bd7f14b56d2b44f4a7922df4104cdd09,101,49,52,Africa,17,770.43
bd8220cc95c947f1be94fa592ddfd269,355,305,50,Africa,23,1642.56
bd82a1c04ee547fb89e6aecc5bb8a40e,72,42,30,Asia,25,494.56
bd86acd0ca7f4e33ab27920135105eda,184,126,58,Oceania,20,543.55
bd8c4a8d05fc4cc5aa2bfcd53da6b9f4,154,117,37,South America,22,1112.95
bd8cb17cfbf947ceb7b5bc237ed7e4f5,249,225,24,Oceania,23,1913.9
bd8cc0cc39474caf84521d961741ee26,279,225,54,Asia,16,1469.95
bd8dfd4c4c88440dbf3425ef22a0c0bd,72,35,37,North America,19,484.68
bd8dfff25a144c47a320460ea5831ce3,357,333,24,Asia,20,2220.82
bd8f2971745f49688311f7262586bafe,95,49,46,South America,19,410.42
bd8f7ff312e44eda8dfef45bffb9c995,232,208,24,South America,19,2010.09
bd9118edc88b4b32950a64e3564e4549,39,15,24,Africa,20,378.27
bd9163eecd0c4dcdae039a56e4237167,359,313,46,North America,24,2136.94
bd9278aee2ca4ad998ad6383657c6e14,181,152,29,Africa,19,1460.32
bd94d63d8dc5459487e9af89813e2154,167,121,46,Asia,20,543.2
bd95e48f2b174f21958346b9c6b89c95,247,196,51,Asia,19,1344.66
bd982a36caee4b6caaae289b3541ea92,152,112,40,North America,18,800.28
bd987ad5a7734bfe84660d0335e36a10,185,129,56,Asia,20,741.1
bd9bb2c7e79049db8859d0ab72ee0c62,272,240,32,Europe,22,2695.8
bda01079a84a41d1b52ce3b03ae8b0ef,118,74,44,North America,18,641.42
bda2f99781c94d2eafe8cdfdc2229659,258,207,51,South America,22,1114.89
bda2fad44e3142bd866bde6164f4d800,365,350,15,Oceania,28,2760.82
bda30d495c3b406497c8b8a9f0ee4374,119,81,38,Europe,24,789.85
bda36d5e95704a6c9f6f010f99b74e46,150,96,54,North America,16,510.44
bda4145db42b45af9be88fcdf26413a4,321,270,51,South America,23,1504.94
bda53daf52fd41d9b94b8eefea451254,157,107,50,Oceania,20,938.58
bda6ba1a43b84dfd885cabf0e592d213,201,161,40,North America,18,1610.48
bda74fd961ab4592a943ef2cfc1e62cd,364,362,2,Africa,22,2331.47
bdab661f99874f5699a4cce0a25ba236,178,131,47,Europe,21,1100.76
bdad123ad0ce4774b6fad7c3d0ef7d22,335,296,39,Europe,18,2431.43
bdadc75b2ad2485cb7d5b000b73f5473,355,315,40,Europe,23,2669.55
bdadd7d64b99486299e3e62a9bba96b0,283,238,45,South America,21,1126.22
bdae692f81f643b79138feaeeeeb9c4a,323,290,33,Oceania,20,2119.02
bdaedcd66fa949afa386a73326d08e1e,115,69,46,Oceania,22,457.61
bdaf3079a19d4d4296a077b8152b384e,365,363,2,North America,22,1217.26
bdb053f5d33a48cdaacdb434f202725e,143,109,34,Africa,21,389.73
bdb0ae89bf0f4eda8abeb465a4565c9f,347,304,43,Oceania,21,2922.98
bdb32754bebf49349234ce46f258f27c,331,286,45,North America,20,2130.79
bdb4884384fe4d17b6b75acd2e90905d,354,331,23,Oceania,25,2479.45
bdb4e7280d7e4d83b044c52e07c72658,55,30,25,Asia,16,603.08
bdb5bde45132418381419caa72f9a128,181,134,47,Europe,24,718.1
bdb5efe6667b474d832afc1a7b7ade77,281,257,24,Asia,16,2081.3
bdb75272168948bc9946fafedc2badc6,344,317,27,South America,20,2555.48
bdba33af614d419c8b1fcfb749003409,350,325,25,South America,23,2495.37
bdba5f7eb82d4827a642bcd7b9c09fa2,195,172,23,Oceania,21,1381.19
bdbc9efe9d5d4a408e6debed32c604af,210,163,47,South America,19,1201.16
bdbe6a7e843b4debba99e8c466e4b1eb,291,266,25,North America,20,2262.11
bdbfaf8be36943be9dd06d98c4585867,361,309,52,South America,24,2131.12
bdc201bea4624bcdbc12d59fc26a0fb5,214,197,17,Europe,19,1883.06
bdc5ab2d031e420c96ea920b4f4e0579,134,104,30,North America,17,841.91
bdcc380c9eb64f1fb9c5afcb2c3409aa,234,210,24,South America,21,2382.2
bdcd8333513b47479565fcf90caaee7a,88,61,27,Oceania,16,464.85
bdce1f635c054bceb743f02cb5988c3c,114,58,56,North America,19,468.91
bdcecc71a022403183ba1118b9f2dc3c,64,23,41,North America,17,491.29
bdcef9c993a244c594be9ce9b837a158,119,85,34,South America,18,1193.08
bdd0fddc9e4f443a92d92443682a2f0d,363,322,41,North America,17,1413.13
bdd1c17861c544c4a62e10c5830004c3,168,142,26,North America,20,1141.12
bdd2f058efba4317857069b940d98937,322,280,42,Oceania,21,1034.14
bdd65e55ee9d4a6394cb965387a08fa8,342,302,40,Europe,23,2499.89
bdd79ffa1d6b464a8383555ffd580f14,51,7,44,South America,20,139.8
bdd962469f1245e584b641f4a5451bc8,158,110,48,Asia,20,1007.63
bdde0f00fa0443b5bd6b8bc156696d5f,268,242,26,South America,22,1856.92
bdde3d5df7734ec59a881f884a5debe4,48,15,33,South America,23,62.06
bddfd128e94c46e5ae9ab849c37353c3,148,126,22,South America,21,603.78
bde0b17ecd3c4a509f055703f34925af,266,224,42,Asia,26,1693.5
bde0e369a8144a29b0e0fe205ebe2af4,313,263,50,Asia,16,1648.72
bde158a32d6c4bbfa017a17891185598,155,131,24,North America,18,1136.08
bde4e4d7d0714c80b83f0148966fe69a,64,36,28,Europe,17,483.32
bde553e1629a4e78820c6119ac28a5f4,160,120,40,Africa,19,1276.47
bde694b97012400a8eb9bba60d7059e9,295,257,38,Oceania,23,2353.05
bde73ca01541494ea9c8cdfe81b8de94,135,100,35,North America,20,858.69
bde8a0bd86b8474ea5c56aa2cf6c2b06,49,19,30,North America,14,481.39
bdec2fec4e784d83907fba5834710ae1,359,311,48,Africa,23,1602.92
bdee4c469ab84df4b3a94d56d07bae83,363,348,15,North America,16,2656.05
bdee6c1713d942a1bd2786dcaa3868a9,246,214,32,North America,23,1351.19
bdf1415db403416f9a9d6ee9339a9928,78,57,21,North America,22,574.96
bdf5daca267d4474be3e19edbeca837e,219,200,19,Europe,19,1258.6
bdf5efda38df4b8d87ed1d42dda9ce87,361,323,38,South America,17,2365.65
bdf80a63600b45dabad6a7681f8290e1,275,244,31,Africa,20,2164.97
bdfa3c0d1e6b4673a954510faead0381,195,167,28,Africa,19,963.06
bdfa9e158d1d43d49c337c9d795b1b19,319,278,41,North America,23,2131.67
bdfc79969a2b4966b4471fab48abf68a,92,44,48,Oceania,16,617.68
bdfce9adc12245d28b3f1012debe6009,236,199,37,South America,21,1483.08
bdfe3e1f92014fcaa620eb8d47eea8d2,238,208,30,Asia,25,1560.88
bdfe66a9eb914cfea684e6b82bb1900e,77,53,24,Asia,14,825.79
bdff4a21c99b4563a061a7ef73d09e1e,42,14,28,Oceania,21,204.07
bdff926de0034bc184bd27747502dc87,341,323,18,North America,20,2044.04
bdffcfe17dee4e2b83daa5312b868b98,304,267,37,Africa,12,1555.05
be00ad4f719e404dbfdb07b630f52cff,203,170,33,Africa,26,1265.69
be0103e300654beeaaf98d25d28a0ab1,31,10,21,Asia,15,314.3
be01ece86d7849b694b7a3f4ec1d71e7,66,21,45,Europe,17,314.9
be02e3d4bc804039a5b70fab3459001c,293,246,47,Asia,11,2641.54
be039bde87ac474ea3350121d624d463,358,306,52,Africa,18,1787.71
be064c5a372d4a54843e9f6c7b14e242,220,168,52,Oceania,17,934.84
be06d364dd4a4300a683e7294179a561,216,177,39,Europe,17,1938.91
be07423451e54c679b6463e2a3aa2b9a,189,129,60,Africa,22,856.06
be07952f2ed0453ba912b84b05d932a2,301,267,34,Oceania,19,1538.3
be0a5554b77547c9b235fec7742bf9fb,79,52,27,Oceania,24,704.86
be0bf05d15a843cb81c72d87aaca9b57,365,356,9,North America,14,1992.95
be0c070936c5475ba875bae17494deaf,259,216,43,Europe,19,1017.52
be0c717cfde2439783cf480d691c5699,171,131,40,North America,20,966.67
be0f9522445342b0af50031002f02c57,365,329,36,Africa,15,1619.31
be103a81027449f797ef142a91e289b8,308,277,31,Oceania,16,2047.04
be169342325e45bc9e452ed56cd36fc2,345,292,53,Asia,23,1587.71
be16f9f637904fa4b2ae9d6a8678b44a,365,361,4,South America,20,2603.05
be181d8d648a4480baffac78cbf72403,151,124,27,North America,17,1210.15
be1a59919068463193892ee967701360,365,323,42,Asia,17,2119.2
be1d19ed52bc4f848b32072d8574c9f7,86,33,53,Oceania,21,135.3
be1d6d76d8fd4d9c9aa52abdd873e562,264,245,19,Asia,12,1640.56
be1e7d097985494abe3b18676f82e4ef,77,17,60,Asia,21,293.04
be1edecfda8c46caa66277f722325d82,276,260,16,Africa,21,1828.22
be21bae9086b4e2f981b5b63f28b3d5f,57,33,24,Asia,20,467.42
be22eea40965449a86aa0e2f2685fb73,204,170,34,Asia,23,1753.31
be231e60d5d04db7b238c4715ccf080b,246,186,60,Africa,18,1429.52
be244cf2c4c149aebbeb7d44ea4d9f36,109,85,24,North America,15,645.15
be2558b07be843d595066d7e098339d1,129,80,49,Oceania,19,610.93
be259bc86fe743afb37ee630e7495636,360,311,49,South America,19,1868.21
be26038cffcd4428b2da9ea60bccbf9c,340,310,30,Asia,26,1869.03
be27119b5ce64f29861dcb9d7719fd44,244,208,36,Europe,26,1503.12
be2928f228ce46f881d816a673addb9c,272,232,40,Europe,19,1995.68
be2992ccac0c46579069ff4e01115eee,37,4,33,South America,19,258.19
be29d81fd6ab4ae4834d252d05f9b479,45,3,42,Africa,20,313.11
be2b9647ff0548bd86e24c1945ee5e48,342,301,41,Oceania,20,995.52
be308c6aedc849e7a84173552224c79e,147,106,41,Europe,19,913.87
be31d2b353eb40e8af5ff78a36409a0d,177,149,28,Oceania,27,1118.26
be3526c0c0534271b82d7dbe2a0c2d3f,192,143,49,Oceania,13,1257.18
be35c5106f0441b99fed82474dd8cea3,362,352,10,South America,22,2584.48
be35ea21c6784e21af0f0e124caa4220,105,74,31,Africa,22,754.72
be37be779cb641b2bb066169b6b1eec1,357,307,50,North America,21,2009.85
be388ca75edb4b4fa37459cdfc9fb818,170,119,51,South America,12,949.31
be3a3c0d737249a58cc1e09745c1d941,157,110,47,Africa,19,991.19
be3b2e2935cb402e9a5726db662b79aa,191,175,16,North America,21,1488.33
be3bf23855504fca8ebfadd7a6fd5372,247,201,46,Asia,17,1284.03
be3cd6b2e2614ba48f3220a3b110bd47,291,246,45,South America,17,1858.75
be3cda24c51a482ea953cbcbcbb0852b,193,171,22,South America,16,1862.87
be3e107a989f446188b3c89365976a0c,86,63,23,North America,22,460.61
be3e4a8b0e9f4ed297c0f1467f978028,191,158,33,South America,19,1194.93
be3fec031bd24aa18190c528781231ca,53,11,42,Oceania,19,82.59
be426b1c203244fd947d4384e64dd757,321,277,44,South America,16,1740.24
be427890c8ed4fb3873d73c185a53a39,297,274,23,Asia,20,2162.99
be43d283e743423e860fd0855dee7e7c,162,140,22,Asia,16,709.43
be454e96af7846d69c021f04cac8677b,365,352,13,Europe,21,3198.63
be457416181b48848e5a1f4056731574,208,182,26,Africa,24,1400.36
be45a853def24bf3be979a56b1e3675c,119,76,43,South America,25,1080.24
be45af568dec4da29657932a4a9fa753,191,179,12,Asia,24,1042.39
be4886e6ac2d4463ad43ebfa00355877,238,196,42,South America,19,1481.77
be495371b62c49a3a91c12d0d8d89fec,150,107,43,Oceania,27,1447.86
be4a7e436ff34166b20f93c30d18c2f8,364,343,21,Europe,19,2573.82
be4c4916b8754eddb9ede98fab6a0ad4,144,89,55,Europe,19,929.44
be516228e27b4fcd880d2cefac5d6228,56,22,34,Africa,23,179.81
be517bdf97c04a14a7164a4c44c5e1c4,239,209,30,Africa,20,1881.56
be52e60207954bf78822b492cbc17ae6,364,340,24,Europe,18,1928.59
be551ffbe5d54fc0867f7853a60bdd08,36,11,25,Asia,23,797.22
be56f7c69bdd4ddfbad635919ef652bb,258,232,26,Africa,26,2111.38
be5834b0908b4f6ba0f25a027959d402,203,159,44,North America,18,1650.79
be585c20e2e84d5cb0fc5a6d99794fd7,365,355,10,South America,21,1926.75
be59e4e82c434418ad1374f75ace4eec,197,159,38,Europe,21,1709.65
be5eefd0bfa744d6b72875fb6393d570,126,78,48,North America,18,559.39
be60712c7eee43549b22ff760885673f,140,106,34,South America,20,887.62
be63d37858774afdad90722dfe254ddf,363,360,3,Europe,20,1427.12
be66afebe5c143058cecbc6098073fa8,287,245,42,Oceania,17,1626.71
be66bd2413374aafbd71e49d2bab518b,255,209,46,South America,20,835.61
be6cc41a596847238089167eb44608c7,46,24,22,Africa,18,346.13
be6e87f16e0e42e09a042634d36803fa,139,89,50,Oceania,16,983.21
be6f5fda5413438d930ee1fabb6f1257,253,228,25,Africa,19,2122.76
be70c5ea2ef440b98f62720c5072094f,207,163,44,Asia,23,1178.71
be72e7d2ddaa4ac6b6c631129e8810d8,165,143,22,Oceania,22,644.7
be754cc7440a4e57851dbe5530b0fec5,357,304,53,Asia,21,1985.53
be7654ad08d646c997908a4b5ebfd4a2,119,69,50,Europe,19,381.75
be76a425dd6a4d2d934c0ed148cc6585,364,361,3,South America,19,2813.06
be79c6ae3bed4ba8b0da5d156f0f1eed,123,102,21,North America,22,1046.51
be7a47f91b20421db9dd35bf687c14b4,143,122,21,South America,21,1349.69
be7aac7ee55749fe83fb9dd1e2eecc93,286,247,39,South America,18,1714.77
be7b01e28f6a4e36aa9f3a7082145bc2,285,255,30,Oceania,22,2081.21
be7b4ac4a42f4c828d5441f8583f2f92,364,337,27,Oceania,21,1524.4
be7c3bde9ae8457bba39ef0086652293,145,113,32,Oceania,18,1190.06
be7e78eccce340dd8a331003990be8f5,128,102,26,Africa,20,463
be7ec05dc2384dd2a85831ec2b5ce1ad,333,298,35,Africa,22,1851.8
be7f8414cb60430698534e35ab744ac8,357,335,22,Asia,17,2643.03
be83c997d83f4ba7a296aba0af1eec33,364,340,24,Asia,24,2444.95
be840739aec447aa921e2fd7742b06ea,364,340,24,Europe,25,2130.45
be845db0735542ef9f6c075829559960,218,199,19,South America,19,1375.41
be84e54401b24108a37b717aaaedbb36,224,185,39,Europe,23,1677.81
be854fc4d9754d46a91b673ad3fee0c8,364,346,18,Oceania,20,1948.68
be8631117e684360958d0d0e46fe0d25,263,228,35,South America,18,2554.12
be8681950183418cb3875479b8e67e44,108,73,35,North America,20,704.43
be87a08c762d43d68e96ca31c17e6f46,229,176,53,Asia,23,936.74
be87b294a8954d169774dfe42dc7bcf5,52,17,35,North America,17,385.31
be87b2c0a58e43348da5660b0b585114,261,230,31,Asia,21,2079.23
be881806bd074c39bf10c1e30e7f0f1f,78,27,51,Africa,21,651.89
be89f40b860a4dfb86aa5cb3c9d6af99,138,110,28,North America,21,748.11
be8a180820f0442c9b6a672f2098ff58,118,85,33,Asia,25,493.15
be8c48bdee464467b6d9b8db632e16aa,150,131,19,Asia,23,1038.97
be907a2ac84b4fc9bad7245a545a68de,227,207,20,South America,16,1504.56
be93ded6ca074f86a3ddac65bd719e7f,279,228,51,Asia,22,1830.32
be94697560ee4ebaafbd3cf6c77ad084,94,35,59,Asia,19,610.95
be946a55e8dc4466838c8d8672429561,143,87,56,Africa,18,502.93
be9619e983974d4ba31775fc3512a365,303,277,26,Oceania,23,1577.67
be9b8344a8d246f0b86090883818681c,365,363,2,Asia,19,2570.85
be9b9225419a4cecb716a1b79177a626,327,285,42,Asia,21,1412.26
be9d0b28974c4512897e4f6bd1bdcf3a,275,234,41,Asia,17,1549.92
be9dd7d932884d92a655519bc71076c6,219,194,25,North America,23,2101.9
be9ec9abc1f04e248af4daa2aa79a4a6,219,163,56,North America,21,1192.03
be9ef664b6834ba68e4378b8d78900df,273,234,39,Oceania,20,1741.25
bea048699ce642558ea8e61ed749c0c2,245,214,31,Asia,25,2064.45
bea10d77ecf64d59b6161741a763d160,157,129,28,Africa,19,606.38
bea343af7ade4358b9aeb88c9f0e6498,259,213,46,Oceania,22,1242.46
bea3463ecdd2412aa8c3e2aa79dbeb1f,137,96,41,Africa,22,1570.02
bea4a74f6fa94d689af8e1f58b9f598b,277,258,19,Asia,18,2169.64
bea6825d70b4462e8374fc2f5c259cbb,362,351,11,South America,24,2251.02
bea7239aa67943a8a8d42ac03a44d15c,83,41,42,Europe,20,331.72
bea78fbbb4a6425ca7d83010533d02bb,57,28,29,Africa,17,584.21
bea899c3d1f64f8ebd96eb791ad0d756,242,218,24,Oceania,22,2029.22
bea8f614419a47588e5797fd9e06c3c0,348,317,31,Asia,21,2914.5
bea9a955dfcb470bac34f58bb4031e8d,315,283,32,Oceania,19,2186.23
beaa602e0b784457b8890717943021b3,352,305,47,Oceania,16,1938.32
beac7647f7a14d3a8af550183133888f,159,119,40,Oceania,22,1368.54
beb12335bc784eb2ba687a560e85bfc3,81,44,37,Asia,20,382.77
beb398d431f44b298579037aa54ddda5,239,201,38,Asia,17,1231.46
beb46458166143659077db4ba3405eb3,190,160,30,South America,20,1256.12
beb47e88dc6c4593b0d9b348687d7f61,211,183,28,Asia,21,1948.73
beb8df8b0793417cbd5da783072dcec6,125,96,29,South America,20,936
beb9e2a5f081449c876c79d3e81fb21e,363,321,42,Asia,23,1863.1
bebbbb04de304391889ea533ef69f022,278,247,31,Oceania,19,1643.1
bebc4553c1764c388061058a63d2fffe,272,253,19,Europe,21,1904.21
bebee03453c4475e892c600ca5fc38ca,268,245,23,Asia,25,2424.29
bebfe7badbed46ab9a2bb31d073fcd72,73,43,30,Africa,22,591.53
bec0c431da734ced9cbe8984f2b05632,332,281,51,Asia,21,1637.79
bec0eee5502e4bb5b096c178b761675a,290,263,27,South America,22,2326.16
bec2ffa2776342479309ed52315eebd6,351,313,38,Africa,19,3159.28
bec526ade19143ca9c2b374d9de6be9b,167,145,22,Africa,19,1064.64
bec749014fce48ec9112ff52afbe0ae2,157,103,54,Oceania,18,630.44
bec750cf0138490c897b6e88ba2f30ac,154,117,37,Africa,19,1105.46
bec9f2b4144e4b169aea881915303d89,77,42,35,South America,18,432.15
becae43ec3274a839d66cddf17d7e9c3,121,84,37,South America,21,1071.34
bed0de9103a74bd094c123fb22fab0ea,91,65,26,South America,18,848.96
bed320b5aeb0484ca32c00bacc986c65,365,327,38,North America,17,2062.44
bed4874cd48f4badba09fad3d0f70ea9,128,100,28,Europe,19,1323.22
bed6f4a0d0b44bcf93d05f4569feb9d6,262,219,43,Africa,21,2010.15
bed79cff38ac4050aff017ee916735d1,226,216,10,Oceania,26,2481.05
bed7f53544da45ee81332f641130fe0b,232,184,48,Africa,19,1084.53
bed8fd6b5d22469b8c913d009c696b0f,365,347,18,Oceania,21,3497.05
beda2b97261b4480a3b0b9f70728fc31,239,181,58,Asia,17,1268.89
beda8cb1a56a4e668c1e6c974d7c7a3b,96,55,41,North America,20,456.75
bedc7d8b514c403dac4bd84123d7e98f,64,44,20,Africa,21,709.96
beddcb3fd9a9450e952cd63b48cc234c,161,127,34,Oceania,20,756.64
bee04803f8c741a593b3458815473e8a,365,334,31,South America,23,1771.02
bee379d1b9cd46dcae517fe67050db33,211,184,27,Africa,23,1410.91
bee48adde4cf450499daa365297d8390,247,192,55,Asia,19,1294.6
bee5157a49b8480a9a942a7702536a63,197,158,39,Africa,21,1474.69
bee589125ef54c12b71aefd087d5e9f7,169,137,32,Africa,21,1338.68
bee5d8da6a9c44379f48f8555aa28e77,100,49,51,Europe,23,643.11
bee743b9b436464980239c4d44ef3860,251,201,50,Asia,27,1377.25
bee75e1bca0c4532adf67fd86a01b2cf,60,29,31,Asia,22,514.25
beeaa88ac30144958e8b77326f6a53e2,365,358,7,North America,17,2525.96
beec889162cc458eb2c97afc2dd1c84b,237,216,21,North America,19,1453.7
beed002887844176b7a30f56c4cbc993,47,15,32,South America,19,624.09
beee679948424c8e97a62ee010b52e5e,286,233,53,Oceania,17,1217.6
beeefc8291a94fc3b9905e3b3195d17e,313,266,47,South America,24,1786.86
beefd8572de843d9a68d26ec0dc1bba2,364,325,39,Europe,21,1823.29
bef096e56df74acd97be76db9966fe65,243,226,17,Asia,19,1896.1
bef239a435344f7abee7b9c48e9ed0b1,56,25,31,North America,17,467.24
bef371503c9746f18cf1e320338e1fd9,345,299,46,Asia,21,1188.15
bef48016c8b7411aafd0f7a61359514c,224,186,38,Africa,18,1431.05
bef4c64e77c8431aa19a33c3b0e2eb85,123,69,54,Asia,18,689.87
bef4cd84b7304ecb98d96b0c25d0839f,98,51,47,South America,18,513.67
bef6a022601d4189b56cedc26ace2603,365,335,30,Europe,15,2357.84
befaca6c45884ff89798ff1db8e35285,91,67,24,North America,22,653.03
befad0c047574083b95a9d2f7471da13,254,207,47,Europe,18,1197.4
befc86b7b3ac4cfb8c6f5ee1e7e450ab,329,294,35,Europe,22,2408.39
befe46f9b2d24ec6a49b516d944a69bd,305,261,44,South America,24,1430.74
bf0007311c49402ba4d316a91d4e2f1d,320,270,50,Asia,22,1599.51
bf00481b56674f6c93685eb8f9a20142,203,176,27,South America,20,1384.28
bf00990459d24b71afca252708b78406,38,2,36,Oceania,22,204.64
bf0109fdfb054595a2fe42d5b61c100c,86,43,43,Asia,21,292.74
bf01a3325f5e4bf2ae50cda696ec32a4,143,114,29,Asia,15,622.98
bf02b16ffd144cc68249bacbc1e088c4,294,239,55,North America,24,1407.39
bf04973750b64049b38ba83bb00f882e,331,302,29,Asia,20,2112.03
bf06e566f6084d46848c9a512f839774,281,253,28,Asia,19,1819.91
bf075dc32fd3440a925aba8be828feb1,50,21,29,Asia,22,509.58
bf0787884f9c4d93b31bcbc3e6bb5e92,162,126,36,Oceania,18,767.59
bf07bc606911498bae42dc51a1187d4e,44,19,25,North America,20,199.47
bf07e1f327c448439e028347567f1634,336,286,50,Europe,28,1366.99
bf09a483599940518cd2815e550bf1d4,114,82,32,Asia,22,1076.99
bf0c1559dc594205943aac87f7fd2357,104,70,34,South America,19,907.45
bf0d10331bcd41e39ef6fa2b3a0f442a,183,138,45,Asia,20,1255.91
bf0e887ffa754dd38bfe8008757b880b,227,168,59,North America,17,1076.53
bf105bd895524c66b37d118389438343,75,44,31,Oceania,19,537.23
bf11ed6551a041a5b16a3b0c8e41193d,323,271,52,North America,19,1569.41
bf14a047072942b4b3a8a395beeaa500,266,250,16,Africa,21,1465.74
bf154e7d717b471093949c95fa170195,149,109,40,Oceania,21,728.44
bf172b0722654183b200a3b49c88d987,127,108,19,North America,17,870.52
bf18656a870e4779bbd2f7e3cf0287dc,59,24,35,Europe,22,190.5
bf1b43e61a794951a870c1fa7ac481b5,175,132,43,Oceania,20,990.8
bf1bf0dcbe6e433787909ff5d5f57818,182,155,27,North America,20,1739.49
bf1db60727954ec285681b8c1a1db6b2,231,209,22,Europe,21,2526.63
bf1ee5b833f74f01b15c761bb4839fd5,236,197,39,North America,19,2044.02
bf1efce0c7b449bcaacfb7b984f12cba,186,148,38,Oceania,18,997.15
bf2223d50d70487abd3f5a5a628b9d35,111,71,40,Africa,22,500.8
bf23906613b841fca3fa86dce63eb122,303,247,56,Africa,20,1477.18
bf24167f21ef4ffb94f56694cb9445ca,109,64,45,North America,20,680.21
bf24189183454eff91b68d1c654446a6,105,86,19,North America,24,836.67
bf24a6cf63ae4d05adff33fb46223f10,137,93,44,North America,22,881.11
bf2725f09b014e5c9b9cd2baf1a3984e,31,5,26,Oceania,22,365.2
bf29262174714c789d36c1cb568e674a,332,305,27,North America,16,2426.25
bf2b8702f0c34b5e958c55f47d29407f,239,188,51,Oceania,16,1090.77
bf2c03662d794e3fbb63853af7904621,363,352,11,Europe,19,2813.48
bf2c4bc1e16047fda6f8f9cdb84ed5c6,187,153,34,Asia,14,1097.2
bf2d295d8c044403b21d4273a12d6563,312,283,29,South America,14,2485.46
bf2eee04481f421eb83757d4211537ff,133,92,41,North America,17,624.12
bf2fcae21d724f978def4ebbc01e4c6b,292,262,30,Oceania,22,1613.87
bf303d3435044f44a9e20609d79d27dc,233,209,24,North America,16,1547.28
bf314e7d46e7460aa4e188ea18705480,254,211,43,Asia,13,1570.77
bf33df91c0ee4256aa32e89774abd78c,262,234,28,Europe,19,2018.73
bf342396a0bd44a5b4a7ccfc5217b09f,121,68,53,Europe,21,576.23
bf3ba12e58644e558d2a9eb8737c838b,200,163,37,Africa,19,1647.86
bf3bcf5f66ce41b692894199db9ed39a,310,283,27,Africa,17,1721.2
bf3cffb1aa2e4a14b1825123eae50ca0,333,298,35,Oceania,14,1973.44
bf3d4e348f394fe1ba06ec366636ed98,363,343,20,Africa,24,2755.31
bf3f3fa28bca4d7dbefae19a18ddc4fb,238,209,29,Africa,27,1417.86
bf3f6cc6fd634ad79c4d8df77cfac836,365,331,34,Africa,21,2095.6
bf41014b4e60400db6d2d49605c10120,269,248,21,Oceania,16,2557.14
bf4424a394974c6080af94e6ba8f96f7,364,329,35,North America,18,2401.24
bf44db5be5e94497b78bd285a728d9b0,138,99,39,Africa,19,1096.12
bf450f968f7e47798097fd1e22e07b13,337,317,20,South America,17,1975.39
bf460ed8d390444ba5b727a3b13e6635,85,57,28,Oceania,16,683.36
bf467e4cf7d8486abef87818652d6db2,257,209,48,Asia,21,1202.68
bf48d3e4308a4296b0742b0889e82ff6,51,23,28,Europe,19,597.05
bf4c3e72f07e46e8a762c889c2db5d5c,363,334,29,Africa,15,1692.73
bf4d3b04873349cfb8396b20b132bbc2,365,325,40,Europe,19,1505.67
bf4dd991eafd47639dc9a268e14d47de,193,168,25,Oceania,20,1250.01
bf545d6d4db24165bbf6bd5ea365ca31,57,29,28,Asia,20,269.69
bf5481bc638c49479bef8609e9cb47d8,346,316,30,North America,21,3272.33
bf56fef1356346f09d179fb4e1405b07,199,174,25,South America,22,1914.01
bf58385caafb4b7d9367eaf049146052,365,357,8,South America,22,2006.98
bf5945a6c59d43339edd4307b008a5ea,342,306,36,South America,16,2697.22
bf59572575d8485e975d447a698d0247,233,207,26,Europe,19,1956.8
bf59764085b7417a90a150346c8e34c7,62,10,52,Oceania,24,357.2
bf5dd629f9f349ffa441b12def0d7513,82,55,27,Oceania,19,395.77
bf5ee651027d4dd5bef2ef2aa01c6d35,325,295,30,Asia,22,2349.24
bf6179003e044b39a26f459460b5ad79,237,185,52,Oceania,23,1647.52
bf61c933229947558038758cc7263cc2,156,129,27,Oceania,19,1539.44
bf625a53d93c4ecb87a690b7c66d3b20,54,28,26,South America,22,444.61
bf62e25ba944443e867687d7fa82a93d,346,322,24,South America,21,1798.23
bf68e026f07143ddb2b6e4b47d544c64,55,15,40,Africa,22,323.48
bf69466091644ade9c54c6dd9954d10f,94,65,29,South America,23,712.61
bf69706c7de2491f818aaadb32b12936,97,52,45,Europe,16,468.09
bf6a2ac92c3b4c759e2d0bdda3f44819,349,329,20,North America,17,2424.17
bf6b7fd1178944a09a73b03a6086c291,243,196,47,Africa,23,954.98
bf6c5621227b4e61937d98ebbf1fb5e1,108,88,20,South America,16,826.79
bf6e37bd83f64fc88a27be38771f741b,244,200,44,Oceania,21,2032.43
bf6eb9218c5f430fa10e3e6c737229f3,156,134,22,Oceania,22,1336.36
bf70ea7f2d5743bd9b61e59a9aebd1eb,363,362,1,Europe,21,2649.46
bf72be7880924b27af6db48179562e12,37,9,28,North America,18,339.62
bf75e052d2a84997b50004a516f0763a,126,95,31,Africa,21,736.27
bf760170ddc9447d8d85136eeabdf38b,235,180,55,North America,26,1207.48
bf7694b3515a4db5bebe49d21372398a,365,317,48,Europe,22,1867.65
bf78f5c8c5f947368639afef6f6a43aa,344,290,54,Africa,17,2172.88
bf7ad71077a14ebcb7702fb4ef425b9d,201,154,47,South America,16,925.6
bf7ccc59d96a4988a637b6d8a57214c2,347,315,32,Africa,19,2950
bf7edbc645b6415ab077f5b9a8537c35,127,92,35,Asia,20,1492.38
bf83aa85e4e741a3b5e6a71dd7b13298,243,193,50,Africa,16,533.1
bf85e73b32ac4c2a893c1571d2ae29de,111,62,49,South America,17,445.67
bf8650e75c954054a3eeeb31817728ef,167,139,28,Africa,22,716.84
bf86a7bb355345e190903893e3b85e20,284,238,46,Oceania,23,1089.14
bf86e2651ebc42449f496def648b5b24,112,68,44,North America,19,454.37
bf884f08c0c145d7824446192d63f1f3,316,295,21,Oceania,17,2785.26
bf89fbf2fdd14d1587d88709ca502399,342,306,36,North America,23,2831.76
bf8bbf69046943aaa667d0caafd36b4c,290,253,37,Africa,21,2115.64
bf8c6f66806b4f7582edf3e9129e29b6,364,359,5,North America,17,3528.44
bf90ec3e9b02406e9860eec85482c5a0,363,346,17,South America,13,2425.26
bf916ac4202e4b19987f1838d1941263,53,21,32,Africa,22,223.53
bf95317492324c70a40469b7e7208db0,364,346,18,South America,23,2950.79
bf9552e5552e4cb68b081c60e5f9cfb3,333,275,58,Africa,22,1405.68
bf96bd9a94434f7fb1330b4b6f086495,263,225,38,Oceania,21,1806.28
bf997d55d14f42208f777fb6de417a7f,99,46,53,Africa,19,648.71
bf9c58256c064ea9b52be3240e8022a7,227,189,38,Africa,21,1380.35
bf9d525a91cd49b6b50e75e00ffbc07b,243,196,47,Oceania,23,676.69
bf9d5c07585e4e6a9b850c735d80ef17,348,300,48,Asia,21,1767.15
bf9eb79bdebc4b7e80680253261f4270,364,349,15,South America,18,2392.05
bf9f699af86846448da464a283762928,128,72,56,Asia,20,631.13
bf9fe61330da479c897b57bee3e328ec,365,354,11,Europe,26,1602.11
bfa6b5e8b7224df0b1836b0c7b41e539,52,24,28,South America,18,386.51
bfa7e549232246e0b2a0765d01de942e,171,121,50,South America,18,1176.04
bfadf25a5180402094ffd4ba6050c0ab,258,214,44,North America,23,1742.21
bfae5ef8aa5f446a9fb4d5919ae5baaa,298,257,41,Asia,22,1981.49
bfaf63f219024f4f9d1fc4bd7dea6d71,139,92,47,South America,23,434.07
bfb02197528f48b7a54a0351bb64c5f9,271,222,49,South America,24,1984.39
bfb08d0e4bf7414ead7a2f026eb7f08a,364,332,32,South America,24,2058.37
bfb0f897b6774290a332fe010db29a71,229,192,37,Oceania,20,1574.42
bfb2b09ad3244dcea49f7368157c1729,255,224,31,Asia,21,947.69
bfb2f6299fe742138b2c535750806642,91,55,36,Europe,10,387.54
bfb5a4238d3b442b9b944946798d2a4a,291,251,40,Asia,20,2602.51
bfb5ea000b404d0ea218aad5191bd8f8,298,257,41,South America,24,2348.05
bfb6272509f546f98f1da719709650d7,109,87,22,Africa,24,1030.29
bfb63d77557e498a9826b5480c100a48,365,344,21,Europe,22,1957.06
bfb74c27fd2b4526aef9a4aba4ed41d4,165,113,52,Africa,18,587.86
bfb7e1079fc243639801d96318d639d9,346,316,30,South America,21,2428.74
bfb88cf8bd9b4736916e92465d9c4553,270,236,34,Africa,20,1690.65
bfba06cf5d924465a343105963891a4d,277,250,27,South America,20,2620.91
bfbc8d98dca24f6993d3878680e1efc4,269,220,49,Oceania,14,1599.48
bfbcb788ae7641089a0f37ba58adc0ca,321,293,28,South America,19,1412.06
bfbd227352384d9a9292321a0597393d,46,2,44,North America,23,152.42
bfbd58bf6b8f4f8594161d1cd1c4855a,242,219,23,North America,16,2514.28
bfc487a4ff93495eaba5bbf412e983e1,188,179,9,Africa,21,958.37
bfcaf4d9a42e455082325f3a7e34e27d,273,226,47,Europe,15,1745.76
bfcbb35066444cd9b4212ba627dd2af6,344,293,51,North America,22,1550.52
bfd0a6113f91491dbbf7bc6e6df2bfc7,138,78,60,Europe,27,970.89
bfd0e7db5a8249388a28ee4bbbf76f18,198,151,47,Europe,20,1451.8
bfd225903a974d9db10dd5d38546c467,365,354,11,Europe,22,2710.95
bfd8027979fd4250acb9068db5b3bfc4,274,236,38,Oceania,21,1475.03
bfdaf93ae6ab4fa78cb0beca11df6768,363,359,4,Asia,14,3232.99
bfdb2158667245608b607a49678e6c39,244,224,20,Oceania,25,1584.36
bfe0b3eb05bb4761ab82a991c0acdda6,88,32,56,Africa,18,555.23
bfe3826e6b5248b79d4c9100faaa503b,29,3,26,South America,23,366.29
bfe390d762a940b5ad2af799c860175c,186,160,26,South America,17,1421.82
bfe472d18c664c4e9a440f11b4bf6d93,336,308,28,Oceania,16,2270.5
bfe5d4076dbe42fa8c217f61d3c70417,303,247,56,Oceania,21,1424.51
bfe5dc2b07e9431ba59607697a1b32b0,287,252,35,Oceania,19,2136.15
bfe6629d9ca442f99281757fb925a5af,365,332,33,South America,23,2444.33
bfe762d15cff4a3bb32eb2d4561d734f,239,206,33,South America,21,1597.83
bfea9d23b6164b54aa6e07a160299af4,75,53,22,Oceania,14,515.11
bfeb847e17d1440c82c2bef26eb9826d,365,357,8,Asia,17,4110.36
bfec8f120c2d4e4aa1cd458c1b2f47dc,16,4,12,Oceania,19,116.97
bfecc07e8bad48c59c4ee685d6e087db,173,129,44,Asia,21,720
bfed91425c0a47d4aab1a17b3536e510,272,242,30,North America,23,2428.74
bff06272c0cc4c27abced9cee20d2adb,338,317,21,North America,12,2568.25
bff26b50c2504035968a016ef48d5c89,144,122,22,Europe,22,1233.96
bff354dbd2764ecfb76b533d872cc8e3,153,118,35,North America,20,1414.02
bffabc00e68149e1aeb0e0c3fc328455,365,359,6,Oceania,23,2202.12
bffc5bff2bee4cabb54edaff2ae0d01e,121,79,42,Oceania,16,459.29
bffcb8fbb86a40d8a7924ad86f9b0430,182,145,37,Oceania,19,971.81
c00001c9ecfc4567a26c7da8ad675082,292,265,27,South America,19,2439.67
c0008752f19642fabf1415812706ab72,345,318,27,North America,17,2520.41
c001df73bb144f66b00bd16755379ad3,38,9,29,Europe,19,417.91
c002a1bace0b4c56a65c0d642cd19fc0,257,213,44,South America,16,1797.45
c0030e81c83143b695bfa6ca4833c424,277,222,55,Asia,22,1251.22
c0031a4fa1884fb8bf2ef92bf45004e0,94,55,39,North America,19,774.66
c003e89ffe1648e8ac6f7912c9a3ba2b,80,48,32,Oceania,18,454.03
c004579a0b2b476483b897d85915c3cb,365,361,4,Africa,21,1636.18
c0047b76763b4893badb7559ed92feaf,131,84,47,Africa,23,776.1
c00707230cbf4cc8ae9a6898f0b4b5c4,204,181,23,Asia,17,1799.11
c00977501f194ccc8f11013c46149edc,223,190,33,Africa,22,2048.49
c00b03d94e2244a287caf7e0ccb6151d,105,50,55,Asia,19,706.54
c012beefc07449939210173a62929ef9,132,80,52,North America,18,359.9
c01317cd534648cfb086cdfe63018091,365,351,14,Africa,13,2185.91
c01494aaee4b444ab429de4d66901ddc,279,236,43,Oceania,20,2165.25
c015106921a941e3b41dfb9f07da04e9,306,257,49,North America,17,2024.73
c016598a8cd24da38f1e957be80cb2d8,242,200,42,Europe,23,2007.71
c01a5882be70405a97163747f9678540,42,9,33,South America,19,200.9
c01a800521794c8dad07e122de2cc8bb,71,26,45,South America,24,295
c01a99c6b59748aa83cd38124d0cb63d,211,152,59,Europe,20,1167.34
c01a9b7d66de49f5ade7b20c14524f94,168,123,45,Europe,20,773.12
c01b79fdfc7a4dff9c1aa75b3d5e4d9f,182,162,20,Europe,21,1364.15
c01c05741abd4e1682b4b9cb683e0467,71,47,24,North America,19,230.02
c01d84106dc849abbd5e675f7bb6b535,64,35,29,North America,21,709.17
c01ed430e1924ab287a00c2267ffe430,108,81,27,Asia,20,1047.11
c0271bcd91fd48b08f55e43f32b42dfe,248,192,56,Asia,23,1365.82
c02727db1f8d4ce28a7dbae75c09cf18,236,179,57,Oceania,23,871.02
c028a6badf9a441fbe9a20000294893b,340,300,40,Asia,21,1677.57
c0294e126d614c5fbfc23f5751435d8d,314,269,45,South America,21,1329.66
c02b1b794c754a43b3385f0ec853afa7,159,143,16,North America,19,1250.53
c02c4144ec064dcea0ebd4616aef0dae,365,331,34,Europe,21,1638.27
c030f158839f4112943a6d96ef9063d5,129,101,28,South America,32,1297.17
c0329fcaa593442e93403d8a4ed102bd,73,51,22,North America,17,825.28
c0395ae8d0c74f76a8480d5dfcceb65b,365,350,15,North America,20,2206.26
c03a1be4ccef404ba48506c6d636570c,237,210,27,South America,22,1199.55
c03d1253739b42cea747de8f756f3b75,300,243,57,Europe,28,1397.94
c03f55e8291644a9af5134ef8ded4fcb,150,131,19,Oceania,19,1277.7
c041e17eeb49413ba5a764f88145f2df,336,317,19,Asia,15,2417.5
c04401f86a634adaa55ed1ea508a70f5,244,212,32,North America,17,2314.78
c04407a112c34c428161d8dba8bc6495,252,199,53,Europe,17,1379.41
c04454acd86f4991a99651affdeb266d,305,261,44,Oceania,19,1761.69
c047ef15dc4d404d9defb915ebd582fd,365,356,9,Asia,21,2379.45
c048770e8e3340b88c4e92737188a4d7,198,167,31,South America,19,1315.33
c04927db203844e6bfbc3bc29c9f3da3,317,291,26,Oceania,24,2512.65
c0499739f3194c9593937fc78a544157,282,237,45,North America,15,1664.2
c04a560b746944e68143d2109784cc3c,164,118,46,North America,21,703.54
c04bf2c7d94547fc96f61b2f35f13091,201,183,18,North America,18,1202.34
c04cc3485c64478bb0eb4ff2912272a6,151,122,29,Europe,20,1106.89
c0522a79c46041d29a59a22bcdd3a58d,168,146,22,Oceania,17,649.25
c0524e0c9024446c91336f6ef73c673f,365,345,20,North America,18,2584.2
c05364afda08469a9ebb86c53f4f2935,72,31,41,Europe,16,365.13
c0553ceeb58648a29ffbfdf8cef4f73e,88,43,45,South America,16,521.09
c057a03c57b64f8491e77a29a57684bd,329,294,35,Africa,17,2661.89
c058631387274560a7043e71f958d185,134,94,40,Oceania,16,1053.58
c0586f9a3eaa4a49b50118d6e9780ff2,319,275,44,Asia,20,1597.96
c058d8114777447293551a3a20793cd0,164,121,43,Europe,23,848.61
c058fa5459d94dd382155919713783dc,354,305,49,South America,18,1395.1
c059f9f10726424a904014f53139519f,200,166,34,North America,19,1169.7
c05c1c58d54446d3afb5e8677bfc30b2,302,253,49,Oceania,17,1776.64
c05c2600ed13405aa8d307d4d024aa87,90,62,28,Asia,17,832.32
c05d75ba51fb4645bb020fa02af6c215,308,282,26,Asia,18,2158.27
c05e882d65ef40f782a60e6551861c8a,110,66,44,Africa,20,716.8
c05f6a64ede14505a6c56ae896e6d0c7,84,55,29,Asia,21,658.62
c060d8e1d3cf44d083c88473be875496,203,163,40,Asia,17,1264.89
c068fe01e29a4b54b175ccbb88f3111a,365,341,24,Asia,16,1830.31
c06edb99a7ed4cdb95247db433506d04,132,107,25,South America,18,875.69
c06f7dcfef9a4086aa1c9c9211c6ebe5,135,115,20,Europe,17,1189.26
c0704781fb0c4aea8bb777b0c4b0e5b0,285,252,33,North America,21,2429.97
c070ceb020c741f0a42b94ddee609c30,116,65,51,Africa,13,579.77
c0757fa209d8473c87dfa3757e6f4024,258,217,41,Oceania,18,1238.7
c0758578852e41d7960c10b67f22cdaa,283,235,48,South America,19,935.23
c075b134584443b08d938bd4c9339a1c,29,3,26,Africa,21,183.03
c077f39ae1a3414aa2cf947022f18367,200,151,49,Oceania,26,749.88
c0797e37d1e344d7b79e4070fbbadce3,63,14,49,Asia,23,353.42
c07d1052d48746d384af40a9ad242142,276,259,17,Europe,21,1823.26
c07d19d87cbe43ee9bd39a2edbadde36,60,16,44,Africa,19,227.07
c07ea4d3268841c79e2e182f79dca410,365,334,31,Europe,19,1210.53
c07f8dae5e6741faabfea966276b777f,61,10,51,Oceania,19,111.71
c0812cabd48c408ba2fd103ac301d473,358,342,16,South America,19,2264.5
c083903178904b719ba01cffc3cf782b,275,249,26,South America,19,1610.58
c083904a2e6d4a9b8561414a458fbdd4,59,5,54,South America,20,370.18
c084795410bf4583bd602cda72344cf7,365,349,16,North America,18,2830.68
c085f2d77f8a4aa6a5906c81615ae2e8,249,206,43,North America,23,1474.17
c08b70c670d741de8bd12adf839b18a5,364,329,35,North America,20,2624.42
c08b9cb2cf084e51a3c65d7a5d36f0d0,87,43,44,Oceania,18,798.63
c08c34d35b444f599c85b25f1558fd66,296,272,24,Asia,28,1797.23
c08f268d05714f9cacb9edd460a35e1c,89,57,32,Africa,24,909.84
c090b2b012624c5f9737548527ee79e5,236,178,58,Asia,18,985.87
c0911bde33e649b793e4b88c94ab01ab,51,11,40,Africa,17,286.87
c091f11af81e49459f029447ced5e045,322,279,43,Europe,19,1450.16
c093657258d94bc4a1436cd13880567e,187,138,49,Oceania,16,1045.06
c0958894547d499fa3ba346cc144362b,293,234,59,North America,22,2082.75
c095975e63e24fdb8f2a5c799eceab36,63,31,32,South America,15,698.13
c096595627984e4ab761d20b85b88db8,356,336,20,Europe,21,2766.69
c098661e4f2c468a89deaab87d4acbde,364,328,36,Oceania,16,2029.05
c098f141532c4e978febbb1f4b539afc,90,32,58,South America,20,559.97
c0996549e4904c3ba1f7e26d00c550f8,254,211,43,North America,19,2297.33
c09ae4cae5414342abc2d08879370846,162,138,24,Oceania,17,665.29
c09b7fd93e9946b28f0793d749fdbc11,232,189,43,North America,17,1540.93
c09c7d5f2548478f8068b24e3ec15fc6,360,307,53,Africa,13,2375.34
c09d4e1047a64d0d8dc123110eb23b08,309,271,38,Europe,16,1688.47
c09d55faef3a45d2bf5c9d206a771c40,365,315,50,North America,18,1649.26
c09f2bc62d8f4f2a9c8735ec5ff5ff0e,89,56,33,Oceania,18,516.83
c09f71c584664673baf7bdc10b4fe409,97,67,30,South America,16,685.72
c0a602df1b114d05b8bb48521e378270,95,49,46,North America,16,398.84
c0a7522fec0f43f1b40a21aad94dc0db,249,226,23,Asia,23,1696.97
c0a7713d78334f159415b28ec254cb9a,75,34,41,Africa,12,413.13
c0a8854f273e43f9a12429c179fb4704,340,301,39,Europe,15,1989.03
c0aeefa21043446db898063412a9384a,94,40,54,South America,20,580.47
c0af96e515df44de8b9d347b9dadc577,125,75,50,Oceania,20,939.44
c0b0a74826174530bc2e027cceea91df,101,65,36,Asia,18,885.27
c0b12fd249ac4d049b6365172434d756,112,63,49,Asia,18,241.14
c0b1aad53d2c4393acdc4dfaf9a4fe59,202,166,36,Asia,21,1898.62
c0b2b407f92a45a5a4dd3f6dae7fd1c3,267,222,45,Oceania,20,1082.95
c0b36a5ec2354c7189c8e1dc6967a821,340,306,34,Oceania,20,1772.08
c0b4043c1a934fa583059a64d89559c7,138,99,39,Africa,19,899.91
c0b7f18400644266b2c7a0bf155f5bae,107,54,53,Oceania,20,392.24
c0c12c422419415bbe2895856f21b590,365,349,16,Europe,18,1745.11
c0c2d5cccba2465ea92f0f19454b676d,363,346,17,North America,19,1811.4
c0c2f91084fb43e48d680f0581802cfd,270,212,58,Europe,20,1241.31
c0ca3b696e4e41f0aee2958cf2bf9780,329,290,39,North America,18,2313.76
c0ca4982c0074864b05dd955878300f5,54,23,31,North America,16,302.97
c0cb42d7399a4199a725b4b179429007,42,1,41,Europe,18,267.68
c0cbbe02e1a448c5acd7caa6f67a0103,171,121,50,Africa,19,1240.95
c0cbc39ddffc4ad6992b7ec2c643099f,243,205,38,South America,16,1760.8
c0cdad43830c43aebc6a1fb4e310b6d1,55,22,33,Africa,22,509.46
c0ceab40b2b4441586920e8a1de2e465,364,347,17,Europe,19,1927.72
c0d1c6441b744cff8d640ba3d7ce07a9,43,1,42,Africa,23,270.62
c0d3bafd9f564b3c8a198b954bddafe0,216,184,32,North America,20,944.2
c0d77c02c38c454f9e17a7e60bbd93f3,156,127,29,South America,12,1514.04
c0d83447646249a1881e562258b903a5,183,161,22,North America,15,1099.26
c0d923ec77b44a458b45d655ebe5e4ef,225,178,47,Africa,18,1200.22
c0da304add6145598161c499dc40e5e1,76,24,52,North America,25,302.66
c0daade4509547cc8c2cb8b5e53a707b,333,306,27,Oceania,19,2790
c0db65fbfe904177a920add45f72179a,207,157,50,North America,20,892.98
c0dd05261af34ef0bca7de1ba276d370,212,182,30,Oceania,12,1559.42
c0ddf58c1a524551a3ce94056606d1c5,116,85,31,North America,17,760.77
c0dff27bd8224c898355fedc1409be9d,335,301,34,Europe,27,2069.82
c0e254dfaf1b46478a1dc9bd96932f86,73,24,49,North America,18,578.15
c0e25b8cf7c74aaca9ca66d5913a92c1,112,63,49,Asia,19,574.58
c0e763cae77b426493778a2712df7401,294,267,27,North America,17,1674.59
c0e78e0d6bef49c1ac65567759efb617,364,350,14,North America,16,2702.2
c0ea06a2784e4d709d18ef78be468939,128,88,40,Asia,21,1271.95
c0eaf62312a7457d83dd2ea07f1118f0,198,154,44,Europe,21,1035.01
c0ebc7c5631f4ca9b8d9d4188fb704cf,147,97,50,Oceania,30,997.04
c0eebaf4d84549b58fb95398c797603d,204,180,24,Asia,17,1980.72
c0ef3acd526e469b82943fec48733891,279,257,22,Oceania,18,1658.87
c0f0f85585e24a64a294015d51a579f4,238,198,40,Africa,18,1570.17
c0f179045dc44307bd44a0ceaf3cd469,255,223,32,North America,24,2108.58
c0f3fff7f341452c834a80af23f3af78,222,196,26,Europe,25,1713.27
c0f5e186a503463b917dd58ccc68a29e,365,360,5,Asia,15,2880.5
c0f6371a3fb24b4486e80b1de077d06a,365,355,10,Oceania,16,2577.67
c0f751b554cf4055a68147d3a92993c4,323,290,33,South America,19,2577.84
c0f814469e3d4047b36634777129bd49,257,233,24,Asia,16,2189.41
c0fa3965245041fda02676fa1ed91ff9,203,172,31,Africa,19,1424.51
c0fad818b8db453b940a9267e0c33feb,239,187,52,Asia,17,1300.65
c0fae3aa8b1c4fc4a9dab9254b857d28,89,64,25,Asia,21,491.71
c0fd02fcc48f4d2f8236a4c079c643bc,211,184,27,Asia,20,1752.66
c0fd475e440149c288de27185bd9c51c,361,326,35,Oceania,22,2315.52
c0fd60eae534463c93a1fc885383d407,365,351,14,Africa,20,1564.34
c0fd80bfef354b6b8bcaa55ddf2afc00,58,40,18,North America,25,475.47
c0fe3d16f7a44965a7f9a8f47a4effe4,235,205,30,North America,26,1458.64
c0fe76624fb34b1e868942684ff34420,185,151,34,South America,17,811.59
c0fedbf48a4a4e22a51e8c65e984281e,183,138,45,North America,24,819.48
c0ff1fba917d46e8b8622f18118f87a6,239,197,42,Africa,16,1438.74
c1006007a72b457297102e81a43a3a57,365,322,43,Asia,12,2288.28
c1038d3c2c594dbcac00fb1e5e0ced96,253,213,40,North America,20,1629.22
c108b6bf431e4f14b17e2d1eed9ca53e,362,348,14,South America,17,2135.97
c10ce16ab7724e4cac30305ffa463cad,365,328,37,North America,21,1897.1
c10d45191dd14025aff36d502c7a80ff,319,286,33,Asia,17,2555.71
c10e39874b8c4f1c9b15449a0846a2e2,186,137,49,Europe,21,805.81
c10f0ef97da74197a4c0c4c970542e5b,268,241,27,Africa,16,2368.29
c10fabc9e48040329b285cca5240fb87,310,287,23,Europe,25,2223.61
c11085f6949c4c0a8a9b1d02c2433e32,106,84,22,Oceania,20,875.44
c1139713fc66474e8179257e2b0b18d2,365,349,16,Europe,18,1779
c114fb745ae84d858cbc13d8ccbc21cf,269,245,24,Africa,21,2029.42
c1158fbe24d547b8ad5bab8e2c1c2aa1,284,261,23,Africa,19,1970.91
c11abab5c60c4f2e9e8ec14b7a3c6fc7,220,183,37,Africa,27,1815.33
c11b0c4778eb4f9592e03deec2d0f136,104,69,35,South America,18,740.47
c11c20020b264845aa2cb5f71995fd72,129,96,33,South America,23,1011.81
c11ee9f16d234d8a9a9fc3bfaf33f5c2,365,360,5,Asia,21,2979.39
c120d7943eb443159f3e3df72afe22f2,358,330,28,Europe,23,2909.98
c12244093c534ea4a6d1cdcb3cc2db24,364,337,27,South America,17,2585.67
c123ae3271c54cb18bc4a45657bb485e,101,50,51,North America,21,830.05
c123e9d595cc416790e61cf8f616d03e,304,257,47,Europe,20,2586.97
c124a165879c43e6865bbb313f6cf7d2,153,124,29,Asia,18,1047.4
c125394bdae641fba3b9e9e208ae4e93,365,350,15,Oceania,23,2659.32
c125544d1a164b51b293608da00b79e8,176,128,48,South America,19,841.37
c1272f29e6c245a08fa35205f40f291a,299,270,29,South America,21,1809.47
c1275e8ef3cd4fa59f10444affbdb2ee,84,23,61,Europe,19,372.33
c12849bf324c4e55bd67d770a4d31a69,50,4,46,Europe,19,148.35
c12d6a93df9a4436a6b56dbb9dc663ee,95,38,57,South America,22,396.34
c12e5847da984e48a266d68f68f8a087,127,103,24,Asia,20,1176.93
c134b349589f4564ba3db077ce7f3857,249,227,22,Oceania,18,1806.68
c13991890e944897bb1dee053683bfa3,112,88,24,Africa,21,1111.17
c13a2ddd88174fcba6dbdcf24c841e7c,365,334,31,Asia,22,2653.94
c13b9d62853e40cd9c948f5d63275032,316,277,39,Asia,19,2514.81
c13e6c0293cb4f7d900050267e02c6fa,260,210,50,Asia,22,1804
c1403a4a67584c7dbacd108c75537166,74,32,42,South America,22,368.16
c1414dedcfb44553aaada38ae5386458,272,237,35,Oceania,19,1836.14
c14410366b3b482b84725ac2d31bf7db,69,33,36,South America,20,551.93
c14584664741407db62fdf9311037953,272,245,27,Asia,17,2988.61
c145ccaa318d47ce9d627d264ba171bc,323,299,24,Oceania,16,2271.03
c146931c2f4a4162bd512845b72dc22a,106,72,34,Oceania,24,686.98
c1493d7c268f4027bdd1b51a64b1bd26,345,289,56,Oceania,21,1792
c149b94e44694a159c17f63e1ca1114e,239,215,24,Oceania,23,1871.86
c14a01103b3e41278775475faf30da44,311,289,22,Oceania,21,2997.13
c14a4b27f5e3468abe6d87ab77f09af6,208,163,45,Oceania,18,1175.44
c14b980985734a1aba841e5707fa4656,364,345,19,Asia,19,2566.31
c14ddd6176c34e4f9716103e9b82a3d6,82,46,36,North America,17,195.1
c15076ae9dd74478bfdb5f47df9996f1,130,104,26,Oceania,18,1163.41
c15095df3a904909a3c0590d3e4b8a8f,364,337,27,Asia,17,3026.5
c15099ac1f6b48bc8efcd6ba64bd4f7f,42,8,34,Oceania,20,359.37
c150d410e96f442495d0c22e65429e2c,365,364,1,South America,22,2355.77
c151937f90714ef0a5d3e584154b0244,319,289,30,South America,23,2232.11
c1563d93fb244bc28ac7e9716e93847c,284,243,41,North America,22,1560.85
c156485966604ca4a543f1b4d3281ce4,147,121,26,North America,15,1212.6
c158f203931c4e34aa670b476994ff40,144,103,41,South America,19,1002.1
c15a4b5e46564ec0884d35a02b4e33b2,312,296,16,Europe,16,2248.66
c15bf0ede7404a4cab568a3af615fea0,67,41,26,South America,20,422.13
c15c6ab8a2e4429c9bcafafb2b9bf453,353,309,44,Asia,23,1962.61
c15e85892a62447e8025e445f6aba2d4,75,35,40,Africa,18,243.95
c15f31f3ff7d4bc29820e2627032cc49,273,224,49,Africa,18,2663.74
c162b84b13f34791a9c00c9b66b86f4b,40,17,23,Oceania,26,188.99
c164cb485570402f9330596e94014a95,355,326,29,Asia,22,2466.01
c164db320c544100be549682e4c1e630,192,161,31,Oceania,20,1295.8
c1662c4009ea48fd9cdcc8018ba8e033,346,315,31,Oceania,19,2276.44
c16ba5128836485e86ea3d78dc121778,70,44,26,Africa,23,754.02
c16c2d4a447b47738965411d952d0859,324,305,19,North America,21,2783.9
c16f0ba5c3cf41fc8edf2db32662879e,231,182,49,Europe,21,1141.04
c16fd52676104cac99da1caa52a95717,261,242,19,Oceania,21,2206.09
c170a83a586444ae95a3c36cf710295d,364,331,33,Europe,21,2023.93
c171d09b12fc45528cb11ac93105d00d,274,242,32,Europe,20,2072.44
c171d1f4c5a744f4b4e09f60347dc696,292,273,19,South America,21,2086.76
c17563bc7650407f8f214b9a247b282e,237,203,34,Africa,24,1105.33
c1765509874346949e24ace3a6d464d6,214,188,26,Africa,20,1288.02
c177f79b666f466092af168edf8db64f,75,24,51,Asia,24,406.15
c17a53d7d96f4f95a14355dbe651ef39,115,93,22,Oceania,21,1125.99
c17b1e934c8d4014884dc8b1ca95737b,365,350,15,South America,19,3143.53
c17d8286f8f24fe99c87080ef64a25b5,199,166,33,South America,19,1469.05
c1801cc9d39c44ba8dba1acaae470a1d,182,132,50,Europe,18,1122.77
c1810765b01846aabd58794efab2c5b3,110,60,50,Europe,19,629
c182abb987394921960095c0d5a82299,115,78,37,Africa,17,612.14
c1830ff454f94cb2b4add48e5225a399,194,168,26,Asia,26,2154.76
c186731edf704ac286fe413bbc096513,64,36,28,Africa,19,278.79
c18870c1fa054c75a6cfc3f1dfbcd8e1,188,154,34,South America,19,1625.16
c18b5d5f036945b792847a8890c62327,362,332,30,North America,22,1930.32
c18b7bc431c1440a9bc03283a523ff2e,25,8,17,South America,18,447.94
c18c3109693649b9ad51c5041aba5568,276,241,35,Oceania,22,1451.94
c18c3f7cccbe480887afd3c8be855655,356,324,32,Africa,20,2011.49
c18cac36f15740bb856855aef45e325c,101,62,39,Europe,22,702.77
c18f6fc18f9f4fc8bbef6b2abe7482cd,221,200,21,North America,22,1743.37
c19118d4b91740f58905e032c51febeb,295,257,38,Asia,20,2347.18
c19151de51fe4ac2ac64ee85b9214565,80,34,46,Europe,20,245.36
c19152a29dc5479f8680cc24d1d21780,186,157,29,Asia,21,1660.18
c192f324390d42c1b7c339ea5ee58d5b,350,330,20,North America,21,2554.21
c1934a9ee14e484384f79f64e2e87100,249,208,41,Oceania,18,1559.48
c194a9c816784ac48870fe528f13d906,50,24,26,South America,24,673.61
c194c9d1082e4b85a35853ff9608dd4b,348,319,29,South America,17,2496.32
c1985df0d1114169813be013bf78e4f0,131,103,28,Asia,22,1185.62
c1987fcbab7149a998d22290addca60b,186,135,51,Oceania,19,1293.55
c19ed05ee52d4b49ab527654ad8d30d7,172,119,53,North America,19,801.97
c19fa5bde0d84b909a41169843179efc,220,185,35,South America,19,1255.98
c1a28b712a154774bd694f8777e147ca,365,354,11,North America,21,1983.62
c1a3979255334eb2a71ba748584681b3,170,154,16,Europe,19,2014.69
c1a3aa65dbb64aa1a1ddc31f43454645,365,344,21,Africa,22,2251.41
c1a44fd5e13d4bb7a1da0611f3d1b8a3,94,51,43,North America,21,510.96
c1a46d1aac8f4898b956bde418fc53de,192,162,30,Oceania,24,1196.48
c1a513a5719b41b2a194431a0db9f171,351,330,21,Asia,22,3174.77
c1a52049e1f04a068b6ac25361a85bc2,361,347,14,South America,17,1616.43
c1a830cd388649a2b86588122d1eac36,166,118,48,Africa,20,822.8
c1a9672c38a24923aab24863051773ef,133,80,53,North America,23,563.52
c1aac7e10ca64824876ddca37bdf83e1,325,279,46,North America,17,1664.61
c1ad757e567142f5ae1b9674e3864fb9,164,125,39,Asia,17,868.73
c1b0006ef84c44d3b31bca66fd8cb8be,329,298,31,Africa,25,2179.7
c1b3303add074ca5ab02fafbec39489b,215,171,44,South America,26,1432.8
c1b35e2d04e3489f83e97335844c35c9,199,157,42,North America,18,1123.75
c1b47333b44d403791e406aa6778b7ad,348,299,49,South America,25,1970.2
c1b59a7f5cb5493fae47d0fcfb4bc29b,137,102,35,North America,21,907.17
c1b618f3e6f9484b8c7bc2529cbd04df,113,56,57,Asia,17,955.24
c1b7a543862f4bc3aa5e8686a6db76f7,205,159,46,Europe,22,1488.14
c1b7efe9274c45cf81323b21ec0a0931,159,130,29,Africa,21,1484.9
c1b7f28dc0c14805b111e79e50a2fb8b,34,7,27,North America,16,238.64
c1b8dfed569847b3aa02c42ed5248453,209,173,36,North America,21,1566.8
c1b947b2242f4accb260ba3c63896853,335,320,15,Oceania,19,2606.08
c1b9eca338df4eecb2af616dcab396d2,81,48,33,Asia,21,895.55
c1ba4674d48a441185fe530d54f4de65,364,359,5,Asia,21,1661.99
c1bfb6515b594fb495738c979f64a2dc,289,260,29,North America,18,1829.53
c1c06b040f19493d9ee4e85a6655e336,189,148,41,Asia,22,1045.2
c1c10e514e804ea2aa20f78a5b26e6d4,348,307,41,Oceania,20,2610.11
c1c32dccb1b0496ca99609e9726240f9,365,361,4,Oceania,23,2024.79
c1c336ac4754458bb1bfb51355a0245c,182,142,40,Europe,20,1068.9
c1c3c6b87acc425598ec24880eda7580,260,210,50,Oceania,18,1573.2
c1c4070ad6de4b578fe734e7cb07a2d2,305,274,31,South America,16,2333.11
c1c6632a447e48eba7526df2d901adab,88,46,42,Europe,18,659.25
c1c71a826d3347db886cc0a25cd8a061,365,356,9,Europe,15,2287.62
c1c84362afd14a948616e2e231d0caef,280,262,18,North America,20,2127.65
c1c9bb5fb7274866b22034487f14f160,201,160,41,Africa,17,1666.22
c1ca19e278914a36bb44998040a91a95,156,133,23,Oceania,22,897.48
c1cdba01094d4f90800fc803b6969261,309,285,24,Asia,19,2113.03
c1cdca5fe9f4466bb8c37930490a6629,350,303,47,Asia,15,2062.98
c1cf26e94ba74d7c8b0af4859fa53d28,161,116,45,Oceania,22,997.39
c1d00e8d049f4377bbf0d59f5ea18287,154,123,31,Oceania,17,947.35
c1d17c654c644f51a42d613929c962dc,104,73,31,Asia,24,596.84
c1d1aa8c5180443e9b7b2b262802f556,221,171,50,South America,23,851.01
c1d314a5caf348faa30b83a51e4e7c0c,258,206,52,Europe,18,667.8
c1d7a855cdeb47398c10e293ccc9cbac,188,156,32,Asia,26,1422.14
c1d98ab64dd74b26a9591a21b1f52e53,188,163,25,Africa,18,1275.34
c1d98f2a34694e399c89f9f60bdb4dc8,72,39,33,Africa,19,504.21
c1dbcdd9ac9644b3920ad78342b478e4,364,358,6,Oceania,20,1748.2
c1dc1c96476b46dfa7fcce96f638b34b,102,70,32,Europe,13,783.42
c1dcb5a6bc4141eeb932eac71d885a3b,361,320,41,North America,21,1896.42
c1df2d39307c40c18d135032ae981dca,59,18,41,Europe,18,348.44
c1df4c18cfc64103b789d740b95bca4c,156,108,48,Oceania,22,821.56
c1e1927800b14c83823cc2596953097c,315,280,35,North America,20,1838.41
c1e33faae6474749a9b382419cc80f21,185,153,32,North America,17,1320.61
c1e3f2c83711443dbe193a74a3518c0c,50,23,27,Asia,19,471.52
c1e647e8641d4dd580a60c35b4a4c44c,283,234,49,Africa,19,2078.84
c1e71cf35d214af7879246bd35f123da,114,63,51,Europe,21,489.64
c1e85ed5e24f4215a86035604da7d5a6,69,50,19,Asia,17,336.53
c1ebb1ba2fcb42728ab5ce801ec32768,298,264,34,Asia,25,1908.63
c1ebb838175a4a478ff720cb5e140d4a,365,328,37,South America,21,1479.11
c1f1539498dc4e638972a56e4978c28a,277,253,24,North America,20,2380.44
c1f17071806d4dc1b579566df826a8b2,347,319,28,Asia,22,2772.39
c1f1d30a91e74385aab54cf1057d6c8d,169,124,45,South America,23,795.83
c1f2eac6701b4fa3b6b3ff905d5cb736,129,72,57,Asia,20,841.05
c1f3b5d60aff432cba2c09c567df270e,365,359,6,South America,19,2410.36
c1f502f8e14b477eaf32e10787a70a15,217,189,28,Oceania,18,982.15
c1ff48b371bf4db3ae0c4e606728c1b5,289,253,36,Africa,20,2061.05
c1ffcfdd340e4707937d75f58192013f,169,131,38,Africa,21,1716.9
c200702be3d4417bb9443e3083168073,365,322,43,Oceania,20,2450.41
c202d1f46bdd4eaeb6e66af473492d98,329,304,25,Europe,17,3034.76
c209bd1b644e4ad9ac18a6dc8937dcfb,167,122,45,South America,20,854.19
c20b82331aca4aeeb8e34d81e7768a51,200,148,52,Oceania,19,1066.58
c2120f0f112d43459f4885444ae63f6e,206,186,20,South America,14,1621.79
c21327849752400abe4ea1e32f6cdabd,266,213,53,Asia,20,907.97
c2142c71ca1a4c78b7c079dbc6fd1bce,362,323,39,South America,18,2682.51
c2148f4f56ff4dcf82c0d5e665f5918b,93,59,34,Africa,17,651.28
c214c85857a04fb692396df0be64eead,151,120,31,Africa,13,1457.71
c21552756f144a588547333b704d15d4,341,304,37,Africa,14,2749.7
c2164ec3ad50474186a512e836c7bc63,194,147,47,Asia,22,1280.56
c217f8671f444f4f9dc299a2274b7e2d,87,58,29,Europe,22,626.93
c218fa2b0b794dec9203bb780db836ca,245,200,45,South America,17,1849.24
c21919a452384251b59cdca882ef31e2,335,290,45,Africa,19,1690.49
c21c156c10834e47b636fcb8d8122e11,266,214,52,North America,20,1093.07
c21c1575f9e841d99efd1630e9990162,365,356,9,Africa,20,2396.96
c21cd6186fd74bd9a627341bba436ec1,269,239,30,Oceania,19,2061.5
c21e644218684107bf94b4acbe05a39d,364,350,14,Oceania,24,2853.54
c2210b01fece48f6a0bc15837da4a76d,147,106,41,North America,18,1670.95
c2217b6763344e1f89d5ba557d79b441,127,98,29,North America,24,916.69
c226db1d058a4d38897d090a596498ce,318,295,23,Oceania,19,2051.14
c229b22b82c142cc9eeb04de35ffbf47,297,245,52,Asia,20,1924.76
c22a65acb9394b5a895746c0d8dc986b,134,113,21,South America,24,1097.79
c22cfa4608dc47449c96c2079bd93cf3,106,74,32,Africa,19,598.8
c231c40c2bec404a9b6e6d021a19d4d0,229,203,26,South America,14,1834.29
c2354cc586b745b69ddba63a52e759f1,116,88,28,Europe,17,1262.56
c235df5d1c3d425cbda1f72ecaac2b65,279,242,37,Asia,19,1981.42
c236d924f4bf40269a9a1eab5d11e058,59,23,36,Asia,22,411.79
c239a2bf87cb4896a840f1910f5a6291,163,138,25,South America,22,1400.69
c23abef5cadc4c28bc250019ca655ed1,365,326,39,North America,22,1614.94
c23b3874c5d945ea8b91ee73a5809935,364,337,27,Africa,19,2293.78
c23e7690f05d4939981bbf991b3b6cbb,319,271,48,North America,22,1581.72
c240dfa25df44357b611345f75ab3498,363,359,4,Africa,19,1923.19
c2412f96e69245b48de487f7696ab6ba,80,43,37,Europe,29,558.18
c242da122d6e489c82c3827946c4c521,228,172,56,Asia,15,1567.82
c243bc11ec0f4559b3203ea034a1ffb3,153,95,58,Europe,23,659.73
c244faedab8d4d0d8db17ba359ab14b3,155,113,42,South America,16,710.16
c2472adad55445c685c60b8ce5d61453,302,275,27,Africa,23,2321.44
c2486c5a0e6c49f0882e72c4385d3a1e,227,213,14,North America,20,2684.34
c24982f1217948fa9e8a52572152b535,251,200,51,Asia,20,1614.19
c24cd754ce1a4da49322a4abf9c010be,204,173,31,Africa,17,1326.85
c24fdb7b32f54dbf9333094499539a72,288,260,28,Europe,15,2478.62
c2508c486fe44344abf6d312ba4f726e,136,118,18,Oceania,23,1041.13
c252ac750db64a588306510f1c460814,188,161,27,Europe,21,1446.06
c25339c4ac6c4c0c83ec9c303b89f9dc,99,71,28,Africa,19,1005.1
c254c97444934aa9ae5861541e5f1357,173,149,24,Asia,19,1201.81
c2562cc66e7140968d22c4bd8dfb8e1d,289,246,43,Oceania,19,1612.34
c2577e89edbb4106a805ca06425eff23,361,353,8,North America,22,1654.95
c257ca7eb42e433dbb3a2607e6063082,256,240,16,Oceania,22,2031.65
c257deb88fb24abaaf91e5264a64b65a,365,344,21,South America,18,2992.63
c25cc9aee6ad4995979f7743323df4ed,173,143,30,Asia,12,1014.31
c260222cc693480882b66618c50d76e7,264,219,45,South America,22,1342.56
c26148a71cfb4707a9eab722efaa5bc1,337,315,22,Oceania,21,2454.91
c261a2df151945949340f17cbeed8036,96,70,26,South America,20,474.23
c2653adfbdf94db4affa21d0e831d51e,298,269,29,Asia,23,2612.4
c2657f618a964d5fa36f8f6da2b82f0b,348,321,27,Asia,18,2755.34
c2678f664a704523a95f207b595c324c,365,360,5,North America,18,1987.43
c267a3fd0dc44450888625fe3954222a,273,239,34,North America,20,2059.24
c26873d9e588404c8fb42b4dd477dcad,197,158,39,Africa,19,1627.48
c2694ff7b6394bb397590c6de07f227c,239,211,28,Asia,19,2135.38
c26a4dc445594a0a833a3fba4b8ee91c,266,231,35,North America,16,1954.63
c26d68aa0176429da014ad7459a59b98,332,286,46,Oceania,26,1263.57
c26de7315b2d46c1908d6f6a31a9f146,333,290,43,Asia,25,1433.3
c26eb2a3dfcb418ba3075c0d7c544a79,90,48,42,Europe,17,573.27
c26fe032bd1647629fc1133be1ffd7c2,172,126,46,Asia,18,1343.05
c2702f0fc8c74e929d359411361f12e2,298,267,31,Asia,20,2428.57
c2705cd32d7e4f549c6ed51356d33e36,364,338,26,Africa,23,2078.07
c2725ed50b9f47e5a62331139b876ab4,145,113,32,Oceania,23,959.62
c2731c07d2824a2694facf6fac1c69e6,345,313,32,Asia,22,3310.81
c273ab54966d42e6abe532c3cf80a508,180,130,50,South America,22,1036
c2744a2cd83c49e9b08616a78255e46e,129,81,48,Asia,19,991.38
c275a647ab8645abacb72d66dfbd9ce0,161,119,42,Asia,20,1062.81
c2778288f40147cf86a882401f06532c,266,239,27,North America,17,1580.92
c277ee3a58ad49a495f508a72f9947f8,310,270,40,Oceania,21,2393.43
c2793d29ec9940e684e3f479e7d8d805,34,15,19,South America,19,302.67
c27d17c9baea4f949fdcb3e20564ff51,364,361,3,Europe,23,2311.62
c27d268631e94ea7bdd11a1524edc7cf,137,93,44,Africa,22,709.65
c27d715f2de147c3870942aca869c344,146,94,52,Oceania,18,488.01
c27f3d048b0842fb8144defb2208d898,265,237,28,South America,21,1381.58
c281588f90314fd589b9c0a4715560eb,165,110,55,North America,20,1040.06
c28340d8f2cc4cbe837d052b998209e0,252,203,49,Oceania,22,1532.64
c283892dac4c455aaa459b02ac985bb9,364,345,19,North America,21,2464.2
c28883d66c4b47408b78bf9d3c2e8117,106,88,18,South America,25,733.93
c2899971215642259ffe8c26aaac2d3c,301,276,25,Africa,19,2993.91
c289f59a60b245af9fcdab804a296e5b,361,347,14,North America,23,3044.95
c28e1076dd95450d9b16d7c8f6129e73,238,190,48,South America,18,1632.25
c28e7bfed8644ed0bbc6857abec7275a,183,148,35,Asia,20,1239.88
c28eb341f0a84908be72d60fb3f1c167,256,225,31,South America,22,1552.41
c28f7aef12c34eb282f65cfac65ece08,239,191,48,Africa,23,987.07
c2929fc2954d4bfaa7c4b13366e405dd,102,58,44,North America,24,553.64
c294afb847a44fe9ab2ac454ed7ede21,163,121,42,South America,18,890.34
c294f2b4535a4e1e835d8506609b9fa5,364,348,16,Europe,24,1917.36
c29ca20308934994b617673c8c9b3883,105,62,43,Europe,24,664.43
c29cdcd5ec23467581fd187ce538b6d7,364,348,16,Africa,20,2881.31
c29d3966b5994286847e207d90f8d4d1,96,56,40,Africa,21,435.1
c29f5713b5b948e5b0989d06e0392ced,88,57,31,South America,14,485.89
c2a2174e2e934e04aba3606395c19c3c,365,346,19,Asia,20,2109.31
c2a51d563990477797ae2a3f9c64cf7c,288,269,19,Oceania,17,2512.3
c2a9aac8e47246d68dd4ef7be915688c,285,257,28,Oceania,24,1776.74
c2abb4e1c37840c9be08f90c1086ac21,348,308,40,North America,20,2796.55
c2af49cc6586474e94544ebc09cd6fd0,72,52,20,Africa,19,763.82
c2af93e58c7b41bbadca2b695e8d3aad,56,26,30,Europe,23,376.96
c2b0a270eebf4ea1ace0c5ab604aeb31,365,351,14,Asia,23,2748.58
c2b0c36cb50c43988fa3492ba9fab44a,75,37,38,Asia,17,723.29
c2b1985a4e9341d08c26221046e5334b,216,165,51,Asia,22,914.98
c2b1f1340b9f4b8caadd4a25e17ec04c,176,130,46,South America,21,1122.45
c2b2e2cffc9e4760a40efb710d9c8f88,115,80,35,South America,20,1019.32
c2b2f0d8deef42dc9ee3e61d54549d30,165,120,45,Europe,19,1068.19
c2b460bbd1ce4abda6ab8f167d644704,119,74,45,Africa,12,365.79
c2b5ed747611408fa2c0b855863b858f,353,323,30,Africa,19,2003.71
c2b5f66cc1904d6e98d1b744727968fb,186,145,41,Africa,17,1398.41
c2b7b319cc5240139a2c0cd68b57053e,97,50,47,Africa,18,295.92
c2b8804f3e20439190bc25b7e452661f,79,55,24,Asia,18,677.39
c2b99a0d4abe4ed29770a04805e5b771,50,33,17,Europe,20,239.16
c2b9da1bd6ed4f7dad4ae05490e67f75,82,36,46,Oceania,15,316.27
c2bc262fc50541d09a0fe629867e2f70,96,52,44,Asia,22,362.7
c2bc5c2792a0462d811d498df0d0305f,192,167,25,Oceania,19,1655.1
c2bc8362da474f52b32424208b9dd538,37,5,32,Asia,21,266.54
c2bd21a76f5b4516a50dcca04c5a5829,185,135,50,Europe,19,617.41
c2be2260583244dcbccf4a2f6febd650,365,353,12,Africa,20,1615.06
c2bf109ea1e54141a7f8cbef94b9ce5f,350,316,34,North America,24,2532.19
c2c10c4a76574188bbb05b7c0fc01475,210,152,58,Africa,22,1468.86
c2c2901079364420b1182eb527ad35f7,365,361,4,Oceania,20,2703.61
c2c6be027ecd4b3f92562a6b8fe2d059,364,352,12,Europe,25,2232.28
c2c8bd1ce9784752a64165a25310e1cd,302,274,28,Oceania,20,2090.52
c2c996f5dfc34343a687b6d7f24baeb4,116,79,37,Africa,22,833.71
c2cb902c2b114e1dbbbebf96d0f2c5ae,298,260,38,South America,21,2632.89
c2cbb8452a4b4f0eb841cba328042024,363,356,7,North America,19,2519.81
c2cbc5ca419242369f9ac206b6c5ce71,278,239,39,North America,18,2045.07
c2cc7834f056439a88432eede12a43db,363,327,36,Asia,17,1973.21
c2cd31541deb4e398dc354ed75f4ac18,103,51,52,Africa,20,659.41
c2cec999de3c4a3b900aadb10b786d5e,154,105,49,Asia,18,1370.41
c2cf73a448c649fca5e3404957874da6,365,343,22,North America,18,2401.15
c2d05a73afc245c6b4b333ce65d16f67,349,307,42,South America,21,2353.9
c2d12f90a8904e4e87d1ad9bc826a585,358,315,43,Asia,24,2772.09
c2d9c06bacea43c495f93347137fa415,365,332,33,Africa,22,3060.21
c2dac9b70e174e259da452c66a6a7ad6,273,234,39,Asia,14,1669.03
c2db493a19fc431191f5d4a8e02dc764,63,39,24,South America,14,299.95
c2db8a8c19c34cada05ee72100d57c59,141,95,46,South America,16,1100.84
c2e07640e2444ea183ae382c3f138b4a,342,312,30,Europe,21,2747.96
c2e25bed4afe484ca1dfd1775325d8b2,81,28,53,South America,20,610.38
c2e484fcfd6549438d558278c9a56b6d,242,204,38,North America,22,2316.3
c2e6555d404a47e69f41b471abc09c64,132,83,49,North America,19,577.14
c2e6557663eb4250bdd6dc976b58f080,327,302,25,Oceania,25,2982.38
c2e7aa9985224acdbbf6fa00c9a36bb7,318,295,23,Europe,21,2036.89
c2e8f2a64e554cc18b854220a7b5030d,180,151,29,Asia,22,890.58
c2e9eb6ee3f04b98bdff6ec145766d9b,365,354,11,Europe,17,1676.78
c2ecbc85aeb444c497381b735f14a8e9,358,319,39,South America,20,2279.86
c2ed3ad14b824b9daf30161ba5efbbac,62,14,48,North America,20,654.31
c2edf3f417d34864941fc877fbbd6ea6,363,337,26,Europe,23,2188.51
c2ee913ec8f644ff9e766a8ce7fa6b90,355,301,54,North America,18,1802.8
c2f104e226254153a468b9a952098317,45,22,23,North America,19,308.59
c2f6c3bddf774b66873674825482f9a5,306,278,28,Europe,20,2676.39
c2fac3f7701a4bd798aec349d538cfb9,219,183,36,Africa,23,2200.86
c2fcb33ff1454affa626d3e9cbcca1a1,110,70,40,Asia,21,616.75
c2fcd5844f1746fbb091338fbc24fe67,241,219,22,Africa,20,2162.76
c2fd841f28104800986019acf773c443,49,9,40,Asia,22,319.1
c3016760fa7f4494b2610eee53d6857a,365,324,41,Europe,20,1495.49
c302a357ccf2486ab6cb82bb7c78c44c,231,195,36,Africa,25,1847.37
c304d03a046b4c089c7d40508acbb03b,138,88,50,Africa,15,1203.88
c30557feb65641ad9edbb06b861c3438,98,55,43,Europe,15,710.21
c3070bb5188f404bbbf64298990fd523,299,246,53,Asia,25,1459.67
c3086dd374c04e9d99429e49b7c2ad57,340,283,57,North America,18,2105.76
c3089d8846a943e6b368e417534a1e6a,310,282,28,Asia,18,2209.9
c30a1694840143c098e01c58eed198e1,65,41,24,Europe,22,443.15
c30a88012c9a4d9ba2f641fb577e4d30,104,83,21,North America,18,1244.29
c30ae067dc6d44b3a4905186d09f1196,59,22,37,North America,23,119.88
c30c273f21ec4b71ae1390c8e6d25261,224,175,49,Europe,20,1109.6
c30dad3cdd114f47a9d2a191f8f7dcd7,304,289,15,Asia,23,2030.2
c30eacfe27c545fbb46bdf24183618a5,126,86,40,North America,23,928.12
c30efdccd0724f1dadf98dfdc91c76f2,292,242,50,Oceania,16,1576.16
c310809dc8f5461a871ca5ec6086d499,254,201,53,Europe,24,1031.39
c3110e98b8ad40469134c76bea262d6d,213,182,31,Europe,22,1501.57
c312626d2b9b44d8804199d018d2db4f,310,282,28,North America,19,2131.6
c3127397e956404e9d4738b227aac914,59,25,34,Africa,20,295.01
c312b2296f1b4f2e987c23f6e6efc3fc,231,204,27,Asia,18,1233.15
c313ad0fe86942a1b4e5f0b683904663,350,297,53,Europe,19,1907.6
c313b8a7a27d41d5b241e06eced98a80,181,142,39,Europe,20,1712.93
c31413e6d7984663b7b6bd8188ec453d,167,143,24,Africa,23,1141.59
c3145ad53e2e45ee88eec0d66d91f8c3,269,231,38,South America,17,1948.22
c317853ddb4945828e1d863f2d8a8e8f,74,34,40,Europe,23,314.06
c3190dcd973d4d8797dbc842b5ecd235,178,154,24,South America,20,1121.06
c31a8f6400994e8fa1911160978ee315,241,187,54,North America,21,1378.09
c31c1448972346ed880926550b309c8d,110,90,20,Africa,23,847.33
c31ce97ff0f14b94a7f51c9024aadc62,221,168,53,South America,18,871.29
c320600cf92148f2b5613e4a207d067c,267,208,59,Europe,17,1240.71
c321ca3f85d5436babd8bae2fdecaa96,57,4,53,Europe,16,140.32
c3220fdd391644738af9066425780708,257,211,46,Africa,14,914.28
c3221cfc9cdf4e0bb13cd3e1043f6442,236,195,41,North America,21,1885.54
c3224fabda5e487f9e251242cd7023e0,276,239,37,North America,21,1664.8
c32338d5442a471ca375853d9464d6aa,363,327,36,Oceania,17,2745.1
c324a5779a9f4ff3bbbc06143c471906,344,305,39,Africa,18,2300.62
c32d37fc703446298995a8db6db39b7a,206,178,28,North America,21,1535.92
c32f324d2a544fe386c25e4110e865e8,235,213,22,South America,18,1757.67
c33013a612844744b66bc493dbbc6a0b,252,223,29,Oceania,21,2121.33
c3308f002d7e4712ae51f18ac3c9a66f,86,64,22,Asia,24,1197.33
c336b4b2e64b4c95a32d6b6d90d012fd,188,161,27,Africa,23,1328.29
c336d8160a5d48288a778af78d0d84cc,247,206,41,Asia,17,1301.79
c33700a67f024ddaa090a2f7e7d78cd1,72,16,56,Asia,22,261.87
c33b5b677d5b428785e19c2d630f28ca,364,332,32,Africa,17,2067.06
c33bd23600ca48f8aae2b7d1cb957843,47,9,38,Oceania,21,323.57
c33bf5bab09141728889a48bb4e7ff7b,220,181,39,Asia,21,1408.26
c33d31a9d7e941f89c7d544fa025a54e,76,29,47,North America,22,285.24
c33eaada4a1d437e9ca104fb353017a2,220,175,45,North America,22,1659.41
c3420bc253ec4f9faafeddb8f64c4a6c,177,131,46,North America,23,930.51
c3424a55f20745e397fb42fc00528069,343,305,38,Europe,22,2185.14
c343a1571f004b35a61f18c76f00329a,360,340,20,North America,19,1805.57
c343c6b019e1490ea36af21b7d09e9d0,364,350,14,Europe,24,3057.25
c3456960cd2d48f5aa14e453757f1038,312,271,41,Africa,26,2226.6
c345caf881fa4d8798b61270d1763f79,56,16,40,Oceania,17,426.1
c348fa2b102c41d9b7037b45e5ea8fcf,48,5,43,Asia,20,333.32
c34a84d01f0e427fb96a9f53a207850d,68,31,37,South America,20,381.75
c34d084e17cb4371b879165a1cefa561,365,340,25,Oceania,22,2517.19
c34e628b83d144be884eb7eac662b545,64,34,30,South America,18,451.65
c350985fdc64496fba3e69338dbcd881,271,223,48,Europe,19,1479.92
c350a45f081f4a35b99e7829824fee6d,197,170,27,Europe,24,1736.46
c350af65fb9b4c639177be98daf95841,169,135,34,Africa,22,1252.66
c351385139654138b748d7332da1e5e2,68,17,51,Europe,25,360.02
c3523b49739d4cf6863991693ad45a35,35,9,26,North America,22,372.09
c35369b3f428426c9579e1d563ac8283,55,3,52,Africa,15,364.33
c353946fe6964307855599a5053d4934,303,284,19,Asia,16,2188.41
c353b6035ba943eb994c1d1d46365c7f,253,227,26,North America,23,1752.09
c3553e9b2491441b83c5e755413fb6e8,164,141,23,Europe,21,1611.69
c3569cc8ce7f4a8fac3fa47eeae66b60,51,18,33,Oceania,19,291.19
c356cf1be95d467797df857566133831,174,145,29,North America,21,1465.85
c357acc97dd248819ee4de5e95c4a764,227,192,35,Asia,19,1786.5
c3591f3c44834e3cbd62e2af950dd246,63,6,57,Oceania,19,387.67
c35d2fe1dacc4cd588aae2879e4466e2,191,147,44,North America,20,1095.18
c35d4be62b20494fb37c47291f562325,326,304,22,North America,24,2754.6
c35d612b633e4c989dc7ee2fcc9689e3,282,262,20,Africa,18,1728.44
c35df1e91cc34d82b5c6be7e94b1eb94,358,321,37,Asia,16,2412.02
c35e4c5e26454e7aa96bd169a74ec98a,89,54,35,South America,21,560.85
c35f3bef2f7c4f2bb11a5419018285a3,82,50,32,Europe,19,790.04
c364d0fecfa5444f83c2d8f1d2113d76,93,57,36,South America,23,705.81
c36a074fd045417b87133f23aa866703,211,173,38,Asia,26,1564.62
c36dba206bf943598687502724dd3109,280,259,21,South America,19,2039.8
c36ee3a605d74ed3acf0ddfb72a9934e,365,338,27,South America,22,1859.12
c370318ca90947bbbec77831703e0191,137,116,21,Asia,17,976.67
c3720731a0a74f27ad45a5ed48fba63f,260,220,40,Oceania,21,1521.81
c3736103f98342858f9f1f19399a7a7c,188,167,21,South America,13,1942.17
c374b0a70d9d4ffba834883b0cf1e0cb,158,139,19,North America,23,1522.93
c377691357c5417993471a05ecc2670a,121,96,25,South America,21,886.98
c37856c81df045e199ec43efc55bfac2,36,18,18,South America,22,356.43
c378635c0878402cb84154921598dc6b,264,207,57,North America,20,1072.55
c3790cb82d6841bdbea2952ad2a8ab39,168,130,38,Europe,27,771.26
c37d5b0b8d7d457f8c9b67769a191364,199,146,53,Europe,18,924.15
c37f4a62873b4befa943d72047ae677b,313,289,24,South America,18,1970.46
c37f8cabfac545bf92d25816130d855a,182,148,34,Oceania,17,972.18
c37fe99c39c64d43982a2e672b77cdc3,92,44,48,North America,19,724.22
c3806a215229411a936ad32084c62310,175,137,38,Europe,21,1172.75
c38351cc121c423faa6edca48aa3fe8e,278,233,45,Africa,18,1578.86
c383bceee0a244e4a036bbdfb69e7ba6,234,204,30,Europe,18,2106.5
c3840c94a6b142f589904b021f970526,119,67,52,North America,19,582.94
c384374e004f4155927c611b063e7b5d,341,305,36,North America,19,2260.15
c38459dc19484d9ea86ed3cdc30163cd,184,137,47,Oceania,15,891.82
c387904c9c6343c4b06d66db231604c0,177,158,19,South America,21,1393.63
c38944be577d42308bca5c2dc5b617d1,255,213,42,Oceania,19,1757.34
c38b141391ab41248b5215605d37d494,161,121,40,South America,17,1181.12
c390104a76df451b9c1bc1feb9ecac78,186,165,21,Asia,26,1380.88
c390269fdec4481f80a88f4e16bea96c,277,225,52,Oceania,23,1138.5
c391a30c25ff43b68e31b72790757f35,192,151,41,Oceania,15,1733.06
c39360764ab340e08ee73cc43428eb59,38,6,32,Europe,23,364.48
c39382b9214842b4a7081233a85445cd,212,190,22,Europe,19,2126.61
c396428aa168467a95a9f53d01544a61,356,318,38,South America,13,1990.95
c3997b4f640c42ce9dfcb96535c55ad4,314,267,47,South America,16,1588.85
c39a06eea7c345078dab8c2001a255b6,364,326,38,Africa,25,1499.09
c39ad48da612419db340e24a58258251,338,297,41,South America,24,2439.46
c39c3b2e279049538bbab6ac60a4b073,365,342,23,Oceania,21,3763.04
c39cd97557b24092919b86cad9101ce6,114,88,26,North America,23,1231.59
c3a2a8999ea4416481fe5896a7386d52,269,242,27,Asia,21,1664.9
c3a37bf7df444a66b132dcac118d634e,364,332,32,Oceania,19,1720.56
c3a3ec9dd56c446db1970f25a107299f,355,319,36,South America,21,2187.59
c3a3f43b582c44b39116dd87de837c5e,222,201,21,South America,21,1182.68
c3a4e7b0a4404884b5d1db931ecc4209,311,289,22,South America,20,2553.72
c3a75111a83645028366fcfff79b5a74,128,87,41,Asia,19,525.75
c3a86167422e496a855fbc24d8f36c5c,277,239,38,Oceania,21,1696.85
c3a9c6ffd9d646338f6656b101391c5a,262,211,51,Asia,25,1321.02
c3a9e9745ec84fa49d06eec8654e3200,115,67,48,Europe,18,426
c3ac28c1c25b443f986d6c1d8478de4f,363,327,36,South America,22,1858.03
c3acf6f980bc4ed99e68983cfeb46df1,222,167,55,Asia,19,1281.64
c3ad1fe2839847239ac65edfb6f9dd94,175,124,51,Europe,23,858.94
c3afba0cd38f4274898c295356e20d64,234,182,52,Africa,20,1714.46
c3b1c411432b48179da2a167aef167b6,156,101,55,Africa,17,480.64
c3b2c4ed9e104808a417244df40017ae,62,24,38,Asia,22,326.75
c3b34a99ae094d878d504f59b6c2789f,140,95,45,Asia,17,477.22
c3b39edc96d64c38a91cf7c5596705ee,184,151,33,Oceania,20,1602.16
c3b96c636c724286b0681a4e386fd0c7,156,124,32,Europe,24,828.58
c3ba664010464ac48b4864eec46383f5,209,181,28,Africa,22,2101.31
c3bac7d0bb5846cb89e6f0b9664ed445,235,211,24,Asia,22,1798
c3bb03eb7b1946a783f8f9513f72d3e2,365,352,13,Africa,22,2226.43
c3bebc0c06194fda9d9e400900b62178,303,274,29,North America,15,2553.49
c3c1665819d344759c5b7e3c48133216,284,243,41,Asia,19,977.23
c3c1c19c41ef4c31b2133355c3564326,365,325,40,South America,27,1507.68
c3c345bb44b84204a96dc4e8da67d790,229,213,16,Africa,26,1536.61
c3c36147fe3c45f3820d5c69e476ffdf,250,197,53,South America,22,924.9
c3c38089bd6c496aafa2bfcb9c84bf74,133,115,18,Asia,24,887.66
c3c465713bfa4fccad87b1cf73d33f6e,365,356,9,Asia,19,2401.95
c3c584a602b140c5b3813cd19c87b146,79,55,24,North America,18,580.86
c3c72d7ada974cd8ad26f6589b5be515,59,20,39,Oceania,20,608.11
c3ca64c3e8e44fc6ad27405ebd866f3d,95,65,30,North America,20,785.17
c3ca6e2ac37143d19b41e35855828c6f,126,74,52,Oceania,22,700.55
c3cbb0079448439c979221732bba0e1a,192,146,46,South America,27,1393.49
c3d135ad95084fc38c920cdd74b08ce6,133,87,46,Oceania,20,455.33
c3d1af136fb7427582865a5a1cc973a4,364,321,43,Europe,21,1806.53
c3d1b22c21c84efd93b195555f3aeda0,285,245,40,Oceania,21,2094.64
c3d1c2e3ca6448ab80e1ab3afdef8801,350,321,29,Europe,20,2005.59
c3d7861cbf7b4430a6ece5abac472fc7,53,34,19,North America,20,198.49
c3d8de9bcf5a440aa60611f8c2a4e43b,365,351,14,Europe,16,3033.15
c3d9b67f39784f9f92c89f90053dbf43,218,194,24,Oceania,21,1626.85
c3db35b12a6b4a83a49cd92c9875ba3c,97,81,16,Asia,17,1010.53
c3dc58e00343476f9386a659f608491e,137,88,49,South America,20,945.15
c3dfcba5034240689cb2b334bf9789bc,70,43,27,Asia,14,862.83
c3e00037895e460e8fe65575d6c53d3d,365,335,30,Europe,18,1716.63
c3e12f4c9b4b408aa32b292c56344649,203,159,44,North America,26,1600.21
c3e14b5108484a7dac32ac31f9c4cc47,314,287,27,Asia,17,2264.57
c3e17157109d453b86e22fa16c03174f,157,137,20,Asia,20,799.14
c3e2af79d0b6447b897d43ce34087088,130,88,42,Oceania,18,460.57
c3e56002be054323843c6e4443f63ff0,201,153,48,North America,19,1288.01
c3e7aef59af9440dafa0a66f02d10fd2,54,11,43,North America,25,564.68
c3e92616b6b1461daf371991f152d5c1,76,26,50,North America,18,234.41
c3f1daaf10314c84a44b8f84762cd039,247,187,60,South America,25,1047.03
c3f85194ca1a4af1b1d8151898032bca,104,68,36,Asia,20,880.11
c3f9189d4cb345649c2a588468ec7a80,316,266,50,South America,22,1418.39
c3faa8ad277941988d7cf5309cb852eb,79,29,50,Europe,18,487.94
c3fcb0f7a05f4ea7a81bd0f494dcdef9,343,311,32,North America,24,2345.81
c3fd8630f74c4a17a57cff236cb22ad9,245,218,27,Africa,19,1455.42
c3feda0799e145eeb88f605246e197c8,187,140,47,Europe,22,807.75
c3ffcce9242141338af0e73980bb3336,58,2,56,South America,23,98.48
c400ec8ad1bc4727b8cb2cdf0399d7ee,146,117,29,Africa,21,837.72
c40298465c79497b9e21897985ea80be,65,23,42,Africa,17,419.71
c409a7bd8f3a4803890339c481088c19,128,113,15,North America,19,825.96
c409bcd572ee421d8bd73ae710135d83,124,68,56,Europe,24,443.34
c40ae23f7ef24c0bb7dd06ae302d601c,318,266,52,Europe,23,2071.72
c40c945e60824c56a3f93cdf8f3f7a6b,365,345,20,Europe,23,2754.51
c40d404d9b73403c9cafb36869eba674,186,151,35,South America,21,1385.76
c410e92fc4284ba9a4754fe335973242,212,160,52,Europe,18,1347.27
c416245a80cd4b3b8bd6ed6846d6da44,253,199,54,Oceania,18,1197.58
c4183b58fc514c10897660b22908c96d,264,244,20,Europe,25,2195.85
c41905a5334e4f2a9a8875fa461c1636,122,67,55,Europe,21,603.97
c41b7c0944fe41bfa59e234946a82a41,343,302,41,Asia,21,1755.19
c41c9946053c4399a598470a0497657a,185,132,53,Europe,16,776.43
c41d8c35e3f740b9bc69dcdd55b5b265,105,54,51,Oceania,19,458.89
c41dcee29d5a458d9b20b0f83d55c402,91,37,54,Oceania,20,494.51
c41e48a732e1456b83b186d08615052e,164,133,31,Asia,21,1238.25
c4215b6fbb9a49658923bad5beb6066e,90,66,24,Asia,20,632.96
c4277bc7a24e4c4d90896a1895628b15,199,183,16,South America,22,1637.52
c42a34e4628e454a91a40602ffbe2ed5,286,250,36,Africa,17,1625.28
c42aa851ecfc45beac301abc3d0fc7d3,111,77,34,Europe,18,814.96
c42cf58fc42c42e0aa81fab5d99c83ee,140,115,25,Europe,19,713.4
c42d3868cde243ad9da472585e7367c1,64,20,44,South America,20,360.31
c42e5b859d25401e81ef8419944beeb9,153,120,33,Oceania,26,1295.94
c43015dd030b4ebd92ec9fd928efa1dd,364,348,16,North America,27,1711.89
c430d5f04ff04ff9b864483233c0104e,252,224,28,Asia,19,2217.27
c430dc8ae54642faa576360a80ad0712,145,104,41,Asia,24,850.64
c433dd5b7c0946f0b0aab65d8eaa8288,253,200,53,South America,17,1270.94
c43454c589e44a8fb6b17f09cbbc7b08,355,325,30,North America,20,2783.8
c436b93c3f344c73bef7bd57edb17a85,365,340,25,Oceania,21,2081.12
c4371d6812314cfc866034b08f8c3fa9,36,6,30,North America,17,420.91
c43771c4d2c743878e1b86df5bf2d820,204,181,23,South America,23,1491.43
c437741a0751444bb8166e1b53ec44b9,315,280,35,South America,20,2873.22
c438d928f3ea4e7fac855c8f78148107,308,271,37,Oceania,19,2322.39
c43989f5ff5843649be84a548532f131,360,338,22,Europe,21,2782.43
c439b31dc92840258ce9f50e50108ad0,198,179,19,Asia,19,1243.55
c43c5c67dd7d424c86eb3548eef48c0e,155,105,50,North America,18,587.6
c43d33c9101d4b49bb6960585f2aec71,159,121,38,Asia,22,869.96
c43d3c330edd471e8939b82f3e47633b,263,225,38,Asia,18,1609.07
c43e4adad29c4ce1a542de57bc4bbafb,98,47,51,Oceania,23,848.15
c44076cf916b4487926e0dc1552647c2,97,51,46,Asia,20,892.44
c443505cc3f5499c97040c340830d7de,155,126,29,North America,19,629.66
c443549b824c4bbd9011ae8cf29706c0,364,339,25,North America,19,2480.55
c446116d329148de8c95c82598f02b8e,321,289,32,Africa,23,1829.26
c448fccb28bf4e2b813f2145ab2fdabe,78,32,46,Europe,21,666.72
c44a754aa8364894aea87f138613ec43,292,253,39,Africa,19,1349.19
c44aa9c2bbdb4d8caff8ccf7b5bf1a73,205,168,37,Oceania,21,1019.49
c44ab962d7504ccc849ae51a87607caa,91,48,43,North America,17,815.41
c44ba51454e24d95be10911b945e6370,94,46,48,Africa,20,808.41
c44ecfd40a3d4d4cb157352faea0f971,128,95,33,North America,24,898.51
c4509b0a8f7c4377808ce42e8832f57b,237,210,27,North America,25,1214.83
c45c268d885147d2b4e828a700bb8a96,158,117,41,South America,19,729.26
c45d867562c84b56b6670b709789f820,114,76,38,Asia,21,568.93
c45f3465d76246b7a92dc8126dfb36d9,309,267,42,Africa,13,2202.97
c45f5206a65f4b0d976ccda557c34c9a,261,217,44,South America,24,1068.74
c45faa85934b4f46bea617438707cde6,254,216,38,South America,18,1892.27
c45fe74d5acc4b9a989376a941d65ad9,261,233,28,Africa,18,1991.22
c45ffa698d5e460a9634dd2bf99e8c35,340,293,47,Oceania,23,1732.36
c4619042dbec4d2cb9817f51afd4c029,186,135,51,South America,26,1084.17
c461c81d4bd24d58af980e2029675038,40,22,18,Africa,15,66.43
c46334a0ff4342119423c3d9069e760e,137,88,49,Asia,19,987.93
c463c4917f1c4af3800457250314554e,339,301,38,South America,20,2526.48
c464b7d6894b485fa5029a9090ddc3e3,161,140,21,Africa,19,1271.26
c46629d663cf4ac191e175643f3f2a97,361,331,30,Africa,19,2867.24
c467baa1bb10476e9bbeb1146cfbb54b,157,137,20,South America,20,1429.48
c469b01100a24af3b1c0d5ef03b5c28d,75,25,50,South America,23,512.5
c469b36d511c4126997fb104d6361ee0,148,118,30,South America,20,898.15
c46c03fd11284c838bad65441ff3f431,365,321,44,Oceania,20,1765.21
c46c683a73734f239b44a7568de8bfb1,317,284,33,Asia,21,1947.89
c46c88e53b2f49e3b5c0d88ebcc2ffd6,34,11,23,Oceania,23,99.64
c46f3cdffd124913a331a2b61f24f0cf,95,55,40,North America,21,449.27
c471c16505904bd9aa23441e28dd0b60,344,320,24,North America,22,1983.28
c472283dabd7455cbb61de9f7a373111,364,361,3,Oceania,21,2822.23
c4730e8f7964498494dbb71ff386597e,259,211,48,Asia,22,940.27
c474beda1c7f4804b9cb50d91e7045d6,344,295,49,Africa,16,1362.15
c475a828389d4c83addef6a29f2953d7,262,217,45,Asia,17,1373.23
c47814c684ec44f7bbdb9f3b6f095672,88,68,20,Europe,18,545.53
c479c13038754a50bf1167fa60ba6ef6,270,220,50,Europe,24,1252.35
c47a6ad9a0fc4cecb579f271289fcfaa,130,86,44,Africa,19,493.88
c47b144bb92045aaacf07d9def321d60,130,92,38,Asia,25,681.23
c47b722372c14e82adf9fa8ba5ef1f5e,67,20,47,Europe,18,161.27
c47bfbdb5c624fdb8787863f86159dad,249,200,49,South America,19,1511.62
c47c2a59000a45cf9bf3a2a375e27594,204,152,52,North America,15,1314.34
c47cd78bbee04a50a99910d1bc090c8a,170,138,32,Oceania,20,1316.22
c482937587ce41f4a6e2c47d2da40170,93,62,31,Asia,17,503.84
c48500e606ff45a98c0073996bafa45c,80,53,27,Oceania,21,506.89
c4851413ccbb487aa2858cd47c0f57ae,82,36,46,Oceania,17,483.57
c4851e9e1ac84010914926bcd7ae2989,146,123,23,Europe,18,1339.1
c48716031e04460698b45f2935d086a8,253,224,29,Africa,18,1974.75
c48af7b7ba434fea808c411cc7216397,318,290,28,South America,21,2685.62
c48c24b97ce5475a8e5348aea83048e9,59,24,35,Asia,20,222.48
c48c85c90ecd4d6b9da888af03ac919a,333,316,17,South America,18,2793.34
c48c9fae97f34060b379726179e46127,300,260,40,Europe,17,2214.38
c48cbb9e02104ebfbfec2a5c3af93e73,297,254,43,Europe,18,1277.6
c48da4be42ee4474bb907aa64c0fe2de,364,331,33,Asia,25,3138.72
c48f148a11f54100a5e4fde05a9fe515,153,103,50,Europe,15,910.7
c491e33bd9e84e2fa0f8e3a171fc7da0,339,317,22,Europe,18,2363.04
c4929e17ccca48d38da030bd3a21d0b5,308,253,55,South America,25,1587.39
c492e43e6bed4c4095e5068ba1b7a9e8,97,45,52,North America,23,523.6
c49496fcb6364b9b84fdfe3ddaba6dc1,278,245,33,Europe,24,1140.01
c49585e438514d5c9f78a88de807cdfe,165,147,18,Africa,20,1174.59
c497da901bfe44668839670563cc3833,107,54,53,Europe,18,625.97
c499e1309ac941089b6861be81e2f43c,116,96,20,North America,21,950.95
c49be7831236464b8e30e3ee1ae37957,64,13,51,South America,22,266.1
c49ff6968c134bf8aa23109d1c56a9da,364,323,41,Europe,20,1248.48
c4a2082848d5492785eec042aad8d37d,122,95,27,North America,19,588.11
c4a535a79d2d40ed956e8f3ff7f716a5,339,322,17,Europe,19,2056.84
c4a5eda3964c4690ae7b071eec7daded,317,268,49,Europe,20,1379.09
c4a6d2b1b23546e7a7903488602717ad,265,226,39,Europe,16,1486.23
c4a8548c259c410cbc93780eba6f2529,143,115,28,North America,22,938.52
c4a8c8cf5a3a4b69a8274da435574482,363,331,32,Europe,19,2092.04
c4ac7e9ec397447ca636696f28f6b256,56,31,25,Europe,19,684.86
c4adcaeb04da46f5bffea2702ee4bac0,151,115,36,Asia,20,1107.83
c4ae124c67c045c882ad14105703a7cd,236,202,34,North America,19,1619.71
c4af6f92bfd64202b27665fd7bb938c3,258,243,15,Asia,19,1662.4
c4b226fdd0a84431ad2be7c9e3d27e62,296,261,35,North America,25,2316.68
c4b2ec2cc85543e0b5ca8f0b284393f4,350,301,49,Asia,14,1849.6
c4b44cdbd6b5440e863f48f077ec3b8d,194,150,44,North America,21,1665.47
c4b51d5ffbe74da0bdd2ecfa1f0a5ad5,95,48,47,Europe,21,604.41
c4b5b3135b2f425e8ca00a708f66ebf6,362,317,45,North America,21,1745.65
c4b81e5adfa54d3480b809c2a8b1f16a,365,343,22,South America,18,2594.72
c4b9ab23984440f586b73f1980aa916c,300,280,20,Oceania,23,2476.81
c4ba848e23aa4d438b5c0a9e35485df2,231,194,37,Oceania,20,1485
c4baa288917d49c79de65c0093e3c597,297,250,47,Oceania,23,1251.15
c4bb8f9822574400a292119b808d92de,346,293,53,Oceania,18,1855.23
c4bc3a22550c4cd686e33931d366187c,220,191,29,Asia,18,1550.52
c4bcf0afc84a4effbf3d5a53c478533c,125,99,26,North America,14,968.54
c4bfcad39e244267887db946de28131f,121,77,44,Europe,17,881.92
c4c13e174fb14c74babf3751396af864,365,341,24,Europe,21,2519.07
c4c1dce71a904b83b53586aef4149177,89,46,43,Africa,17,586.12
c4c20f0dd77d46c2a2ba4d707f355b64,162,126,36,Africa,20,657.73
c4c2fc5aaaf143a0a2942b49ca393e71,152,131,21,North America,23,757.99
c4c3a08d5095449eb86486b9a64ea209,170,134,36,Oceania,18,873.9
c4c6d842b06e438d8451529e4acc77ab,365,361,4,North America,22,2322.39
c4cc1158eb0e480e9d25187258698e16,229,195,34,North America,16,1254.39
c4cc8c92a08647dbb4f485fbc4ea6222,134,79,55,Africa,20,585.83
c4ce2d49e03642d5893055f78798020a,263,224,39,North America,14,1685.6
c4ce55169622489d8aeab4627f16729e,236,195,41,Oceania,18,1654.64
c4cea784d72741c88a277d274421021d,64,30,34,Oceania,24,457.5
c4cfc2048d744caeaf8e8ba6385219ef,364,343,21,North America,20,2790.91
c4d026d5eb7e45e4a5701b5975ed1e77,67,11,56,South America,17,304.71
c4d1866ac2ef43f9893b71a7ac5bfa2a,55,30,25,South America,13,300.22
c4d1bdc1652c4ac8854125abaa2d3a9f,127,76,51,Europe,25,476.94
c4d2da1944e446e59617e8cf14aaa907,68,20,48,Oceania,17,489.61
c4d3079be4ef4e6b89b4b3eae10639c1,92,52,40,Oceania,20,675.26
c4d3a6286d9f453aae5b334d0a9679b8,338,305,33,North America,17,2728.44
c4d429d22cfe4302ba5bdacff418285c,365,342,23,Africa,23,2745.47
c4d4f1619bdc46878722f8cf07635a23,218,179,39,Oceania,20,1331.67
c4d683d7fd73459db0a83275d9d64079,207,160,47,North America,23,879.68
c4d9fcf06b9c4e3ca1cd06c6c0773807,194,152,42,North America,15,1351.04
c4dfbfce6621419ba9288e1bb4515235,262,220,42,Asia,14,1497.69
c4e1b6b67b4347a992a05e4998be8f70,333,292,41,Europe,16,2508.25
c4e32f377bc04286b128205aaf5e3653,65,13,52,Asia,19,281.85
c4e4f24a09ea4d17afd64ad71ff21bfb,221,180,41,South America,19,1170.17
c4e65004e3b94060a5674c488fbccd00,205,169,36,Africa,21,1529.4
c4e6526da3a1490990995471cfa86e87,194,153,41,South America,21,1266.21
c4e6764b2d6c4626bbbd88a48cce6e86,205,164,41,Asia,23,1217.55
c4e6aea8803042bb9beb93af66f392df,218,172,46,Africa,24,1337.98
c4e7e7dec02447dd9e5f8f08e444f632,111,89,22,Africa,18,907.19
c4e981a83b2c4c85adfdb2c28eeb3266,314,285,29,South America,23,1530.72
c4e9c6be222440ccb59a42394455d92d,258,233,25,Africa,21,2143.73
c4eb201cb579495b815fdafad6403b88,327,290,37,South America,13,1908.1
c4ed0a2c716a4e6b8e3fb0d59a9913ca,364,330,34,North America,20,2038.64
c4ef2e8209e44e83b76c61bf76edbb36,264,212,52,North America,18,1563.42
c4f124a9583e4e6e8c0f59c1f5b1520c,279,252,27,Africa,23,1834.27
c4f14ea3a313433f934b258d04e1ab88,123,83,40,North America,19,487.16
c4f437ccbf044460a767fb11bfd3857d,166,133,33,North America,22,1011.36
c4f5057d726b43488c2904a702aa85bf,94,45,49,Africa,23,546.27
c4f5e0fc79fb46aa8ee632324bf687ff,207,181,26,South America,17,1488.52
c4f6cdcf1b3646c584480c8cdc7a2c84,358,336,22,Europe,17,2785.84
c4f716f3992549a8b25634863a0bc7f2,365,350,15,North America,19,1852.65
c4f8f984a2cc4e67990dbd9bf0484edf,365,352,13,Oceania,20,2928.32
c4fb3cc02b6f4ee39b95a22435514d4c,88,33,55,South America,16,162.42
c4fc13815ef8484495048bca41f7aab6,62,37,25,Africa,27,551.1
c4fc83542c784ef2a82ca04dfb13bd0a,365,322,43,Oceania,21,1953.97
c4fc92f701214cf9bf6abb7c31e8076a,283,229,54,Europe,26,903.29
c4fdbb5956f245ddbd74a3395b8cc15b,95,45,50,Europe,25,445.91
c4fe3327e93e4c7183989703d7f3325d,216,180,36,North America,23,1124.54
c4ff1256fb94439cbfe47e3dd38760fa,264,241,23,Europe,19,2390.66
c500ad8ff14d47249acf5bd4c2faf437,185,152,33,North America,20,1116.2
c501951c3f274e3fa1aa40c8d198a00f,261,223,38,North America,16,1087.07
c5028ee830c24e1ea95d397257ad84fb,365,353,12,North America,23,3050.28
c504fcb682bd46bfb11c0cf26bc6cde9,187,148,39,Asia,22,1967.28
c50509824502420b8087c9a74d5dadbd,199,155,44,Asia,16,737.54
c50a39769cf44baeb4db627a295e95c6,69,42,27,North America,20,532.99
c50c7e0f1f6a4dc3a494778a777a17ef,365,358,7,Oceania,21,2481.85
c50c828ce6014bad81ca312bd5996835,189,171,18,North America,19,1403.44
c50caf999e3a40a0a626cfa30c616c17,109,67,42,Oceania,16,918.07
c50dc2673ee242319f1c0f27588711e3,203,171,32,North America,21,1893.57
c50f82b67d4741bb972bb0eceaf9991d,189,150,39,Europe,19,1247.44
c50fa3c1c6c448679d1b2acb7b4415af,296,261,35,Asia,23,2235.02
c514eaff6b9441fc90fe176dfd69f4ab,51,18,33,South America,19,315.46
c5153cfb70f54e92866563390947db7c,60,45,15,Europe,20,342.54
c5169ff7fcc94684a2ea095f0edda93d,365,335,30,Oceania,24,2546.37
c519645b0f964ce09c2338091962bf41,329,306,23,South America,19,2944.16
c51a3189f9864fb3b8e4e043a6dc0164,365,346,19,North America,16,1622.05
c51a3d1441494220840094b17f489de2,183,144,39,Asia,21,1408.75
c51ab3d04bb64ab6a73aa599f10c491e,242,210,32,Oceania,20,1808.52
c51ab7b2206443828bd967eef4cdf56b,356,306,50,Europe,20,1848.98
c51d890bb0984e9fb0a9d3971e68db58,365,312,53,South America,18,1203.87
c51de4f9fcd942c9b1b51e3c7ed508e8,189,165,24,North America,21,1392.1
c52320e569c24487af11c0b09db2f230,80,50,30,South America,24,586.51
c5234f6f0aec4f76a6e0b6cd8de5c2ba,118,97,21,South America,16,894.08
c524a31359714a7b949e89842658c598,345,314,31,South America,16,2214.28
c527e9f152c244de9703c770428a0960,325,295,30,Europe,18,2416.73
c5281a0ed4be4803a254bd64364d8999,334,295,39,Europe,22,2017.36
c5284e316b514a4d9d17086fb5622c3f,106,43,63,Oceania,23,545.34
c5290348a7ce42efae0730a062a60e18,150,97,53,Europe,24,908.49
c52a3c460df949a594be022095df1353,214,185,29,Africa,24,1469.52
c52a6003b09448d58330d421f7e568ed,109,58,51,Europe,21,315.59
c52ac7cc98a241af87f78af9cef06319,199,153,46,Oceania,22,650.36
c52c7ad8a1af4f6bab1004f75d0a7545,269,224,45,North America,14,1887.65
c52eef53b7a740d283351083c8e13f9e,222,198,24,Europe,15,1293.54
c530b252d3db47cf93dce56bd5fc3324,33,14,19,Oceania,21,518.83
c535b3d923e1494d84f20d4058e1fca1,133,100,33,Europe,18,748.16
c535bef7684b481eb715641e51d44a16,230,189,41,Asia,19,1779.48
c53777e8d445495aa6c163886cd3883b,364,337,27,North America,20,1833.67
c53ac1e828da4197b05c24708f7a62ef,220,182,38,Asia,22,1915.64
c53c13f49bc74be3bc486e5e306e7fdc,195,161,34,Europe,14,1625.29
c53d476e51ad462ca6cdd996d5f3e0ec,225,173,52,Africa,22,1318.88
c53e61786324429fbad67d499a8e5d04,275,245,30,Europe,23,2520.97
c53fde485f98422bbf0d4ea8de594f2d,271,241,30,Africa,20,2058.29
c5418736cae24d76830b53db97f13720,365,339,26,North America,19,3348.17
c541d1d1c14049f89ee242f15682020b,274,257,17,South America,20,1794.82
c542c1a04d3745d587250c959ea487dd,132,102,30,Asia,18,806.03
c5434a88766f42f089510b839a673415,246,193,53,Africa,20,1291.93
c543d64e7d8844b4af25d6543c1c6ce5,217,173,44,Europe,19,1043.6
c544263b80364fd78e69b5d82c70f440,364,359,5,Europe,19,2205.18
c544af73419e4aff88fe273f84561f2b,37,7,30,Oceania,22,496.29
c546d7bcc18346aaa93c51ca318647e2,55,30,25,North America,19,467.32
c5474ed2e64b4f2188d6d5d19017dba9,204,160,44,North America,26,924.5
c54805a8044740e4883c13a2811e0bba,179,148,31,Oceania,19,1319.05
c548278a55e540f6a3f7422ab1818f2f,365,364,1,Europe,17,2958.31
c5491aaeecf344bebf41e2f759319eba,338,300,38,North America,21,2078.76
c549b5d771a640abb161f8c67e3606e0,49,26,23,Europe,20,282.29
c54b2a152c9c498281e9b9da705ab7d6,135,100,35,Oceania,19,857.82
c54ba14fa23c435fba26208f2c9bdc86,149,116,33,Europe,19,938.92
c54ba3a7383043869297f449b09cf96e,120,70,50,North America,20,465.89
c54c0a9b04454524abb8b87504804265,317,270,47,North America,27,1508.03
c54df0b31ea54554b8406a4b2d5243b9,142,91,51,Africa,17,1190.86
c54ef9eab374472aacd0a66c86e68453,286,250,36,Europe,19,2708.3
c54f79abd5494d32bbc83b8e8eeee52c,365,331,34,South America,13,2639.53
c55228a2b8964bfabd5a3195b46e675b,168,125,43,South America,19,729.02
c554f320e54b4acfa5cf704a857a4a7e,361,328,33,North America,22,3101.27
c555ab89a8f94542b00ad061e9458b89,362,323,39,Oceania,21,2191.94
c5583438f11f4df2a8bcfd6721e97de0,99,52,47,North America,21,189.38
c55a3cb6fe394cbbb20c6ec401e8e619,262,224,38,Asia,19,1826.12
c55b16d194ce4ee4ad107552051db93d,365,363,2,South America,24,2526.39
c55c56a7984a4bc0be1f5dfa4801d821,73,32,41,North America,25,548.18
c55e59cb0f2e4e3cb616e4d5ba39ad84,61,11,50,Africa,15,199.15
c55f1e7a78334d6d9069862058f14137,170,134,36,Oceania,22,1077.76
c5616c4c98ad4526ac95053b61192448,109,74,35,North America,21,866
c5621472c6514498b101a86f4d29ead3,245,193,52,North America,18,1026.5
c564bf1408b34117b0343f0df9a4cdd5,148,126,22,Oceania,20,1267.37
c564e58e57b14b159f839af3c0fb8ac5,325,288,37,Asia,20,2112.43
c5662719061e4213a97edee242948b5c,282,242,40,Asia,23,2046.71
c566e956ab134d5cb4349136bf125f2f,217,179,38,South America,22,2471.74
c5694f82d75e4abb9e514e90e45b7f4d,348,311,37,North America,19,2759.19
c5698fe4f7114fc898001289220b4a7d,149,127,22,Europe,21,982.32
c56a21c16b0b4921b30327b659d54d7b,62,31,31,Europe,22,729.37
c56aa40851c54bce9676e70b75b749ba,84,24,60,Oceania,22,331.85
c56aef700d7b41feb6173e418603d66e,94,81,13,Europe,19,559.45
c56bf583ec154501ab8cce86bde3ea39,291,261,30,North America,23,1666.77
c56f814a39d542faa2f6ec42836bc121,307,262,45,South America,18,1805.96
c5703af867124d0ba0d90113d856915a,113,58,55,South America,17,320
c570611420ff4e06a08fc688e6bf3e53,132,110,22,Asia,19,737.45
c572779ad3454976b2b6ae6a79cdfad6,365,358,7,Europe,15,2145.73
c573ea64e34f4ccd964ab66c38d78288,182,158,24,North America,20,1554.61
c5749911970e4eea9e958b29c1508c66,300,264,36,South America,20,2124.19
c5750e3e0ba9469cbd33bd8b501941b9,316,289,27,Asia,20,2008.68
c5777c77dada4966b30d5dd2c41130b7,357,308,49,North America,17,2851.97
c57aa45339e84487976a354addc13955,328,297,31,Europe,26,2652.68
c57bc8d2370147b38ddcc4306e21db1f,137,88,49,South America,19,787.23
c57be8a223904dca9192855e27129942,365,351,14,Oceania,20,2814.17
c57cc818392148d8a95205d63c28dde1,339,322,17,North America,19,2457.03
c57e168e3a2d434eb7610cd62378449a,153,116,37,Africa,21,904.54
c57e44d7f1634072bbdf352f1737a220,265,227,38,Asia,22,2504.8
c57ed853dd6f43d09bc5c61d94df1faf,149,119,30,South America,17,685.54
c5800b1d4b064e9ca89b495ffe89cf50,179,148,31,Africa,22,1208.15
c5805c672d914f1f89d875a8e2ae2561,116,75,41,Europe,21,373.81
c5844fb9f6e242c2a4c36501f25092fc,167,145,22,Oceania,23,746.43
c58a205c69ae4539985e4a2f2d497cbb,290,245,45,Africa,25,1114.98
c58a6f34fed44cfea25ccc4661cbb84a,336,294,42,Asia,23,1658.85
c58b8ce099c14be7b597cbad11e6a69f,97,42,55,North America,21,221.14
c58e8229c75043e7b9a68746cf2af4be,235,214,21,Africa,24,1617.67
c58ea999c7a9454ba4804c96a9c463dc,365,336,29,South America,22,1833.18
c58fee8ad620498e94a99813d9576a8b,179,160,19,Oceania,18,1601.01
c592459d074442d7b250da2e097f9fdc,316,260,56,Asia,15,1792.27
c5924ae590844963bd9c8b37a79b998a,44,5,39,Oceania,19,601.3
c593bd095cbd401aafd694b39022e453,364,358,6,North America,24,2001.58
c5957baacdab41b8b48ee05b1b9d1588,277,239,38,Europe,20,1485.66
c597daa6d8c646b6853768654708158c,343,309,34,Europe,20,2452.01
c59b489444de4989adf3d39ee103e155,38,13,25,Oceania,18,328.2
c59b6c4fe6e6441e83e5f6c4dcb1eef2,56,9,47,North America,23,174.33
c59e7bc7a3644504bb3a4b998a7ad075,128,84,44,Asia,19,802.38
c59f17697a99439792c3c359a9ae7a8f,173,156,17,South America,20,1467.74
c59f3d99836e4397a5a3a2d47a1b7cfb,365,359,6,South America,21,2734.67
c5a0ec0ade064f2788de6cb1ba8459c6,292,257,35,South America,23,2140.48
c5a39f77120c42e780bd30f98fb29d15,206,156,50,South America,19,1385.19
c5a5bea7d3a54a51abe13e561145e3e2,179,132,47,Asia,22,846.71
c5a64c1383864c3aabf094f8e16b7c0a,264,238,26,Africa,20,1616.82
c5a6510d20bf4cbb9b924d4287ace1fe,44,8,36,Africa,20,181.29
c5a78b2e0ced4727914d2947c5cfe499,179,161,18,Africa,13,2068.16
c5a83c48c9464855ab007eaf60e674e8,155,141,14,Oceania,17,1606.31
c5a864cb49b94c8196046887be6248da,321,277,44,North America,23,1339.49
c5aa27eda81f40a49cf3670036ba9c60,176,122,54,Oceania,18,575.54
c5ab238bd4d348e0953059385c1242ce,121,76,45,Asia,17,826.71
c5ab341c59e24202ba08322d427616ba,73,55,18,Africa,20,787.72
c5ab902f86894dbc9154b863e3b7f965,298,253,45,South America,18,2180.05
c5ac3f918671492fa6dcccddb11d6d00,76,45,31,Oceania,23,912.61
c5aca2df66d2490bb3300a8a025a7621,283,237,46,Oceania,26,1926.98
c5adada2c5e64eca9d1ac4366516d0c5,130,75,55,South America,17,885.72
c5adf87d3e5a4103bdd708126053d009,109,57,52,Africa,21,375.38
c5ae87ff750f42ad96f4bce818a8936f,341,298,43,Oceania,26,1994.16
c5ae901ab6af4ebfa2fc66610e081238,96,65,31,Oceania,19,992.26
c5af03152c58406ea6d2be0deef1c994,158,120,38,South America,19,1291.44
c5af5190f90e4482b0265900dd59f070,282,233,49,Asia,19,1058.13
c5af6ca5e2d6485a881394861b02f2ce,244,201,43,Africa,25,1898.9
c5b021b5595a4712ab5a964d010bd5e2,29,6,23,North America,24,116.41
c5b20a5e85bf4ea5bf52e0add0d7e43a,341,301,40,Africa,21,2346.85
c5b262752e144ee9ae9f053017e7a36f,228,208,20,Oceania,23,1741.87
c5b3c37f57764d28bec50532b76fd0cc,101,80,21,Oceania,25,783.9
c5bc9f1ce41d4f95af3dd6592514376c,77,41,36,South America,20,717.97
c5bcb56600b940deb0f6e578e1b79615,162,123,39,Oceania,22,543.52
c5bd8fe54ab24b90b1454651d0b739c5,84,43,41,Asia,18,493.5
c5be4998de2e4ae1b4cfc65c1790aee6,152,117,35,Europe,17,1076.53
c5bea82186c64418873a322f5a57b557,316,267,49,Oceania,16,1247.21
c5bf5d12d126482a970aa795753db2fe,155,128,27,North America,25,1098.43
c5bfcd2ad58a4431aa13476915ae41fc,361,326,35,Oceania,23,2352.4
c5c020e7b0ca41e6a3ab0ca59955d202,264,244,20,Africa,21,1933.65
c5c22963f7e3478f9f4f8d376b17230e,166,128,38,Africa,28,1302.48
c5c3f12abb97469d85dff1a669144082,340,312,28,Europe,24,2859.2
c5c6582388834184bb481e764246cefb,88,39,49,North America,16,292.15
c5c8c833fd1246f8a8d705256db9f95e,365,336,29,Oceania,21,2851.58
c5ca9d83d91848c797f21f95493d1640,228,178,50,Oceania,18,1291.32
c5caa48077db48c080ceb50652039b1a,364,312,52,South America,15,2126.62
c5cbcd71755241c89b0d5f0f2fc73780,285,244,41,Oceania,20,1897.4
c5cbe8df17df4f9f95e129765436cf69,360,337,23,South America,16,2891.88
c5ce3c4d9f734f46a63f77b464520da9,273,243,30,South America,19,1965.79
c5ce767a7a1445fc895866f699aef7eb,193,177,16,Oceania,20,1788.75
c5cf26ea0b1a436fab84ba37f612abd4,49,24,25,Europe,19,198.97
c5cff4e8f5354c32a1306e879cb607c5,246,206,40,Oceania,21,1038.55
c5d960bc3f4b45a09d42d53d8f613fb1,118,94,24,Oceania,19,643.14
c5dc4bcfe9974d89a519fc34bee7bd6d,365,365,0,Asia,23,2437.55
c5de267bf8f54acd800af4832ddc7475,364,344,20,Asia,22,2369
c5e07c54f40f411fb63b99bb0b6a1e19,56,38,18,Asia,21,728.46
c5e0ff6b051b4e55ad67951eeb8b15c3,132,110,22,Europe,24,1386.21
c5e4cc30aba44c1fa24e8c4526dc73f3,192,162,30,South America,17,1424.31
c5e52bd171b646c9a15d4d16e410efa9,364,347,17,South America,21,3045.83
c5e98cd2aee04bad93bd7896e9448d74,179,143,36,Europe,17,1404.87
c5e9edafa4f74e2594a0bf609a3e5ceb,352,327,25,North America,18,2797.82
c5eac2bab33c4dcb9f5cb35ac759feaf,76,23,53,Asia,20,252.61
c5ebd0435e104a71aeb7c76bc1fcfb1d,135,119,16,North America,23,1157.05
c5ec384baa3f4e0da988ad1551b64ddf,347,298,49,Africa,13,2006.61
c5ecbf9fe38d4650b0d92c24d30d56fd,123,84,39,Africa,13,376.03
c5ee4fd732254602a2c0c02ce490bfc8,272,219,53,South America,20,1147.95
c5ef09db57ff47cc8a580e92662ccee1,228,210,18,South America,18,1470.31
c5f071fe9a8a47d1adccd18666447e91,365,322,43,Oceania,21,1686.29
c5f1ef34d24344b192be7de20911e77a,132,115,17,Oceania,26,985.17
c5f2475a715d4d5c9de90cc113cd445c,29,5,24,North America,21,222.51
c5f380c26f5b4d8e9fc3e6b69e0ca142,266,239,27,South America,21,1520.98
c5f507af18d747ba80a7fac61e45b1a3,101,60,41,Asia,22,791.83
c5f6bcd144754377b59407570151fc68,320,261,59,South America,21,1613.23
c5f872cf8a52466a9ed0304002f351f6,93,71,22,South America,22,641.43
c5f9e7a8915b4ded94905d7bf8418938,62,21,41,Africa,22,538.33
c5fb2d8d9be54fccb96854de9f8c4931,362,347,15,Asia,23,3003.88
c5fc28db6f894520a35b64ca99b900f6,256,222,34,North America,20,2071.02
c5fe1b1c5b684ab8b839608bbbffacb3,239,204,35,Oceania,20,2336.83
c6034993771245b4a38cd38a3520164e,81,53,28,North America,21,512.56
c6042d828601494ebddf9e54071e3706,108,75,33,Oceania,23,1089.02
c608f46d3f884d5794d70cf7aa343e18,136,88,48,South America,18,504.45
c60a25b328b84caf858817081dc6be01,281,256,25,Africa,17,2952.25
c60aa44d9ae84e939fc5267413dc0bb8,355,316,39,South America,24,2042.01
c60afafec3a14e09b66e2cb5535ba9e1,270,228,42,Oceania,21,1659.81
c60cf6a8e5484ce1aeed79219881a534,154,113,41,Africa,19,879.66
c60d0b4a307e433d8e466f96b395032c,269,240,29,South America,19,1503.35
c610c6ae50e542fea3d4fb5004c5f874,173,156,17,Asia,20,1100.6
c611dc9e89784764b9be9c5fbf94dc99,125,94,31,South America,24,974.46
c611e23a0ccf43c4bb84676f38e9ad64,218,188,30,Africa,19,1208.92
c6138cf4d1fc48f7ba01d538e67e6530,364,350,14,South America,18,3784.66
c6157c82d71749099f48ebae4f5f09fe,303,267,36,Oceania,17,1947.31
c617c05f16c14b2485c08ec7bd1eb8c3,365,327,38,Asia,20,2097.58
c61aa8c91229471d80e1368f52a7e9e0,359,325,34,South America,19,2383.74
c61ae687c27947a4a41bd79abf2db869,365,349,16,Oceania,21,1518.1
c61b0dba16d14effac7120f24179ff99,361,348,13,North America,16,2020.23
c61c25d33cef4bd7a39a03b7042c3e60,212,173,39,Asia,22,1199.63
c61eb75dffe749f7a692d7784f9b34b8,233,211,22,South America,22,2300.77
c61f0b95bd674b53939e33d33410f937,363,330,33,South America,21,2171.6
c62055ce58764485bcab7dfb3eb64398,69,12,57,Oceania,17,380
c6225fc0bdd64571b1bd35f7d738f073,147,100,47,Europe,19,1547.4
c623ed5cdd19454482d291d4e794c81f,150,126,24,North America,14,607.73
c6247ea2a8634a60a83c3fe00a9607db,188,136,52,Africa,19,1057.81
c624a881140a43f2a7eb49bc0ae81988,295,267,28,Europe,28,1928.26
c625bcdb549643f98afd6d44c374c80e,153,116,37,Oceania,19,1265.55
c625ec24755a4af29263396c3779cd6b,348,296,52,Oceania,20,1762.13
c6265ca1f98b4fcf8f6c848f1a246cb8,250,230,20,Oceania,21,2776.47
c62af0778eb94531935271b81fde5cd4,359,334,25,Oceania,18,2503.3
c62cb802b2d44bd1b4024a26aee5be4f,239,185,54,Europe,23,1107.87
c62e351f081c458198addefb8350a5ee,269,213,56,South America,16,1062.3
c62f36cf832645a788ecea6909c401b8,306,268,38,Africa,20,1895.09
c62f839937c34419a3175fd4bf870861,363,345,18,South America,16,2743.69
c62f91b3020e42b78cd38fb97d0e49b6,166,145,21,Africa,21,907.82
c631f0faa5224d5b80e9c59231d2235a,365,321,44,Africa,19,2088.06
c633f053886c42bcbd403c24c3b70ec1,176,130,46,Oceania,21,1150.9
c6341f878bab4508b1a773bb4ef02bed,230,196,34,Asia,22,693.11
c6357e9a7f664478af26df4e6ac3752c,345,322,23,South America,19,1973.04
c6365df428d64973bcd1239ed938419d,124,86,38,South America,18,1179.53
c636d47b85da47329824105006138c34,300,252,48,Asia,15,1220.17
c638769c095b4d98b05a245dcef626ef,190,160,30,North America,18,1647.27
c63c193dede04f3ab921cb98747ea6e3,339,304,35,Oceania,22,1656.18
c63c4420de8248afbb9852d70552f2d2,301,249,52,Oceania,15,1274.43
c63cf52c10354bb0882be91f93c9edde,365,356,9,South America,23,1656.44
c63d50300b6341d8abe379354f077004,159,119,40,Asia,23,963.33
c63d5968f0de487ba598ca2945cf2a9b,99,50,49,South America,17,486.46
c63ee1d27f8a415da59301513730319c,279,250,29,Europe,22,2444.07
c63f79f943ab4e9385245cc4cd5dbcbc,232,183,49,South America,17,1016.22
c641155b71da46ca910f6630c35d877c,131,91,40,North America,28,1167.5
c642aaa93dd74f1abbf88ef33a9692ad,364,328,36,Europe,19,1989.24
c64428cbed174a4bbc27e55d5281e0cb,70,28,42,Europe,23,307.68
c64460b0a23148369931d1165096d030,192,159,33,Africa,18,1237.17
c64797862d714dcd8dca28fd6e5f9a93,268,236,32,South America,22,2185.94
c647c6f9796244ab88c862eed4e924bc,365,356,9,Asia,19,1887.14
c648867bb95e4947a594256ae42b2370,351,318,33,Oceania,26,1921.31
c6499c6fca33451696f1a60d728f29f7,344,288,56,Oceania,21,1325.9
c64a2046b1e04d37a9be5b9ad970e80e,109,86,23,Asia,17,685.31
c64a32fed15b46149b48304a1cf9dc98,90,41,49,South America,17,531.09
c64bbbc0e837467aa703194241fa1c2a,70,18,52,North America,19,255.75
c64bbcb287e547cbbe7e4d5ec60c22d7,364,327,37,Africa,18,1720.35
c64e99713e1f4b8eb8aace44ad276e78,307,288,19,Africa,15,2118.77
c65235b09ade4b7a8710e96c3a492f11,80,21,59,Europe,26,338.9
c6533612e05b401d9b189669e9ba35b6,181,168,13,South America,16,1497.95
c654afeed1534a978ba3a133d7bbbc5e,156,123,33,Asia,22,772.29
c6597a42beb04bc1956374fa17e55ad9,315,273,42,Oceania,18,2167.72
c65b84e45983446bab5778445630b02f,251,225,26,Oceania,19,2140.18
c65c92d521324e9aadc2b47b8df4c18d,364,353,11,South America,22,1201.41
c65cb79e9e9a49598b7c9a5dfb0570c7,326,273,53,Asia,18,1154.4
c65d1acdfea948e295035eda834bb506,74,38,36,North America,18,336.07
c65d98cd52ce4542b3cdab5e1a0ed9e8,314,262,52,Oceania,22,1608.13
c65ec15e3d18468886b01cda634de4cd,118,68,50,Oceania,20,466.93
c65eff012a0847838bdeecb09f478088,239,219,20,South America,19,1710.16
c6606233840b4045958cb9509a2f29ec,311,273,38,North America,20,1670.6
c661c458ebb644ca916aba2507dab99a,365,365,0,South America,22,2100.27
c663986a96714d39b91eab17e00e7134,318,268,50,Europe,19,1954.11
c6639b9aae144959aff8f7fa39a9595d,42,15,27,North America,20,444.23
c6651949a38847e7a72e3054b93e7ae8,106,58,48,North America,23,453.35
c6666183191647f78b0e4bbb1201e2c1,215,187,28,Europe,21,1750.46
c668230ba8354f65af1448406646ac2f,262,224,38,Asia,25,1452.73
c66a5108af0b42d98c00cda227d41da5,66,39,27,Oceania,22,852.05
c66bce8aaa4246a388eccb3255488284,364,360,4,South America,19,1683.01
c66c5ec9dfd74ce5a49cc92d18c6c90f,301,260,41,Europe,20,1706.07
c66ec26bf6324509b2204f250111bcb2,183,158,25,South America,25,1803.11
c6706fe836904d58a33043a2aa7c952c,364,360,4,North America,18,2332.35
c670b541896341e0bb604bf922626b6f,329,281,48,Asia,18,2200.34
c671214412544b0aa3d0c5f67b540de0,109,86,23,Oceania,18,675.76
c6774a58c63240b5b891a48abc863b1b,181,140,41,Asia,23,1013.15
c677bf1ee14244d4aa70e0689a1b6d4d,319,296,23,Africa,21,2493.58
c67b936a636f4364863795cd17eb3d5b,92,62,30,Asia,17,603.99
c67c8ff4af5e49f28951d2ad2653816c,265,219,46,Oceania,24,1749.27
c6800e02ed8f401ea2bf7e5c9219bb13,147,108,39,Oceania,19,781.31
c683cb1c60724c849a7839b43bdd83d1,295,245,50,Oceania,19,1167.81
c68584a23746416fa42b8f90857eb4a7,134,91,43,South America,17,552.7
c686a179bd7c4014aa218823526dd377,329,305,24,North America,20,2496.07
c686cc59b46e45289e2c5e9f14cd5091,290,236,54,North America,19,1219.06
c6880ccb6017440eae203534c6483653,153,126,27,South America,24,1431.88
c689326410a14d9f8986acdc3015c181,363,339,24,North America,23,2337.38
c68b2be7df3041069a9aae0594303720,328,299,29,Europe,22,2465.2
c68d5f0760cd430fb99bda615f424754,37,14,23,South America,20,349.42
c69243f0e3654fe2a9a311132517584e,338,308,30,Asia,20,2492.95
c692cae7e0a94018ae774a9df5261e13,364,340,24,South America,27,3275.14
c6941284fb894f3da99d033c9eee7380,222,185,37,Oceania,19,1664.61
c6964e7a4b1b4709900273024d5c9b84,121,104,17,North America,20,738.37
c698c45fbda64d6a84b35415e21b6cdf,347,301,46,South America,18,1228.09
c699cfa9c71a475d8ae46633c02f8b0d,309,267,42,North America,20,1948.28
c69a9888a1134b1f9f177dff15060122,364,363,1,North America,20,2546.77
c69b85f506c34647aafc1affa51f92f0,49,24,25,Asia,17,505.4
c69d389b5068459cacbaf56a3ba0bf3a,261,235,26,Europe,21,1978.96
c69eaf57dedb48ee8aaa230478600373,346,297,49,Asia,22,1955.17
c69f0f04f5e14043bd859622e462d025,60,15,45,Europe,21,249.37
c69f1846169d420fb2a1c2b144145aea,101,50,51,South America,17,682.78
c6a1323b843d4663ab02da6c414b6fb2,365,320,45,South America,20,2135.39
c6a1f5d4594f4bc581a6d8166cf53b23,281,246,35,Africa,22,2101.44
c6a298880c214d58b6c07c5da0f75a76,291,254,37,South America,20,1728.13
c6a35defaf7a49c998538ea201b550f0,72,33,39,Oceania,19,420.67
c6a723a529ef4307860288555a5bef8c,321,273,48,Europe,16,1493.47
c6a786fd16e44233be38fff04e119514,141,89,52,Africa,18,758.06
c6a78f69cfdf451fbe199b5ce439cce5,267,216,51,Asia,18,1737.05
c6a7d01bc54543bca92fe35f3d2b6c04,48,4,44,Oceania,16,344.5
c6a8cfca110a42299216d7dfc2b91684,127,79,48,Europe,22,417.5
c6a90166ffca4021a25e445cef64c745,124,88,36,Europe,22,828.5
c6a93c4b44c7424cb94bd8bb9353acf0,322,295,27,North America,25,2188.19
c6ae0cd432a74ec38e764e3ece637589,89,65,24,North America,17,562.45
c6ae379bba8e411097e253915b90b254,68,45,23,North America,19,707.79
c6b11e401b9d494795cc1677a9f101eb,247,207,40,Africa,22,1589.65
c6b13082336344f9b991ebd81a407bb7,78,55,23,Asia,19,382.23
c6b1f32926f74de1933c77d09f257c74,70,54,16,Oceania,17,479.48
c6b2481a26374a9d8ce44fe61f5e7b2e,91,55,36,South America,26,659.45
c6b2e2db58fa4f4894b2b59249312c4f,124,71,53,Africa,20,576.79
c6b87b6b462f4bf089d4af859e1e21e7,111,80,31,Oceania,16,1045.85
c6bb2f1d4f5e4407918da0e9c315071f,364,337,27,Asia,15,2321.69
c6bc1a858123492f8a4f69157452b512,364,340,24,Africa,23,1635.64
c6bc45c85e30446ea8113541617cbcbc,365,351,14,North America,21,2858.35
c6bf5c24afc3413aa4ae0440e5e840ba,161,129,32,South America,24,1554.02
c6c519ec1d744d95a3a5c0c68b54ed49,290,261,29,Europe,17,2048.82
c6c57cae94eb4780bdfeddd4ce4f05f8,303,273,30,Europe,17,1726.26
c6c6592a546a45ce9d104ec308f76928,142,105,37,Africa,24,905.28
c6c83a18af3f474e9ed2b9b4d327f25b,47,6,41,Africa,24,223.14
c6c885d38e81471bb23d2040c6bf87f2,345,307,38,Oceania,17,2729.77
c6c935015fec427f8d38fbe46d197545,60,38,22,Asia,18,538.87
c6c99cc62623422dab7da060eb137995,260,229,31,Africa,17,1644.79
c6ca5375ecf347678a9f246f8c7f4926,350,317,33,Europe,17,2510.09
c6ca935fd0174258adc1aa0a8236a038,108,71,37,South America,23,539.98
c6cb44d6933d4c5097b359993409c821,208,167,41,South America,23,890.36
c6cc9783549d4d198d5b647971aa9d78,322,279,43,Africa,21,2236.26
c6d00ed2599540109d8b4a0c9f65d70d,193,156,37,Oceania,20,1525.39
c6d0aff7aeea4864bec039622ebeb691,166,109,57,Europe,23,898.87
c6d1486b3845413c95333a24deb117d8,215,162,53,Asia,19,964.96
c6d241594ae34fe09d83bc6feed97a0c,347,324,23,South America,17,1836.55
c6d288cc807a4f4194534a5b6ae79cbd,360,339,21,Asia,20,2340.67
c6d2c9f946884dc1bb01402f050a8147,37,6,31,Europe,17,123.24
c6d47c1802d541238727cd4ba7d80cf7,35,6,29,Africa,24,293.87
c6d6b5141b914e63aa8a95af26e5a819,176,143,33,Europe,17,1285.25
c6d85f14557741ed9551e212e05776c5,275,231,44,Asia,23,2416.7
c6d89cf170014aaf91c95c393c422825,77,52,25,Africa,19,554.59
c6d904811c02487fa183c92e8de98cad,223,167,56,Oceania,18,1102.83
c6dcc0c583134e44a22b28c2ce1d9663,258,219,39,South America,22,1776.82
c6e0fafefd2841b2916da85333f50be2,352,312,40,Asia,17,2851.34
c6e23660a2304d0f864d2a1964020d1c,54,10,44,Europe,26,226.77
c6e897384f4f4574ac3f151a903fe56b,214,174,40,Africa,16,1157.7
c6e91265e1644db39f77ffc2072e0693,361,342,19,North America,15,1700.16
c6e92ca1a4e04fc2826468aae7bba178,116,58,58,Asia,20,406.08
c6ea96ae7dc24b6795139590963f6d26,95,72,23,Europe,21,820.4
c6eabfc282234f54bf47ed614161e126,70,36,34,Asia,23,746.43
c6ead6aad90e48c480c40a0f95f3ce41,58,31,27,Europe,22,481.72
c6eb50bfbb014b90b7ed916a79e8c0b9,79,32,47,Africa,21,231.15
c6ec4e60f6be4779976099941b15ed8b,363,354,9,Europe,21,2008.91
c6eeb7da7b1b40f0af55e2fb23e5b814,42,16,26,Africa,15,422.66
c6efbd9a7b5f46278af378bb49a8f0c4,66,41,25,North America,27,446.48
c6f2ffe57c924ad0973e8f46264cb00b,77,36,41,Asia,21,540.7
c6f354f464b24583862df74a28a3648a,56,3,53,Asia,19,99.18
c6f41c309c4d4a45813491e829c83171,161,119,42,South America,14,880.04
c6f4289729c24056bcae7449aa676d9f,307,274,33,South America,20,2026.66
c6f4873233214cd78fb091f034c48533,217,167,50,North America,13,1097.11
c6f670922ce14b0db7c8cc621fa240e8,325,308,17,Oceania,23,2434.35
c6f70eb23a9a438cb7ffb081e13661b8,212,169,43,Europe,23,1211.92
c6f92748761f4c2cbda4ae0e645da1b6,194,167,27,South America,16,1137.09
c6fd774b91af4652a613315950518adc,317,301,16,South America,18,2365.45
c6fe1792bf6d466caa2d276b64d46881,363,337,26,Africa,22,1433.81
c7007b16678a4a03b6b7099cf40f1b48,259,204,55,South America,17,1304.27
c700bba070f047138b0dc94f3dd1f7bb,211,189,22,Europe,24,1429.88
c7012212ada849c6bd607e7bdeedd215,265,220,45,Asia,18,1991.87
c7032e85fd5b451b90f5a91896d006e4,127,94,33,Africa,19,954.17
c7045406181e4d8e97dce03502db7ff6,346,299,47,South America,21,1298.27
c705de65d04a47a497590bdbdaec77f8,236,212,24,North America,19,1590.73
c707ed6be40945cba0c0ec363dec1b8c,188,144,44,South America,17,906.72
c709237927c543f2a82469af9b101847,237,207,30,Europe,16,1980.32
c70930a109aa40ae8075801db2e83c0a,54,26,28,Africa,17,396.13
c709960f53ce4cbda33f611688c00674,65,44,21,North America,23,305.28
c70b1a35caae44fab5d18149ef8008cc,334,297,37,Oceania,22,1477.87
c70eb611e1de4e988d5de02158d1de9d,190,146,44,South America,24,934.39
c70efd8707b946468e0226105eba59c5,175,120,55,South America,17,508.26
c71055e0d5364186a384c1a2c354f116,111,80,31,North America,25,1049.16
c7115f97921345eea00ac4d8a0421760,361,356,5,South America,19,2078.04
c7118cc5a8ad4fa188a16684adfbcc74,135,117,18,Europe,28,1148.08
c7131af34efd4cbabe0b3461eadc0dd2,365,348,17,South America,21,2755.61
c71424cb973b4b1ba90d764dec2c87ba,359,354,5,Africa,23,2679.44
c715b94e41664c0581e150bb2366fc8f,210,199,11,South America,21,1518.86
c717c48548d34b9aa9f622f2a63438fc,266,230,36,North America,23,2604.6
c71a2a8bd8794daea7d6188673f18cde,209,182,27,Europe,14,1875.87
c71b0a693b9f47c3a53f8dc4cd6baee2,93,46,47,Africa,15,492.29
c71b9e8bd37f4c1c98ec6530b3bd3166,184,133,51,Oceania,19,1341.4
c71bd5ba0d41429c95e3f93d1baa497f,187,146,41,South America,24,1685.42
c71e27b2ce2d420aab9068144d10695b,155,140,15,Asia,22,1121.34
c71ec7d0db3243aaab7b7874f8f02d9e,46,23,23,Oceania,23,296.47
c72341d01dbc4228817d02cda5e05014,152,132,20,North America,18,1463.38
c7240b27293746fe909e09976ec0216e,361,312,49,Asia,20,1166.81
c72496d80a6a4cb48eb9caf3a27b4035,186,142,44,Asia,15,855.83
c7267070702b47d084f3f48e45694468,135,96,39,Africa,21,1301.02
c727d8e3b2d1455bb99e9ea6ae058bd9,352,309,43,Europe,21,1712
c729eeec8eaf4ca4b73a1dbf82144481,87,66,21,North America,23,403.17
c72a6dc9999d48c5a8e09dc0f5a009b6,323,300,23,Africa,18,3234.64
c72aa54b64f94366b718852f6073bc04,364,356,8,Europe,21,2788.64
c72b46bff0734f52b22dc0efa0768178,210,174,36,Africa,23,1341.58
c72b5adb386843b8b2d9cefdcb31574d,176,145,31,Oceania,19,1190.64
c72cba15138540c0948525b5234d0c15,165,130,35,Europe,23,861.04
c72d77087f7442bca818b7eaa56c1e7a,331,290,41,Asia,21,1940.21
c72ea4ab0e17433d870126c3102082a5,245,205,40,Asia,22,1503.15
c73139bccdaa4f3bb77a10059f178b91,329,285,44,Europe,15,2041.52
c732461695cb400e9c9ee6fe5baa4c10,241,190,51,Africa,25,1178.68
c7376c684d43443d9fbde1dc6c1fac2d,365,348,17,South America,19,1879.21
c73787825ecc407fa759e1c8e880d490,50,12,38,South America,21,88.6
c739d93233104c84a9d73a8cf1d16a42,285,235,50,Asia,18,1521.32
c739df44b0a945dd90877cf6c2a937ba,365,359,6,Oceania,15,3156.88
c73e6dcf1710488fa716f3101143151e,236,209,27,South America,22,1452.5
c740895f820b49eebf545765e3e092b2,353,322,31,South America,23,2641.11
c7414d2af4bc4019bf736357348467fd,143,118,25,Oceania,16,729.42
c7415797da4c4685bec2dc699273747b,109,70,39,North America,24,605.15
c7422b09ebb84af38189e9513c33c5c0,23,3,20,North America,20,268.47
c74360a8ad6842ceba7880eb6ddeb61f,61,5,56,Africa,18,504.16
c74410bb24594f05b728f7fc98993c2b,179,151,28,Asia,22,1376.8
c74569ad8f7845cb912ab964e52bb12b,130,108,22,Oceania,18,905.33
c7488ee909d74eaaa86de64caa4fcd7c,65,14,51,Asia,23,448.61
c74a53c3f62840e3b9dccb0a7bb52f80,257,214,43,Asia,23,1463.68
c74bcdc6d6bf4c6e8765cbe6ce102554,328,288,40,Asia,21,1927.97
c74ca60e8a9643b695b2460f3880f1ad,244,185,59,Africa,22,1099.33
c74d584517e342c7af4d0c656441f08a,227,176,51,North America,21,935.62
c74eaf5602c04688ba5da0c77bb29ac5,54,11,43,Europe,23,291.74
c7512d9738064b65a14683fe2ef51954,228,199,29,South America,20,1759.68
c752a5b0d9394aeca8d8c08ae43313ed,293,237,56,Oceania,21,853.46
c752f07378a54a38a1371e85d939e397,99,50,49,Europe,24,298.92
c753f6eb085544a68966c72f616201e8,309,274,35,Europe,15,2422.89
c7563b95735142748083fa7f2012262b,360,319,41,Asia,25,2481.48
c758f4d8cd2d42d49649ea4496726e05,170,137,33,North America,14,1220.77
c75a478b9c2a410a80472f817ffbb70e,110,84,26,Europe,22,1286.35
c75a6cd157ea47e8bf3b4f8489c6cc7d,86,54,32,Oceania,23,432.76
c75a794786c345e2a8b14f4ffa6f1cbc,364,364,0,Europe,20,2463.7
c75bce51e0fc4894bf1e97f2393be898,228,164,64,Asia,21,1113.06
c75efd0a9cf544529ec5f5df225b26d2,335,313,22,Oceania,22,2637.26
c762719dfbd840299fdaf0216ba42a44,160,136,24,Asia,20,988.45
c763440371e4423bbf6430c80bc29d07,365,346,19,Oceania,18,2796.3
c763d385d590476d851e6613c5f536fd,42,17,25,South America,16,185.77
c76526022ccb44ca979e489f2b626445,306,284,22,Asia,26,2209.51
c765864eeecd48f6a0ddfb7ea64ed23c,136,88,48,Europe,23,656.2
c768555fcc404bb6bbaffc62769590e1,309,283,26,Asia,23,2638.81
c769ec2ff3214278b14390fd35a05ae2,357,340,17,North America,20,2380.85
c76d1f64312747c58f0e03da2797d95c,360,307,53,Asia,22,1453.9
c76d8400ca2b4dcc970ce1d395a0730a,106,64,42,Europe,27,647.53
c76e7ac9b18a4cffa0fbdbcb2deb38eb,345,302,43,Europe,19,1617.21
c7735b77ef464aa6885fbbd91b76b189,115,76,39,South America,23,901.7
c7757e96a498488781ee2186965da8bb,285,253,32,Africa,19,2611.86
c77629ca5c8b47c4a8ba6be67d264a4c,125,99,26,North America,23,1419.74
c7772af4fb494724bbfc1268aa72b9d0,240,183,57,Africa,18,1313.47
c77905b282fe4efc94df80515ff8d5bd,148,101,47,Oceania,20,780.49
c77b39c78c9649bbac3410420e396e95,77,55,22,Europe,21,545.83
c77d72eee70c453cae2cb843a8792333,182,156,26,North America,19,1336.36
c781a79ae8d648aca3d031f2a05f01d7,364,345,19,Europe,20,2283.61
c781c9fa264f43f089940dcea81976d8,96,44,52,North America,20,393.84
c785a16d3b48416d9e342227b9b09bf0,108,78,30,Oceania,18,998.9
c7890c7144d644cab786d7ea058f90a1,85,39,46,South America,21,537.07
c78ae0e46c924a46818e867df3139759,112,61,51,Europe,14,709.33
c78b0115e28c4933bff650a97df188b1,146,122,24,Oceania,19,865.87
c78c6de3d8ec4bb0a201e64934ca1a7f,365,343,22,Africa,24,1967.14
c78cc6816fcb4c399639c02cb787a886,364,349,15,Asia,17,2829.12
c78e9fbfa699427595436f6e2f86396e,85,67,18,Africa,17,565.91
c78ed95a38ef43a5a6497e6b76640b00,262,234,28,North America,23,2186.06
c78f8781c3d548c6831acae553f7266d,270,225,45,North America,25,1041.08
c78feaedeb044623834e3f052fb41694,31,9,22,Asia,21,248.02
c7923c1eadf649cb90d69860a02b447e,278,218,60,Oceania,21,1098.63
c7925e0a803f48ffae11dba183f46810,78,36,42,Europe,19,797.48
c795001be4294f3387cbb9e2909566c4,355,321,34,Asia,16,3010.29
c7965fee1d844d4e98157718edcdb136,74,55,19,Africa,17,589.2
c796e1068b8744e29d4ff10f9df98eff,353,325,28,Oceania,23,2247.11
c79b52e6c56f426da4d915967220476d,101,60,41,North America,17,452.99
c79bdb9cea004704a891ae6a194a513a,111,69,42,North America,24,474.05
c79cbee53d91478788fdfa600e3b737a,235,180,55,Africa,21,1064.27
c79de58982d64c4581b45f7198d6701f,201,168,33,Africa,24,1598.62
c79e6cb269394609b2b4adf9181702e8,110,48,62,Africa,16,376.57
c7a10d9b60aa41d1b53983c68790151d,78,28,50,South America,19,269.7
c7a2423a58244890afa77e7475f930bf,157,124,33,Europe,20,1474.44
c7a2ce3a204f439294fbe86ddc154ce3,257,204,53,Africa,19,866.19
c7a2fc16dabe4092b1dbe456aa34afcf,259,230,29,Oceania,21,1887.89
c7a4d4cb00f842dbab6ddbbc2ee8e8b7,178,142,36,Africa,14,1683.75
c7a4f0d3e6404f6db9036ad3245dc750,184,155,29,Europe,18,1202.28
c7a500beb458496ea6e5003d521ecf13,159,116,43,South America,21,1307.21
c7a8e05df88c446f94dc06ba49a6f8b9,121,78,43,Europe,20,760.59
c7a965fb99844c2b82292c21fcd37ba1,347,290,57,Europe,24,1694.8
c7a9ea7833cb4a1bb8faf488875225d0,365,321,44,Oceania,24,3088.93
c7ab6665a33c40d38e0885c022b46252,165,132,33,Oceania,21,866.47
c7ab8c1833a142b9a7f05b043bc765f8,256,220,36,Asia,19,1682.07
c7ac315bf646431cabcb9ceddbc1cddc,106,63,43,South America,22,582.36
c7af466f7c71467982da3600d897a19e,271,231,40,Europe,25,1315.46
c7af73a9f9f34c3999be0b1dbf872e82,141,100,41,North America,19,1173.5
c7b0f9d28b8e482093f07f57d08e2c99,95,71,24,South America,21,950.98
c7b1a3f50b404b249d3c0147280f6674,209,183,26,Africa,15,1321.56
c7b52ebae8c34f269b86bea60999fcb1,162,109,53,Oceania,20,725.43
c7ba737c81e348c286d9c49f13e1e563,183,158,25,Asia,20,1334.62
c7bcf56f6f12446b95accaf1dedefa2e,52,6,46,Africa,17,169.26
c7bdbe690fcb431995fe4ca00ae0bfe0,157,110,47,Asia,18,478.49
c7bdc1970dff49509837a63b289968a8,246,215,31,South America,25,1724.63
c7befce023f8446b94e27d4092ce1d2b,279,259,20,South America,24,1922.62
c7bf13ab7c4f417689ae2b582b41015b,205,151,54,Africa,17,915.1
c7c03045650a446a9483a4a1f4943b38,176,141,35,Oceania,20,1290.85
c7c0fe29398045c6a647ae9a3848406b,53,18,35,Asia,21,333.18
c7c1c8991c6a4605b5b55a1ff791ea97,173,151,22,Oceania,19,1610.63
c7c27293aab9423bbc5fafce27071382,94,58,36,Asia,24,804.85
c7c4ac6806d041eea5ea15944f99f1ef,365,325,40,South America,20,1866.01
c7c68dc74c354d33bca3fda003c0cb07,83,46,37,South America,18,446.43
c7ca029045644fecaa0c742856472ab8,76,22,54,North America,19,214.74
c7cab7c0a8a3402abecaf2a428ce8606,316,278,38,Oceania,19,2991.95
c7cb10657db04b7c88389ebabb332b7a,365,356,9,Africa,16,2992.86
c7d1202e953c48c39fd23483d4c3b769,166,126,40,Oceania,22,1127.71
c7d463fcc1d54238902f43953a70d476,239,187,52,North America,25,1235.38
c7d58eb9029b40b28ae73be2d5cc9923,170,143,27,Asia,23,1307.84
c7d694dce8464b7187685768ef74fba0,210,158,52,North America,19,838.98
c7dad904683a4167a167795d8d05d674,128,68,60,South America,25,628.3
c7dd3c66af224230914e63dae45c3936,281,226,55,Europe,14,1131.63
c7dd4c38a0bc4293a7d262a413351831,128,103,25,Europe,21,946.76
c7de18198a0b4d3ca44cc106b671fecd,349,318,31,Oceania,18,2694.84
c7df56d810ae4115bd5b8f95a618dc08,170,123,47,Oceania,21,1132.11
c7e4f3236be049dc8f7ef34535745fc5,166,140,26,Oceania,17,1334.75
c7e5bc8e3d8b4728b5d87f82d924c718,54,18,36,South America,21,408.03
c7e8461ee7394b19ad4948d37293a933,363,333,30,South America,16,2442.66
c7ec67c2c935439ab916b370dd8e63e9,247,219,28,South America,20,2068.08
c7ee32c1df934510907ebb0a29ed3376,326,279,47,Europe,21,2503.67
c7ee97c5a4ea41c7bcce641264e8e0c8,174,126,48,Asia,16,1124.68
c7f0e55e7db34f10889b8e146fdc4199,362,338,24,Asia,19,2026.16
c7f15901a0094732a662c3ef82dc3bce,47,12,35,Asia,21,393.38
c7f2e3a5a9614edf99cd6f348cbdf3cf,314,261,53,Africa,18,596.78
c7f350e5099841eb9f702d705104a3b3,159,118,41,South America,26,1277.08
c7f5a2327a1142a886b322b5bad2ba86,135,88,47,North America,17,901.14
c7f731de25c145bf93a86e321e763731,363,347,16,Europe,28,2299.48
c7fecf6ca59648dabed102ac8e486b31,349,317,32,Asia,19,1720.24
c8010006709f4bbdacc3f967401191ca,90,50,40,South America,20,794.11
c8026ce3f2d54a80beba1b2b8e3ef7b2,223,174,49,South America,22,967.35
c8033e5e10314024994fbbfc2775af2e,78,62,16,Oceania,24,461.07
c80390459c194bb6b6b3ae9cf80962bd,286,237,49,North America,20,1265.75
c80522d9a5dd458588c26e3cb11c04f3,120,90,30,Asia,22,1417.58
c80631fee8a246ddb74b298f28c6dbe3,44,17,27,Europe,21,220.93
c806d410804f45b3bc6dffb4836f70e1,43,9,34,Oceania,17,451.12
c807a47d219545fa94d21e94f91ce793,272,221,51,South America,21,1105.33
c80809714a6f403fbb296b9681bd3346,364,316,48,Oceania,21,2995.01
c80886521efa4ed28a96f604e0f1475c,346,301,45,Oceania,22,1395.65
c808ed90c7c24c32bb9153d3c6b7e045,322,267,55,South America,21,1508.08
c80a48ffbe9042d6a4d99cdef6521756,70,32,38,Europe,20,432.49
c80ac1bd4d134e1d9cdb14096c8ffb3c,63,39,24,South America,23,512.62
c811eeb749ee437689404c3435750e99,222,191,31,Africa,15,1285.79
c81266bf3c724120b05b1f6a0d2ac94c,320,266,54,Asia,14,1510.64
c8150f69c9e245a68edbecd1eb6fa28a,359,306,53,Oceania,24,2028.41
c81a262fba2b49859e4f7de2ef159d2a,58,21,37,South America,24,226.18
c81c2ade91064e6aa9ff30de43d54d42,251,226,25,Europe,16,1816.28
c81c976d86234d8ca3f896c7d1b24170,323,299,24,South America,24,3189.22
c81ddf7931634837a9d21a3974c2c9e0,136,83,53,South America,17,643.85
c81e28f2b53a41f59dd6448685f96d6a,277,228,49,Europe,20,1477.45
c81e319af4b34ef1a3b5d6f3450dc55f,251,197,54,Oceania,21,1349.36
c81eaa38c5d341948e44277a449cfacc,138,103,35,Europe,23,1239.61
c81f794932ac4df9b9e51c70de5764d8,168,136,32,Oceania,20,1470.79
c820f6860633459195fe6630679e32d2,265,216,49,North America,22,1332.37
c8229556e5d74569bb2e873e4f52cacd,363,334,29,Africa,24,2233.63
c822a07f5f6345fa9dc4d9dab7d2a741,75,47,28,Africa,20,870.75
c8238aef9e214795a5f753b0b3954352,47,10,37,Europe,23,308.29
c824d9e11e414d8a8edb880231693ec6,100,85,15,North America,22,603.54
c82af572bd5449d394062906048af838,254,205,49,Africa,21,813.91
c82b72d987364a42af303808a887e7b5,292,244,48,South America,20,1146.27
c82cc2110d38417d98dc067ee7df2703,363,308,55,Oceania,21,2111.01
c82dbb27ebb74eebb6c1c66b1982bb82,89,66,23,North America,23,801.78
c82e5d6d6f194f2dbbf814e45e589f70,300,267,33,Europe,19,2094.25
c8300790fc3746278994fbae9ce57690,105,55,50,Asia,23,373.82
c831bf74fd4440e9861d689543bdb31a,281,260,21,Africa,19,2277.88
c83210f426b4475eb23838971c143e3c,242,213,29,Europe,15,1442.81
c834be59fe934899872043a5a5c64023,87,43,44,Europe,20,302.57
c835baa3285a490ea1e0eeb7a6f00e0d,268,225,43,Asia,17,2057.82
c83703ed8f8945acbd7eb6be2a0e7aa5,175,121,54,North America,22,1056.52
c83d0d0cf22249c1b2907b973c36f26c,221,183,38,Asia,22,1396.39
c83d3bd8bf74435dbf735457295ae174,311,265,46,North America,17,1929.49
c83e8fccc9e642538ae1595961af8528,100,51,49,South America,15,431.98
c83f5506bc4743aeb876fb59b37f0136,303,264,39,South America,12,1778.5
c83f5619860c4e27a51bda02ef66c784,102,91,11,Asia,24,770.56
c84035c75ff4468b9377705fcfc97eac,193,174,19,Europe,20,1415.28
c840aa1f2a0f4d96ae49326be2487e4a,243,201,42,Oceania,19,1755.53
c8444cd6611448fda26a89d8d74d6064,60,14,46,Africa,10,349.32
c84489e84c4640a1b147d8e66562a952,253,222,31,Africa,22,2125.72
c847449b100d4ad6abff3068dde5558f,263,219,44,Africa,27,1077.7
c848919742974f8786e8d7616ad92fe5,220,197,23,Asia,20,1440.86
c84aaf17169240e0ae73ef25616d6e75,262,213,49,South America,19,912.12
c84c7852d58f49efa61d8b73a4e55cd9,364,351,13,Africa,15,2168.47
c84d28001a5545fa955d804322a5508c,111,70,41,Europe,18,692.6
c84e5b69018c4dd79600756523ae70c1,49,30,19,Europe,24,438.33
c84fdb4d59584f4c836b797719266365,66,24,42,North America,23,333.34
c85255a459b44590b73e6d07fa7991cb,163,130,33,Asia,23,710.22
c854820f0e8f48eea0d9fbb004ce78d5,103,60,43,North America,22,1278.96
c8554d07d3b2406ebd1adb14ccb2dd38,283,239,44,Europe,20,1742.24
c856ef696bdf4dccb8cd73c86bc9660c,226,202,24,Oceania,19,1856.6
c859c366fd8f404bbadc210904cc49a6,129,98,31,Asia,24,974.98
c85a1b1977354089972e628cbd68e2f6,286,232,54,Asia,19,1699.42
c85b3f656c7a45f5b6750baba01d54b9,364,353,11,South America,20,1513.7
c85bb9c16b63408191dce5d3ba921f1f,364,335,29,Europe,20,2369.73
c85c4a33f0064484b8f214d224df310e,365,329,36,Europe,24,1781.1
c85de15bc1544d0a949490ad97fbb196,365,328,37,Europe,21,1329.99
c85f57ad27f5499f93dab34259d41a91,209,160,49,Africa,27,983.47
c85fb3485a8249cdab7d931a83178784,58,30,28,South America,19,644.4
c86024096497407a9eb8ab1a0dd1e410,365,323,42,North America,21,1596.41
c8602ee42ab94fa5becb020cd2de5b4e,300,276,24,Europe,15,2863.48
c8610c993cbe42e7835954a4bf54f18c,70,11,59,Oceania,19,200.12
c8618bf3595943cebbb78e8ad2f1e56a,51,9,42,Asia,22,373.03
c8618c9f1b4840018864662e3c761d7a,348,330,18,Oceania,17,2298.11
c861c475de424b9abc820faa03d38987,201,151,50,Asia,19,779.22
c86432aa3efd41dc95f0adaa3ec88727,236,194,42,Europe,14,1455.57
c866a03309e044bca58f1110d3d8bb22,219,172,47,Europe,26,966.43
c86cb41a4b4a4e8dabe0865f25f007de,29,2,27,South America,22,80.1
c86f677eb8a444149708fefecdf5aa3f,314,289,25,North America,21,2092.87
c872cb6d29b643e6834d48fd4deda063,363,360,3,Oceania,19,2794.24
c8754e029b9d4e44ad78d04168e90629,310,280,30,Europe,17,2187.43
c877403a83d74073a4be284892b15c38,200,171,29,Europe,20,2045.7
c87bf9816d894ae39334506ea221d226,203,166,37,South America,19,1791.71
c87c088a76e34929b5566dfe96bfd19d,86,38,48,Africa,17,614.71
c87e22b081e242008d7f05bf47a4db5f,82,56,26,Oceania,21,496.09
c884271612fa418b990f3a76577977b5,54,28,26,Oceania,18,353.23
c884317b3ba44163983553295e4a4a46,174,136,38,Asia,19,1083.22
c88480f8fab84eb0971187c660c0b241,49,6,43,North America,20,329.21
c88742cbd84a4c268a2cea700a1520a5,347,322,25,Asia,18,2509.24
c88855ab40c54c7bb3b8ae3fe0c643af,150,102,48,Africa,23,754.55
c889a4006ccf4034ae9c518c636313fb,209,178,31,North America,22,1654.21
c88a4b0afcb2441c9f424a010106b79a,322,298,24,South America,18,2561.45
c88a4e4b5441460898e7824360e37e10,329,308,21,South America,22,2707.06
c88bbf51c1ac4613b8f68d68bc2e0b60,40,22,18,Asia,19,65.92
c88bef05f6f2441ebd791ecc9306dcf0,347,307,40,North America,14,2125.76
c88c527cb6e44e428bcb80ee61876960,46,2,44,Africa,20,377.94
c88d316f4970428fa88d23d24d80bf82,349,311,38,Asia,19,2152.51
c88d6f089d8d4077a66941667f743b1d,291,268,23,Oceania,15,1951.17
c88d9a0434484d78b66dd40fd11f8a59,149,131,18,Oceania,12,1066.77
c88fa036b2584861a4cf43249cedec28,66,25,41,Africa,21,252.59
c88fa60f9cb94cf280f8f4e785c43ba7,111,78,33,North America,24,1032.14
c895fdaa334f4bb89550bda1b5e829ee,103,48,55,Africa,19,453.68
c897bf3b339f4d5bbd847689000970bc,254,225,29,North America,21,2444.85
c8988d99849e446dbccd8063e4e1e8cc,137,93,44,South America,20,675.52
c89a48bd14444c3a8304362cee2edf5d,364,339,25,South America,23,2315.91
c89a968e86a44acea7f661f3205c4a61,168,119,49,South America,18,1593.53
c89f20c8ab7f4f52b2768e825ffd8547,72,40,32,Europe,22,295.87
c89f2a1ebc814e77af06031096b3d261,86,39,47,Asia,18,566.77
c8a175371e754e478d9e5a8513e5bbd2,280,230,50,South America,27,1183.38
c8ab17d8ef154d168b53f4cbcab4b7e0,84,55,29,Asia,17,513.25
c8ad94e82f3e4f43a8c62b17e42f321b,283,256,27,South America,20,2026.66
c8adede977d741ddbc39347c8bf5dc8c,363,346,17,South America,15,2204.34
c8adfed7605a49d2984875ee432eea56,304,272,32,Africa,21,2386.28
c8ae30710c194733bd56408db426bd6a,108,70,38,Europe,21,554.97
c8aeb80fe3b44e6bac21e1f906d62fdf,31,2,29,South America,23,169.21
c8af237195bb48b6a4c60755ad707610,318,306,12,Asia,23,2300.67
c8b0eba396aa4be4825854aeca6dcf64,246,204,42,Oceania,21,982.49
c8b0f191548d4fdc86ac34d076ab7dcc,54,6,48,North America,24,183.65
c8b1ca1ec25d40169ec123ace564b625,108,69,39,North America,22,679.92
c8b359a45a184a079a3e5aa6799b90fe,313,288,25,Oceania,19,2646.42
c8b88898532b46999f3c448ef2d9f77f,143,120,23,South America,21,1105.41
c8b939343fdf465996ab349a73733751,329,275,54,North America,20,1829.4
c8b9fc5dd6624227b6dfd0aea8a419e3,91,60,31,Oceania,27,504.03
c8bb04e068604f20aaa3c25cd992bb2a,365,343,22,South America,20,2073.15
c8bc6838ec1344fb8f95340762bd9eb9,224,167,57,Asia,21,1155.27
c8bcee8201fe4597a0d8b93264dfbeb0,330,277,53,Europe,16,1636.13
c8c09697bfb346729bc9d428ef0712bf,213,180,33,North America,20,1623.29
c8c19b0e533a4e84bf8baca585052e55,136,83,53,North America,23,968.39
c8c3c31bdbb542f8a0415ab54f0e6d51,296,256,40,Africa,23,1901.24
c8c46bc357cc4f66add9067cdca34bd5,280,238,42,Asia,22,1461.76
c8c49b8036b64774a105412473eafc52,268,245,23,Europe,13,1900.41
c8c5042934b54d2aa050d7e90c9ba6cf,305,257,48,North America,21,1669.17
c8ca00f69fbd46eb8025b36421b5ca59,213,184,29,Europe,19,1475.46
c8ccf1ace1164b538e0e262474a51a9c,364,359,5,Asia,23,1699.87
c8d0312117564b86a85a9dfbbaf30b1c,219,188,31,North America,19,1492.96
c8d2f57c83ab4cebb1d195e887e7952d,357,312,45,Asia,25,2024.38
c8d470b4026b456cb92894d6884b9286,248,199,49,Africa,20,1827.59
c8d69c81504447f3a496961640893d12,103,63,40,North America,20,380.97
c8da2ddfea194d95aebc54a9f886740e,307,257,50,Africa,23,1529.57
c8dc8974eaf04fe1ac36b502bf0e7d1f,221,174,47,Europe,19,947.4
c8ddb0f763c54bc4b21ed2a0fcc536ec,364,364,0,Africa,19,2250.07
c8de3d62cabf48dfa0c0dc476edbac78,317,273,44,Europe,15,1875.17
c8dff8d70320475a9f117765a508b87a,78,31,47,South America,17,453.19
c8e49a8e061f4ca894639c84666fae6b,120,90,30,North America,18,870.76
c8e5492cc7f54861afb63a95d66bdbb1,136,112,24,Asia,22,1032.2
c8e5e80f1c5341aca97ab952d1176da8,365,348,17,Europe,18,2347.22
c8e6299073aa4faeb8704a1d5143ce34,231,209,22,South America,21,1322.82
c8e6be5c78c54b44865a4eb532c976c5,153,126,27,Europe,12,1260.37
c8e7e25c24e243cf973d9453fefb24e3,229,206,23,North America,20,1319.36
c8e8b2ed802d49928bffd533078ba8fd,158,118,40,Europe,20,1393.1
c8ea537afbf146d2a439907333b7dc93,115,89,26,North America,17,962.9
c8eb08e93a59478f8f51c0a02f240a76,272,233,39,North America,24,2260.93
c8eb9112f630425a836edea00a8cd2aa,324,290,34,Asia,20,1882.56
c8ec7a4ebde4423595272c371cf1dea1,220,198,22,Oceania,30,1435.36
c8eecb97e0be4f5caf79f5aa808af2e6,162,122,40,Africa,23,907.3
c8f17c93ccc7427096a99dc0819d3769,163,128,35,South America,23,1247.72
c8f2b1284e854d24a9a291934ce74bec,172,120,52,Oceania,21,813.27
c8f34d7986094d4ba7c16bfc1eb11c14,272,247,25,Europe,17,2133.75
c8f381fff0c34dc7af854f0635b47537,111,59,52,Oceania,23,648.45
c8f3b3627f6c47af8e873265d0dba8f4,364,315,49,Asia,19,1957.43
c8f9e700fe0c4d26b0202a373ded01a1,86,50,36,North America,24,423.33
c8faae267d574a33826dfaf1fcaffe16,329,282,47,Oceania,19,2276.74
c8fc1f862f9748cab9b9ab6e2d060d26,71,18,53,Africa,31,61.54
c8fce5e917824a48b5f05a0825c943ec,190,142,48,Africa,19,1262.62
c8fdf3e959244d95bc8e548166a87b81,223,190,33,North America,27,1501.63
c8fe1dffaef7427faf84ad8b15f747a8,226,180,46,Asia,20,1169.72
c8fed0fa1b4c433cad940ae4a5a53f65,106,83,23,Asia,21,612.52
c9007dfa95db49dfb84004f0f4c8df13,302,279,23,North America,17,2056.58
c900cdd479dc4e1aa31c77d443ea4511,282,248,34,North America,15,2110.99
c9041fd405fd4d089ec9bac8beb54956,109,51,58,Africa,21,450.46
c904964081b44245a2336368d6ba79ee,60,45,15,South America,18,607.14
c90590196a674e0299d88ad1c10c9c35,141,119,22,Oceania,20,1397.9
c906424cb0bb496798f0fc2c15f3fd3b,291,252,39,Europe,25,1862.52
c90702e811c840a3af4cc2ee24dc67c0,281,244,37,South America,19,2114.31
c90a9cfa096c4462b67488d8f897b8e0,266,222,44,Africa,25,1180.77
c90d2ef749d84aeb95e312d1510d662e,326,290,36,Europe,19,1758.78
c90ee73f4c464f0d84f8bc1e46bb703f,47,13,34,North America,14,375.66
c90f778322d24df3806ebcdea996e67e,229,185,44,Oceania,20,1346.36
c9107852d5ee4cf788dcaf99eb32cc64,365,364,1,Asia,22,3472.42
c913d84a43d443788995b9b82b4a6b17,229,203,26,North America,19,1063.96
c913f2065aa944caae406670067b197c,89,70,19,Asia,17,623.42
c9140065799c4e25aaccf4ec53925018,360,305,55,Africa,21,2203.81
c918536027224472b4ffa7bccfd754e4,307,256,51,Europe,19,1458.05
c918994e9d4846e382af6c4b7eb4a319,240,212,28,South America,17,1866.14
c91a36082d11437f86f6e9335164401f,203,152,51,Africa,19,1091.1
c91a3da0a2674042af02c25935de79f1,175,126,49,Asia,22,1040.58
c91b794d519448cc8355783d6a36f76b,260,225,35,Africa,18,1841.46
c9201cd73a7e4910ae6f0560dd8e94d4,325,282,43,Asia,19,1683.45
c92062c3b8594bb7aaa43e54902e7857,98,54,44,Oceania,23,506.79
c9225b7e54394288bbbf8aa31b3ad17c,236,195,41,Africa,20,1680.26
c922a0062f0d46bfa568b4e81707f6e8,156,106,50,Asia,21,1031.73
c922ec5adf6144459e894be7b3b85bff,243,192,51,Europe,19,723.57
c92598e05f2643ab80368a37ee8aebee,243,218,25,Europe,14,1395.5
c926319ae8b547ea91c1b329d0970150,264,221,43,Africa,21,1922.91
c92671c426924487bbfc63d8c1cb39da,272,250,22,Oceania,18,1940.85
c927b8e6ef4947ddae9d01db4919bcb6,96,43,53,Europe,24,119.64
c92853b7b90a46a98a7c302e93d8fdc6,115,80,35,South America,21,865.11
c9289214cf6949368b874fceed7ac96c,62,32,30,Africa,21,413.98
c92a3f17289544458697331c432fb83f,80,54,26,Africa,23,210.56
c92fd189d7064262b7f422d73e230fe0,245,209,36,Africa,21,1651.52
c930f2af6bb14fc1a7ef499f570a3a1d,351,316,35,Oceania,13,2032.06
c93248283db74c6cb9dbfe3fee520b4f,365,316,49,South America,18,2427.12
c93a1c4d5ff34235ae5c65876aa2e481,330,286,44,Oceania,22,1470.38
c93c2ffbc7284a5aa05f7aeab6539a05,91,72,19,Asia,19,429.44
c93df30b4bb943b4903b51a0c78a8fae,294,272,22,Oceania,19,1897.29
c93e5b38cfbc416cb8fcb228685d0d9f,334,275,59,Asia,15,1699.16
c9406d02e23841f3a3ab009417364b9a,172,143,29,Africa,24,1958.25
c940c105d8df4d78810f8c29203df976,365,346,19,Africa,21,2223.21
c940d5d0d7034f46a0e3293f5303a1ca,219,168,51,South America,16,1170.66
c943e5b317334abbb9f37f0eaf02f628,150,102,48,Asia,24,641.61
c9450bceb9094bfaba71385cd2a2c608,262,213,49,Asia,20,1032.44
c946a02e6f4444348d4abf465710318a,346,310,36,Europe,20,2693.21
c9471d4679bb42ccb5546cca0ea12c99,98,64,34,Oceania,18,356.05
c948b87892224c49bde9669a2c343e62,217,191,26,Africa,25,1894.82
c949c3009b234215b257939ca4532264,145,125,20,Europe,20,1180.35
c94b4dd2cfa046b0badf89f91e22ab4c,120,102,18,Europe,18,631.89
c94d353b0ba34beeb6e95a8ddc1abce6,75,29,46,North America,24,406.14
c94e0456b0054bbaaeb225268735bd26,180,140,40,Europe,19,1189.69
c95044ca70064a2297dbccf052971443,361,323,38,Oceania,19,1916.56
c95251fb79f440018434b09cac682a1c,40,4,36,North America,22,276.93
c95618c19dc0437ca80ed80774a4a570,192,139,53,South America,21,990.02
c9568e54594645af962c4de977ec450f,165,115,50,Europe,18,956.57
c9571b2903cf4a05931cc2d1fa334c15,157,139,18,Asia,21,1232.07
c95779329c054061b07f53d02dbd58b3,117,91,26,South America,17,1168.24
c95a03f9165f4b1eb828fa4d74fa0070,295,260,35,South America,25,2218.92
c95be634f0f346d08184a1c7b94ea3f5,150,124,26,Asia,26,778.68
c95de40407334f81aa150fec2cb1cef9,81,59,22,Africa,21,523.86
c95f9732a18f43828c67d896c9b5e993,89,55,34,Oceania,18,255.05
c96019c776f847baa7d66eab7404613f,257,234,23,Oceania,21,1803.82
c96377841e9a4d71bddb3082895bf5f1,251,213,38,Oceania,21,1825.24
c96808babe3a48318879b20938dc3d9a,282,238,44,North America,19,1303.43
c968288a5f7a49b295dddd211a271178,165,116,49,North America,22,1071.06
c9697eb938d941dcb2a68fcbcffb9fb9,365,333,32,North America,20,2302.72
c96a25db0daf4cbd8e5a54771507db67,155,122,33,North America,27,1032.58
c96aa57a3c6e451487f8f9778333f36c,295,269,26,Europe,20,2658.42
c96d400ab9e44722aa0ee6fde5eed97f,270,222,48,North America,16,2031.42
c96d6d74bd264bbfb8b71db7ae7a4f8e,135,104,31,South America,19,972.6
c97027d7bb9842b5a2fd14722f6bf593,364,363,1,Europe,23,1928.79
c97041d6659248e29489715fb1427e87,37,2,35,South America,17,311.7
c97203daf43a47ef83dac92e11e58218,103,57,46,Oceania,30,785.24
c972fb6bb8b54b3cbe3b5f97893909f3,365,338,27,North America,22,2131.31
c97329a143ae43a293931fe3f20b5e2b,108,85,23,North America,22,419.57
c9741b2595a34b0e830ab0c7b59cade5,72,27,45,Asia,20,329.28
c9768607ed6d4654bb58a2f4891cd751,138,116,22,North America,25,1162.21
c976e68746e749cc8a57c61e99e6b40c,122,76,46,Africa,20,1037.77
c977290c553b49d8bf752778281031c2,51,27,24,North America,22,438.06
c977ee420b0c4a6683faf17cd49a5d98,164,135,29,Africa,23,1369.39
c978bd76274d40c0a898302afbacc447,105,70,35,Oceania,23,598.34
c9792e2bc2a645c1bfc9831bdaca38eb,231,202,29,Europe,19,1792.48
c97cd9e7486d4f63aa988cdec901d53e,112,55,57,Europe,17,523.06
c97d583a947e492fb94d07c27bce57f6,252,221,31,Africa,16,1852.62
c97e05b10a3c4f0ab7aecd8e6905f516,267,228,39,Asia,18,2293.52
c97e34396a06405c828a3e9230e4bf53,363,308,55,Oceania,22,1907.32
c97e479030d648a29a7fa868fb6a4f38,167,123,44,Africa,19,859.71
c97ebd3ebde34686be7dba99bfc03b6a,324,276,48,North America,23,1373.59
c980f07a04e74a989f64574a6b0e15a4,148,90,58,Oceania,19,729.52
c982377471ee48349673ca3a811dfac5,288,264,24,South America,21,2010.58
c983f5c5cc6e48daa7cf7ae63e1cb4ff,69,31,38,Oceania,21,469.93
c986a55de2aa437bb56aeb4e218727b6,214,175,39,South America,17,1757.58
c987ea688fc64a768cbab0670584e059,143,96,47,Asia,23,693.71
c988321781d64b7eb556ad70414163c2,365,356,9,North America,20,1944.08
c9889051b39548e78b02284a77e3111d,217,168,49,Asia,12,1265.83
c989ee372c1c49a887cfe459d6f0ce7b,285,240,45,North America,20,841.32
c98b01ff48944aa69b21fb746e5601a4,364,346,18,Africa,23,1500.75
c98fa7c0f937423c8fdba728b4714b04,62,23,39,Africa,22,274.22
c991754a1c0c497780131ee8c7418b03,175,136,39,Asia,20,1303.13
c991cc45d5bc495ea80d8d7004c8d5c4,61,10,51,Oceania,20,323.93
c991d9137fea4113a89e49ed38b25c33,74,28,46,Europe,23,294.45
c992e8e77ecd43d49b393f38fa50e05a,58,16,42,South America,25,519.42
c9936bba9af645de9194981abcab3713,58,33,25,Europe,24,335.83
c9941fc6335140c3961bd3bf8336e941,190,140,50,Africa,21,591.7
c9958a3cb10145c2a9183a1b017201d5,247,203,44,Oceania,20,1030.08
c99611b4509246fc8672182a235a21cb,275,231,44,Europe,27,1579.36
c997289053934918b4cf54bf495c71bd,76,52,24,Asia,20,991.35
c997df538de34197a7eeec8f5a7460b6,105,52,53,Asia,15,242.85
c99a53b96cb7401a863a72ddc353e3ae,195,145,50,Europe,22,1151.91
c99b14a6655740d89f52020efdb8278b,224,213,11,Africa,16,1774.43
c99bc25fa21f4d10a1aa02776b8c70cd,255,210,45,Europe,15,1375.91
c99cc0eba6b14c37ac28a26299c5f4a3,49,22,27,South America,19,550.03
c99dd2990f2e4f7f911e6bb417e67a18,123,74,49,Europe,21,597.72
c99ee313617e430eaebac1a0d1d5762f,362,331,31,Europe,19,2972.26
c9a113447dbe47099b8aca1f77e620d0,339,285,54,Asia,19,1859
c9a11c51c97842c2a3082144b7e86c40,121,72,49,Africa,19,970.12
c9a1d2659a304f4abbdb79bdf7ca273a,224,180,44,South America,16,1493.86
c9a360f3da0d46cfaa03c2fd8e9c123d,134,109,25,South America,23,1182.35
c9a362243bc544959bad612599a999d4,333,277,56,South America,26,1964.63
c9a4a8a6fcac40788612872896a779c4,152,103,49,Europe,20,538.45
c9a4e8720c054974be9e77ba1bc7a33e,363,353,10,South America,25,2667.84
c9a5bc7b59444068acaeaa64adc04ac0,333,298,35,Asia,18,1403.02
c9a60985b37147dfbb415ac120f8453e,365,342,23,Oceania,22,2241.38
c9a87ef30088466980e65f196ed7d582,358,325,33,Oceania,14,1976.18
c9a924de55c04dbd8ab02451068d6ce7,262,226,36,North America,25,2196.56
c9aa1454fc3a4c7eaeed9db806558e77,183,151,32,Africa,19,1265.02
c9ab9ebb19d04e99bbef0c739c9dbf04,291,252,39,Oceania,22,1315.04
c9ac0002181c4c92b8c084114cefa1ce,135,105,30,Africa,18,1610.68
c9af0614cf6f4d5994f3eac6ae057639,234,203,31,Africa,18,1830.95
c9b24a32ab324858a22b51a594b357c0,323,260,63,Africa,18,1937.55
c9b2aee05c1e48289f6fbebf2ca6616a,68,29,39,South America,20,469.84
c9b2f8068a8744e784046804839c4801,232,179,53,South America,20,1234.46
c9b384285d3c4ee9ab72513fcf9358f3,282,232,50,Africa,25,1651.21
c9b3c60d67f24c63b9e6f6b794a956f8,101,78,23,South America,21,712.76
c9b44832c5cb45fb98c324b85033be87,201,165,36,Africa,20,1210.25
c9b73888f5a2430bab73bce0f15ed4e5,364,356,8,Oceania,18,1764.88
c9b775a92cac4d6db1339fd65b0b9f32,365,329,36,South America,16,2030.6
c9b8f8b40a0f4c80aefb67ca0ee5777a,321,270,51,South America,23,1800.54
c9bb4abfd0094ae09b2290b9529a2055,267,241,26,South America,17,1942.96
c9bb967e4ae84aaf9450b3ac7e1a30ec,135,81,54,Africa,20,1117.89
c9bc7edfffea423f992d7a120abb7e83,119,80,39,Oceania,18,311.99
c9be8cba5edb4630a38dcb482f384081,243,223,20,Oceania,22,1572.95
c9bea236487c49da9dc9b7b447a841f4,242,205,37,Asia,20,1751.47
c9bf05f9939047cf8616aaba59e09f25,312,266,46,North America,20,1634.23
c9bf4685ac8647c38fd2c676914e29c2,261,216,45,Asia,21,1225.97
c9c0e082c4294ebbbe161751d1f7f55f,160,112,48,North America,19,666.29
c9c27456c22649459ecca69dfb5c2a86,84,47,37,Europe,20,926.1
c9c5246686c74794a166a9f5e2e7fe54,57,32,25,Africa,13,725.39
c9c6e403f6314ac4a0a882ab2b48d729,88,27,61,Asia,28,461.1
c9c83d739e0444a38ab2b31649d9cbfe,57,33,24,South America,13,314.39
c9c87d7c342c448880503a848c7e0c65,230,191,39,Oceania,22,1159.01
c9c984b65242413f9e7b272f99ca91dc,268,218,50,Europe,20,1383.01
c9cdb51b7c9c428a8469a6a72d52132b,142,104,38,Asia,19,1369.83
c9cdbe380bac47b9b7dd366cd2983c69,173,159,14,Asia,21,1380.75
c9cf7d2735014c31aec7fc0002a16849,364,312,52,Oceania,24,1974.62
c9d08048bb62440aa702f8deccd7f840,306,264,42,Oceania,22,2144.37
c9d1928bc5d54ff58514fae9fe177462,253,218,35,Asia,17,2253.19
c9d4956db87a48ec826be05e3c43e6e0,262,224,38,Africa,21,1572.43
c9d4e230ace7459ca53a8d64442dd61b,317,275,42,Asia,22,1203.58
c9d5cf39731b4e74a037c30ae578dac3,150,114,36,Africa,25,1072.56
c9d63ee743e94722a58ad89bf47a637a,365,318,47,Oceania,24,1885.45
c9d7c3e5404b4609908390ebf889d510,95,48,47,Europe,23,450.05
c9d924d9bd7643c2bf0203d8b4090a04,254,198,56,Asia,22,1331.95
c9dbe63adeeb48a7a90ffa8cda1edb83,169,134,35,Oceania,20,1107.23
c9dcc29617ec43e4a6f08e0b2111b22b,365,324,41,Africa,17,1724.68
c9de6f09b97646e98dccc7dfd2c96237,294,238,56,Asia,22,1597.01
c9deb3c56cd94b6f89175f2962682194,172,130,42,South America,15,969.57
c9e0fabeff8d435b8ceb745d1188acf7,181,159,22,North America,21,901.24
c9e2677ea74242b28df870908346a164,200,142,58,South America,20,658.58
c9e878f78d0542b68d1fd47d238d07f8,206,153,53,Oceania,18,825.08
c9e914aab7e94b71ba83dd71d06716da,27,10,17,Africa,20,56.08
c9ed5c26f9ac47e9959f044fbd16d52f,320,280,40,Africa,22,2037.59
c9eddbb52f664350ae767a2f2ea1a14b,148,114,34,Europe,21,1119.32
c9f273933cbf45f1ba35fd95d7013084,255,233,22,Africa,22,2023.85
c9f3a84bc4434a548b3369fe1516e8ff,118,76,42,South America,19,697.74
c9f4d288ed1342af8a38e774163a7c9c,236,179,57,North America,17,1223.86
c9f72e7d8d514657a361b243ea055dc9,176,139,37,Asia,19,1219.21
c9f865b944b948de8326765c6a5b0636,129,76,53,Oceania,19,443.04
c9fd48f0fdcc4976a360405eb800e102,345,327,18,Europe,22,3368.69
c9fecb04d74f45478c27bc83165ec35d,156,134,22,Europe,27,1621.38
ca0008db1d7b4cb6a9e157044b14c73d,365,347,18,Asia,24,2229.89
ca00247070e9449b93422de8ff5d59d3,117,94,23,Africa,15,837.59
ca00cd4941da4c49a7ce5a366f97ef02,101,71,30,Asia,18,897.87
ca02efa6288b4eff86b99523b514c487,285,242,43,South America,17,1189.84
ca04b8275802461685963526e09536b1,64,45,19,Asia,23,839.1
ca04eb0b197446aa87ae3233911bd0ec,355,307,48,Oceania,17,1711.68
ca0a0a270e0643868d803368845d6e96,115,64,51,Oceania,21,556.69
ca0a6507eec14ea9a53c8ba0d702eed2,207,161,46,Africa,18,552.57
ca0beaf32c5e4bf8a32b17c3b7fd6deb,139,122,17,South America,16,1100.81
ca0e3352dbf04933b4fbd702ee8cfa84,365,363,2,Europe,17,2489.43
ca11141f607248c28ba8c79db2a1055a,99,72,27,Europe,17,551.82
ca14467c9afa41189a4cfb3c48ae32f5,350,326,24,Asia,20,2603
ca1bc2cf827b4c25beaf97845c35677c,317,284,33,Oceania,22,2363.19
ca1bf3fb2d8c44cf9cc91ebc2a96cb79,339,307,32,Europe,19,2068.17
ca1c2dcbcf7b4890b21907d5265e5d4b,318,262,56,Oceania,23,897.88
ca1d890b862c4a02b6ddcadbcb04772f,324,307,17,Africa,22,2031.44
ca1e166ffcc64a58af873f766a6f9d24,312,267,45,Oceania,20,1929.24
ca1e5d528c6f442ab861b007d5259a36,128,103,25,Africa,22,1042.27
ca210a0061d34ac0987dbcee550349f8,303,257,46,South America,18,1535.55
ca22dcc9ca324b3fa870299dff1c17ab,208,186,22,Africa,17,1338.68
ca236c138eb64f799619ccbd27b2f223,220,168,52,Oceania,21,983.77
ca248c8c887046e584354f19fa1acea3,29,12,17,North America,19,85.31
ca252f7a16cb429a89ed386a0302881e,345,298,47,Oceania,15,1682.82
ca271462346142fe82fd72a09823e1cd,246,222,24,South America,14,1327.95
ca27189751b3442296b8412e2b206e4d,61,40,21,Europe,19,693.92
ca284e8d899946d69dc66e7bb395bf7d,351,326,25,Oceania,18,2687.95
ca2b6a2860264ba7b0bef49d5b3a7ebe,205,180,25,Europe,21,1455.63
ca2f0452007f485db51bf4ada1220fa6,250,196,54,Oceania,19,1066.47
ca318de85b3b4620b168d2d0f96b25d6,77,50,27,Europe,15,441.17
ca31a4455fe949aba05873981587ed96,28,12,16,Europe,17,202.12
ca337ab127164d8a8631ce0b3d7f4110,72,44,28,Asia,16,456.56
ca365ba6b11746648e932be9fb278ac9,53,9,44,Asia,20,370.75
ca37e9d758a645e0abd893d1fca8b035,106,53,53,Africa,24,929.54
ca3c5138b83e4a8abe3ed043b0a0f143,155,115,40,South America,16,575.07
ca3fe8d4b1da4e92b0fd7234a883abe9,237,208,29,Europe,16,1393.54
ca4025c975834e7ca2f65ee81363c44a,213,180,33,Africa,21,1177.57
ca403dc4f5844f58964f54bc61182f66,274,247,27,Europe,19,2458.53
ca40b445f3004c14a5f9db4c7a4e9f0d,268,222,46,Asia,24,1289.49
ca40d936cdf3474f87eadca7688c8e6d,157,117,40,Africa,20,851.32
ca41ff19d3974f93bee035c5e5511bc4,119,88,31,North America,23,864.92
ca423193f1784730bf15f706601e5190,54,19,35,Europe,20,292.4
ca444832ce454b289a9e04b13acb3c3b,52,12,40,Asia,17,195.16
ca45334c7e17476684c6b0e21b57cfe0,181,158,23,Africa,15,1048.91
ca45361749604e39b6b7832965fcce1f,298,262,36,Asia,22,2069.39
ca46f68f5843473581839279c0df9080,261,217,44,Africa,28,897.82
ca4811c8df6742548f7258864669bb63,101,48,53,Oceania,21,121.56
ca4a7a9bd3da42018c1ae578a4cfe13c,126,90,36,Asia,16,1229.19
ca4b8fc7bd4648f69c50f52d32d7649e,252,211,41,Africa,16,2130.06
ca509afa5a7747f8b7b409e5fb03cb3f,21,1,20,Asia,15,126.06
ca50f42c91354c11a2b9297d0a7e96ba,351,319,32,Europe,22,2265.21
ca5133298f514f06a346b3d80393e599,26,5,21,Asia,21,335.31
ca53c9c7efa24dc9896d693be6c9abfd,300,245,55,Asia,19,1342.17
ca565a497fdc4c1aa166fa01aa650aca,217,184,33,South America,23,1044.6
ca572a7e5dba4b5da6a595f8b9093cb7,75,44,31,Asia,24,708.13
ca5905d68d0c44b08e999ee1c2a95a2d,80,40,40,South America,21,766.08
ca59cfc5aed94f88afd34bf296c3d36a,357,298,59,South America,20,2445.05
ca5b08d77e8a4e95bde47a17b5bb53d5,364,351,13,South America,13,1669.2
ca5b354d931d47a79d61251f66515a29,364,349,15,Africa,24,2825.96
ca5f67b64bc0491c83d4efecd18644a3,232,208,24,Oceania,20,1639.89
ca5f796be58841f1bb31c457a424a782,199,154,45,Asia,20,1613.82
ca6371f8153647dfbb82cdd5e1ae47b1,348,325,23,Europe,18,2604.58
ca63e095682a41e9b88602d945a9be70,241,202,39,Europe,20,1082.08
ca645c19d7174ec88d1fc018e021385f,176,115,61,Oceania,20,951.69
ca665ba8e1b9470f8d4277d6059aeba1,85,32,53,Europe,21,416.61
ca6686674dbf480baf562f63191e4875,365,349,16,North America,19,1923.45
ca67f17633594ea093471af0de57bc1d,282,236,46,South America,23,2011.77
ca68983e175540b282622a3f210d982e,238,206,32,Asia,24,2208.21
ca68a131ff7842b3b3ed28cb05dd30fc,210,161,49,Europe,23,1454.27
ca6acf8ea29f4888a9f6fc5d727a4607,209,170,39,Oceania,20,1689.64
ca6dd5d923de4582bde9924caa2d8a06,42,8,34,Africa,23,379.74
ca6e67ef57b349759a4290dfb5e650c0,365,365,0,Asia,16,2721.02
ca729e1773ed49a592c93cdb9d296c5b,184,141,43,Oceania,22,1229.32
ca78b2d31d244408adc500c6653f02a0,216,166,50,Europe,12,965.38
ca796fd8db0346068ecf483870ab7c4a,201,173,28,South America,21,1939.72
ca7a4118d7734c8cbd54d6c3dc67a969,58,37,21,Africa,19,464.01
ca7b3a94c39c455ca5beb323fc1c9cf0,180,139,41,Europe,19,872.93
ca7b9b59da2c4f8ab86e386d43c1bbb0,150,122,28,Africa,21,1418.19
ca7bf7289efb451b818b59c96c4e88cf,234,179,55,Asia,22,1319.67
ca7f66ba46ff4ba0874ec9f96fddb978,306,285,21,Europe,18,2404.54
ca80bdf20d724ff2a5eb7b3e7a59ac1d,251,226,25,Africa,20,1526.56
ca826d6422e7410ebd428e90908255be,131,76,55,South America,17,398.75
ca831e776ebc4407afbf9864c0d95169,99,47,52,Asia,24,436.21
ca87b5b68f824f66bb503aaf2220aade,233,176,57,Europe,22,1393.43
ca87d74edafa4abe92085fcea2c3a45e,63,19,44,North America,23,198.61
ca883f76203744a9b730501523f631b5,105,64,41,Europe,19,628.69
ca8bafce44d64622971b56971665d998,364,355,9,Africa,21,1709.61
ca8c7b4d75154829b660353fd2078afe,365,328,37,North America,25,3279.53
ca918e8bc6e04953952dbc664fff39bf,129,91,38,Europe,21,739.98
ca95be6c40c34241989288015bd980d0,365,350,15,Europe,22,2426.78
ca95ee75f9fb416f930bf2c8356c6e9b,101,70,31,Oceania,21,545.25
ca976bac9782457fa6a62f0e136c72da,171,140,31,Africa,18,1589.91
ca98ec1fbfc0436cbf45206a5f02d290,307,262,45,North America,25,1747.27
ca9a524a470d422c80fe0aaeea8f25c3,135,82,53,South America,21,653.9
ca9ec03849fc4434a7421be715818fc4,135,113,22,North America,16,1319.9
ca9ef79e13704522ab36be0e7e626a2e,100,66,34,North America,21,494.2
ca9f2c874c424effb46f123b1d438ee6,75,50,25,Africa,16,687.08
caa5aca5484e4144a9880203fc495af4,263,215,48,South America,20,1511.24
caa8d1380cc14001aeaff0d123024a86,161,140,21,South America,22,1577.47
caaa1506d21541e29eec442ce7260905,228,180,48,Africa,19,972.21
caab756f768c45188f311b16b4b862fe,99,55,44,Asia,21,376.1
caad94e0d560468ba60a1578fdd51450,204,161,43,South America,23,1430.16
caaf0392a5f746fc87af0eea9fb92d90,295,260,35,Oceania,20,2039.63
cab09fd1a9fc4d3684902ccb119fec20,275,233,42,North America,22,2261.85
cab18df87bf44cca939a86183dfcddc2,270,228,42,Oceania,19,1993.74
cab1de3f762c43b3b891b435dcc13140,25,18,7,Europe,23,194.92
cab32ea8999b4fe0aaa980aa96fc894d,220,168,52,North America,22,1111.78
caba06105cc5489182ed0cf4a5f0910e,222,167,55,Oceania,21,1457.04
cabac7df5d514038a1d9ebf140c38bbe,336,309,27,Oceania,24,2592
cabb59751abc4ebc93d65e510e778967,223,179,44,Oceania,16,996.89
cabc2374abd949fbb9ab4ad789291482,145,108,37,Europe,20,1065.9
cabe6b86862a467fbbae060a5640a2e9,230,205,25,South America,30,1464.72
cabfd9ac727746058c210258ce1c9ab2,126,98,28,South America,18,661.35
cabff08c156147e2bcaab8b7937abd96,245,211,34,Africa,16,1281.79
cac28de85b924ce4b42f02b56f7d48f6,223,171,52,Oceania,20,1160.73
cac3fd577d3f42c0b9cbdc7781a0f39e,209,161,48,Oceania,16,1110.52
cac42ba44f0149658e7bbf6b82eaaf38,122,101,21,North America,19,953.6
cac615cc3a1a4afca7f8214a1cf5a6b0,143,116,27,South America,18,972.87
cac632acf7804d599954bde8a7330000,364,322,42,Oceania,16,2594.16
cac9185bc2cb42709803e888acbc0c88,34,6,28,Oceania,18,331.91
cac91c1bc4924ceb9f8432d9b01a1731,193,150,43,Africa,19,928.65
cacb25247c2a489a82e60497de7078ab,236,194,42,Africa,22,1099.46
cacb4267ef8648adbf3bacdf7fed1f22,168,123,45,North America,22,1000.18
cacbb5b0a7bd4b71af1b41f90a02d33e,228,196,32,Africa,18,1911.27
cacda9129c4740628e0e864c20c43f21,114,82,32,Europe,22,870.99
cad076645e0b4c898e3dc525a3c31c18,93,46,47,Africa,22,499.37
cad3caed51e04f729d9917d1852ae1d5,126,104,22,Oceania,19,1026.69
cad964cff5d14f32a8fc89bc2e7b03bc,265,225,40,Oceania,20,1441.37
cadbaaf52926402fb8a7fed8aab7d309,318,296,22,South America,20,2539.02
cadc1fdc65af427cab2738fa07ebf4f2,96,76,20,Africa,21,687.43
cadf02032032418d984f6c3a104b45c1,215,169,46,Africa,18,768.45
cadf31d377a046c3991a7f3d1bf8a4c4,127,69,58,Asia,18,563.43
cae090b9af084ad2a63eee95ffae9ed6,329,275,54,South America,22,2287.53
cae3a63ae3f8460394d377906ce699da,215,193,22,Oceania,23,1789.13
cae5699e3b85415696ac4114e7a64df0,84,29,55,North America,21,330.64
cae59707cc414edabae947db1005f95f,118,86,32,South America,15,695.62
cae873e160084a038e202f26b0c146b4,52,23,29,Europe,20,180.19
cae909a541de4dd18cef18f6e115a26b,302,272,30,South America,25,1735.11
cae9b4fc53c94bc7a1fd44dc68eb73ad,135,86,49,Asia,18,195.87
caea4b0343d348b1aa15e16248659abf,364,347,17,South America,26,2258.51
caef17892b9e4b69be7cb8cc6aa353a0,81,29,52,South America,19,319.84
caef79582b184e2e8926dc8fbe8b6652,365,363,2,Europe,22,1899.53
caefc2e7eaff402eb16ffb8a75596350,295,252,43,South America,14,1371.6
caf14bf1c77140e19faad5dbc87333a2,349,329,20,Europe,15,2481.65
caf37046827941f3b1009ff0cbb084d8,122,99,23,Oceania,19,716.71
caf4291d892c4989b0a4e0dba02a5cde,161,118,43,Africa,20,969.75
caf7bea45d47488dbeec4c31238bc2dd,303,253,50,Africa,22,2053.28
caf8786e5dfc40e4b298e96513b87b68,119,95,24,Oceania,26,1141.43
cafaadf3215246b9b132669439dcecd8,357,321,36,Oceania,22,2376.6
cafb814fe5de4968862610d7d865e3e9,187,143,44,South America,20,772.35
cafb8b02330e402581b2c6da0fdff0db,360,317,43,Africa,18,1954.39
cafc0964b96840ac9140f762683bd4e1,180,162,18,Europe,23,1350.46
cb013944a5d14277a01b56df1ee2b9a3,106,68,38,South America,18,848.59
cb027ebf8b4248b59bb0c1390aab2882,51,29,22,Europe,19,363.49
cb0430e3f5c748f9b494674a529d39da,362,319,43,North America,17,1957.27
cb0438437e7641c1ac60847aed7c9783,364,340,24,Asia,20,2148.03
cb04a508fb5d4b888381432b582fbade,365,355,10,Oceania,16,2733.48
cb067dcd7dd7440f82f684ac89e57177,365,357,8,Africa,20,2076.64
cb06b68dbe0e4ca4ab6199d6074b5fd9,360,336,24,North America,20,2748.89
cb088846f34a463dad285d248fb1ddbf,104,44,60,Europe,22,394.46
cb0c58c5f35d4926aceb51475808b285,326,290,36,Africa,19,1954.9
cb0de220dfe44bd1a03c5208aabf9016,310,292,18,South America,21,2088.48
cb110de173314426ba71bbe186cd6aa1,352,309,43,North America,15,2255.08
cb11a135dee040578e848b1e4ecb7054,47,20,27,Europe,20,206.59
cb1348d8e2314c4288de60754f573079,104,84,20,Europe,20,1052.5
cb15ca7886814abc9e05e0d0c24bb7e6,59,37,22,North America,21,572.02
cb16e9c1b5fa46af90f26ccedfa67852,364,344,20,Asia,25,2937.57
cb17cea5b8044adbaee8ceaf653dfbde,234,217,17,North America,21,2043.78
cb1802af25b3407caa2704137a0efb27,199,155,44,Europe,22,904.87
cb1b002f83fb445999f2b9b7d906c332,84,47,37,Europe,15,692.32
cb1f2d60256c4bd1b8047777d2981703,212,175,37,Asia,22,1334.28
cb21370f383343a88281cf2939fce448,190,153,37,South America,20,907.4
cb2210d1baa34b6d99ac031da44305bf,202,164,38,Europe,21,1994.54
cb22b657ebca4b9db310003413dc2009,362,305,57,South America,16,1373.98
cb22f69b10d34968a80322e49f179ea1,364,328,36,Europe,21,1614.47
cb2506fd144e4e8aa71d01fe87d97b0a,37,11,26,North America,17,275.13
cb2642b360744aeb93f6a1fa6f06faa5,240,217,23,Asia,17,2564.82
cb265ca162334d44a39e3c95b6d57cb3,335,280,55,Asia,22,2210.35
cb27d516daf54633872dd670a79b406b,43,24,19,Europe,16,240.95
cb2865b307b542409b5f424093c32da7,305,260,45,North America,22,1516.16
cb2a89caa56c46ea81b9240a20aab012,215,185,30,Asia,16,1764.99
cb2bb80173a748689580511bd331c18c,188,154,34,South America,19,1372.89
cb2bbf269dde4bf3b8b881748e6508bc,305,290,15,Europe,17,2169.31
cb2cb360291d4ee9bf0b05c84331deeb,352,291,61,Oceania,22,1624.77
cb2d30e27ca44ed8a29fd3f42bddac16,365,353,12,Africa,21,2398.33
cb2f5801b301422f9fd0e368a645eafe,329,304,25,Asia,16,1828.96
cb320df9fcfe4292b8f6fc7094514291,191,146,45,Asia,23,670.13
cb33094b0f4540ccb1934a9044e66077,273,234,39,North America,21,1704.25
cb3483f0945641bea9a730eaf4d01cc5,266,240,26,Europe,20,2235.9
cb3c344a858047258af6ef735ebb55eb,92,57,35,Europe,19,760.11
cb3f609752fe48698cc51b8d778de37d,271,233,38,Oceania,22,1490.5
cb42223632dc451faa818a8e31f7b999,302,275,27,Asia,10,2342.9
cb4326e9a0af4bb0a8fae1124d297969,146,118,28,Asia,17,1141.92
cb43b63c48f34cdd872de7f002e70766,127,78,49,Europe,20,544.72
cb43cf1869274e139d45869125a185d3,214,162,52,Oceania,24,1343.77
cb4587f85bd94a0fab3c9c33e8020548,324,302,22,Europe,21,2750.23
cb46e2247cf1443a8be7866e02a3b5f7,262,233,29,Europe,24,1525.05
cb4a1fe410ba4e2490e677ca129cf009,57,37,20,Europe,15,386.38
cb4ae45080c9420480460bbd86ec6ed9,240,190,50,North America,22,1355.22
cb4af676f6724603bd80086d5780c83c,112,78,34,South America,23,1478.93
cb4b8f1db4884c5297b937211184d45e,302,284,18,Europe,17,1761.61
cb4bd8ce2b8145779d58880ab0e0d906,217,168,49,Europe,20,918.4
cb4c80a025df4ec4a87525840893fe1a,314,262,52,Asia,19,2481.77
cb4d929e7a974d4db18a78f051900936,364,344,20,Asia,20,2501.27
cb53a5878e964b36b8955416d9a4384b,280,235,45,Asia,22,1836.12
cb5500a61d894319a73aecc099904ad2,154,127,27,Asia,11,961.18
cb5570ad4d8c4461a995b846044727a8,62,11,51,Oceania,19,193.31
cb57eacabad14af48c8f53c954d7b140,76,30,46,North America,19,530.55
cb59335a99a341d09ef88ce26a6e97d0,141,87,54,Asia,22,831.08
cb5d54b4a9404c89bb7f44a9cdfb8018,102,48,54,Asia,20,510.48
cb5e58e6c760439fa16624b3540cdc73,106,73,33,Africa,19,958.03
cb5e867eb86e470fbb5938b3de7a1597,225,175,50,Africa,22,1061.87
cb5f7172d35347ff89e8ebed928eee94,185,147,38,Asia,21,1740.5
cb60977ddd7a4d84ab86de96ed3e2916,83,58,25,South America,23,643.31
cb61f2babfe049e9a09bfe9c22b2f007,364,316,48,Africa,19,1833.01
cb6240670ca4493c9a17ba8871cdcf6a,256,216,40,North America,17,2223.48
cb63bc4eaba74034841348791c707006,365,335,30,Oceania,20,2639.21
cb63f1754dc24991a50d3b059996ec7c,129,112,17,South America,14,880.2
cb642bace1ab436ab6b513946d651336,241,219,22,Asia,21,2165.73
cb64797e3f6044a2b511d06747aced5a,132,84,48,Asia,19,674.44
cb64bb5782dc4cfe9d63cffa0acb8e85,276,224,52,Oceania,22,1204.83
cb653f45125049dfa294ba87e70ada2f,365,363,2,South America,13,2542.83
cb65989d3b3b4fee892c53f8009b89f3,198,148,50,Oceania,22,846.53
cb66e5f8bed04888aa59536ae22442e4,98,81,17,Asia,20,783
cb681e3d821d4436944c38051545d966,145,95,50,Europe,25,1180.07
cb68627335944e16aa2483f79ff5f3b5,132,74,58,Europe,27,406.5
cb687097de11436cbc29f5bcae9f8e00,80,46,34,Europe,23,614.34
cb6b1dc54738455692ed9a74c525afa5,211,174,37,Oceania,17,1561.07
cb6d34a5d0de48eea9a3f556e7c870ce,187,141,46,North America,20,886.49
cb6fa8cbc77e464ab5df966b75371107,269,250,19,Asia,24,2308.52
cb70432ce8214f0fb96c11ea2d4c5fb4,53,23,30,Europe,20,672.22
cb71fe7bfab24bbf920e31b565b61353,152,122,30,North America,15,1206.45
cb72ef7d97484ab380dc7ae31477cebc,158,104,54,Europe,21,431.94
cb73a7aa2fef49d8865c2738bf4e85d9,154,105,49,South America,22,1099.65
cb73cc460b07408984804279b2e6645e,81,50,31,Oceania,19,607.93
cb75319145e344b983f59fe5b0162da4,363,324,39,Africa,12,1745.95
cb757ac4c7be4bcfb52954323d676ba6,141,131,10,Africa,18,1183.38
cb7683a35ddc4ab8ba3a41c577ee5038,296,257,39,South America,18,2349.9
cb770b5ce6594864966220802403e656,362,329,33,South America,25,2314.73
cb79ef96f3ee4d96a2cc9b7a0ef25c8d,285,240,45,Africa,18,1365.8
cb7aa69bb32f40869f1cd34de64f0158,127,99,28,Oceania,15,830.44
cb7c3363d4cc406cba9f6d34a9e3eb56,252,227,25,North America,19,1600.36
cb7ced433f1440d98a00f2dd663e09da,67,33,34,South America,22,309.77
cb7cf2b7751146cfb6ccbd19d21ce720,247,196,51,Asia,19,923.87
cb7ef656a85f4beaa9c05ea6c10b33e0,303,283,20,Oceania,21,2029.29
cb7f00f434164e8c83106ccc4af38ddc,135,92,43,South America,21,656.94
cb80aa4801f44e2b86c246c8daaebbcb,364,337,27,Africa,17,1363.86
cb80f09e58be4c05a8cd6b939dae3f83,250,234,16,Oceania,24,2005.92
cb825b36c0f54d0c9434c99a40dae62a,29,7,22,Africa,23,115.41
cb842df18f394c4fa356f9299217aab7,128,105,23,North America,22,1178.35
cb8486cd91114aee812a52874547dd27,326,295,31,North America,17,2660.16
cb8a681d9940454493a9a0b1788a3d72,191,159,32,Oceania,15,1407.05
cb8cd11545244a48986a4820b6489df6,351,321,30,North America,22,3101.85
cb929913bd824c9294956b08b318e8c2,318,277,41,Europe,14,1449.34
cb98eb23579843eabe2f6d0353612322,100,50,50,Africa,24,463.57
cb99254cd06e4ae4b77c0dfe1e108bb8,364,359,5,Asia,23,2050.64
cb9b37e17ebe4ee88e1b009be8b6bd9e,154,126,28,North America,17,1413.77
cb9cd9df9f7844d9bbb3f86d8f78f985,364,346,18,Africa,18,2364.76
cba0c2407c504633ab8078bb2ef45ffb,153,105,48,Europe,16,1110.3
cba12cbaf17c4eeba1dbc611a90f97a4,363,317,46,Oceania,23,2332.74
cba3c6c56fab4f9cbc6d896cae15b502,91,46,45,South America,19,554.59
cba496f72e3b4278a6e2405226d34cee,113,83,30,South America,27,972.3
cba535148f744e8dbd5cd14c546646c9,171,152,19,Europe,20,1593.24
cba59aa1f16749e780518309d896e3ca,247,208,39,Oceania,19,1032.64
cba6a4da86c34127a60bb27f1fd600e4,194,154,40,Europe,20,1465.55
cba768b54b0d4e109661026f9906f93a,331,294,37,South America,18,2737.77
cba7c1106fe7425e93f3ac8ff895fd8a,339,317,22,Africa,16,2261.15
cba93ddc02a74bc68334d3317be99b8f,70,40,30,Africa,25,243.35
cbab478885794b159bcc35e4ddf00fb8,149,110,39,Europe,19,1125.19
cbace12e333f497ba43380fff2ea4bd5,188,151,37,Europe,15,1216.9
cbaea2f2011045529f3964c58d0c65a6,117,95,22,Africa,14,567.18
cbaec2f5b02a4884b8b1b70625a76b21,275,220,55,South America,16,1173.06
cbb28aeb83ea49148818e8bf3797b2b3,112,76,36,Asia,21,651.91
cbb3ab43f3ff4d7d94a5559fdd8bdb0f,291,256,35,Asia,18,1978.24
cbb686e9f35d41d5ab4183768da383f7,122,76,46,Africa,19,908.29
cbb7127513e542c5b581ff4d4b032fa4,216,191,25,South America,22,1715.67
cbb8383f618247ea80ecaa901c408577,285,267,18,Europe,20,2490.71
cbb8f0e9d3b64ea8a77f060fa5e2ee36,126,87,39,Africa,20,485.89
cbb8fb5aa9c340c1979bea9603b02d5b,242,215,27,Africa,20,2127.53
cbb9c3871993405fa70cf1ed6a21c9bb,110,60,50,Asia,17,897.09
cbbc1eb1f6b9447ca7e54caa94f808d6,155,107,48,North America,26,594.35
cbbd07311f584456bc44995f6d1b3d2f,255,221,34,Asia,20,1941.24
cbbe8812a2af45289ca0c2337366a0a7,106,64,42,South America,19,1134.22
cbbe9004b5d741f9a260c306f2dc8c87,365,359,6,North America,18,2587.82
cbbf4debac6340f399c7d7237656e980,200,185,15,Africa,20,1540.25
cbbf5b0fbf7742f6a978cbd85c41adba,351,315,36,North America,19,2262.11
cbbfb37e15bc4bc19a735840cc8c0c87,363,363,0,Asia,18,2007.4
cbc01562951848b784e96887e52d9b6a,70,29,41,North America,20,437.16
cbc2c7c9531c49689c5f65816f75a8d0,228,178,50,North America,22,1191.95
cbc4c132745c45f897ad387b6b578547,360,359,1,Oceania,19,2899.03
cbc4ef30b2d840d8a476118a55a6eda8,177,126,51,Oceania,19,643.77
cbc67f957c2c4b9cb36b62ab34d7263b,69,49,20,North America,23,308.93
cbc80f5698514af5ac51142c953d26e8,175,151,24,Oceania,21,1440.8
cbc9056881214d09946845177b335799,311,286,25,Oceania,20,2493.37
cbc9ad1bc2a84d51b7f5a4435eb483dd,321,266,55,Asia,17,1655.06
cbcb2133fde049d5a9977ed886940603,71,19,52,Oceania,19,310.95
cbcb66e9129c419cad28a70286aa2549,365,350,15,Asia,13,2528.74
cbcba4d253944b4e823a2ca386268ce6,232,180,52,Asia,18,1153.92
cbcbfdf41c14479d818665cdcff519e2,208,184,24,Europe,20,1204.6
cbd01c57eec0446f886d35402038fff7,105,70,35,North America,16,691.27
cbd0c851f1b8449d81cb22a14abf7096,150,106,44,Oceania,21,1251.95
cbd271a2ab9c4ec9ae3a9d0ff8ea3545,257,217,40,South America,23,1362.02
cbd43596deef4867ab8edc6c37303a8c,104,84,20,South America,17,755.6
cbd43c63fc6a45f0a625377e47db6e16,159,115,44,Oceania,17,1416.77
cbd53ea5592543a590c1b8cffaf2ee84,116,91,25,Asia,21,901.76
cbd814aeb56047a69fe90b9024f1e8a1,234,188,46,South America,19,1288.34
cbd862b76c6847cf80c4c256681681f3,135,117,18,Europe,26,1262.36
cbd89adf78b14aa2a7bdc250057b2bb9,151,129,22,Africa,21,1110.19
cbd8cd06171e40448a23ca2ee284674b,345,313,32,North America,18,2877.82
cbdb952ae9a845dd9c658c29afa5d31e,261,222,39,Asia,20,1709.94
cbdc228a70d541079c9a84915cce969d,365,327,38,South America,19,2984.48
cbdd97b822714bf19f4727ebee68803b,365,347,18,Europe,21,2295.8
cbde75d0abb5401b91322523b0d0c130,171,134,37,North America,20,1091.53
cbdfeef3a967470e8835ffdab2dac208,244,214,30,South America,24,1435.33
cbe3692c7c9c476589697c84a1454052,81,35,46,North America,24,91.71
cbe59b1885a34a87acffa397cc8b0c83,99,70,29,Europe,24,334.75
cbe6c554ee754a0da61c2a0b2d5e03e7,179,151,28,Europe,24,1408.06
cbe6dc73afb94d5f902d16427e784261,79,21,58,South America,21,515.75
cbe7603aebb3487e97a350e4780c140a,278,254,24,North America,11,2368.8
cbe80d481f674bb3bc038cbed6e60fa2,56,25,31,Europe,21,397.41
cbe955191df64fc995efbbddb1736f8a,105,66,39,Europe,24,796.42
cbece1feedf94f58ae2f34ccfea0ba59,196,147,49,South America,19,1069.5
cbed575465be4dc883842167001d0c88,120,103,17,North America,13,862.59
cbf2996678374a45b65535d9ddb36c3a,213,161,52,Oceania,21,757.29
cbf54d18470b4e8db18dd14a9445bf92,176,135,41,Asia,19,1283.69
cbf58952b0a849ec88af3e6841eff04d,165,127,38,Asia,19,660.71
cbf9090db6294ea48be8534515cd8df1,151,131,20,South America,20,1456.53
cbfad76500e1473782676d9e8e67f5f9,259,232,27,South America,20,1743.79
cc02bfaf7bb94dc580abe47c57b96422,193,170,23,Asia,21,1148.48
cc046470b65d45ce86d9d7a2e45d8e83,200,148,52,Asia,20,1096.72
cc065b5f47154c40bc04adaacd75ab4c,165,128,37,South America,17,1553.35
cc0675eb16584248a633b793b63245f1,116,88,28,North America,27,610.87
cc0b8661f6ef48db9257ccd8e68dc7d8,227,203,24,North America,18,1799.44
cc0d81e5e09145b9834c88feda547326,179,128,51,Oceania,18,866.9
cc0dedc9f2ad42bdbedb6e333ea48acc,361,350,11,Oceania,20,3668.91
cc0f9722e2b8421f8e8674b05ce29784,338,312,26,South America,21,2026.26
cc1250fb1eed48be93e8f439cd99198f,340,293,47,North America,18,1355.37
cc13b09a86394ac7959f047cb2a2e5a9,76,45,31,Oceania,26,677.01
cc13e9f8077d427b91cfea20179ddbf8,247,207,40,Oceania,15,2336.59
cc1400e6e7b04e51a95fd3b63cb49c60,352,298,54,Africa,22,1925.56
cc168bbd35e34ba7b61f09fccea40652,99,66,33,North America,26,557.75
cc173054b25b4f2c9c9067bd567c6013,190,149,41,Asia,21,1240.9
cc17775cec5d4ac0a0b58f6d7c615695,325,304,21,North America,25,2150.76
cc19566acd6a40e4930a69d501e1c269,284,257,27,Europe,26,2106.42
cc1c868bec6d4f3b8f783624eb720307,68,42,26,Asia,15,376.56
cc1cf31603294f3894972264440f3e05,37,5,32,Oceania,17,217.8
cc1f4ee9c55b44f5be8394cbf6a0779a,52,31,21,South America,26,623.95
cc21637e3f18432d825f2ad8ef0964c2,271,226,45,Africa,18,1419.01
cc216a96a37f437f9b6908b72dacb051,302,272,30,Asia,17,1935.91
cc2510b60f7a47138ca3a20f0ac1bd8d,314,284,30,Africa,21,2008.95
cc267981a2494d24bf7ca27ed3cbb76e,187,144,43,North America,21,1128.45
cc2da99ffe3e47f795451d7ede77354d,124,82,42,Oceania,23,353.12
cc3099b4064545b3848751d4a65ad9e2,274,251,23,Africa,24,2261.59
cc3338ebb6624ea5b345b1971f294e69,127,100,27,Oceania,13,933.6
cc339577d28648508c2c82e6940f4e24,48,7,41,North America,18,243.71
cc3512e0abfc4fba98ef6bc9690364a4,97,61,36,Africa,25,382.39
cc36cf305f3c4badaf25b9a38a672c47,344,300,44,South America,19,1673.39
cc37329ae9734c60ae6aa7404ecd4c04,277,235,42,Africa,21,2350.33
cc3760fe5307411dba912220f6228c7b,217,174,43,Europe,20,1540.05
cc37631fcf7d4bb297d4f0d282095857,62,39,23,Europe,22,377.82
cc379797003f4d11a1fac662744ee5d9,118,91,27,South America,22,599.96
cc387bf93db2412080aa3338ddec94ba,365,359,6,Europe,15,1485.46
cc3aa916af6145b49f1f422ab9e80d74,170,148,22,North America,19,1994.4
cc3af21ca5fb4a35b5c1fe8ecf04f90d,163,108,55,Europe,13,628.79
cc3b8494252c4b2c8f7385d719ff15ad,73,23,50,Africa,21,224.18
cc3bf305961d4d2c9439e6f23c6b6de2,23,3,20,Africa,25,37.47
cc3cc3c894534a0195c460c3f2788a36,212,190,22,Asia,20,1501.62
cc3cdc2b6ed647308fac388ece5ef3a5,175,129,46,North America,15,743.16
cc3ce8f250f441d3807f6d904a2e35c0,42,9,33,Oceania,24,188.47
cc3e24bf4e7447c8a36bddb2eb578751,145,105,40,Europe,22,823.93
cc419eade1894967a66b3ac75d738230,324,296,28,South America,23,2115.37
cc42510fa48b4e549f71ab4284add103,186,158,28,Asia,23,1192
cc426807af0643828cd5abb3ac17cca1,97,55,42,North America,23,537.56
cc43241d5a8e4f59a898cf3dd7ccc44d,71,42,29,Asia,16,408.72
cc434e7efb0f4d8699c0a64493d12dda,67,33,34,Europe,18,727.69
cc454cd2728d486480652bf818c9d694,180,142,38,Africa,15,1993.52
cc470627558f40bcba601344f57404af,274,238,36,South America,21,1633.8
cc49b1ed6ad04c739ea451338f8d13ed,322,277,45,South America,24,1473.74
cc4a00b53d5d4293858a8e011cb8e813,275,249,26,Oceania,25,1236.78
cc4a84adf47f4369b699ad4689b02038,164,115,49,North America,11,369.63
cc4b709624d84c1c924366aca726d706,342,307,35,Africa,14,1992.98
cc4eec260b5143068cb5c293de6f3bcc,250,209,41,Africa,18,1769.58
cc53bbfe168a476abbb79081bd2518dc,330,283,47,Asia,17,1734.77
cc53dde966bd4332a63d242c921ab1aa,292,264,28,Europe,20,2272.22
cc542c9361324f35a85b8794b11369fb,320,261,59,North America,23,1490.98
cc545b26543648c5816bf8aa278fa082,155,114,41,Africa,18,582.38
cc55c116dadf41df938022150d23c9f9,229,178,51,South America,22,1138.34
cc572e16dfc34d639dd7b2eb9da0d678,244,216,28,Africa,17,1510.93
cc57d8bb28744dbcabd0850f0fa4cba8,357,338,19,Asia,18,3162.36
cc583469043049ffb6e991e5996c0f10,202,174,28,Europe,20,1544.34
cc58c689348d446d9946b61e05d65deb,253,219,34,South America,14,1826.94
cc5addf0f70844a2be6f49bfabd14c36,69,18,51,Oceania,21,289
cc5b4d89b1614e119d0faa7b2666b26d,342,305,37,North America,19,2149.94
cc5daf0bc81e4008a5ea8edc8f6ea8c8,231,206,25,Asia,18,1762.29
cc5f903420cc413e82d0e98c5425d5bd,348,315,33,North America,23,2504.44
cc60a3d829354c6ea5cd45bf26755f02,60,31,29,Asia,17,595.78
cc60b317d3ce42a080681dc55171dac8,70,47,23,Asia,22,395.22
cc627e721939425f867851e45c15e3a9,76,27,49,Asia,18,591.88
cc62e2ac249241bdad1d1ea58aa3cffd,313,276,37,North America,20,1589.36
cc65f759041a4ddc9454a59ea007c59a,194,170,24,North America,22,1853.26
cc698c3b2f6d4c04b29198525f625a37,364,359,5,South America,18,2968.44
cc6a9c0dcfb5444a903020c990d99c83,361,340,21,Oceania,21,2265.32
cc6b97f1bc224671a3f723eeeef77cf9,212,193,19,South America,15,983.16
cc6bb500da91470e9e859a8529f033ae,73,24,49,South America,19,463.27
cc6e017f074b4a02bfd0ae1e3b0de4be,236,209,27,South America,21,2175.79
cc6e958f5dd34e1598ecba25684d695f,152,119,33,Oceania,21,1296.28
cc6eeb8ac9984b1a9d04ad7f4f31eece,307,249,58,Oceania,17,1631.78
cc71575eba0b4b22a34c2baaf46c0135,365,343,22,South America,17,2023.24
cc71acfd761b439488b5b83d3e75c1a4,148,97,51,North America,25,586.11
cc71ef0b9e694256ad6e7b7c3cd04fa7,113,81,32,Asia,24,1071.91
cc72a28e8e224a458cd7986737b570a3,315,290,25,South America,21,2325.44
cc754ab33a974b69bac7ddd66af50fcc,132,92,40,Asia,17,1173.29
cc7557676acf49d4b77095763d514261,364,352,12,Asia,18,1908
cc763b10534440339ed4fb6dd3d5f9a1,127,79,48,South America,25,653.62
cc764dc4a78c46a5b2c1ccf0b695440e,123,99,24,South America,18,642.87
cc7af1130e20438e85af0aa2d2c45238,86,50,36,North America,18,466.49
cc7b6b1777414c51a9ab73b9bb544bcd,50,5,45,South America,25,186.04
cc7c95db100a45608783edd9ac771d3f,364,340,24,Europe,22,1568.63
cc7ec22e54b646c4a877056b92b990e4,352,315,37,Asia,18,2173.8
cc7fbe0da0634b9b9a8837b78cfc2045,182,159,23,North America,25,1472.4
cc803926b1a84b48a1fcf407ada15e72,348,298,50,North America,19,1602.9
cc804685182e4ef3b896fa462d38ac14,364,351,13,Asia,18,1929.15
cc843726665044a3a1e362d0eb1fc32d,364,362,2,Africa,20,1663.5
cc86cb90cff44f2c96ae7a58d5dd004f,27,2,25,Africa,18,127.16
cc8774ac3fe843fe86351148d1ccb19f,158,119,39,Oceania,23,1483.46
cc8909468970489da76f2e03c4bac170,296,241,55,South America,24,1534.37
cc8a64a8bb1842a7b37746313172efe4,222,180,42,South America,21,1144.88
cc8b551322ba4fb989c34ab6aed37fd8,365,353,12,South America,23,2136.48
cc8dd66410344f89abcf4f8ef0248536,148,122,26,Africa,23,1105.37
cc8e8846841a4470b549efc04772d33b,172,142,30,South America,18,958.66
cc8ff1c88a654db18a1f9fada9fb209b,365,344,21,South America,23,2376.37
cc91a883dbec488b8ffb5feebcbce819,180,145,35,South America,16,1675.05
cc939e0bc07b4d8b8208d7bae8f2d21b,278,225,53,South America,23,1281.3
cc9512a31279467aaf19d371be44f43f,147,110,37,North America,21,878.47
cc95da817ddd4e208583f1c5931671cf,70,30,40,Europe,18,317.24
cc96c32642a149d9bafabf0183f465b6,61,14,47,Africa,21,752.51
cc976539764f4aaf894afc28c720f265,226,196,30,Asia,21,1897.45
cc9876aa1e7f418c8e341f07e4b560bc,124,78,46,North America,20,943.53
cc9b0a55378541a0998bb13159af8e4f,167,125,42,North America,20,1675.49
cc9cdf9387cd421db76f803eb25b3f1d,155,115,40,North America,27,669.73
cc9d197470c54a2bae61745e06ac8d75,82,59,23,Oceania,16,410.25
cc9e01124b9740ea96cda2571d871d74,34,3,31,Oceania,22,189.01
cca0dc06247546c0b212b0290f91aab1,201,176,25,South America,18,984.59
cca1b44ee4024f7d9b17f68f2fed9e82,261,239,22,Europe,20,1768.8
cca25dab6b724695a6e20ea6a6e133a0,268,246,22,Africa,21,2277.37
cca34cd4859742f6a67ce1a56a166f30,129,114,15,Africa,22,1085.8
cca614ff0b1b4d39bdd069e573381b5d,365,318,47,South America,21,1818.54
cca689e120c0408e8ea30ae2f0dcf105,316,275,41,Asia,19,2383.21
cca74c537c1c467e92b1822dd2a33909,334,302,32,Oceania,19,2007.14
cca983eaa7084c50aea37f3444d440f9,362,357,5,Asia,18,1694.98
ccaac309e8bc4d9f97f6a768044078d4,325,293,32,South America,19,2043.49
ccab5499342a46c2aead231f0c624c96,177,126,51,North America,16,1302.35
ccab6276fa38412387cd67aafb7766e9,316,298,18,Africa,24,2540.31
ccab827b7fd9408e9e919e6160ad5786,348,298,50,South America,24,1423.16
ccac4ae21f1e48a49db67ea5051105e8,236,179,57,Europe,20,1322.52
ccb2bd4407054e59bb34270e03bd7d55,58,36,22,Asia,27,480.01
ccb38726a36f41fbadfba64ed01a79c5,83,40,43,North America,22,328.26
ccb3a5221fc640ec92cf739031b70dad,240,212,28,Africa,21,2579.1
ccb5008d264141d0b1c58000d648aa4e,210,156,54,North America,21,989.41
ccb51d1452c84ebe86d913bf4ad7a3dd,365,365,0,South America,17,2500.96
ccba324d572a424282133894943b547c,123,73,50,North America,20,823.16
ccba81ab43fd43dfbd959c130eb8da62,161,122,39,Africa,23,1014.98
ccbb174a1feb43738742fed5c2845ddd,224,167,57,Oceania,20,1215.33
ccbb9a9cb5dd44ca959f806f501add92,365,354,11,South America,23,2371.7
ccbc9942d9f245c1a900c962cd9cd29e,345,294,51,Oceania,19,1574.46
ccbe59db1e8d4d9e8bb2aabf4df5c2fd,258,234,24,Europe,16,2132.94
ccc0d29e125241759d4485142fa5d838,319,275,44,North America,23,1057.25
ccc196a230fb4dd39a19e23f90b87aca,73,45,28,North America,16,412.79
ccc32073c8a247e684c01ac3cafe593c,364,328,36,Asia,20,1697.36
ccc4ccfab2e4483e999883dea8a6be8a,166,131,35,Oceania,23,767.66
ccc83f9941c44a3f8f9c358e82d0df98,365,360,5,South America,17,2199.03
ccca77e3c17a48ec92e336f163b23a3e,364,311,53,Asia,20,1923.02
cccb8d96ad1a4f88b0bbf99a88ab83a7,295,247,48,Europe,20,1605.07
cccdeda482244e36b6d5ec951b36e750,70,27,43,North America,13,449.33
ccd06ec457a3464ebfd29fe463ee3976,77,39,38,Oceania,21,702.12
ccd2d0ff3faf4ccfa5c43bd1ee41c245,327,305,22,South America,15,2327.95
ccd48119fa544a4683eb74f5b9aa8c93,241,189,52,South America,19,1486.78
ccd51477aeb242edb5fb717ff09baeb3,326,288,38,Oceania,19,2428.42
ccd56f8eaf374768ab19215e98eff8be,181,141,40,Europe,22,1487.92
ccd5b5db6e254c3282ea168cd7a8c905,254,208,46,South America,13,1303.91
ccd7a507a9324c5d9051ea63c88a7a9b,103,56,47,Oceania,21,182.71
ccd7d8c3ff664e00bf7b1674b5741157,213,155,58,Europe,20,1120.54
ccd830c7487f40cdaf0f3fe8a3e6f5d2,115,65,50,Asia,21,450.77
ccdac533bb9d4c2f9db1a45ad4359748,347,289,58,South America,21,2158.56
ccdd9a398dac4a9fb032adf6fef25c4d,323,297,26,South America,21,2438.11
ccdda60727f44879be18ba5b3d03e553,299,250,49,Oceania,20,971.49
cce3da8496df4f2a924cd6b5cc3148b6,44,7,37,Africa,17,360.66
cce505083fc349f9a504ac962d5ed4d1,154,131,23,Oceania,21,1015.92
cce8666952f4479eaf5883b336cf8fc1,108,86,22,North America,22,684.74
ccec5e151bb14ee9ab9a25da8cc19c3f,244,204,40,South America,18,1393.68
ccecf009286849c09cf8c4f205f8c1e0,365,352,13,North America,22,2711.61
cced33e70a7b4c47b3e23499372ff8e4,262,239,23,Asia,19,1958
ccf29610b3d04d20896d4c3e2d9306e7,150,112,38,Africa,18,1244.63
ccf40c8b88444bc28c0e4a2cd4d44b7c,171,150,21,Africa,24,1153.01
ccf46a5b5db2468c8d36ca2a111345b9,361,316,45,Oceania,25,2537.94
ccf4939664354805bda5f00e1871c3b9,113,79,34,Asia,17,585.76
ccf5856fb58741788c49cc834f1fc11d,347,326,21,Africa,18,2871.59
ccf5b156213a4840bd04d03b17f70723,364,345,19,Asia,21,3267.48
ccf5ca7ba14a4b048e1386be74f991c0,193,168,25,Oceania,20,1792.33
ccf9d5b25d11474d9806cfb1f60aa3e8,315,279,36,North America,22,2050.74
ccfa499ea39344e589db172bcb23e90d,167,113,54,Europe,19,827.67
ccfed064939d4df89a8193b5ea4af2ee,168,118,50,South America,20,1289.89
ccfefffedea441e5bfe108a088da58f7,365,359,6,Oceania,20,3177.72
ccff10198bf14daeaf11f0e2ca549742,173,139,34,Africa,20,638.82
cd062ea19af14a5593191b19e2344813,365,362,3,Europe,18,1574.71
cd0646bdd55c4d789daf2741df8e7888,365,335,30,South America,13,1649.29
cd073d5afa8e41fb8635e95620dc6429,245,195,50,Oceania,21,1183.57
cd0931f065dd4e36960a6cc6cc0d6f54,365,348,17,South America,21,1365.3
cd096466f69b4ce7adb63a217e92d284,261,212,49,Europe,18,1332.6
cd0f060863334dadb7db291d5f703818,365,349,16,Asia,22,3183.62
cd1159e8ec3440b99b910ce7bd486022,323,287,36,North America,22,2192.04
cd12b9891fbf4e05a8f58a0047b154b5,262,210,52,Africa,21,1336.43
cd14acb07f16449aa53a1b9b4cdc8332,45,22,23,Africa,19,188.74
cd14fb803749477eb6d122d71372ab19,169,144,25,Asia,22,1355.49
cd1714ba443342a2a0ff1940d9010b19,61,39,22,South America,13,554.07
cd194c3f4488460397c80a8be6a6ac90,137,111,26,Oceania,20,1250.99
cd1e32201a4245e49c4376c5b099c0a5,61,29,32,Oceania,21,580.83
cd1f6742b50a4a3886d94fffe191745a,86,57,29,Asia,16,741.34
cd1fd137c5644707a6281b62a3fa1561,183,140,43,Europe,20,1013.5
cd20b9e84ebe40d6923205c6b91f4929,229,180,49,South America,21,700.69
cd211379e2154984965445750a055d94,165,128,37,Europe,26,1416.9
cd212d2749c54bd5a97b55f06a006e76,364,340,24,Europe,19,1441.14
cd219e8f12f84b23a1b6ea33a2dc7a2a,315,298,17,Asia,15,2513.29
cd21aef10a27442b90e9abd3c43ef04e,129,83,46,Africa,21,803.16
cd221b2f33be472681bf08e290a3c31b,47,14,33,South America,18,462.95
cd22fc3ade364f79a197e6b2c4db0d8a,176,129,47,Africa,21,970.46
cd23486a9a7648b7a96a9429568dc802,215,169,46,Europe,23,1813.9
cd27feec5f17494ea918dd072303ef61,183,140,43,Africa,14,411.38
cd2818ddcdff4b4d8ecda55b8b4cef45,302,274,28,Oceania,22,2169.89
cd28f74e007849c78bc916336f092498,334,282,52,Europe,22,1606
cd2c49ebe0804db59bb8818feaf8caa5,243,204,39,Europe,21,1830.26
cd31b950635446b3856728bf60985a73,181,160,21,Oceania,22,1574.91
cd31bfbde90544938ff1053a407cf6c3,177,116,61,North America,21,706.19
cd334c466c2642dc823cc3c719f68511,37,3,34,Asia,18,214.18
cd342a8c002d4bfebdd244972496210c,216,165,51,Europe,21,1509.58
cd354464f2a541a8924908c4d6a1448a,337,293,44,Oceania,22,2234.57
cd36a1dcf5324d50b751a95a488f479f,53,24,29,North America,22,240.45
cd386014aa374be4bd40edc41050c240,177,134,43,South America,21,499.34
cd3cfe2916d04a07a2031f9981e0911a,99,58,41,North America,19,879.07
cd3d3c0e1ca84018808013430af0359e,94,57,37,Europe,18,394.16
cd423d2ecd0340cb8489e05a5c30a526,303,281,22,Europe,15,1544.73
cd433317ee724528829f1ef0b59f2a76,265,219,46,South America,16,1407.06
cd47c5f88d7e41bbaea1fce4a7850ee7,361,359,2,Europe,21,1816.08
cd4854ca14d946a290c76829a3e8751c,177,144,33,Oceania,15,909.35
cd486a0ecd5c4c939b1a37daf2fc880b,203,145,58,Oceania,20,1606.13
cd4b9c5b01324c569458b29202e5efa3,341,317,24,Oceania,21,2691.3
cd4e04a5dd6046b2b5804882d6ae7444,168,145,23,North America,21,1441.15
cd4e10c75ecc4ba0918b9d3afd40a47e,363,357,6,North America,22,2228.08
cd4ec4ec4d1440cc9e58077de640accf,34,2,32,Oceania,19,343.81
cd4f58b6ffbf474d981123d3a5ac57af,365,340,25,Oceania,17,2150.6
cd5054fab20b4bf5b55f3ad320ce0c67,66,9,57,North America,18,314.9
cd51690058384e868af64127c69e1b79,74,43,31,Asia,22,690.33
cd52ad2d20264b28bdfa49909d63df22,235,203,32,Oceania,26,1441.73
cd52dce2d8bf4c238a90d53d1fda30c1,140,113,27,Africa,31,974.81
cd548dfda41744f58ff8cc41129ae379,115,61,54,Europe,19,319.66
cd54a3b7352d47e8bf9d245c65c464a3,347,300,47,Asia,20,2586.44
cd567132bf3c40e5bd99b58362c1d1e9,316,277,39,Europe,20,2373.44
cd57886210ea40b8986ed28c9eb86457,315,283,32,Europe,23,2188.03
cd57caf7dfd84fc981494cba34384020,124,75,49,North America,22,757.01
cd593994aeac47bc89b4d4fa53aa5640,169,118,51,North America,24,839.01
cd5adbfd4cfe468dab074cc2e193460b,173,143,30,South America,21,1156.77
cd5b9e7f7b31421e96739f15427d4538,365,316,49,North America,22,1856.65
cd5e89662b284dc6b6fff93e963ae2b7,168,121,47,Asia,18,999.46
cd5ee6797b084ca58df29a5323211861,269,215,54,Asia,13,1210.86
cd6091bf569240a1910a0a5e0878a686,272,243,29,South America,20,1837.45
cd6168cfaeac4493ad88c7c7cacb0c20,322,295,27,Africa,20,2675.05
cd6233fe13d94c20a1cf80aee67b98cd,89,58,31,North America,22,669.19
cd62edbc84514560a43cbb603dedd0fa,353,324,29,South America,15,2499.31
cd6375f1ad834736aa96b9822142b3bf,186,133,53,Africa,23,540.63
cd666bfd75fd482d8c776a1a22251d6f,41,1,40,Asia,20,406.45
cd67419df84e4b609e74ce4cb349f054,272,241,31,Africa,26,1724.52
cd68e11d8aaf4a4fa3bbacb1411c3abf,288,248,40,South America,16,1928.04
cd6cc659db9749db9c44ecee396e7509,342,304,38,Europe,14,1877.05
cd709f1a066841149bfcbc9c439ea345,203,163,40,Africa,16,1471.61
cd711788e98244d6bc429262f660cc38,365,343,22,Africa,18,1681.51
cd71c7f9e3f948efa8e9fdbc3bb72e58,181,143,38,North America,19,1748.51
cd722a127821413d9d7498c55c75d414,309,267,42,Asia,22,2298.57
cd75ad9b98a242c2a957b9d29849e8eb,134,115,19,Asia,17,1389.6
cd7b77f6ec3345238755b1adfa97f8ca,105,65,40,Africa,17,480.7
cd80a5114266444f8d264261eb95fe83,162,119,43,Asia,19,795.18
cd8146fa1e2e4f468f64cf39fc81abf1,313,263,50,Europe,21,1397.72
cd83ae9649b249fd86b610f95677a943,337,288,49,Africa,21,1382.31
cd83cb93cfff4820a9ca0b97082dfd96,70,35,35,Africa,24,675.91
cd84c38f5a7b4bdc865a8cf897a456a8,42,11,31,Africa,19,50.01
cd859349fee94f04bdf3a79069819132,180,148,32,Oceania,18,966.3
cd86969a0ae747868d09407afcd63745,258,205,53,Asia,22,842.27
cd86e063c96c4afcb83a06ca990e9f5c,121,103,18,North America,23,984.39
cd88c3cd8f994b1dbf6b72f7743b9e20,356,320,36,Oceania,15,2423.3
cd8b222a127749f88842387d5fdaddc2,178,123,55,South America,20,789.11
cd8b72803e2742e197c2494b4f8ec901,357,329,28,Africa,22,2455.53
cd8c7a8057f9434f9babbdebb9312754,268,211,57,Europe,31,1292.01
cd8ddeafe8284053bc11052f670dbac7,365,340,25,South America,14,2577.97
cd91fb9b71114ba18c90705c5cdc2603,199,155,44,Asia,15,602.93
cd941ab5401b4452bee879b96e68bf18,109,65,44,Oceania,17,841.6
cd964517f6d14a9ba1d408e7267951a9,365,355,10,Africa,17,2151.51
cd993f1c74c84c4b972952e23783faf8,365,347,18,Africa,21,1890.02
cd9a6a4a2f6047feb45f21c175616a13,247,225,22,Oceania,18,1451.77
cd9a720210dd4fae85772aa29dd131af,103,55,48,Oceania,20,753.66
cd9d984f658d4476a0eb584c806e3445,197,170,27,Asia,20,1441.28
cd9e9a7d8a29457a89ad036501c9903f,196,150,46,Africa,18,1132.79
cda2f6a0d4bc45c99438d6a5b6bfbce9,267,220,47,South America,16,1041.15
cda2f9ff3b6f40988f6805ed2f15a616,114,76,38,North America,24,1166.64
cda3a2f216194da2b7cbfb863cb46d1a,365,324,41,South America,22,1565.91
cda4bdbceb6d4cd79810eef10a2cf275,56,27,29,North America,20,324.82
cda76c7bc742405d82f433eba1055a45,67,17,50,South America,23,350.31
cda8c48f32d14d739246e4ba649d4562,187,171,16,Africa,21,1471.64
cdaaae01ffe24ca8a57c6ca578cd2385,252,232,20,Europe,21,2226.96
cdac9ae57f434c2ca79b132ae831084c,140,99,41,Oceania,17,908.8
cdae39ec80e54877b000196b8522977e,256,214,42,Europe,20,1922.49
cdae4bef70ed4cb88a735d38da2a4425,74,26,48,Oceania,20,564.78
cdb25387128f4f17b2c8621cc142e855,130,96,34,Europe,19,287.18
cdb342f4f3f74663a0dcdecd5f6e3cd1,262,230,32,Asia,21,2461.87
cdb4f85f26b24867b9cc1a27ecf90ce4,365,337,28,North America,20,2276.51
cdb5682f274a4727bae7fbdf245ea8f0,155,106,49,Oceania,22,1045.71
cdb5bcf815bd45909018209ebbd53436,92,65,27,Europe,20,709.17
cdb65525f7bd42da9e5f680c32779929,330,286,44,North America,16,1944.72
cdb693a261c64333aef768dfaea31ec2,361,322,39,Oceania,21,1606.77
cdb7d293d1b9419d82f7323f10cf1513,171,135,36,South America,19,1103.39
cdb86c8481394e6a8be36717be3eade9,205,150,55,Asia,27,613.34
cdb872806e8445d68d0bc243b7a74db2,301,278,23,Asia,20,2242.12
cdb877e56eaf45e4a4ed45b73de39a38,147,111,36,Europe,16,1028.72
cdba3f4cdd774bcba7fe1b99c94addd6,94,55,39,Asia,18,1123.22
cdbab97ec71646c69fb94ec4df943b27,250,225,25,North America,22,1892.07
cdbad7a0e56b48bea90aa1958364a108,280,252,28,Oceania,20,2042.97
cdbe15524a774d7597431c4edca3704d,130,85,45,Oceania,17,721.88
cdbf5c5a61e14d9a9faec358bee1f459,274,244,30,Europe,19,1846.6
cdc106d1dadc45c7822f0fe4e09a09aa,47,10,37,Europe,19,248.26
cdc186d6d006453c906623e524ff7ea7,158,118,40,Europe,13,998.89
cdc343b495074799afa072ea9c3cd67c,221,203,18,Asia,16,1652.49
cdc381cd762c42c299e4d86eb9cc8d51,351,329,22,Africa,21,2731.77
cdc3b5424ac2430abecd74917217b988,202,171,31,North America,19,1464.07
cdc5bdd2504e4baaa7b807c6bae787cb,136,92,44,Africa,21,1150.35
cdcbb5f439504a5ea8dcd34816297522,355,330,25,North America,20,1870.42
cdcc461b78b14c35971b093161949dab,299,273,26,North America,18,2063.2
cdcd052a22f94c47b3423bbf37030df5,363,324,39,South America,22,2718.84
cdce10468f314a95b388f482447d8a8c,110,62,48,Africa,23,750.88
cdceed2c4dd546a1880e49d980f2b536,227,202,25,South America,16,1991.82
cdd018f76f7c4fd4913dc444a959bf5e,85,45,40,Oceania,17,498.2
cdd0306df3bb4440841596d0a978eeaf,68,28,40,Oceania,20,257.88
cdd1f4f07db64cda92e9b468a3fa13ea,296,269,27,Oceania,25,2270.85
cdd33a5a3cda4e4ebeb08a563fb77443,361,327,34,South America,21,1677.75
cdd414489e2a4dc1aa030ae9c7f7dc03,164,126,38,Europe,23,838.05
cdd41c114ea24a68b5539d7111fbfcbe,147,126,21,Europe,33,995.39
cdd4c4c53dba40e0af1fa6a8a6fd0393,180,147,33,Europe,21,1515.47
cdd65eda71be4999aac90f16ee309102,102,70,32,Asia,21,1229.68
cdd69d07307541d888ace63805772857,79,34,45,Europe,23,619.96
cdda822c0e4a437e8e63c657e5514c44,61,18,43,North America,19,340.79
cdda9b30108b4110b35727decc31e178,52,22,30,Africa,19,242.62
cddad6048bce409e9a34c0a4b92502fd,269,235,34,North America,17,2265.07
cddadecf59a54e45b2c6b8df91eb0323,126,77,49,Africa,21,306.8
cddafef3a84c404a96536e081d7808f8,168,143,25,Asia,25,1021.51
cddc3a17f5ee43848f5dc68ccc275b90,270,216,54,Asia,19,1475.65
cddec3cebd4e4f84a7d1916393212637,365,353,12,Oceania,19,1478.67
cddfde96bcb94cc3bbcba7315586d30d,270,239,31,Europe,19,1942.49
cde06f40a76441c78b8b49aca8918869,365,351,14,Africa,18,2786.19
cde1149685ab4e38a047243596e723ba,356,340,16,Europe,16,2595.7
cde1bea5d0db482681b40cdedf086102,91,57,34,South America,21,915.69
cde1fe9a0d6945aa837ebf12b5e96c9e,244,205,39,North America,20,1748.93
cde59cd6d61b485ea123f34d57668f12,365,351,14,Oceania,20,2770.14
cde5ba911b6449fe9bdad42469d4e652,356,318,38,South America,19,2111.13
cde81ff2444f4c579fbcfd7d9333ed12,95,55,40,North America,17,649.37
cde8674236a74d78ac6207d9569883d2,60,32,28,Europe,22,290.77
cde8b503bf2b4d9a8e7740c3a2fe31fd,154,117,37,Europe,22,1688.37
cde8cee454264c27984664e38f9f24cd,304,258,46,Europe,17,1670.82
cde98a1ccfe44a55b8b8915acfea6ff1,291,250,41,Asia,20,2041.49
cdeaf4d974a345ef9fe66046d1544f15,77,32,45,South America,15,204.39
cdeb73169fb34ca1b226b009e96bbb69,54,12,42,South America,17,43.4
cdeb7db90f8f49dfb8465251e25fe663,346,306,40,North America,17,1801.93
cdeec5944bad4b83b2d53126e861fad5,119,74,45,Oceania,20,480.14
cdef9f473f9d45bf93c19bc9bf24207e,187,160,27,Asia,18,2058.44
cdf022300e78455cb386a5bcf2cdabcf,338,298,40,Europe,26,1944.39
cdf0914d35944e2fae39fceccbbf4c26,158,105,53,North America,21,863.95
cdf0f7521ce340c288a2b3e8eab48cd4,182,151,31,Europe,23,1277.49
cdf10c7d5b1a41fc8e60693ae29bcbd9,113,90,23,South America,15,952.87
cdf244f8db544b82a7f8ffac9cecd044,47,5,42,Oceania,23,314.8
cdf276097d3340da9ced371d39e48668,357,326,31,Oceania,18,3248.1
cdf2f098f1fa4dfaad83f2149fd5ff04,117,94,23,Asia,20,1065.2
cdf3ae1c00db40589016cf167aa973f6,189,167,22,Oceania,23,1203.15
cdf64b4e88a64cc884ac8590d78366b8,365,346,19,Asia,20,2316.9
cdf77e6e29664509a011dd754014a1c1,346,310,36,Europe,19,1857.4
cdf87954e1b2456db7cf5ad4743ebde2,208,159,49,Oceania,22,1114.91
cdf9e524dfb54d86b5bee7b88420e3f8,184,150,34,South America,21,1171.36
cdfcf2d23bb249bb9a8cb74f512eff7e,210,172,38,Asia,27,1639.09
cdfe767b7903441fa45d8a2d84c5e1b9,149,104,45,Africa,15,694.92
cdff2d36ac494cd180864c832f209962,324,276,48,Europe,23,1141.89
ce00414c744142cf86486b85bb34e035,350,332,18,Europe,19,2350.97
ce00a25100ea4422a91ec6f7d2809b19,162,122,40,Africa,18,1143.34
ce0116f246c448e8b50b04d5341211ed,285,248,37,South America,21,1946.39
ce01455f4e6c4217b551f56691a4520c,225,178,47,Europe,19,805.64
ce0398b3f80346cc84441b2ad234c926,168,110,58,Africa,19,989.42
ce056cb4cd094497a7cc21e1f39e79a9,107,55,52,South America,22,488.74
ce0684227fdd410a8b059fcbcd1232df,337,281,56,North America,17,1554.72
ce072974d4d6488cacf1312849f7ece5,302,264,38,North America,23,2536.54
ce09e5a5acb34c4284de4751b874eb85,179,152,27,Asia,19,1406.1
ce0a56cbd7ad4864bc46538430014469,41,6,35,Africa,13,267.51
ce0b21dc74ed4a978280bed86b7dffd2,180,118,62,Oceania,18,1098.08
ce0b4d801c6542c69b34d95283e1f4d1,139,116,23,Oceania,18,848.61
ce0b648a50c74ee2a06e918aa2908698,285,244,41,Asia,23,1609.72
ce0d1f7a22204c61872bc96f02974529,181,134,47,South America,26,778.9
ce0d3a59220a4339938c44d0086fda80,71,44,27,Africa,21,803.98
ce0d5533ec57451b9c9f2e8d96858d6f,161,111,50,Oceania,21,1210.99
ce0f070a04dc404d9f723f4b79ecf4a3,354,328,26,North America,18,2557.62
ce16477ecf954a07aa660d4ab14f473a,332,306,26,North America,24,2777.19
ce1681c3171d4602950788ac98c0c9bb,132,97,35,Asia,18,969.34
ce17b656a36f4145914a4e8b1dd78a26,187,165,22,South America,16,1676.27
ce196dc692f34ecb8214bfcaa0e6948a,214,166,48,South America,23,1136.69
ce1dfab5c3104a0ba304bb7385f0ee6c,364,354,10,North America,17,2502.22
ce1e48674c32418db5481ffc25f0487a,278,233,45,Europe,23,2182.89
ce1eda67817a4394a28cad56b43ddf87,341,315,26,South America,17,2262.31
ce205e0c09a74022b45b97006ec0bc13,183,135,48,North America,22,1429.26
ce21ce1bc055442b9e82bf22d8ff905b,171,118,53,Oceania,17,990.61
ce23bade75f442bd9fab39840244ca2b,280,229,51,North America,24,1783.95
ce23bf2499a246969843066e332bdd8c,364,355,9,North America,20,1633.47
ce23d7c4a2d74ff8b4df81931030e197,112,80,32,Africa,20,842.5
ce23dd3a9c83446faeddb699eed52434,136,86,50,Africa,17,578.4
ce28944ccad34b87bf381e0f54aa6f1e,266,217,49,North America,27,1489.94
ce28bcd900a94e4a9fd39cd78cdb8658,70,38,32,Asia,14,502.39
ce292c716fd4462b870c4db167c39fd5,285,269,16,Africa,26,1921.29
ce29d655aa0545e68cdf525dd0b02bc1,62,7,55,North America,23,75
ce2a4719ad14471fafbc327cd231dd61,272,236,36,South America,17,2261.37
ce2afd0a7ccf46a9bc742f491509dc3d,275,247,28,South America,18,1905.94
ce2b44cba21647199c48fa4b24a5bd0e,240,185,55,South America,19,1044.04
ce2c6ec1d08245cbb729a71feea5c5ff,247,212,35,Oceania,21,1392.07
ce2c74b9a4864bb1845bfdd7f03057e3,53,9,44,Europe,19,285.31
ce2d035a344344ea94470f4099c71bbd,187,166,21,South America,17,1437.96
ce2d99cf2bd8467aa8248d67c673f9b0,327,284,43,Europe,19,1707.5
ce2df1669d374b0993dcde8f907656cd,236,197,39,Asia,16,1351.7
ce2df16d991f45978137cac94de73ace,260,204,56,Oceania,22,975.69
ce2ed56015a54411bf088c71ddf634b9,180,153,27,Europe,21,1404.04
ce2fe712f6cc4a599f9812641eb732eb,82,62,20,Europe,20,666.12
ce3077031f344e9d831fa4cb5029daaf,286,256,30,Asia,20,2442.6
ce30e653b87649978a4e8e1a87ee6c22,296,260,36,North America,22,2330.37
ce3178b2dc954dd3b96ff23df71bab8e,75,48,27,Asia,16,466.97
ce31e74f4770493b80ad548a9ec1198a,112,76,36,South America,17,659.86
ce334b81e25e4a29974d01450a3fa6de,156,121,35,Africa,22,1238.05
ce339dfb4b1d4669ade53eede0abd838,91,55,36,Africa,18,681.62
ce33f6bf3a324481b6b26023a3c00609,81,26,55,North America,18,377.28
ce33fb6167e745b48104ef87643e28e4,320,290,30,Europe,22,2432.92
ce350d86319849d195b57c225cb9c1ca,225,195,30,Asia,17,2021.52
ce35a2a25c9b4db5a81ae5a49a89b7fd,281,244,37,Africa,17,1648.3
ce366c29da944585810bd5ff7ed755b9,355,318,37,South America,19,1887.16
ce37c238d6594f2a96e75657243ae7f7,54,10,44,Asia,21,533.61
ce37d72a456947efaec97549fc388e14,144,107,37,Oceania,12,799.75
ce39f35e1f774951bbc4558aa85c8c83,40,17,23,South America,28,498.43
ce3a1ff20a9341c7baa613d4f20a3566,51,26,25,North America,23,480.83
ce3a601e826c466cac8e5c8054ba96d5,363,329,34,Europe,22,1865.33
ce3c2f009f024aacacd36c89f4b40898,365,321,44,South America,26,1361.54
ce3ef37a031b420790b91127d9f2b05a,295,257,38,Oceania,22,1939.51
ce3f016f6b624faab034f5eaf6104846,365,316,49,Europe,25,3227.12
ce3f1e8891f84acf9abad7ae6fd5871d,332,280,52,Asia,18,1551.85
ce42392769b94e4a87130f7deb2b87c2,259,207,52,Asia,17,1357.34
ce4252ea14774e7c9d85f268ec059d18,363,329,34,Asia,21,2570.75
ce438e30d5d743d4a87d173843128b06,185,153,32,South America,22,1084.71
ce48cf996b1549c88354da1eebe15d31,301,264,37,Asia,23,2422.24
ce4c74677ed042d8b4dd159e25ba8af8,349,337,12,North America,23,2869.58
ce4cdefc52be4511a1c3a650903f51ac,78,24,54,Asia,18,449.25
ce4d688dc6614b26a92e0062f35570e2,103,82,21,Africa,22,915.05
ce4e5bd8312946a999948de84d17fc19,311,287,24,South America,23,2235.44
ce51796904c54280a217b4deee827c51,319,286,33,Oceania,24,2106.31
ce5296e62fde4fc6a664149e9a6d0c50,108,87,21,Europe,20,1324.75
ce557c678fb64d25bc2ca50b5ffd06fb,177,154,23,South America,24,1527.24
ce56ce75896f4780b1a2f68a2c5f9d84,223,211,12,North America,23,1595.61
ce5846912fd9444e88783dde59489e47,216,198,18,Asia,24,1540.81
ce58d673805342038d583a6773cc8447,332,281,51,Asia,24,1882.24
ce5a8d5afff34a25a0cc34dde6cd0e89,359,333,26,Oceania,23,2791.88
ce5cc1ca202d4f3989e13fde07286f63,128,88,40,South America,20,584.77
ce60212d521a4a6d8f54b477f891cc54,365,364,1,Africa,22,2003.69
ce6022964b4347719be6ee4cbd09f99d,194,172,22,Oceania,19,1377.62
ce6134655bd74c0eb275b72a581d5e1b,110,77,33,Asia,20,601.22
ce63b533d9f649c887f5d3d5dcc61a71,71,40,31,Africa,24,446.6
ce63e1fb29cf4c138768fc000cea0488,45,3,42,South America,17,222.47
ce655cfef68942a39a9f90ee2ff7e4fc,195,162,33,Asia,20,1612.89
ce69234f234849bfbdba2bfafd6bf306,364,342,22,Oceania,16,2225.02
ce6aaf3bd030438a9559aa33ae74f804,354,325,29,Europe,19,2434.69
ce6af4a3f65c4926afcec40fe9220652,55,21,34,Europe,22,244.19
ce6df2d4b8d44e39abae9a6bb725e68a,144,84,60,Europe,20,471.15
ce6ec522527949a5806ecf816985eb6f,364,330,34,Oceania,24,1823.99
ce7175d787c547ecae4e01e0e5542932,363,321,42,Asia,25,1738.34
ce730f3499a14b19a093e16b59215b18,212,167,45,South America,14,1160.2
ce73a4a4f7094891bf6011cea8096a14,341,324,17,South America,21,3164.28
ce756af50c214ab986c391746612b7ac,136,110,26,Europe,21,907
ce776dffca2d427899812063e80ab9b2,80,55,25,Oceania,22,403.03
ce78bc148e724028bc965d5f5b93b439,250,221,29,Europe,21,2166.02
ce78eb8b0e96403c8db4797d86de6433,361,327,34,South America,19,2744.73
ce7ab530c6eb451a80e85a755068f67b,81,59,22,North America,20,808.56
ce7ec3ec7e3f4245bda7aaac3d9c2b17,288,256,32,South America,21,2211.11
ce7fb6a985f14282920c9600a6ca6e41,212,158,54,Oceania,20,926.61
ce814a44563b4ff59140804cf4dda6b3,344,325,19,South America,23,2410.31
ce81a962049d4f44964f753527e5177f,289,253,36,South America,20,2436.66
ce858a211db4440ab03d846bc207fe9a,122,88,34,North America,17,929.09
ce86d52ff2944edf80cdfef822643c6c,221,190,31,Africa,22,1181.03
ce879892bbf944f7a65a52411216901d,291,251,40,Africa,19,1802.95
ce8aaaba3ba44327884dd1b1336485e6,283,228,55,North America,20,1894.25
ce8cf56e7ff34b03bc636814944672e5,345,290,55,North America,22,1735.64
ce8f7ae6aa804c2f98ff3cde39136c02,75,32,43,Asia,25,212.13
ce918afbdbbb40559a6d74486560f49b,50,19,31,North America,18,458.51
ce9220e5e5644ee08a84f41ed85ba608,327,296,31,North America,23,2790.97
ce95599469c4421084724f9c2b94aa16,230,190,40,Asia,16,1317.48
ce9670eb67bf4539b83b035c91d76fb4,118,71,47,South America,22,842.87
ce9b9493a27e4fea96eea884ee6824ed,193,168,25,Oceania,25,1421.84
ce9efd7488a949be95dac602e75c741d,89,36,53,Asia,17,259.54
cea37d82120942128f21a2b12fa0d94c,196,159,37,Europe,26,860.6
cea3a277103545ebbdd5ebe3ec1438fb,222,168,54,North America,21,1281.1
cea3dfe6170342a7a41b69f1bea17a8c,230,197,33,Asia,23,1439.98
cea4b900a4e4466ab7e76a69a9641fc8,241,212,29,Africa,18,1848.08
ceaee4ec94c443939854896c86f582e2,309,277,32,Europe,18,2207.66
ceaf0902bbb144b29ad927bc24ef3982,161,109,52,South America,19,1198.63
ceb29417b29d458698c14491d1b96ca5,83,46,37,South America,19,508.71
ceb6118a63e8421f88fd2e6c2b948ff2,99,50,49,Africa,20,616.8
ceb913b16d0e4d12a799554f0f0f9bfc,191,164,27,Europe,19,1184.56
ceba4aafb0b34f3e830ce5a00498c71a,205,166,39,South America,9,1238.4
ceba8f55519f45b7882d796f5caeb5ee,245,188,57,Europe,23,1082.54
cebbc2f487e6458280f837d92f8bab7e,201,183,18,North America,15,1456.98
cebfa63b22df4db1938eba9decac7b7e,92,34,58,Asia,23,659.46
cec343e18c9f45cb91003c5c2522a6d7,358,320,38,Africa,17,3215.8
cec450f3bded461f8a11ebaceeef7c43,28,5,23,Asia,20,72.24
cec53c7f49e649babff810c795b5261c,284,245,39,North America,18,2169.51
cec5d78939034938ac644ec27b004fa8,216,161,55,Oceania,24,1384.49
cec747ccba6f440dad0d81c4b50b4b53,48,16,32,North America,15,205.68
cec811d932d041abb0f6cfdbdc9ce945,365,354,11,Europe,18,3067.56
cec90c83b7fe47dcad4b0a0dad83a422,55,20,35,Oceania,26,625.07
cec94107a82049b8bf8f5d1b43d8defb,211,153,58,South America,25,1276.82
cec97e4477bf43dbb8e698423bf565ff,224,177,47,North America,14,1161.73
ceca242fc6fd4d48b516476f916cb8ae,307,257,50,North America,15,2359.74
cecba82d8cb744f9ab88d81f5244044e,233,185,48,South America,27,1185.62
cecd7a2d891548b0a9c4b99001c69d65,365,327,38,North America,25,1885.94
cecd906c10824b4a82ccf9fef2ec8fbc,164,119,45,Asia,18,812.75
ced0290bbf5c4e3cb0553e8d09c712e9,60,28,32,North America,24,547.19
ced41b67cf17471387b121493c06421c,292,243,49,South America,25,1613.41
ced7a33db1894b8483e740a3681eeb08,65,11,54,North America,16,433.61
ced832e9db8b438c9c32a44e33133126,85,38,47,Africa,21,576.59
cee1e0b89957402fbb4bae02f092e035,365,346,19,South America,24,2112.54
cee22c16472e4883b60f370ffda34d44,261,241,20,South America,20,1907.91
cee62b5cbfd84c1fbc95de2b0013dcd9,281,248,33,Africa,24,1884.68
cee7c4aca72a48f29c0e15b29781de1b,62,26,36,Africa,18,164.8
cee9aa2677d64a018c1aa6a0f1719fee,98,66,32,Oceania,20,952.17
cef29a6d1b174bf9add01b5d07ed8fae,168,131,37,Oceania,25,1500.38
cef44d5241d948789e8edf6da13339ff,365,360,5,North America,19,2718.95
cef4e2a206ee491c9ac5f5ba006050fd,50,30,20,Asia,18,386.54
cef54173844544dda486134dba21ae1a,244,216,28,Asia,20,1712.42
cef6ea65a3c540b0869b7b287ff4b31e,313,288,25,Africa,18,2450.32
cef7cee207514e29b5add3584c6c017f,129,99,30,Oceania,16,791.52
cefad4bd5931440e9259fe44d3bca635,365,355,10,Oceania,20,1924.65
cefad70e055b4144a484c29ae59f0808,53,14,39,Europe,24,338.3
cefd2d0a79504697acbd6410c53cd50c,182,164,18,Oceania,21,1496.71
cefdcc05eba44148ba17be2a20b40fd8,200,168,32,North America,24,1488.03
cefe50cbad2b49da8cf617f726e6fe47,317,292,25,Asia,18,2226.77
cf01f6f3b5104ee981bca0ad941e31a8,84,25,59,Asia,16,294.6
cf06077e9ef64adf8cefedce0c422a9d,253,192,61,North America,18,1462.14
cf0709cea3de42a8abc25c57fd6adbd7,119,69,50,Asia,20,426.33
cf070e20f9cd4238a1525b84434a99e8,260,206,54,Europe,17,939.55
cf0880b586494a0c9d36285da984f2a4,277,240,37,Oceania,19,1505.96
cf0b90490e144d1dbfe03d80ea5c1f81,126,73,53,Asia,19,202.75
cf0be3ab91e942e0a39ec1a6803a9523,174,145,29,North America,18,1568.62
cf0c3f6b219a4ebeb269cd85b398d50c,277,235,42,North America,19,1703.24
cf0d4cfd45c54769a5888bdc23062c27,240,216,24,Europe,17,1596.9
cf0de0489e5d4e7788f59e5558f54762,286,258,28,Africa,23,2208.22
cf0e4968d5e34b1ea9b144c297a17da3,52,16,36,Asia,22,452.85
cf0f0fe1ac6942e7be1bc347af6bcf84,96,47,49,South America,20,361.23
cf12d69ff9034e7ea711689a5edcc0fd,37,1,36,Oceania,27,134.15
cf13016d4f4046be8a34aa583eddeb35,318,293,25,Asia,20,2497.57
cf133957e0024299a3c47ebe5e345c4c,361,323,38,North America,17,1721.21
cf13b94e79aa4c5c9691c4b076f30016,242,200,42,Europe,24,1330.69
cf157660db3e45aeaa0b17d9135889b8,362,348,14,Europe,21,2943.05
cf16f65bfa5a44c2aabab291c510eac3,168,113,55,Asia,26,740.8
cf17b6247da64fac9975fdaf2bc47117,271,221,50,Oceania,17,1591.2
cf18e0b2c2364011a9c89a82ea13a099,52,21,31,Asia,17,322.85
cf19ed2402d2489d93885aa866aca5d0,292,262,30,Europe,13,2327.3
cf1aafbf43c644d1b4e3cc4a9eab3fed,206,180,26,North America,16,1132.26
cf1df452dcdf4b888540b326cab5c37f,170,138,32,Asia,14,901.81
cf20feeedf4a40a1b5644f84ac84acd0,51,22,29,Oceania,23,533.41
cf2380842f8143ed85cd3dfb84ce3ac0,330,293,37,Africa,18,2612.97
cf243671a8fc4221baed53293e27d7b7,119,98,21,Oceania,16,743.28
cf253372cbcb437eb0c63e2b89842423,91,58,33,Europe,20,569.4
cf2655949e8c413495eb86b0c9b19f3b,82,48,34,South America,18,536.58
cf26b5f14f5a405b852fd81f38f7b9ea,122,103,19,South America,23,804.05
cf26f0c557dc4914bc21b33e064d0209,305,247,58,Oceania,23,1468.13
cf271326db024746b16bed4293508090,81,57,24,South America,21,652.5
cf272271aa104671a872fa141ce4f671,85,72,13,Asia,18,714.09
cf27ad95f61942c6829025333d6ec152,307,281,26,North America,21,2133.39
cf28218ed1f54b1fac866d69b3e23981,364,340,24,South America,21,2633.41
cf2a881f1b414ff58be760872bc2f74e,187,163,24,North America,18,1255.24
cf2aa33323e84a6d8a2ea58b70343cab,323,284,39,North America,20,1803.74
cf2f025cee3d49d69741cde53b5eeb9f,145,121,24,North America,21,1143.75
cf30ae16a068462abf5313c9e2263904,134,83,51,Asia,22,508.03
cf30cfa00e14406e9288fdcf73a4c88c,85,43,42,North America,20,114.53
cf31d0450f734b23b2e7eee61962ed93,89,62,27,Europe,23,570.63
cf31dd5882674c28afc26cfc37311c1d,30,1,29,Europe,23,351.55
cf325d68ee2d4c6e94c4771be19d7c12,320,290,30,North America,22,2265.2
cf35ce1b57a04173a39b4e8d3aabec9a,191,142,49,Europe,17,510.24
cf36d992631a4f898131e914cee1856a,354,317,37,Europe,15,2250.31
cf37a487b6dd43498469669c0b957173,177,147,30,South America,23,971.64
cf39f352573a478b94cf1a0475e041c8,360,305,55,South America,14,1751.47
cf3a683dc790412daa3562ef91fa166e,363,358,5,Asia,17,2523.83
cf3be28ed91d43acbbd43d5508d2a3d8,45,18,27,North America,15,96.03
cf3d404c78e64234909e9073c57ffe55,191,167,24,Asia,22,1496.38
cf3e8ea47a9a4e8d8f67b4d693c283f0,121,71,50,Europe,18,705.84
cf3f3e687eb74abcb668357c0e93b8b2,182,167,15,Africa,19,1019.04
cf3f731b667d47908c89c1b5f65bbb37,178,156,22,North America,21,1828.59
cf42ed20d5b140e588c12fc0eb93c684,68,39,29,Asia,14,570.32
cf4413dee7884a16b897e81d45583976,216,191,25,Europe,17,1949.7
cf45cfc26f3847b2bd85c99687651385,294,232,62,Europe,19,1516.45
cf461ce70d154547a4de400552da8a5f,141,99,42,Oceania,19,894.18
cf47c0c4d49848698853ac3fa86e974d,145,108,37,North America,23,1247.39
cf49b5d97f5945d385f09d21c5bd3dc3,280,248,32,Asia,18,1759.46
cf49ca9640794db989ed1e28210c8460,241,218,23,Africa,16,1863.34
cf4c7b2761814f97a979644a1b5407a7,130,92,38,Africa,20,921.93
cf50fa5e899c4197bea0f7533864d930,62,26,36,South America,19,281.76
cf5337fb48a643f18461976dcfabc85f,102,61,41,Europe,22,804.48
cf5478bb2a854bb187448d67a9da809b,335,291,44,North America,17,1909.69
cf54d9f226c34a53a6a6598878cbf0ac,364,336,28,Asia,19,2927.83
cf54ee18bf6d4b43a52e1cd199555d64,303,246,57,Africa,18,2028.12
cf57eecdbfd04543a0a803674cc47ffc,278,228,50,North America,21,1773.03
cf58845f84114f6e929d62ddcd9cc52a,287,251,36,Oceania,15,2087.3
cf5dee6dbdb04da0b460821d95550483,153,115,38,Oceania,20,1876.63
cf6017648aa5470b9d6320e1e43e58c3,284,242,42,Africa,18,1784.65
cf6018dcc7bd40deb00d78c3a59c4533,112,87,25,Oceania,23,934.19
cf6174a5b06842f4a618fcff22137237,151,134,17,North America,20,972.89
cf633233f8404c06b3e02731cd4d165a,153,107,46,Africa,17,1023.64
cf651af2af994f85ba48eb988159dcc4,239,219,20,Oceania,19,1546.75
cf65cfc12efd44388d8269f865fb4a29,257,226,31,North America,15,1505.92
cf673257347d47d09e85e6272b691708,304,283,21,Asia,23,2080.28
cf6761a694b3419a810b2c79431a5cb4,349,307,42,Africa,22,2452.88
cf6848570db843cebedcf1ce42a89829,364,340,24,Europe,16,2715.18
cf68d2362b08465f9c4e251a78474a04,60,21,39,Asia,20,377.33
cf6cd9d23d44487e9ee42dad3bfd6a58,73,45,28,Africa,13,636.43
cf7175c3e69f4deb8b3c138dc36134f4,365,363,2,Africa,20,2611.43
cf71c26c4231463ea3d99123ff5ab198,291,261,30,Asia,24,1683
cf791ef6e88e4b759d7c4275e6e43a72,364,363,1,Oceania,20,1623.39
cf828d9d379c4b48b4d36b629853091b,170,121,49,Oceania,20,1133.33
cf87030068ed4f5384c24a89a05acf34,365,310,55,South America,23,1546.75
cf8c7d65cb8141ff92171b9a9a5f1732,263,208,55,South America,18,1145.25
cf8cc551a8434add8bdcacdb048debd3,97,68,29,South America,16,593.91
cf8e0584942e4952aa2e77459f2f8254,59,22,37,Africa,20,534.82
cf8f0e660b034406a94bd69f4dc17cd7,107,59,48,South America,25,1198.42
cf9149fe3ade492bad8792af65d47560,305,282,23,North America,25,1797.94
cf92945317a14f118859ccd83d84ff8c,185,159,26,Asia,17,1047.61
cf96c772c4e249e790373caa30ccd5ff,364,333,31,Africa,21,1958.59
cf99022f555048edae74a3b725d8e5eb,330,290,40,North America,22,2680
cf99698329824e1e822b74f05559ac2a,253,228,25,Africa,23,1361.86
cf9a87b2357b458597ba2e2eaaebf5c4,72,30,42,South America,26,625.05
cf9c5776e3b249e19c41fe91346ee95d,266,242,24,Asia,22,1537.05
cf9e061572934de5a8f3d02f9af92fbf,332,311,21,Europe,25,2695.16
cf9f117015794d4b92bcd2b36608d3d0,263,246,17,South America,19,2403.79
cf9fff6980dd4ef48a390075a84c344e,353,309,44,North America,13,1773.47
cfa0a78f271f416ba9d956b8ccccdcb2,312,271,41,Asia,20,1476.99
cfa16bfb3e194ac7804202ae281ef03a,155,110,45,Europe,18,580.65
cfa316fabf9145d29d14f8fe4eaf2870,144,116,28,Asia,22,1177.32
cfa3175e1e5b4381896ed00501da830f,334,286,48,Africa,17,2342.33
cfa3287779b346d3af9e9820d73bfafe,216,180,36,Europe,20,1112.06
cfa3c8c82e83498fa581e525c800f86a,322,298,24,South America,24,1533.97
cfa4e69ba4f549f5b599e3ef2e39443a,167,144,23,Asia,20,946.6
cfa559f545cf42bf8905263a7be623cd,363,336,27,Africa,24,2378.05
cfa9b2c83e724e488af5fd29c66a6ea0,191,155,36,Oceania,20,1442.63
cfa9e37ec5444b50a068342ce71ca062,80,39,41,Africa,23,162.99
cfab887de028424cb7089ed8378fc827,259,203,56,Asia,19,1128.89
cfac39c428de415a9ed14fc0db4d7d8b,40,14,26,Africa,22,516.69
cfad007c3c524fcf988dfbba9924ac9f,273,221,52,Africa,23,1634.72
cfb274d7db6743a0a4a853fe6c0edb24,207,160,47,Asia,25,800.88
cfb417d1c6154e9db50ffc6bd5512b7e,115,84,31,Europe,20,643.43
cfb5154dfcd34327bade7ae460cd3d72,180,126,54,Asia,18,661.25
cfb532e4b82940dc910b9158be6cd6db,199,151,48,South America,21,1191.58
cfb7dbab15394b90963d2512053cc3b8,235,216,19,Asia,21,1582.07
cfb916d05f17477cb76399eb1d99fce1,159,109,50,South America,19,997.76
cfba342f957f4ebda6436dfd61d554f7,117,88,29,Africa,23,841.77
cfbb9fc26ff7468585e1db81c36b93f4,177,135,42,Asia,22,1722.31
cfbd025cea6f4ff59504ff5e67d9dec0,138,111,27,North America,20,962.19
cfbd7df4cab143ba8c8200e23bc16587,93,41,52,Africa,25,417.72
cfbebabbc0a741c3933dd99eecc6431b,119,92,27,Europe,15,1243.91
cfbf100e010e4fec8d1d364602eceb13,267,233,34,Africa,27,2183.63
cfbf6742ccd04887931d11cb5691cedd,74,26,48,Africa,22,176.58
cfc0aee76a1e4334a84a7758116e2b81,353,303,50,Europe,18,1696.05
cfc2369dc5354ada8bde34c0bf79c87b,365,357,8,South America,13,1850.02
cfc3aa33fbb2440ebb2c6a6c68a7a336,220,188,32,North America,16,1874.15
cfc4962c1f0f498f9d7bab03f9b84ed3,77,22,55,North America,24,331.31
cfc4c6314b9e4aee8343a65554deb217,330,295,35,Asia,20,2393.22
cfc5103d90e346618d2e84db46858254,182,135,47,North America,20,782.95
cfc54eae2ce64012bb10ca221b488ac3,100,59,41,North America,18,232.53
cfc71f1987bc495a8738c5d3b67362bf,155,131,24,Oceania,25,1216.77
cfc7bcf9039047e3b0ce4bd976de4f37,365,340,25,North America,19,1716.28
cfc7c9dd037e43c4948c00f6a6f69c18,138,104,34,Europe,18,1423.69
cfca5626c56f4b7b872b33485a01d3f1,62,17,45,Europe,21,275.7
cfcaccf392e644b0b60c7ce6bf2ec85e,109,91,18,South America,22,893.47
cfcbde0f3b984670a99bee55e79a8c81,204,151,53,Africa,18,1215.14
cfcc8155012148449953d55e7878eb68,256,219,37,North America,17,2071.47
cfcde3f188984874951ac2f57d3252ff,161,112,49,North America,19,408.9
cfce599b42294262ab2ad9bfc4fb32c8,362,337,25,Africa,22,2002.34
cfd05b7ab4754c2ea0d037b57dc0703e,290,241,49,Oceania,26,1297.91
cfd296043699439cb6e7ed9fbd2c0d33,320,263,57,Oceania,21,1654.44
cfd4511d452f438d83cc5eecd72fb8a4,364,349,15,South America,18,2190.91
cfd47622db2b4f7c93c5c390e7fe306f,196,141,55,Asia,21,936.7
cfd5471eceb340f5869ab9107952e244,153,135,18,South America,19,1213.71
cfd7958288f24292a4bf4462e62e4749,221,181,40,South America,18,1684.31
cfdaf0d4354c443a906088ce03a61834,172,152,20,South America,22,1387.12
cfdc23ad3d8a47659cd987dd5b6dddba,69,14,55,South America,22,259.96
cfdda854651e4f329d43afa99fa3591a,130,102,28,Africa,17,1191.23
cfdea8aba2cb45eea2bacc7e9143bf33,71,45,26,North America,17,429
cfe0864264194a36b4d4cd6b2ddd497b,190,169,21,Europe,23,1359.62
cfe1fa8479a34828b6e5d47322bfd6a3,365,351,14,Asia,18,2904.35
cfe23f310cee4eb8800aa0d775e3fa09,310,287,23,Asia,17,2003.84
cfe677b43c4f4824bbac37eaddea3004,240,195,45,South America,16,2132.41
cfe6f117400a4be48a760acc5e4f9bdd,203,154,49,Africa,22,1173.42
cfe74dbd5e1f4e56b101bc5693e99e35,50,31,19,Oceania,13,491.65
cfea0c12b5994c3d9d0a07dcb364e3b8,263,215,48,South America,18,1318.56
cfeeb2f86c094569854d2ac1c29b137c,347,288,59,Asia,23,1667.19
cff0952b7dce4b958f8b0f140af20dd8,237,213,24,North America,17,1920.3
cff2c11d86144de9844e17fd62aa06cb,52,25,27,South America,22,533.4
cff5642b2f1d43b7ab3b73b6068a239c,201,183,18,Asia,23,1353.65
cff63511ac6749749d8debde3216c0b1,354,312,42,Europe,19,2075.96
cffb00659d48474c9e970e372600179e,68,45,23,North America,19,724.5
cffc939c7f9e4e1ab906636d73cc8e57,347,317,30,North America,22,2778.02
cffcd97081884b8e9266054095d93da4,59,21,38,North America,15,342.02
cffd559e29f74ddab9cf16ecccc32078,364,351,13,Africa,16,1559.61
cffda5fc9eb24980abac703ebe7dab08,215,164,51,Asia,21,1008.66
cffdaf20f90a4303bb4754b2a862ad85,297,267,30,South America,19,1965.69
cffde5c1ad704e4d9e459ff6e04f1f7b,125,92,33,South America,22,706.14
cffe29db2add428ea7240f57f27a82f3,363,350,13,Africa,17,2115.78
cfff05ca3f8b4c6e8317399dc3bef3fe,351,303,48,Oceania,21,1443.72
d000cfef7f3244c981beee13c9c5abf4,339,286,53,North America,21,1730.94
d001b17713bc47189e1de37f6ee63498,317,264,53,Oceania,25,1551.96
d005828e7a0f4a4fa53aaf17022a4c95,352,303,49,South America,20,1493.84
d005c3185b5246669c9cc99204de3a5e,277,245,32,South America,21,2522.44
d006bc8f7e6f40f5a1dd399c48e8b5e8,294,262,32,Europe,14,1993.51
d00805f3d23c49419656c952c136b2c6,325,272,53,Asia,22,1231.14
d00905afd93a4894b87550b14ac3e137,69,26,43,South America,20,340.46
d009da666e9c4f409ea47ca924924b3a,156,118,38,North America,19,897.68
d009f7b458f94f61aa2ab2346f1d4ef5,360,302,58,Oceania,17,1330.12
d00b9dc6a6a94025bd1134a1d684bfe3,273,238,35,North America,19,1614.78
d00c2cf85e7549a2ae06d589a63f75e1,119,91,28,Africa,25,741.89
d00d4b839d7c4af192d8547a9c78b609,229,208,21,Oceania,27,1990.04
d0102be2446b42f6982bcaec8436b23f,113,73,40,North America,27,796.87
d010528c12d4437183ede074c5e76b68,121,83,38,North America,21,509.11
d014fa79fcda4119ba2b93372cda5da5,41,6,35,Asia,20,433.63
d01512fe2b4a41a0b5bfe1e8d67a5bc3,346,290,56,North America,20,2398.14
d0159aff2bb5422aafb2ce95436021cd,251,198,53,South America,22,936.27
d01626800db94647991eb49ddb5c67f7,114,79,35,Oceania,17,1165.21
d016be168fca4175bf42d73e6ad2e6dc,284,243,41,Africa,19,1943.48
d016c0b75b354506bf4d93ad3de1016f,338,300,38,North America,24,1908.41
d017a99456eb4b1697b84784e4c07f3f,335,312,23,Asia,19,2914.44
d01ec7b6b62645c69b1e4fa6597cdd68,304,279,25,North America,23,2018.32
d01f74ccc21e4843853933fedbbcd0cc,164,146,18,North America,19,1463.68
d01f95a77a5944fdba845957c812b39a,81,46,35,North America,26,691.39
d01fcb271c4f424e8f77ba5378d13647,204,173,31,North America,23,1510.33
d0203e3ee166425dbab773cdbf5676b8,102,60,42,Africa,22,569.55
d021933f623f4dbe906f4c454d1435c9,331,301,30,Asia,22,3205.68
d021f0cd371a435aacd1e584d2163f47,344,294,50,North America,24,1445.38
d02387b802f64087a4842b9cdbb2f27d,307,277,30,Asia,21,2996.55
d02a0df1be0a478abf486955992368ef,55,23,32,North America,21,576.5
d02a982a4a3e42f296a1d60c89773f4e,365,338,27,North America,23,1836.08
d02c125a016646a58b9ec52fdfb72d00,363,342,21,Africa,17,2427.52
d02c1efc27bc4940944b40d3b9fbfcb7,310,256,54,Asia,26,1912.15
d02cc1a4dae64bf0b07c27d739771acb,342,285,57,South America,20,1093.6
d02ce041860041d5b0d508540a3c7ae8,326,272,54,Oceania,19,1750.05
d02d466f4699478eba9fea68e32e7671,98,71,27,Europe,19,810.01
d031c4f5f4034636932d17f6dbfcd652,327,277,50,Oceania,21,1514.51
d032315e12ee46f9939c344b99e4fe50,349,326,23,Europe,18,3379.39
d0330c6449324497a46ba111c378eab9,325,305,20,South America,20,2093.37
d03484219e904b879ff15fa8fee310a8,261,212,49,South America,15,1373.46
d037ed5be22b4dffaf2fe5b9effd2503,331,309,22,North America,21,2830.14
d03c2584c5c04101bf09309ffa91d4e9,365,353,12,North America,22,2548.92
d03c46f4f82040e5a68ffd39711c0c11,365,358,7,Europe,21,2812.01
d03da021cdaf42f4a6a29c190662503c,274,224,50,Asia,19,1268.37
d03f5ab412214f97af0dcad9630766ab,160,106,54,Asia,19,496.98
d0414f37cd54473398ec37f7cba6399d,365,364,1,Africa,21,2693.72
d0425fa5b6b6406ebf4157f25fabf3db,323,301,22,Asia,23,2565.14
d046f2bfd6fe4d4ea17092582d7a3ac8,43,19,24,North America,20,539.32
d048d9e0cfad443a96922462dcfeec25,132,96,36,Europe,22,906.81
d049386a58124cfcab017ae9d5be0477,259,212,47,Europe,27,1340.98
d04991918d6b464d82210f5212f3dba7,232,196,36,Oceania,20,1568.45
d04a15ddaa654835a0e69e2e006fb90f,365,353,12,Africa,19,3039.42
d04ad3dcbbf94aa7b1e079078a8767af,70,47,23,South America,20,587.9
d04b24060dc04dbe89c4dc405c90fe09,215,183,32,Asia,24,736.75
d04cd90c89184444a92047564e3392cb,146,116,30,North America,18,1430.5
d04e90ba15d34029bdfad6e96618e4a7,157,138,19,Africa,22,1133.79
d0523abb1c0a4d07b5cb83f4fc4aea62,305,283,22,Europe,19,2147.29
d0547697b1724d86bf5015b48a4c32e3,340,308,32,Oceania,26,2859.37
d05658c88969483fbdc33cc559205700,360,359,1,Asia,18,3066.71
d056b8ebaa0549b4a3a04002137586ba,358,317,41,Oceania,13,1599.15
d0579233a400445eb540962a01f34e33,365,356,9,Africa,18,2446.5
d058877a4c8a4196a596ef6d42267229,102,68,34,South America,16,870.52
d058d5d3a0dd41d0923ad06791b7d05c,213,170,43,Oceania,22,1380.2
d058efbbeb104ab0ab745a6c9b636a9d,190,153,37,Europe,19,1632.08
d05915a4d7684740a7dbc70b7ff18bba,60,34,26,Africa,23,394.68
d05d8e49e1704a50ac08a8bb0948e809,346,313,33,South America,20,2202.27
d05e42f1695d444ba76820c2a146d202,44,15,29,South America,22,246.84
d05ff8f4de2747008218b2bd308db0fb,365,362,3,Asia,20,1558.31
d0600b1b53fe41c0916597d7658a043f,164,125,39,Asia,23,971.84
d06170d2a77e46a0a27133ac61efe3e8,364,314,50,North America,21,2075.84
d06432a1ece046b3b4cd53174d50ff8e,298,268,30,Africa,23,2471.93
d065d928439842d1b542e46a57014c2d,223,171,52,Oceania,19,1067.8
d0682ab42f2447dd834f360b07a4bbd0,336,289,47,Africa,17,1768.97
d06bc9a600264a8a83a89ceee588c978,251,210,41,Europe,17,1209.86
d06f95eb16684285be747d0742adbf65,270,245,25,Europe,23,1512.72
d06ffa8537594447905caae96b140d6f,364,363,1,North America,21,2333.67
d071205ce9d04b8085425e694c32aada,105,88,17,South America,16,680.24
d0713aba53f7434cbbf3f19e940abb99,349,293,56,Oceania,16,1530.02
d072713ca5984ce98750d0524c801895,294,267,27,Europe,22,1068.56
d074984a57bb47c7965f6bb44ef95b19,347,289,58,North America,19,1405.04
d07579de10a84d5784e64b72058bbc22,365,357,8,South America,21,3259.72
d076e5320d4e45ddbc217ea97077e3d8,228,184,44,Asia,22,1006.98
d07a056213d746db94a71ce7f1091def,133,109,24,North America,20,1350.81
d07bd5c8b4824e2484dd6d4be7933391,283,230,53,Europe,21,960.75
d08234ab6e5a46f5aaa0ceee9aef6b8b,362,347,15,Africa,15,2172.29
d0829d9d0624439598387d3f0927d481,300,269,31,South America,21,1154.45
d08339af52cd489caf6c64a0cc848f47,84,65,19,South America,17,297.25
d0833d7131c94338b1e48c17e7ee53a9,44,12,32,Europe,20,298.24
d0898bf7caf748509c962248ada0b066,266,219,47,Oceania,15,1173.39
d08a5910c0ad407ca3324f0ed28e3cd8,58,5,53,South America,19,389.05
d08d6426af104b49b9dc6c25e3a5316a,162,122,40,South America,20,1209.84
d08f337f4f8646d0b35dfee6147558b0,58,23,35,Asia,19,265.19
d09367d7530f409984825ab7cf7eaa15,94,56,38,North America,19,687.61
d09961d721eb40db86688bf3582707b5,140,121,19,Asia,16,1271.65
d09a81e04bf540b9baa3ddd38df4725d,149,93,56,South America,16,645.35
d09d1de3c1b641db99b67e231576a156,46,10,36,North America,17,328.44
d09f2ef276124e6db1ebecb55cb77430,208,158,50,Europe,15,1149.99
d09fa6224cba462da1582b9e31093475,365,340,25,Europe,21,3389.11
d0a090ec2b444573b25a62d0c4daab5f,90,47,43,South America,17,278.39
d0a0bf47811a4cd0be2a3dff7d30cca3,365,344,21,Europe,20,2718.43
d0a4a2f97111424a86b7591fab5829e1,79,47,32,Africa,18,440.94
d0a53f1c451640dd8d35910ff2ee9082,175,143,32,Asia,18,1101.83
d0a56abd61f24da08bcd542bc19ce1a6,100,56,44,Oceania,19,796.27
d0a6a9d9220d45cfa448e99475327965,357,315,42,South America,15,1344.95
d0a763aa05d74950aa6f2f2f822f812d,359,325,34,North America,16,3043.23
d0a9226d52784283ae03ba61c84c1069,60,34,26,South America,24,230.25
d0aaae759e05495aa2f3185d0d0b7045,189,161,28,Oceania,23,1175.21
d0ab3613c4a5482b83d2fa8c7ee93f02,72,40,32,Africa,21,608.78
d0aeba5018ca44e3a07eee805a926cd9,217,172,45,Asia,19,1309.94
d0b01719f8354eb7b86be626750206fc,107,56,51,North America,19,688.66
d0b031871bd94606b075d9164411a7d6,362,309,53,South America,22,1435.41
d0b14b160527440d82610cd3a3e0d9b6,47,10,37,Oceania,19,144.71
d0b176fef8934ccb8206a9ff396b62f0,163,116,47,Africa,21,645.17
d0b59e0641da4b24b01745e74e9b58ce,105,56,49,South America,18,440.35
d0b5f0bdc98d4fe7b4b6661e123dd42f,89,52,37,Asia,14,774.09
d0b818527f5c418c875f68d7482cdc1f,257,218,39,Africa,21,1297.32
d0b84ca32d1a4523987d19f02477392c,64,30,34,Europe,20,428.81
d0b9899940ae465cb140ebd72a45e1a6,275,253,22,Asia,19,2430.39
d0b9c34f85964597923d047e37141563,336,305,31,South America,21,2032.41
d0ba59f9c7d34041a6c9edd88beeb4f1,293,252,41,North America,19,2460
d0bad695f7924aff81bb6e886cbd2a81,316,307,9,South America,21,2460.01
d0bc10f61074471eb9e7ae2848f11b2b,288,238,50,North America,19,1936.99
d0bc785e43cd4d4c8054ae5ce45fa29a,228,204,24,South America,18,1798.99
d0be1d04f89e49e58c28c0bb60f19de3,312,270,42,Europe,23,970.65
d0c2ddc0985b4b3aa95d61d6d0ad64b5,291,246,45,Oceania,22,2386.29
d0c4e9b1243e4984821112d01ad3dd86,154,99,55,Asia,25,551.29
d0c4eab656a54246b86ce239610f2455,311,262,49,North America,20,1653.68
d0c556a751a74f319bf5969a06e6166b,236,210,26,North America,18,2099.88
d0c57aaa4aff4ab3a024fd417abda3c4,315,279,36,Europe,20,2538.14
d0c5c6c6a84e4495ab37f05e9a739c57,83,62,21,South America,27,963.23
d0c73181c0b247ff85126b26dc413953,255,219,36,Europe,18,1353.89
d0c7d2fc40794cb988f6b6dd29dd48e1,156,98,58,Oceania,14,1128.05
d0c900c6e2fc4e65b0c15ec63f406edc,217,183,34,Asia,18,1972.11
d0cc422082fc4472b0faeb6d22ac7bfb,56,20,36,Asia,17,46.06
d0cd2f0c0a5640d2a265da3984b92145,276,222,54,North America,23,2071.09
d0cd8dbc5af94ea28de64a377b5481c8,51,29,22,South America,24,471.39
d0ce0a88a1fd4e69a24db66c3356dd68,191,145,46,North America,24,1216.91
d0d078c154f94f7ca640cffc2c156e14,324,276,48,Oceania,18,1705
d0d13696a55b4fa58816db525854cba0,314,273,41,South America,14,1742.32
d0d2cbb665894581acafda965d26e6df,314,270,44,Asia,17,1901.27
d0d3dd74c1234898a28f9bee8e7ab7f0,202,148,54,Oceania,18,880.52
d0d4ae12f1e84957850e7e9d86c6a695,207,187,20,South America,19,1541.89
d0d4e516a7294ee1a95baeed752421aa,229,190,39,Asia,23,973.66
d0d61a8d22064ea28da7d3f6bfcaf5e9,298,266,32,Europe,22,1820.45
d0d80ac1073c4f47aa9d56e638aee86b,296,275,21,Africa,21,2289.81
d0d8bd5a05284b0497597118bdbd405d,356,330,26,Oceania,16,2688.57
d0d99f481e1540908da5af91b9905c9d,110,91,19,South America,17,1068.96
d0d9da9d01a34552be27eb3701fcedbd,231,197,34,North America,20,1020.84
d0dbc803556d47fa98e947a307f0be05,365,346,19,Africa,21,2908.34
d0de55f8bbec4722a8f7cbe0df54a7dc,359,327,32,South America,23,2711.3
d0e112743c2747578e47944cf39d13d0,290,241,49,Africa,22,855.76
d0e26d552b6244a3a4ec4a0e8e3776b1,158,107,51,South America,22,920.93
d0e3b7b009f24dd2973fdb06b9443f5a,322,283,39,Asia,20,1952.06
d0e580e1071049b88137dfda908d177e,345,299,46,Africa,20,3120.39
d0e6c64d5b7545cba1fed42c91cef4bd,253,228,25,Europe,18,1600.49
d0e7a6fbc97a449e9fbfc70f7c79b8b6,321,267,54,Europe,21,1916.54
d0e84ab4a8aa47c7b070d02b0c428349,361,348,13,North America,25,2025.3
d0eb87937fc24536bf036c0d3d64f5da,48,5,43,South America,21,44.78
d0ebca53e90841229531bc805ce2fb43,186,137,49,North America,21,986.48
d0f162e770484f86a123b9a0df18e6c4,286,268,18,South America,21,1996.56
d0f212c9e6394de3b0e272856887a719,187,145,42,South America,19,1202.78
d0f44e0541b14abe9000b6c2202ca812,128,82,46,Asia,17,509.27
d0f4b62983d741d5b7ee8d5633ba1fdd,201,143,58,South America,22,821.23
d0f504ef682243a1b7faf7b94459432b,138,107,31,North America,19,1061.63
d0fa07ac14754873b34792e1351129a9,306,258,48,Oceania,19,2296.85
d0fa3cf129f14c95b9b501049e7820a3,169,141,28,Europe,13,1055.09
d10060e8c9764645839d8b4287ae23c5,287,239,48,North America,20,1829.14
d1054582d5be47d19576e15fa7bd727f,130,79,51,Asia,17,366.66
d105eb0a62e743b893d9f93ff646d8d3,359,329,30,Africa,15,2714.35
d106905ebc4f4324a6fee006e6ee52ac,349,332,17,Asia,22,2472.4
d106e39b93ae4341bc7c74d09dba192b,153,113,40,Africa,17,851.99
d1071a441dfd46d2921e79f0a0f14350,139,92,47,Africa,20,1047.5
d10752b105574faa87ef83d33fab392b,317,281,36,Africa,18,2328.54
d1088a6893af4536a1637a0db7a13d25,246,208,38,Europe,25,1579.11
d1089410f71c4c459cf82d9dbd6cfc2b,209,159,50,North America,16,769.26
d109a7ef87c3444c930eb1613b4283df,177,143,34,Oceania,19,1214.91
d10a10ccdbfd4e15a0c06f68c6f13639,91,59,32,Europe,20,1037.83
d10f5ba166314c0885f436ab29e7bc69,28,12,16,Africa,24,381.21
d116257fc16d444a9c23833d7de6d165,316,273,43,Europe,19,1204.54
d1171c917ffb4679821a0def45606bf8,294,251,43,South America,18,2535.26
d119764e8e8546a39305bced18c60933,351,328,23,Oceania,21,2885.48
d11a54c53f584a0385e4de0af9fe9ec4,102,64,38,North America,18,760.6
d11ad42afc244f6eaf4929959b1c0995,204,170,34,Oceania,19,1804.4
d11b3ccf35b54f029b31d134638532a9,276,252,24,Asia,20,2289.32
d11d91c692284cf393f9de1a57ad32bd,180,154,26,North America,21,1382.7
d11ff8c5aa9c4cf0b973e702aa1770bc,115,56,59,Asia,15,558.37
d12082f4204f485cb912901d757b2671,149,117,32,North America,25,1436.99
d12287141e644351840f17ea357c8c34,72,17,55,Africa,16,395.85
d1228c4f94344738aa24545a9b013580,258,212,46,South America,20,1554
d124cfd6171144ad8f53932681588a5f,226,193,33,North America,22,1614.65
d128dbdee6a7454c8871f0cdd041f5eb,220,183,37,Europe,22,1243.56
d12994a0d5134e2d97df3da02c4448eb,145,115,30,Asia,21,1040.14
d12c1e22f9194fce930e8b26bc608a44,83,53,30,Africa,19,312.61
d12e3c2f53e44d989ca5e520d42b474e,48,26,22,North America,23,332.65
d1306f5ccfa14448b5899df35058bf55,349,316,33,Europe,20,1972.81
d13314ae3b32410d861b8c5b84fdfd9a,221,174,47,South America,19,1079.25
d138cad9d2f04c8f89eda6bd1962e0b5,135,99,36,South America,20,990.94
d13bba74ae214d0b9bb19b8e68435240,291,239,52,Europe,21,1673.26
d13bd7301d194378a2f6b369d530f5b1,362,328,34,Asia,22,1798.37
d13ce42058a74f0d80a0810a90c44294,195,163,32,South America,22,1372.61
d13f49aeebbe49de8fcc2e669a2da2e7,246,216,30,Europe,23,2459.5
d1410e1cd4954f4d9f04ec634664f6d8,218,175,43,North America,18,1697.68
d142cc79eaf1406cb50db10a09e03771,210,181,29,Africa,21,1322
d14414a0d57c43e3b92e8e75a73d81f1,186,161,25,Africa,19,1204
d14569070d834f8582fe2ae93c1611f3,48,21,27,North America,23,475.45
d147691b75124c858398a6d733fe1d21,279,236,43,Oceania,21,1792.7
d14fd65798eb408ba94c8ec2bea47832,299,269,30,South America,26,2356.21
d15070cdc88449f9ba54e50b6b324c02,140,108,32,Asia,19,978.09
d150d1b59ef344beb4126cc0abc462a4,142,96,46,South America,18,843
d15189da2db648498a75678fb838d23d,278,252,26,South America,17,1929.66
d151e9a973a349959faec5a608a1dd6e,56,13,43,North America,15,179.24
d152fd8ae3964b9890af56b9b4e32d19,312,258,54,South America,20,2003.88
d1535953c9154bb4b0394d0a6bc700f8,135,110,25,North America,22,1013.02
d154d4a5c957460a9159a1425c32bcfa,94,56,38,Africa,16,453.97
d1553c21430247a2b61a76a816b1c8a0,224,198,26,Oceania,21,1300.21
d15551fe0ae941cbaed706fa956038b5,171,149,22,North America,22,1150.71
d155d7421c5b4fb79f0923b473c02ac7,327,285,42,South America,23,1928.02
d155e368d1e3412fb78679a6fe07a075,159,126,33,Europe,23,1061.28
d157453a36ea4d808bdb6b7fdfee28a6,293,252,41,Asia,19,1641.67
d158058d54f24b51950b6f847e21fe63,248,230,18,Europe,22,2384.8
d15d62cb29ec485eaffe954807e06a20,364,351,13,Oceania,15,2061.51
d15d77cb1caf4c10be7e8bbe0a9e877e,283,238,45,North America,21,1627.24
d15dabb526f242b3a2f8ede9773ad87b,338,288,50,Europe,13,1690.63
d16022fd3b6b452aaffe58d81b8c2dc8,250,230,20,Oceania,22,1303.35
d160cd27a95143e29b876cc0592129ff,270,215,55,North America,19,1184.59
d160f2220bce442eaa372f59dba6e3e6,176,122,54,Africa,15,1169.14
d16143cb51764874a8eb8d10cedd5891,365,342,23,Africa,19,2183.75
d162c9b84657418e9ea463cb9fab57fe,97,54,43,Asia,22,838.49
d163280e7c8a4c338119eaf70643af29,290,270,20,Oceania,24,2609.46
d163a59fb5c045e8b65f590b1f556890,106,67,39,North America,15,810.44
d164f22bbb404f50b7cafb0adef331c1,151,112,39,North America,22,912.14
d1665519b47440439576ab9de9f04e78,273,259,14,North America,25,2078.54
d167bd520842440d90fbf658ae4ca434,95,41,54,Asia,20,441.6
d16a1fc723d84cfa813185410209f617,59,26,33,Oceania,22,776.93
d16d5dce0624418d84f5866492a50531,147,93,54,South America,21,906.89
d16f15cda6f64f3ab6165faa247fb32a,115,96,19,Asia,20,1126.07
d16f3986eae541138189341e9ef3048c,350,299,51,North America,26,2018.98
d170a2c2097d49d6b988a604f569707d,365,330,35,Oceania,17,2266.78
d172d0b7827a44bf89a9c7108db6ee06,157,101,56,South America,9,895.84
d172fa599af2451e9450c5e096032bcb,184,146,38,Asia,17,851.96
d17331af4f48405891b710899bf80a29,270,243,27,Europe,20,2152.08
d174b65666d8497398c9c1cb230c898d,159,118,41,South America,21,623.32
d1753cf9f57d4cc2a544ed3a8745fb34,137,91,46,North America,21,867.55
d1757b0bef3d4d3eba8d7470d0d75ffa,141,105,36,Oceania,20,1018.91
d175cd61c4ad44bc849fbd098481b72f,128,77,51,South America,17,455.8
d1762b423dc24bbbbc32e1b0250d267f,226,187,39,Europe,18,1019.75
d176638038c04861bfc760e158efc57a,204,184,20,Europe,17,2054.75
d176d07a59f2412b88fe2d59f7c0f524,217,179,38,Oceania,20,1503.32
d177a127ae81499992a63728a8ae90d8,51,5,46,South America,17,203.41
d17a9b1030ff4a60a239ba7905a42653,365,347,18,North America,15,2930.41
d17ac847d54b45a1bf601ffe1482553b,251,206,45,North America,16,1165.87
d17c0c01261b46b88cfc2445850630e4,243,210,33,North America,19,2258.85
d17c8f0d18584d7d9859a0387b15da8a,306,280,26,South America,23,1672.53
d17c960e5baf44c68acb12d858f5b2d3,53,2,51,Europe,21,317.62
d17e2f59328b45b9ab9c186dfee0cf12,363,344,19,Asia,16,1617.08
d17e964262a046828170ac3e1172bd9a,112,55,57,Europe,23,757.25
d17ed906ddd3407f8ffa8b75623b1724,344,315,29,Europe,21,2692.61
d182c9bab4b7419c918868285379274c,232,173,59,Oceania,19,1306.91
d183424a0d7d4101ba7ae8d9c88ec153,310,258,52,Europe,18,1865.29
d183c60701a34a7d8a155c880eaad2e1,231,189,42,Africa,14,2041.86
d1849ee5bcea4a828ab90793f1b24e72,102,48,54,North America,18,745.15
d1859426858e4a4fadb8e95257eb36f5,305,252,53,South America,23,1034.96
d185ea2ef66a48c68956f6094075f492,322,277,45,Europe,24,1463.58
d186f1214a8e4a5c90465fca225cc7a9,332,284,48,Asia,22,1295.58
d18705f1dbcd48dbac6cf5a33c01039d,250,224,26,Oceania,17,1430.25
d187edf5b4714497b34c43edd733d642,357,318,39,Oceania,22,2487.02
d18a18bf9262418db21547cf52de2402,328,273,55,Asia,15,1835.29
d18bd7d944e54de99e5dc0b04a12ce46,147,97,50,South America,19,820.95
d18c96234fc9415a9cafee4c739c758f,62,17,45,Africa,18,509.75
d19121005fa44320a17c48ac9e8ea3a7,356,305,51,Europe,23,2121.19
d1969eb37fb146069280ae92beac1a13,219,188,31,Asia,22,1207.33
d199282dfe86450e913c6f1ea35ba96f,285,249,36,Oceania,23,2369.54
d19ad286254e4a8fa8026eb9f50b6a2c,306,262,44,Asia,21,2526.07
d19dca97632a461eaad913d2879cdb7b,193,169,24,Oceania,18,956.45
d19eaaf3865a4baa831b5c30df781de7,90,44,46,Europe,23,1053.62
d1a22a286604434abcec4f3484574bd7,167,144,23,South America,17,1050.84
d1a2b3394b834a0ab35593f5392ab345,364,360,4,Europe,22,2030.28
d1a484cede29498596fccf30057f2017,183,152,31,Asia,10,1354.79
d1a4d67d7567470e926ca471f10a4500,168,123,45,Asia,17,762.95
d1a8c76cb6e540bf88023c041ea39ba0,364,333,31,Europe,20,1324.58
d1a94229c7614386b64caac988274154,303,271,32,Oceania,20,2503.8
d1a950dacf7b41f687a800053f86b2ca,246,194,52,Africa,19,1287.83
d1aa56032f994c67af0777f90004ba32,268,219,49,Asia,18,1246.29
d1ab9ee9af2b4ca69bf6c4f029ad4c7b,124,88,36,Oceania,18,1071.73
d1ac774831054809b47ae3ca87fa646e,343,288,55,Europe,21,1652.46
d1acaf2c04aa4b77a3b00f7d7d0c4f9f,214,180,34,South America,11,1682
d1ad69d1dbc7420a92c6395b93806235,144,112,32,North America,22,1019.47
d1ae45b2b35a47b689b4adcda97e3670,91,55,36,Asia,20,822.14
d1aeffaa5275412b9ecd863b87c14d65,364,352,12,Oceania,20,2159.45
d1b2a1fd5d1646129f2ec674d7fbd9d0,247,203,44,South America,23,2124.49
d1b69a7e6c5e46c3b2aef9e05a72065f,145,111,34,North America,22,1181.44
d1b7494133af4b34a4b9f54aff8412a7,92,50,42,Europe,17,637.66
d1b7e1dd77d141bca130c2638a69b3fa,142,100,42,Asia,17,904.88
d1b80c0ac3cb40d089d00499d46ffdd9,237,208,29,Asia,22,1603.37
d1bc7aad1eb64294ac2851fa6b86202f,355,328,27,Asia,20,2178.29
d1be143e625a43948a45762ba03deb8d,195,162,33,North America,17,1182.6
d1bf3a0806ea4040a693ba7d755dbde3,222,183,39,Asia,22,995.33
d1bff61b7a0e4ae6a73d91dce5201b2d,325,303,22,North America,23,2615.45
d1c1a8a72e94462a97fcd7ee3d3da038,182,161,21,Asia,25,1712.21
d1c21d96961444b995bb8f2fd16fccad,224,188,36,Africa,17,1250.96
d1c411888e854a9799577fc0508015bc,59,10,49,South America,30,186.62
d1c56ca1e9d8421690c225124f4b579d,365,365,0,Oceania,20,2411.27
d1c5ecac882c4e0dab57eddee3bec26e,166,132,34,South America,18,1338.66
d1c65e931652450cba694de8bb0e795d,142,89,53,South America,20,804.58
d1c7b4b09e9e40028ad0e2ed44631f1c,282,258,24,South America,24,2067
d1c89b232ecb48c0bb2d0ceee900517d,72,42,30,Europe,17,503.34
d1c961e752494d94bc99e2fc27cd5e20,156,128,28,Africa,19,1210.97
d1caef10fa5447aeaf5ff5e2f6fed25f,365,322,43,Africa,18,1879.3
d1cb1bc46f3c44628d2bed6f2ffc2df2,299,259,40,South America,21,1712.01
d1cce843d5d2453287afca1a4e81cf1f,203,178,25,South America,17,1421.02
d1cd90dfc99545328debe862c63c9efa,277,246,31,Africa,19,1861.9
d1cf172bffe143939b2bc2e0bdf34d8c,85,37,48,South America,19,431.81
d1cfc85499c34e2e9fc0a2dde8f975be,356,342,14,South America,17,4053.73
d1d070f6b14944d6bd7d73bcc1de3736,206,177,29,North America,18,949.42
d1d10aa02f6c4e3890c59a0eacaba901,258,222,36,Asia,17,2054.31
d1d1bdd9febb4bd0b6e7eec08dffee96,122,81,41,Oceania,22,740.11
d1d1f668df1e4c7786ffcbe906e5f55c,117,84,33,South America,19,962.81
d1d46e93d4a24421b52c53d49af8cb33,72,17,55,Oceania,20,180.42
d1d5e7ceb1ac443d8e65438e5e4ff552,89,57,32,North America,23,516.37
d1d7bd30d5814d678ba8edb86bc912e3,115,80,35,Asia,14,672.96
d1db361fa5724ba9b820c247aac7d74c,345,312,33,North America,17,2340.14
d1dbd1e54306470785a9c37d950ac574,321,268,53,Oceania,22,1536.77
d1de858fa00443028688db64b92630f6,306,265,41,Oceania,23,1952.28
d1e119600e454282b5bb749b5059abc3,108,55,53,Africa,18,664.06
d1e1a2393b0e4cef87dd2ebddb14b1d1,33,4,29,Africa,21,218.6
d1e2d14af97e4056a3098395d3403fb5,323,282,41,Europe,19,2054.75
d1e3ed76bab741279fefe467d973815f,73,47,26,Europe,26,313.34
d1e4334ed4f84f16a82b6a5004af866e,34,6,28,Europe,22,157.32
d1e697b5fc874fe2bb941497b590ac83,291,263,28,Asia,21,2427.68
d1e8996cfa1045d7b4d98a8336eef907,97,45,52,Asia,23,540.81
d1e9f914261e453c8ffa2ab17cb8cb6f,113,79,34,Africa,18,1100.37
d1ec7191fcf1414ca602bf9fb13fa70b,84,32,52,Europe,22,236.26
d1ecd3bad5d34e468c906ae3472cd90d,178,154,24,Oceania,17,1832.39
d1ee7c749c7b4800bb53b7f651fc0506,169,138,31,Africa,19,1365.48
d1eeb6d3fdea44ce82e3683893f9ca24,222,177,45,Asia,21,1363.59
d1f07dfbc45544d28f2fad67e6f4a0c3,92,38,54,Asia,18,155.82
d1f1f3d664ec40cd8ca58bff33fc0148,211,180,31,Oceania,21,1215.46
d1f31db377ba495187af9ad95d585710,180,142,38,South America,21,1009.3
d1f36647093b4e21901ceca24a44bfe3,58,10,48,North America,17,457.51
d1f6467fc590400b8002e34865354412,86,45,41,South America,16,564.58
d1f6c7f9a0ad4d69bf34704c8cd6bbd5,84,28,56,Oceania,20,249.56
d1f9c8e2e3674ea18200a688f86fc8c5,275,231,44,Europe,21,1556.6
d1fc5184f9df479088c313b4f57a78ba,166,123,43,Africa,24,1129.89
d1fd043b10b54c23b89a24fa42f5fe7c,127,84,43,South America,20,718.92
d1ff45dafec8434085d9e1f56e0bb24b,106,76,30,Asia,25,537.32
d201df83fda1469ca182e42991c2da74,142,113,29,South America,19,1258.2
d20255699d654a75a63d69013001090b,363,327,36,Oceania,15,2538.78
d2025c30679341eea0dc160f62189ff2,351,314,37,Europe,24,2087.74
d2048ede63c840429e2d435dd213eb15,364,353,11,North America,23,2977.89
d205f538ccb44460a213b8bb70d22e06,364,344,20,North America,12,1677.57
d20a70a1345d4a5c93eba110e838814f,150,99,51,Europe,22,990.72
d20d1277953440aaa3b5114345ba561d,50,17,33,Asia,23,431.67
d20dfaa03fcd4f10be7cdf308b8238f4,365,357,8,Africa,20,1769.29
d20e26e7b5864202bbca2f04f0ea5741,257,224,33,Africa,25,2013.34
d20f8c4f48dc420cadb36ab9b9912cbc,91,48,43,Asia,21,519.75
d211e976d8b44c61b9863d3b404dd1d0,54,13,41,South America,14,390.51
d2134a6e5f25426e82a92797d9c9a2d8,344,326,18,North America,22,2528.41
d2161dde71e54699b00f7c0b6b40a944,365,353,12,Oceania,19,2578.59
d216582de4d949fa81149ecd078844e5,93,59,34,Europe,24,774.35
d218dac011e74c0d9b45d1d8155bb9c3,329,295,34,North America,19,1968.32
d21aa8ae46524a8ba852ca0b140efc71,364,332,32,South America,22,1981.9
d21e1aa10ddf4ddb997006f5a2ec3e75,249,202,47,Africa,16,1716.44
d21fa0a67c5748b09ffe3c8d41c02681,196,145,51,Europe,15,1012.48
d220e1fb8fcf4593b0748d85c9554a3d,205,159,46,Oceania,20,1036.47
d222d8e00cdf4c5a8cb96d4adfa22dba,127,90,37,Asia,20,795.81
d2231857ee274fdebeb960d88f656298,128,88,40,Oceania,15,876.64
d2232377c05b4d5e8240be90c7df6507,236,177,59,Africa,18,1141.86
d22363c101114368b24e2008d02f301e,313,277,36,Africa,22,1988.89
d223bbd28d904ac4b9efd58c606767c7,254,229,25,Asia,15,1801.55
d223e00aec6f4dc39aed23ded1b5b833,122,73,49,Oceania,19,709.42
d2242a63147c40ec901b9d635ef40f7f,226,185,41,North America,17,747.89
d22520f144324c06831c9aa9f93de103,229,182,47,Asia,23,1212.11
d2262aaf77d04465ac91e0cbd4557e65,68,52,16,Asia,20,539.17
d2277e4403b84673840f25025478289d,362,358,4,Europe,20,2332.33
d227f02522434d77a3e1407dbdd3ba37,365,333,32,Oceania,20,2272.56
d228597acdd342b0b74aeeb875e3745b,320,268,52,South America,17,1910.82
d22920cf7a4a4b4e98be8e8104f6d840,275,239,36,Asia,25,2110.42
d22a305cc6b6454ea77f13114e5bc550,186,158,28,Europe,23,1626.84
d22bfeb661ea4760b29d5732de427bc5,258,236,22,Europe,20,1420.57
d23209c0f5cb4b6e9fcdca197fb296b6,258,242,16,South America,20,1956.08
d2321b365892465d8a442608ca0055a6,118,82,36,South America,25,829.99
d2327b9d63a642d88358e15a98b7d6d4,363,339,24,Africa,17,2370.4
d234910afdf044d79e237f6325996ad1,106,66,40,Europe,22,705.48
d2353db9b796429291eca0a7b65c599f,342,285,57,Africa,22,1389.14
d2375418e2a64a5287e031acc9c00a56,96,70,26,South America,24,594.36
d237cb3e37524bb4b6dac8216bcd4a06,227,186,41,Oceania,23,1702.25
d2385b765d5a4d25931944b5c3e88bd9,98,48,50,Oceania,22,606.71
d2387497f47749db89bac49bc7c6de52,214,186,28,Europe,23,1340.47
d238c3b22f2c45ec88a74a37546aa75d,363,354,9,Africa,20,2423.18
d239754bd2ca44b68a00ef7ba2a9f226,361,333,28,South America,16,3322.72
d239c597c7524419b3f665ea7167665a,53,34,19,South America,22,601.74
d23bf08339c34b7fab0a7b6a5f090824,133,101,32,Africa,18,739.36
d23cf2e02e5747e09809789f7940fb3b,136,115,21,Asia,18,1350.51
d23da97432a34641aae4df4a4cc9f1c9,45,2,43,Asia,16,314.06
d23ddd36de6c4776b4f3806079f532f7,53,18,35,Oceania,19,246.71
d23e863801e24dbea3891cc61a560f0e,111,71,40,Europe,21,797.45
d24036cc1db048c990a8ecc637f67f67,365,351,14,Africa,19,2096.41
d240d2569725491c988ca3ae085adec0,228,184,44,Oceania,18,1862.87
d2421ea9647e4a98898c39e17b09c2ae,317,268,49,Asia,20,1560.97
d242602a3c2046ec884c709a457b74fd,163,136,27,South America,20,1571.82
d24295738e8c4dc589f95c8e33cd7c4d,231,186,45,Europe,24,1217.73
d244c4703ae04581a6991e25d5e2705b,57,19,38,North America,19,183.65
d245fc7a08b94a87a850ef27a5297e05,251,220,31,South America,21,1282.43
d246ac423f324a34b410c024490b89f3,111,93,18,Africa,23,686.67
d248b7bcdc204a7e9680e7800420fd3c,27,3,24,North America,27,219.89
d248e1335b1c4fd1b4f44962cee17c60,207,173,34,North America,22,2175.37
d24931a6a977476f82db315386f2ea3a,250,199,51,South America,19,1063.42
d24ab629526a4859b83d1a6d2471c725,365,321,44,South America,20,1706.71
d24b7ebbf939407e84caa05842fc9f05,143,111,32,South America,18,1618.62
d24c1793ca9847fc9b4adc130f94af51,337,279,58,Europe,17,1291.7
d24dbc3023c84670820e102e497994f4,364,332,32,Asia,18,2715.3
d24f99ce44ae4139bb71ae6c229192ce,362,338,24,North America,18,1647.28
d2514f819fed4c488afdacbfc871a946,243,199,44,Europe,20,870.52
d2555b9adb09467fafb0b303747771ad,242,207,35,South America,21,2040.25
d2565152515b4215a3859a0c008480fc,224,191,33,North America,21,1273.52
d25693e058f24a52972dbcdf66cceb5e,362,347,15,South America,26,1825.42
d25784ab9f7446999631fc0f7292fafe,365,332,33,North America,18,2554.73
d25a608e57f94c1a8eae32e849451a48,59,24,35,Asia,24,396.19
d25abc3fceec4f8799044af96e3ffefe,341,297,44,Asia,20,1842.43
d25b8118daeb4b7da81daf81c4896167,88,59,29,Africa,18,320.49
d25d3e816a0643b4aee847fb1b7a4ac0,365,348,17,North America,22,2810.65
d263885dd381448d8fe2e294e128349f,294,260,34,Europe,25,1824.16
d2653d4813c44b6f9ec61ec8ce306f28,190,155,35,Oceania,18,1043.95
d265bf27323942dd9eaf043aeee26476,162,126,36,Asia,21,1310.6
d266f40d57ab42d3a1958d0b8960b5b0,312,277,35,Asia,22,1805.63
d268276c7607466996a7f4dfdd704552,361,347,14,Europe,19,2731.96
d268dbb233be4ae787356a5dc497bfcb,306,265,41,South America,20,2096.04
d26a2d310751498aa6685c30e872f936,260,234,26,Europe,20,2253.02
d26a5778ed6c4bb8aba1cc54ef8bd66b,54,14,40,Oceania,17,409.76
d26cdba257eb4241b020d0d66c7a9c25,182,139,43,Africa,21,708.68
d26ea000666f49d4a3810a3278980953,324,279,45,North America,25,1470.53
d26f85d306364f89a1c6fae6274afa9c,258,220,38,South America,19,1898.2
d270a8cfd3c146ba8b5d8dc40f6ff727,170,128,42,North America,20,1363.18
d271bbd951bc42a48b9ccd1b778bb643,142,106,36,Africa,18,1305.13
d272bb1f4ce749bfa23e92e2ba214767,213,196,17,Europe,20,1566.08
d27481c13a89486e8c18bb3a5a490bac,214,185,29,Asia,22,2044.75
d276d1290002416d8e4afcdf42ed9300,365,347,18,Oceania,17,2898.28
d27abf9aef7f43acb099046ea3b3a00c,52,18,34,Europe,18,502.85
d27b4c841442499380a5a8e0c6c7251f,287,264,23,Oceania,15,2205.49
d27b5905f81b4459bca9f3c513501474,241,222,19,Europe,20,1492.57
d27b882d15d24e5f9bf9c47195183273,365,363,2,South America,20,3041.24
d2805a2cb29348f990d4a2344821405e,360,331,29,North America,22,2549.54
d280efa59e61481b870ac4032017e6b3,294,245,49,Europe,21,1248.41
d2837c5b2b9a4f2eb51cdb4606fafa63,269,223,46,Africa,20,994.28
d286dc18cfb34bfcb0214c3c6d9418d5,351,322,29,North America,24,2560.01
d288385839fe40208e90332aa6600c2a,365,327,38,Asia,19,1468.63
d2898ed5eb3946578950f148d57c16e3,357,333,24,Asia,19,2612.75
d28a29ae21534f65a7611a59dc457b57,130,110,20,Africa,20,704.26
d28b7448d8554f57a17a15772429a7e0,166,123,43,Asia,28,1118.14
d28b8e49452e4694aa8e7cf700ec9712,267,230,37,North America,16,2264.15
d28ce5404867440d83b82f77664baec4,202,185,17,North America,18,1694.28
d28f954c6eec4e31ba2e43cd820d8386,143,104,39,Asia,25,1176.71
d290771dc0df4d1186eb9475fe7d65a2,169,129,40,North America,20,778.27
d291c2c4ae7e474ea489104344465430,147,111,36,North America,15,1127.88
d2946e740ddb413b862d75b3c00cd532,354,305,49,Europe,23,1942.66
d294df9104d74bccb5b9c05e9a67e202,138,96,42,South America,19,664.9
d29686e2dcd84b4296b043d753b51a69,259,215,44,North America,19,1785.77
d298b0b53fe044f0921b060fd2178f02,233,188,45,Asia,23,1382.49
d299a35f8216436f94955532cfe44af3,171,131,40,South America,17,1451.47
d299bf8d888a45aba015e4897dba76ea,255,226,29,South America,18,1869.91
d29aefdb64234ad4a965743e1d018130,123,59,64,Africa,21,401.17
d29b12a952554e6fb718eca38c55b451,112,91,21,North America,19,599.09
d29bf04367e34ce798fb2e2e0dba5252,204,171,33,Asia,20,1466.47
d29bfb6d9a9a4035a500b832271f5eb2,36,13,23,Asia,17,272.28
d29d5585739c456db51c8c2d5d088d3c,153,121,32,Asia,21,1330.49
d2a003e45ccc4733a8cf73f930e83c49,138,107,31,Europe,16,983.41
d2a20a9f84534e539d33f1f7e456ae68,80,24,56,South America,18,528.89
d2a295745abd408bb10f6bbec68237d1,191,149,42,Asia,15,982.37
d2a4de21e50a42dea45709ea15421126,215,168,47,Europe,18,692.33
d2a4f96e97b14a8da8b643bda7645d52,122,94,28,Asia,19,735.3
d2a6de0355c145ef93d888336d4d46d5,307,254,53,Europe,22,1280.08
d2a7c836ba6c4d15a0f217154eac223e,266,241,25,South America,16,2624.92
d2a817cd8b6b46888b3cbae98db95400,99,88,11,Asia,20,951.86
d2a8594cdae94e54b1152b649beadd06,95,53,42,South America,19,881.51
d2aa7b27c03945ed92ea04fa843d8d88,309,278,31,Africa,18,2497.61
d2aac76401fa47a481a7e9e5b4f125a6,364,348,16,South America,22,1529.07
d2ad42e64a2248f3b785851d3aed28e1,364,350,14,Asia,19,2527.6
d2ade1f87be1478892c2df3d5585fa48,193,173,20,South America,19,1749.95
d2adf571165e43eea9cfa5431770d903,272,241,31,Africa,23,2088.07
d2af93bb84ea47e194b901884165d529,361,337,24,North America,20,2347.27
d2b161da71184f0fb199ea09d3e5eff9,144,98,46,Africa,17,1090.03
d2b227d0639e431cb95a1a5195676460,258,230,28,Asia,23,1674.92
d2b33e4d9f3e4923892c9580e70b3935,365,307,58,Europe,22,1847.14
d2b346dbae1a43e3ab3facfdce5176bc,158,120,38,Europe,17,829.06
d2b3aab6f801499283a9b2c93681bd28,324,275,49,Asia,16,994.11
d2b4dee041684cf89a6e7dffb82fa99e,102,61,41,Africa,21,382.45
d2b6a93afb4d4c06b5fa18cf8810bcf9,217,195,22,Oceania,20,1591.03
d2ba0d8f4c314563b4d5f5ab54e63c6c,213,177,36,North America,19,1156.77
d2bbe6532d2747c6a4bf231a011b6dde,164,129,35,Oceania,18,1285.58
d2be88b3a9ec4067b54e684f16c644bb,105,69,36,Oceania,17,854.49
d2c1e2d432df4d299de3b07f630ce6d6,269,242,27,South America,20,1707.84
d2c2aba7c4bf461c8a433258f9f1d0fe,53,29,24,South America,19,142.75
d2c452a990e5400c8b2ec13565e4d9ee,197,169,28,Africa,18,1943.9
d2c55725c9544322995adb53c31414db,246,206,40,Europe,19,2695.96
d2c57bd77d414fdf9d330a06fac6f5a3,337,302,35,South America,22,2309.26
d2c73b8eb71a4ca9b0779431d5ca29e5,339,298,41,Europe,19,2795.11
d2c75fa536094bf3af64284b65ecdf14,151,98,53,Africa,16,570.37
d2c9ecde219d48abb1c38e96c39d77ae,365,340,25,Asia,23,2520.58
d2caf8bcc4b847a39193e45de0170651,89,31,58,South America,18,553.42
d2cb09c078f5489780bc91d13ee5d728,66,45,21,Asia,23,366.43
d2cfdddd34a948a98be44fff52075880,365,351,14,Oceania,16,3395.04
d2d1b7f2413842949f28f4067bc325e0,161,144,17,Africa,26,1557.2
d2d54e19f9864528a50a8e10548be4ae,298,267,31,Oceania,21,2295.59
d2d5d749f737425f9350b4c66c4a1f55,364,324,40,Asia,15,1974.93
d2d5d88e2cb54725b7c0edc9de298d21,219,189,30,North America,21,1395.19
d2d5fc3092f446e38b892091bb4665da,229,177,52,Europe,21,1027.43
d2d711c4f40146889d337accec150820,352,301,51,Europe,22,1619.21
d2d72fcd5a4e49658d5a26c70bf3a5c3,96,44,52,South America,15,556.26
d2d756454afd4d7db6eba1de5b9c0b5b,363,325,38,North America,24,1234.42
d2d7aa6ef6fc41b08c0a7a4469d919e8,138,106,32,North America,19,1005.9
d2dac2dc68d24a58aad29d874a278db1,272,218,54,North America,20,1599.68
d2db6339823147699fa7893ff351b536,145,117,28,South America,14,1188.6
d2dbfa4b7e2d4acdad5f3acea8175c41,189,137,52,Oceania,16,528.5
d2de5a8ae41b48438d799c7586671662,318,258,60,North America,17,1609.34
d2e1bff8f9e74257a3fa52396e2b8174,83,53,30,Africa,18,880.21
d2e2071e3e2247cc995bd231325935a8,358,322,36,Asia,21,2161.03
d2e44faead47430b873a5001d5303807,247,221,26,Oceania,19,2750.61
d2e46f148d964da8ab8c4b1a6bb1d855,353,309,44,Asia,19,1675.59
d2e71a5ad0bd4b07846f45fd82bd5cb6,171,112,59,Europe,17,688.76
d2e75d8ff5bb4c17a3699f2b4157a7c5,78,45,33,Europe,15,291.62
d2eb54d1cfc24e2dba9c2970023b032e,330,278,52,South America,22,1345.41
d2ec6cd8e45a468dab7e73e5787ea657,318,277,41,North America,22,1448.61
d2ed2b028fa84b9ba9b00b2cf5178b75,117,70,47,Oceania,21,425.57
d2ed53f38aa240bd9eb18b34b22f0891,88,43,45,South America,19,563.37
d2ede4f7aba44ff7bc3fc8237760195d,84,64,20,Africa,19,854.12
d2eefc73826e4ee18fd092d736745f60,166,124,42,South America,18,1181.09
d2ef14afb386473f9074e2eaeaa8a66b,249,219,30,Africa,18,2021.28
d2ef88caab99471ea4fd5ad52a8caf6e,142,96,46,Asia,22,612.95
d2f0deb44dae495d82201d2e81a1c932,365,332,33,Oceania,21,2525.33
d2f952bd82924b6586094119b35a8c2e,153,128,25,Oceania,22,1064.3
d2fa110e3460458aafbf2e08fbc2620c,55,6,49,North America,15,436.11
d2fb67e4dfd348579b55ad54de455fa0,168,131,37,Asia,19,1543.28
d2fba7f705e5487686e4b2fcaedbef4f,306,279,27,Europe,14,2701.96
d2fc0d5f8dfe48f6b20e9c86db536653,328,287,41,Europe,18,1688.17
d2fd67778f4542958487166421a07b5d,268,240,28,South America,20,1782.08
d2fe77c192cd46ae820f1d10a63b634a,227,188,39,North America,19,2458.98
d2fe994c468a4f4299318e74cb0007ef,86,56,30,Oceania,17,403.31
d30e1d9600034fd29b88ca2499989f71,201,149,52,Asia,19,885.86
d30e8a3aa7c34d2aa363640246ad3ae8,56,7,49,Africa,20,363.12
d30f6037171c45818fd988ed1a5ae10d,364,349,15,Europe,22,2831.53
d30f8fdde51e4cae83a09163be790a9b,363,344,19,Africa,19,2219.15
d310837c4e8645228ea12382edf179cb,58,23,35,Asia,26,526.46
d31426c169ad41db9b17e2aa2fb9c73d,210,176,34,Europe,18,1189.55
d314539668b746209805903b66131174,135,91,44,Europe,21,721.74
d3163d9d74ae4007ab2f64e4b689f57a,211,194,17,North America,22,1572.6
d317417a8d5546a199c92dd31424dc90,319,281,38,Europe,26,3565.33
d3190b387eeb4d3ba343e62616b6218a,201,147,54,Europe,14,1181.16
d319f8703eaa45ceaff66d2af6e9526c,319,272,47,South America,20,1745.27
d319ffbe171647a9a3f7084b6e6d6a6c,169,142,27,Europe,23,1058.04
d31a791c7caa4772866e9a03caa42185,201,174,27,Africa,20,1187.04
d31eadc61125497eab99af44c3349299,208,194,14,North America,20,1692.21
d31f42c5a3d24ad3ad2e6c3dffb523b0,60,16,44,Asia,14,235.33
d3203dc1164345a1aa7cc7526550046e,299,281,18,Europe,21,2051.3
d3218311407840529f6ddc7c7b2c6223,275,222,53,South America,24,1317.8
d324ea1f7c9f4247a6f95395fd06970a,320,275,45,Africa,17,2411.97
d325576d779b4e01a732f7d012845980,155,125,30,Oceania,27,1181.85
d325f5d9dfc146469b58b82fbce735f7,144,119,25,Europe,18,837.46
d3277747f62a4587a799e88674ef3958,144,123,21,North America,21,879.53
d3298c96fd2d4170812db4eb0edaf7d1,251,223,28,Africa,19,1604.36
d32a5852a6d640c898f961f2df389dc4,44,17,27,Asia,19,310.66
d32c4ec47482480ca283c0a3f776e67b,115,60,55,Europe,23,449.39
d32d021b943545a08013363fbd045125,333,291,42,North America,17,2173.48
d32e9b8b5d9149e9990ae8929f662c5f,203,158,45,North America,19,750.4
d32f2f7d4d5543539aed5f1a341c992a,245,205,40,South America,21,1731.22
d333aef034b641e19c9574e890e5cd5b,267,217,50,Oceania,17,2043.38
d3373878c6564a0f93f50d8315997240,290,237,53,Africa,20,1685.64
d3376bca3a0d44268ae84d62692aa4c4,192,170,22,Africa,21,1436.5
d3392929b91e493396238cbad1198a71,72,25,47,North America,16,190.27
d33adedbe164441bb8351d31fab638fd,365,343,22,Africa,17,2480.95
d33b5fda6c8d4098abe9d5788f8066f6,215,179,36,Africa,19,1646.33
d33cb3d374754affa505366e1c1aaea6,111,64,47,Europe,17,1032.84
d33d322ce1f9413c97fb6646e61832dd,73,52,21,Africa,19,1031.02
d33dddd39af744169c78b95559ae0027,360,326,34,North America,21,1898.31
d33ddf4809f14bc6a6cd1cd57f3ffe92,64,29,35,South America,22,543.55
d33ec2750d1f4efea98d7c533befbae7,46,11,35,Oceania,20,367.45
d33ed9ac46aa4646983d144a31dd7e96,184,164,20,North America,21,1303.71
d33f7c6e39544dd3baad599692a47634,315,291,24,Africa,20,2439.85
d3408d1634de4ebb96769d78640dc645,364,338,26,Africa,22,2415.8
d340ef29d1f1415fac41e96b7cd9ce60,365,360,5,Europe,21,2249.28
d340f476c8944e55a0287a95a7e87099,267,234,33,Europe,20,1366.61
d341759b4c3049b8a4fda1676321cf8b,190,169,21,North America,17,860.15
d341e28ce2d8456abf7277d4bc172503,345,323,22,South America,26,2999.95
d341fe21740b45f1bbfbe108edee5a85,236,197,39,North America,26,1850.08
d3422fff56fb4a719f28fc1b37c1c860,312,263,49,North America,22,1502.03
d34340afa1cc4d1fa078d10294bcb873,218,183,35,Oceania,22,1113.3
d346aec82ae74b75b98991c0f54af516,303,273,30,North America,22,2572.95
d34a0ec8a9884f14ab4951b2b4a3681a,365,351,14,North America,13,3499.26
d34d3ebc648b408d9df115048684ab49,365,343,22,North America,21,2316.69
d350f9fa58244ed29f47a88277b229bb,261,210,51,Oceania,8,843.64
d353c279b85a4781a683e4dcebf3e7ba,365,347,18,Africa,21,2754.16
d355bf10e5dd46b1b45d5a7446c48375,291,249,42,North America,23,2101.19
d3597e6a5d434bb49d81c9a38b0997a5,246,191,55,Europe,17,1158.91
d35a0ab97afd433da84bed666ce8dd7c,363,319,44,North America,21,1657.41
d35bddbe09c54bdb8292d4adf7fe24a2,255,210,45,South America,22,1341.02
d35be489d87c42e09a026569c2d7f15b,121,85,36,Europe,17,904.46
d35bf711c45c4ae794388bb4bacc2f05,319,290,29,Europe,16,1790.57
d35c17290db04713830068e4b294326a,118,73,45,Africa,18,315.56
d35c971be4a94629810280b0dd264340,174,125,49,Africa,19,1294.32
d35d96dfeefc403e9511748a0bbd12e1,297,271,26,Oceania,20,2261.23
d3621c97de3f44ec98f8ee421dd31175,145,93,52,Asia,20,917.45
d362ad0ba6e842b1b3ce1b3b7c08d213,162,107,55,North America,24,970.33
d363276bfc8f4e6484cd00bbaf566aae,328,291,37,Africa,20,2268.4
d36462c9e33941e592c444412372a1e0,354,315,39,Oceania,21,2655.76
d3652a64520845aa94db512d4591bc74,23,1,22,South America,16,353.73
d36661184431459ba67e0e770a0e179c,329,293,36,South America,18,1919.47
d366e0aadfe54ec18faacda578dec3ec,122,67,55,Asia,21,674.99
d3672470df404855b2d8c23c7569a213,282,244,38,South America,17,1678.29
d367bc83c49443c4b8bb044a8c65d0c9,277,220,57,Africa,16,1273.71
d36ad65515b140ca9131f327b94a8e0b,66,41,25,South America,13,555.82
d36c8fe86fe54dedb3b1bf1ceba8a834,63,36,27,North America,23,677.75
d36df9132d474749be0194c5faa35ed8,153,98,55,Africa,19,774.54
d36e7bb5907f48398ffd1b514165f47b,204,154,50,South America,18,872.29
d36f1805966a4de78eec68676b127253,283,254,29,Asia,19,1623.94
d36f5c15e9c049d4bae828f6c766c680,56,19,37,South America,21,458.49
d375d03bcbca4226a1bb34d6b424513c,311,270,41,Europe,17,2020.93
d375efd7b88f47a4a44d3f63fb02bac0,276,233,43,North America,18,1401.42
d376bc71f49f4f14848d74a951547a44,129,92,37,Asia,23,1220.53
d379338fdfd441d3b871010948e040f2,327,273,54,Europe,21,2283.73
d3797dc2e77941db98372e85273b80f4,53,10,43,Oceania,21,377.65
d3797e97c0b141378c9551cd461aa66a,196,149,47,Africa,23,673.88
d37d1bbfd4da44ff95ee53b7d7e20a1e,86,57,29,Oceania,25,813.89
d383b8383e804f43b66cacbe8240d6de,155,113,42,South America,21,673.82
d3844961a23f4d06bfae40a05091786b,271,245,26,Africa,20,2657.74
d38473412b364690b41e5861b592cd6c,42,11,31,Europe,9,253.27
d3848010303f4444b4fd2b6621c7f814,124,98,26,Oceania,16,1359.77
d387578ff90a4efbb9bdf05bd853f8da,304,284,20,Asia,17,3123.11
d38b33e3ccd8461fb22b998625f83f19,216,182,34,South America,18,1381.76
d38fafe999eb4853a879d1d0a433013f,113,64,49,Africa,20,705.63
d3903cd76e274c9896b1ce5d25e87d8f,147,101,46,Europe,25,1186.63
d391938d372b4617888cc1c8acaa7ce9,263,238,25,South America,20,2632.21
d3920b08128046818a69209e6ba7f30d,365,348,17,South America,17,1890.33
d396c2cb9ed941abade9a6022e98238d,52,24,28,North America,19,323.93
d3984038ee0944b38cea282160ad3fc7,63,51,12,Asia,17,448.42
d398f5476ba04acead9a34e4feeb4a25,146,119,27,South America,22,1034.65
d39b74d9699844ae97e36fb6a2237560,310,258,52,Africa,19,1159.69
d39bf59eea6742498f95931f99cd1437,348,324,24,Oceania,25,2177.05
d39c244d6df940529b11715186a3848a,280,253,27,Oceania,17,2244.51
d39d295f3bc74122afb4ea0ba6b7bcb5,288,242,46,Europe,20,1039.86
d39dffca1c984532843ad7ece89d8bfd,84,46,38,Africa,19,466.63
d39e3fd8c11d4892822fa84a80fb8a93,104,73,31,Asia,24,776.33
d3a18e3be026418a88690da9e718dc5a,337,316,21,Europe,25,2211.04
d3a3d443af8647a8b25a859f003d66c2,335,288,47,Oceania,21,2482.24
d3a43580b511488bb664e4f05498ea6e,252,201,51,Africa,10,1394.27
d3a52b4a6aaf4451bbb37dbd03d1daa0,259,232,27,Asia,17,1936.92
d3a7e947d67347e281158c0f05f058bf,166,132,34,Europe,17,777.56
d3ab570e2d65461bb7c9fe706d85d342,159,108,51,Europe,21,1183.43
d3abeaa47d594b01ae9264a9603c0c7e,352,315,37,Europe,16,2195.68
d3acebd7027049678a318e0bd15a388d,85,49,36,Oceania,17,540.1
d3af1342bbe94b99a4df41cbe62aa06c,170,150,20,North America,18,1168.48
d3af837331314c2fbc6afe05c3b1bb10,295,276,19,North America,19,1765.27
d3afe03150c049eb9952579b04af14bd,364,364,0,South America,17,2839.36
d3b2b3e478524b498631d0d0ca00c9a8,365,354,11,Europe,23,2500.23
d3b471202a60452a98c00953260e8933,175,136,39,Africa,16,837.59
d3b501af2c454b08982d898537d3b49b,365,355,10,Africa,21,3012.4
d3b74ce1a15141dbab82836b1c6700cf,255,232,23,Oceania,20,1896.52
d3b7986812bc4bfe96d38b2671b0cbbb,214,162,52,South America,18,1241.47
d3b817f3aad04c8ea312f8788322d47d,331,284,47,North America,20,2168.89
d3ba86d93ab347fa9615122914978187,130,88,42,North America,19,830.69
d3bb1b1183f248a0967ee64db6cea384,339,291,48,Africa,19,1569.77
d3bb5cb385b84e9a9107a79fec3b5500,62,20,42,Asia,24,303.59
d3bcf8b9449b4a6d8167aca5dce77508,61,31,30,North America,21,421.24
d3c201a1dffa45318da0b424ae7e33c9,351,328,23,Europe,22,3242.28
d3c2b55c3a2345f3b1698bf3cfe60cd7,77,58,19,Africa,21,339.9
d3c35cb803fc4d2899e53c77d997c0f8,53,17,36,South America,25,585.39
d3c54546e45e485cb10a59db18fd0274,364,358,6,Oceania,17,2104.1
d3c7d662df9e483087e2ec41ec88abd6,243,219,24,North America,19,1962.86
d3c7d81ab51b433283d4414262da0f0b,279,247,32,Africa,25,2032.08
d3cb82af083f44aa9890f2c6855ec8ed,173,143,30,South America,19,1240.54
d3ce435e6c4d4b228102ebe91a76447d,247,195,52,North America,16,1451.17
d3cf447f14324e3983d555970da5a140,248,198,50,South America,22,1550.21
d3cf9391cf2e463c8ae69a489f837d92,193,175,18,Europe,20,1137.19
d3cf9da21ff446ebb67d60cd3c555095,265,221,44,South America,21,1510.12
d3d24498ba2f45f9b5efb00dcebe9bfd,265,218,47,South America,21,1473.54
d3d99a6751be4cfcb2330d2f767ec454,268,217,51,Oceania,11,1619.73
d3db038ac80e430bba5d13927184628b,172,149,23,Europe,14,1407.9
d3dd8930aea34551ac7718e4f3a5c303,89,38,51,Oceania,20,282.95
d3dda0acad49463eada07386e4aa04e6,221,185,36,South America,19,2040.44
d3de223f8f3b4ee09d06e0cc11c8832d,54,4,50,Europe,23,44.96
d3e0f454eaa2403f8243b16be4dd9051,46,9,37,South America,22,242.39
d3e12e4b45314baf90c41b10e2c89723,56,14,42,Oceania,15,415.96
d3e3359bcaed469b9ee35bb166546e74,29,5,24,Oceania,21,156.43
d3e3669fcf664844a71385470b3b8b8c,237,189,48,Asia,26,1383.94
d3e47e9c5084432f8f80aaf2d07301e1,365,346,19,North America,17,3165.34
d3e4bbb71e9d49498d21a92534b26742,365,351,14,North America,19,2302.89
d3e6154290954d94b0aa1f33a5e93ca6,182,158,24,Asia,14,1362.22
d3e81312966e461da1caa2182d2d2bed,185,140,45,Oceania,20,629.48
d3e90c68aae14155b60332cdbea02b66,170,119,51,Asia,27,939
d3e93036de684b9b8875e17bcce88bca,232,190,42,South America,21,1383.06
d3ea9b3b50c149a0a11fca233a9dff24,344,318,26,South America,20,2056.42
d3eb16112ff24dc1aea15111066b8515,77,39,38,Oceania,21,711.44
d3ef690d30754dff8658e333b37c0857,365,340,25,Europe,18,1440.09
d3f0afff577548c1947f3d275e13bffe,34,10,24,Africa,20,163.03
d3f1446e506f466b9703871272dcdd6f,185,150,35,South America,21,1361.35
d3f65c800226428baef9757082646780,364,351,13,North America,20,1860.07
d3faa13663d34b1bb6a5d14d18e6d8b0,322,299,23,Europe,17,2407.96
d3fb41ce49554b558d268ea19b2ccbf9,237,210,27,South America,21,1613.62
d3fd1c8bff22455399b0b0e4daa839af,101,62,39,Africa,16,520.6
d3fd7b0b3dca47eca3b4d1a67224b52b,365,357,8,Oceania,20,2175.99
d3feb3708be940439bce83819e8c905b,139,112,27,Oceania,21,816.33
d3ff148d047b4258b751a6e7a3d74276,66,34,32,North America,16,312.92
d40846d7192d4de29a428989090962bf,365,339,26,Asia,15,2993.38
d409122af26e4d6db59178eb30a8a224,197,168,29,Oceania,15,1363.37
d4092b9c35d14759b180053aaf30440a,261,219,42,Africa,14,1890.7
d40c1ccd1f0e495f895273e62b410b63,343,306,37,North America,19,2055.66
d4100bf6a92d4f90bc56d211a92f6d37,363,354,9,Europe,20,2265
d411d5869f24415d9f7978feebb34148,343,298,45,North America,19,2818.4
d4132452edb0435494b007bb8b3b90f6,350,318,32,Asia,21,2822.11
d415a950c16d45a8a7dc5aa95de27a28,321,289,32,Oceania,23,2527.78
d415e21424084b4c8b497b3d66d37d89,346,312,34,Africa,14,2826.1
d416046e2e0f41a98e4d67f685668093,217,179,38,Asia,22,1737.86
d4161c4bc47e4805afb1542f9db691b5,235,190,45,Europe,23,1874.68
d4175d46dd4944a391747cd8ad09c988,210,184,26,Africa,15,1231.63
d418b47a0a674f1caeab307bed21a5e7,351,312,39,South America,19,2562.45
d41d7c5d3f254193bd1b4333d0b6a359,351,311,40,Africa,21,1868.38
d41fc98b98ea47b296ffeb8af8d2db6c,197,152,45,Europe,20,1587.98
d4209a3d6d024a5d8d4ec4b9f2218b76,364,353,11,Oceania,19,1795.28
d421cdb0e04a4ca9ac8e129fdc6fc6d3,108,59,49,Africa,23,515.65
d421f4122cd54d36b1cc239eb4dd69e7,310,272,38,North America,24,2181.88
d4243f6e6e334147a735a9adef448120,365,350,15,Europe,17,2642.45
d42558034a564c46b51dbfc71a842465,364,325,39,Africa,18,2372.42
d4265d4fc47e44afa3834c3c5a70d2ac,279,260,19,North America,17,2571.54
d426830a6fc241e5864ea99142a479fb,365,349,16,Oceania,12,1643.65
d426cb9760304e81a0c5560556b54c00,46,9,37,Oceania,23,386.46
d426d6d9199f40c6bd0973cb9b757b31,76,40,36,Oceania,18,382.39
d427488a02044d2697c0ba5ca49d2890,365,346,19,North America,19,2203.16
d4298cab7ca941539787fcc1a4202685,65,20,45,North America,21,483.98
d42a07dab0844dcb8a2930b940dc720d,92,39,53,Oceania,15,535.43
d42ae361d7f64b90a8dc3b06801b1999,197,160,37,Asia,25,1337.64
d42b805da9ed47a7b4fc5cdf6f16ccba,166,118,48,Oceania,24,543.2
d42eea0acb1546c4ac1522d3dc424c34,122,91,31,South America,20,1191.95
d430fd6606d748b19b4d6109cde6cad9,128,97,31,Oceania,19,971.05
d431ae420cd345efa7a7a588e695e01e,365,338,27,North America,17,2672.62
d43751932ffc48438a982bcd74dc1f6f,259,238,21,Asia,18,1506.43
d4383c4e30cc47a4b0b6cc58d0c58b61,250,214,36,North America,20,1397.55
d4389e05aabd488ebc12943ca31e0128,259,217,42,North America,18,1911.6
d438b5c64cfe4ae883a09f64e0b0f1f4,209,167,42,Africa,18,1547.01
d43d6660b88940e9895f1daf9155bcf3,251,221,30,Oceania,19,1709.54
d43d713307eb4d08834907bcd9e0ada5,365,337,28,Africa,18,1820.78
d43df1051c114cd5bf38fbe46a9b4301,173,140,33,South America,17,930.5
d43f1eb2adf64d078c690d595b55581f,365,355,10,Asia,24,2466.89
d4406bb9cc734e54b14c04afb97af7ef,257,220,37,South America,23,1616.89
d441b9c03db44cfaa3829e9f143c4629,122,64,58,Europe,21,375.7
d4434b5dc25e4a2eb86ca458f04bff7b,99,62,37,Europe,21,637.12
d4436ea60e26421a8bed06c24267668e,43,28,15,Asia,13,114.61
d44375206db347bdaef2cbc7a774fc2e,203,174,29,Oceania,23,1187.03
d4446e446ed845c5b3a5793ccedb4ccd,295,258,37,South America,29,2161.44
d4451f8d8ad249d7b467fd86622d59e5,314,280,34,South America,22,2224.91
d4469eaed6c949b9b90aadb24f1aa345,286,250,36,South America,11,789.68
d4481ed6122f4d1fb2ebf34da2186bc5,262,204,58,Asia,19,1576.11
d44841b1a9fc4c45a3bf2390d7b99faf,91,59,32,Europe,15,727.24
d449920e9a0a4e19aaaffb35a7f0c826,348,310,38,Europe,18,2148.06
d44ad66d6f8e40b19040f253f01d3787,156,105,51,Europe,21,1019.15
d44cb4df86fe47d39fdde0c75eca95a2,120,82,38,Oceania,17,919.03
d44e5850aa7647cab399d26a15988b56,276,253,23,Europe,21,2489.03
d45001bdd5774cf99c36d7352aadfe24,241,218,23,Oceania,17,1701.84
d4500731ea2b4b9cb95b57d0e65864d3,119,60,59,Europe,21,783.14
d4505ea66e344f12912ce4fec15ad4f0,181,122,59,Oceania,24,782.44
d450b9e89454468aad264b92ebe5917c,260,236,24,Europe,17,1708.8
d453dcd8a7e2460ca200a5436ee9aea5,184,160,24,Europe,15,1265.7
d455215d71b84b9588271c1ce1ca984b,122,95,27,North America,17,1132.98
d4552d5b3c284f4fa4dc231120ba80fb,21,2,19,Europe,21,271.15
d456ecc102b64cd9b32bcb38fa5daac4,129,85,44,Africa,24,1061.74
d45af28658334c6d99e70a009e305250,355,304,51,Europe,21,1817.68
d45c3640115d433cb5e4f44912023350,278,228,50,Africa,25,1572.9
d45c6737eb654d479a65aa16aeeb91d8,167,136,31,North America,25,1113.75
d45c86db4c4b4847a26c743a2a7db3c8,204,174,30,South America,20,1287.98
d45d10467a4e4a94b44111f8447f72bd,261,235,26,Africa,17,1574.94
d45e58580e964e0692e62b739b5025a3,309,289,20,North America,23,3000.52
d4609a66548a4894919084a7d334ed4a,105,72,33,North America,20,505.63
d461392f003f456ea197e90bc02b4a8a,184,141,43,Asia,21,773.67
d461d60cbb4f4ff8b321566a36ffc37d,316,277,39,Oceania,21,1595.88
d4625405226b45bfaea6f1e66cbd0a0c,94,72,22,Africa,20,537.85
d462a8deabbc41eea55d34721fb520af,314,289,25,Europe,19,2486.02
d463a2dc6bad4c96b5d892394782dbea,248,197,51,Asia,9,1063.87
d46494cb35f344638ba2b1b8f28f6cd5,254,208,46,Oceania,22,1763.3
d464e13fbfde4f4f82e4696724173e16,210,185,25,North America,22,1410.5
d464e7332b9b4a74b1570a85c4eb4d24,365,323,42,Europe,21,2068.18
d4687e8a5b1d4cd984d8d72b8dfbace1,244,199,45,Africa,20,1066.86
d46956dee55640daaefe754f169efd32,75,22,53,Europe,22,270.47
d46ac2cf54c242dda5da79ac1bc388ac,172,133,39,Asia,18,921.54
d46ba819de3f4476b09146db4afc9dd8,279,237,42,Asia,25,2088.45
d46e2b3424274a3db0287884e9a36b11,279,259,20,Europe,18,2268.18
d47223ec31624c84b3e4627b711766f8,50,7,43,Europe,16,524.89
d47237f2253c49b09bafbab231cb692b,328,311,17,Africa,19,2578.68
d472384aa93e47319c8d65b4e4779b03,39,13,26,Asia,21,524.01
d475f209fe34432a8ddfd4d288b06cf2,210,161,49,Oceania,19,1537.52
d4782e69ea1e492c904de576242e17a0,299,277,22,Africa,20,1802.16
d47e709f6254499294e501f68e3cb099,351,294,57,South America,24,1684.31
d47e8242188145b6a43827d491053274,131,105,26,Oceania,22,730.66
d47e9ee9ec4e4660ab46e4ef85ddec3d,129,113,16,Oceania,22,839.87
d47f44e0b3324b408be6449e30b5a9d2,280,247,33,Europe,16,2266.11
d484b992a163494e88d78fe07a6bd69a,204,156,48,Oceania,17,1012.22
d484f90764af458498a89357ea5f4d06,309,274,35,Oceania,15,1563.49
d4855640479247f0a4afac643ecfc6df,104,62,42,Oceania,20,826.56
d487349a81c4403ab1bd550b0c5dc0ae,283,252,31,Europe,19,1868.56
d487e3f3c6704c6d9725f4b2e3745ec7,365,346,19,North America,17,2482
d488fa1663bf407d861dbffd1711c65b,166,136,30,Asia,17,763.04
d48956f24c064902b87c4ca852bcc912,107,54,53,North America,16,822.13
d48b9107b9904f159f0febb1624d947e,103,69,34,Europe,18,471.31
d48f1a4f3b9b42a4a2175ae30fdfbe5d,92,45,47,North America,15,521.73
d49409dabd444eed9bbb764aab3ce9aa,190,143,47,Asia,20,784.65
d4944a546549489697786ae2321047f4,300,275,25,North America,15,3118.64
d49686b639d44aea9e6c373bb0e300b7,282,247,35,Asia,23,2321.79
d4984e6fbbc443b794b46719a305763b,248,226,22,Europe,23,1829.51
d498796f03354b1f9b00a2327748b0f1,108,76,32,South America,23,872.47
d499c075c11b457d8943273214c368bf,122,92,30,North America,15,842.1
d49a7eecb1b54d7abdf3c8c1732fbca3,201,159,42,North America,25,1504.53
d49b52cf1ae94abe94ad7c730578cafe,209,161,48,Asia,17,993.46
d49b84d61f604cb9a0b0c5f273482193,224,171,53,South America,20,1347.44
d49dea425a83451396857d9db60a8a7f,241,222,19,Europe,18,2305.83
d49e80f48aae437fb42c832346160609,25,8,17,Europe,17,189.06
d49ef9940a8040709e4d52bf2442771b,308,279,29,North America,20,3082.54
d4a2e0fb9a0a4d57bea0e65d94894b1a,329,305,24,South America,22,2287.14
d4a4039472e7462a89eb7b099654b2c9,343,294,49,Oceania,20,1411.93
d4a578bdd43e4a31a45fca41720a394c,153,106,47,Oceania,21,734.62
d4a5f9372c3b4eb79de7e248bcc5c1f4,112,86,26,Africa,20,1136.95
d4a62a0fb00b45f78da06df8a165874d,262,233,29,Asia,18,1582.73
d4a8aa0fd4334b4ea76a1cc8235dfa6a,88,50,38,Africa,20,758.94
d4a8fe81759b4c6ea988248f2863c469,228,189,39,Europe,23,1240.36
d4a98a837d6b4dfdb5e199c00031e218,38,14,24,North America,20,249.57
d4a98c8ba39f49e4967e054ff043ad9d,252,197,55,Oceania,21,993.45
d4aa794568254bac8afdb03b33ad5bdf,227,200,27,Asia,19,1623
d4ace5cf4a73437fa0f6b59c4234bc93,144,116,28,Europe,25,957.46
d4ad38f02f024916ad82f08ef012dd90,310,282,28,Europe,21,2573.84
d4ad3f237189410f82fe632653d84d77,239,198,41,North America,18,1948.82
d4ad7b7262674bb888b074a037d7427f,364,359,5,Asia,20,2193.6
d4afd7d59f6740b289155e12f7ae959a,88,34,54,Asia,20,476.26
d4b08abb113e444680e624d1bfc1c76c,185,165,20,Europe,20,1286.34
d4b0a614f3bc4913af90bae49bcc1eb2,340,301,39,Europe,20,1449.76
d4b226b88c25451b830f0fbab6d2e5eb,227,182,45,Africa,17,1142.61
d4b5c33f124c4215b4d01da810dcbdd2,204,163,41,Oceania,21,1059.76
d4b84491bc7541028e83f942700e3063,290,273,17,Africa,17,2382.24
d4b944ea4ed640d9956a1f71db0206c7,365,340,25,Europe,22,1724.17
d4bcf430d7dc4382a845ee754e4d5b71,96,74,22,North America,19,451.93
d4bf0d1b82d440f7b1f3042e25b63771,211,164,47,Africa,20,1056.36
d4bf341c44664cc1a0c6711772ae48cf,218,157,61,Oceania,20,1035.08
d4bffe47410040a8ac4310f50e517cb9,319,291,28,Oceania,24,2596.81
d4c3a2534da14bfeb5181e14a7f34d51,319,285,34,North America,18,1883.98
d4c534edc83c477bb97cfb1784a1aa52,296,270,26,Oceania,30,1801.2
d4c61ebedb054b018a4e718ce6e5727e,346,310,36,Africa,17,2909.73
d4c6d586cc424df0989e9d4259f0604d,123,99,24,Europe,17,658.05
d4c898cae8374b12b7ec4c0da0fdde95,66,37,29,North America,19,468.56
d4c8c49c9da446149778f85bec61a277,160,129,31,Asia,20,1514.5
d4cabaf25d224a969fff60e7b8fb5b0a,351,301,50,North America,19,1851.8
d4cb9dec1263439db2225837033b0997,335,283,52,Oceania,14,2103.18
d4ce318e557c47e097d8302ee21a50cb,197,170,27,Europe,15,1876.85
d4d0b02a5c5f467f87cd45c8b5feeb19,365,321,44,Africa,22,2414.91
d4d122758ad341ed864418aa2ea7a0ea,365,317,48,Asia,17,1706.63
d4d1aee782d544759c42201aff0e567a,148,107,41,North America,20,663.04
d4d2f0015e874d5daaf7528a5d45f03d,318,285,33,Europe,18,2049.47
d4d36b83e73b428bb77680b0e0b8f758,284,235,49,North America,21,1807.95
d4d857f1bd994cf58c605432d7c48a3f,347,307,40,Africa,14,1569.27
d4d8e4eb78c045ed8eb127d10638a0f6,229,180,49,Europe,19,1446.59
d4da2d7d805143a88f5b2acac48e9a44,330,285,45,South America,21,2024.93
d4da564c33754480b905f9c5bb3084c4,221,195,26,Oceania,21,1328.36
d4db19022e7c487f85961716496bd3e0,70,44,26,Oceania,15,532.05
d4db5c1c5efc44b08148f25d5f00a961,343,299,44,Africa,23,1614.32
d4df6835be784b9a835cfee713b4e421,302,256,46,North America,24,1874.73
d4e3c1b8aedf41a3b77a7eb2d1e2ec77,334,294,40,South America,22,2167.08
d4ee1700f8764fbeaeabf62a7a5e2ec6,231,192,39,North America,16,1243.18
d4eed2cd88b947bd9219715c42b489ee,41,16,25,Oceania,19,325.69
d4f3503e9e8a42f1aa73e4a2dee691f4,66,14,52,Europe,19,320.8
d4f5911029ac4a169c52fc689a366880,91,54,37,Oceania,20,871.03
d4f6aa6561fa433c95ee635faa0067f1,347,313,34,Africa,20,1929.67
d4f7db0867014376a46d0968c9586bf6,213,184,29,North America,23,1660.02
d4f943bf748746529a764b292482e57d,76,51,25,Africa,22,1024.64
d4f9ec2acc3a466081120a4282ea6d63,225,219,6,Oceania,20,1829.24
d4fa6559d4674f37a92894bfc38a5e00,344,306,38,Oceania,16,1650.71
d4fd40c957e2499e8a982abc64e34441,347,289,58,South America,23,1532.29
d4fe1e84748742f182ee7b3919b61430,131,110,21,North America,21,1058.02
d4fe6ecde9fc4f0e896497c809a23553,346,286,60,North America,25,1598.14
d4ff677971584c8f87d7e947ebdb1c31,78,59,19,Asia,16,278.52
d50065e00bf34d92b5790f3b9e656b26,112,94,18,Oceania,21,670.68
d500abdcc0164646a56b55ef24c9adbd,158,104,54,Africa,18,1152.49
d50159a8fc774b589ece1c1963850939,46,26,20,South America,14,203.13
d501650bcdc949b1be1b6c6a094cb19e,203,155,48,South America,26,876.99
d50198fd390346e2bb7263fd8a365e9d,260,242,18,Europe,25,2128.81
d5038291ebfa479e8bfc806fbcbc1836,233,179,54,Asia,17,1092.39
d5046e445ded427caf94dbdfbce911a2,81,39,42,North America,22,579.68
d507c2de44314974820659f8f403e1ab,72,45,27,Africa,16,349.7
d50ad509993440058cf181d71fe6c5af,364,336,28,Africa,25,2538.19
d50ae188f02c4395ae8629302dfe3c25,206,186,20,Europe,22,1741.2
d50b8c1012d340aea3ad5940491e4a00,266,236,30,Asia,12,1713.41
d50bbc2628b244358764e3b42c12fe92,140,101,39,Asia,20,514.77
d50e562292e3442885dfc8a12c03b71c,357,315,42,Europe,19,2147.52
d50f0efd7dfa45df8931fa7bd1960623,173,123,50,North America,19,1199.65
d510be4b5a1644fab92f03bdc5a26b3b,209,188,21,North America,23,1295.02
d511b5dec3f24617a357ebab9d82d456,243,199,44,Asia,14,2055.03
d512838c68c94f44a8f3be7273ca40fc,360,336,24,Europe,16,2241.95
d5156385fb6143288b0c4eb6a22f31ef,346,299,47,South America,20,1754.33
d516edcec9854090b84f5891922b1829,365,349,16,Europe,24,1352.2
d51772225d0242efbbbb4913e060f537,201,177,24,Asia,21,1420.81
d51879d876e246ac811bf4c757727146,322,291,31,Asia,20,2996.41
d519433a84824c3bb6539460bf2fd1e1,363,340,23,North America,22,2515.58
d51e5d23cefa46e2a8d5ae3b9c873a9c,365,352,13,Africa,21,1643.74
d51ebc90c3734bc7b925aca4137fbf54,281,245,36,Europe,17,1685.44
d5212f59438442f585616f4469fb34fa,131,91,40,North America,24,627.57
d52247e70efd4b8998c5b8d65321fdbd,122,103,19,Europe,19,735.12
d522cf41fd1c450786c145702c3dac07,257,229,28,North America,22,1735.03
d52335b933bc4155b751dd95a1c90479,229,175,54,South America,17,1202.76
d523b6e9fbd44641a99586e049a86e9b,185,158,27,South America,23,1611.15
d524a35732454e77909486f26496ab60,82,49,33,Oceania,21,411.53
d524d8e6fa264c69b7155d15b9384742,260,207,53,Asia,20,1274.85
d524fcec5a8a445aaadab91b53fa1361,309,272,37,North America,18,1508.49
d5259c8800be41329bc6f8e6f6b405e0,193,143,50,Oceania,22,1037.45
d5260f4fae3741b68d9314148be5970f,128,86,42,South America,20,782.24
d526c860a8d949c7a9e583c6027a6d99,241,204,37,Africa,23,1596.91
d528109ab4454ab8a61b58cf5f96f9f7,261,212,49,Oceania,20,1282.86
d529170d438c422cb681cab1596c90f8,152,108,44,North America,16,919.58
d52acb0b61674f568ea9105bb971e350,65,1,64,Europe,21,305.98
d52b470836734b2d829454eaa1d8e42b,274,218,56,North America,26,926.52
d52e20a5ce5a4d9ea4e3583556782b77,58,6,52,Africa,17,206.74
d52ef01f1d8f47d9a9aae5517a17f684,263,211,52,South America,21,1170.14
d52f0340168949619be9eb0a58b64f61,212,164,48,Africa,20,1160.09
d5305126c9624ced86c3b1ee4497bb61,190,156,34,Africa,19,1409.58
d530ae2ea928401f9bbe2a64ec2a2963,78,31,47,Africa,27,626.83
d535fc8f16bc4ac5903ae1855e227bfd,146,98,48,Europe,17,834.05
d5369788473142178568fe8d9bdb8c85,37,17,20,Asia,22,440.42
d537ee6199104b71b448e5b3e4427175,288,234,54,North America,18,1560.93
d538d784af854012a17db4f665fb42f6,160,118,42,Europe,17,888.71
d539371724e4438c941a560c52ffcaf0,322,289,33,Oceania,21,2477.92
d53a18d8daf84b849671dc080d195e75,124,84,40,North America,16,823.94
d53bbeb384ef450fb09457149bc54653,360,340,20,Asia,20,2078.63
d53e0225c8bd49ddaa183924b186231e,328,301,27,North America,18,2873.34
d53e86f54a6f4252abc9ab5ae46b7e05,365,329,36,South America,19,1268.38
d5445f9233444c39bd74876cb9dfc0ff,285,262,23,North America,19,1856.39
d54686adc60e439e8e5c44026ae11b79,247,204,43,Oceania,24,1231.9
d549758e36b64d98a0c4497de6dd2a7c,98,53,45,Africa,24,423.38
d54a40cd5a0b4515a06df4a517f5105d,300,252,48,Asia,17,2021.58
d54ad9c834784ef39fd85da3a275d73c,254,212,42,South America,21,1725.82
d54be3a05ce949ffbcf4e3c677036ef7,278,233,45,Asia,19,1170.16
d54c045824674cef86b713fd6261aeb6,365,329,36,Oceania,18,2364.5
d54cda2547cd4818ad3b6eb5921af0c1,280,248,32,Oceania,25,1796.32
d54d4f83b7ef48d4b04c55889859bf4a,88,47,41,Africa,21,584.35
d54e1f31510647ca96b396fd6601a6a3,141,105,36,Europe,24,535.25
d54e2a990b194133bea0fa3013ea204e,89,31,58,South America,25,323.83
d54e2ae346aa45a79a90bd99d7b72ce8,363,340,23,Asia,19,2365.96
d54f0c894cb3455d9eb05122972efa06,231,190,41,Oceania,20,1807.19
d54f37b22db84717a6d1574017754b9b,76,30,46,Asia,17,785.83
d550807814214e4195924cbf9f3b0a7a,365,363,2,Europe,24,1709.43
d552cd61f46e4922a8bb6b9a09537bcb,209,188,21,Asia,12,1284.08
d552febecc1d4f94ac33a7f1c36a41fc,365,335,30,South America,24,2857.58
d55306ec380d434da02b404e926263ae,272,248,24,Africa,24,2378.66
d55390eb7c854be2a93f6cc601894299,214,172,42,Europe,16,1289.55
d555893e96a34d8a8c86af18b2ef6f78,55,34,21,Africa,20,751.78
d55606f328c6496c8e719feb583baefc,364,338,26,Asia,21,3145.73
d5577c0fca4d415381447f6c9c903d08,106,64,42,Europe,21,689.46
d558040314a8427f8c5d1a7e31ad3e81,179,157,22,Europe,19,1127.17
d55845de37cf42f38d7bfe8b17668f3a,364,338,26,Africa,24,3149.21
d558744c8e044239890dbc06c634eecb,33,5,28,Oceania,21,476.87
d558dcf416584d85bcde4e90c4371661,361,326,35,Africa,21,2583.77
d55c5c3f7751438dbe02b12fbe0cd8ed,365,359,6,Europe,19,2633.66
d55d4d08abce4c9fb00043defc46c55c,364,360,4,Oceania,21,1872.67
d55fd34836db480d971134270f561942,337,286,51,North America,16,1521.68
d55ff91f90804826a967bd8f7e6f713b,343,311,32,Europe,22,2414.4
d560e86fb82d464983b130c2f08f8799,246,221,25,Asia,19,1701.76
d56181d3f8d74b649dd1847cfb51cb65,39,16,23,Africa,18,282.18
d561b434b8ed48619c449d99c524b5db,91,70,21,South America,24,511.15
d564bc58239c44989ed1dba4547b380c,242,203,39,North America,19,2040.76
d565fa487a324f93823fe7479949ea19,215,176,39,Africa,22,1662.96
d56768e67d2f45078ffd7edc4d10f398,324,289,35,South America,18,1541.68
d5680b4381e1492ca7e3c0a53cae24ec,249,189,60,Africa,19,1214.16
d56959e2fcb643938ea9e57645ac9e39,74,31,43,North America,19,590.14
d56cbc58948348749d5f150be6c3ff27,65,16,49,South America,22,331.36
d56cc849b6224c93b76626649307a179,270,221,49,Asia,18,2052.89
d56f85aa081244188c002480455d3361,128,104,24,Europe,24,1299.28
d57056d996734ac1bfa65c9a57a5d82f,189,138,51,Asia,25,1039.47
d572cbba20ed416cbca40283c207afc0,365,343,22,North America,17,2849.39
d574144cd2f34b45a056fa30a0d2155e,298,275,23,North America,18,1406.85
d5773561c946445e9b41910dd002124e,287,253,34,Europe,24,1741.76
d577fceb49dc4c16830749c40aa5580b,135,112,23,South America,17,536.52
d5782ff2d4d14112b002d8d5c93e2b9c,225,177,48,Oceania,19,1475.56
d5799d99ac6f4701b36c0aa0fed51c36,207,161,46,Europe,23,1573.8
d579defd911c496eb324a1a1a0a91e06,291,249,42,Europe,18,1901.03
d579ece6019a4ebab4a098741b009767,335,309,26,North America,23,2813.5
d57ac9b5bd3148bea568c855af54d71a,146,117,29,North America,22,1743.47
d57b070fc0a44322976ebf5f002143d7,294,248,46,Oceania,17,1601.67
d57b62a363dd461ea3214466cd3b8fb8,285,245,40,Europe,22,1385.26
d57b98e42e7b4c71b113b0fee10139a7,295,249,46,Oceania,23,1131.21
d57e7e90357e4c93b0bccf0202bd4b82,33,7,26,Africa,25,79.86
d5810bce0b0247488c58dbdb73a4d941,94,67,27,Europe,23,748.44
d58282c500d74550a655315c3ad1aa76,136,113,23,North America,21,739.7
d5829514a62c47f2b74ab9bfb4673f1a,365,354,11,Asia,23,2365.18
d586c3fb2f22464cb58303dc78bb50c7,363,359,4,South America,17,2916.94
d586fa76cf2446cb84c6b6e09c5a2b0d,135,98,37,Europe,22,793.79
d587f85722554a64a309adb5a55de445,294,270,24,Oceania,24,2156.8
d58a1a6d39b54169b183af3fe4de5d9f,33,9,24,North America,16,219.33
d58b67224c694290840b35fcf643d9e4,96,60,36,Oceania,23,496.07
d58ce225c5754839b010f358021c9c4d,89,39,50,Europe,16,265.32
d58ce482d9004136998a0a06a1f76ccb,364,346,18,Europe,20,2477.18
d590732d60b6420d80ebbde50fe09578,364,328,36,Asia,20,2490.24
d591cd41576d4ff3986f6b386067c89f,350,314,36,South America,19,2382.82
d5929aa343494552b25255718b16679a,365,315,50,South America,22,2945.44
d592f3b65c98438ba05b70c2a5a02acd,69,47,22,Asia,20,654.02
d5955e757d16403a8a1ba7e8cb8514fa,225,170,55,Europe,21,1334.73
d59670656f734332b5d8406d9ec6881f,83,57,26,North America,13,716.12
d596d90f47ea47c7898be855197deb73,269,241,28,Europe,25,1997.86
d597db14a9594f6ead4846c8a9070a2d,125,103,22,Oceania,18,1099.63
d59a804c6b264f058285a0bce0796692,193,175,18,North America,21,1699.65
d59b7913cc584349b0e9b31ac311f9ae,363,341,22,Oceania,19,1329.67
d59bb540e0234883bdd7fc7da5b396e9,314,286,28,Asia,24,2276.27
d59c753f3c524153845ab2e8cdda8d5c,111,81,30,Europe,14,859.32
d59cb9eb61c44f098797f383d855e963,362,358,4,Europe,22,1817.99
d59f33d7b5504259a96bd4500ec853e9,267,223,44,Asia,20,1700.11
d5a01bb2104a4c83828177ef267b8d80,208,153,55,South America,14,822.5
d5a202583f114f088c91c6a898a0ab4c,252,211,41,North America,20,1533.7
d5a2a148c41640bc91f1b9c3e30f07ef,343,324,19,Asia,24,2669.13
d5a51c240417448d9b8b11f3bf2f92e8,57,33,24,North America,20,339.71
d5a54c004f2440ebae7458f2514da26c,47,10,37,Africa,20,389.43
d5a70f0238bf43cb858e564e1b030675,163,148,15,South America,26,1032.67
d5a7372afab84a26835eb72cd33a4917,292,258,34,North America,19,2900.62
d5a7c2068dee407d93ccf02b30f08d7e,37,10,27,Europe,19,139.19
d5a8ad06fafd49dbb6a2d2dc18d66b07,213,171,42,Oceania,16,937.75
d5ac911af10a471cb1a5411ab869ee95,352,307,45,Europe,18,2631.95
d5ad124444064c4d8c2ec9e3038e9355,172,155,17,Europe,23,1457.67
d5ae470a1a9e4b018357200a7494adc7,323,276,47,Asia,17,1204.42
d5af353bb2d1492a9275461bca23b932,342,314,28,Africa,17,2616.78
d5af9baf470c41eab7b8fab853a76fb1,76,48,28,North America,21,523.88
d5b06c7b8bc34ebeb99e53bdac69ea31,245,210,35,Africa,24,2176.09
d5b32576139f40878b5ef4e3b6e155de,54,9,45,South America,24,372.95
d5b577f6d33d41cfa6e67f05a9aee658,236,198,38,North America,17,1419.19
d5b5898bc7854bc4a2766fab2aa4a204,62,38,24,Asia,23,347.61
d5b85a842cf345d9b34ec2bfc97c2e8a,42,17,25,South America,16,989.51
d5b96ceba3004b8bad5230091ad521b8,226,170,56,South America,18,1072.61
d5b9ac9dab0a47a5b25369f16fa1ae35,42,17,25,Asia,19,360.38
d5ba5ef188ce4313a4f536dcd306a62f,49,2,47,Asia,19,162.73
d5bb3577ce9e47cd9776760b87cf6656,276,253,23,Oceania,18,1838.93
d5bc22d25f8e464f84cc7c0ba3a5e7df,139,109,30,Asia,23,962.71
d5bcac3a53ff43c8b57d1a3c249de939,85,48,37,North America,22,727.37
d5bd5297570f41a4831f995c112ee0f6,365,357,8,Oceania,15,1958.08
d5c2e64c394042238043977abc9dcd59,158,117,41,Oceania,19,1080.37
d5c3d77566d84abea07d8f1d9ae43f49,128,80,48,Oceania,21,715.8
d5c4ce9476c2480bbcbd45250a546be7,231,200,31,Oceania,20,2048.91
d5c81201f2834ba3b17fa2571d0cecb9,322,301,21,Africa,16,2061.45
d5c8cd71f8144b0bbf90ff0dcef8f40e,135,107,28,Europe,13,601.26
d5c966d8ce3c44d9a7e39dc62e37a152,169,129,40,Europe,21,1030.98
d5cc9768ee6344e7a8ffee86f3bd9492,256,225,31,North America,17,2180.82
d5cd138b9791410e9241768628f9bbee,208,177,31,Oceania,20,1657.55
d5ceafc87c0f42749306baccf2512ffa,37,16,21,Asia,22,232.18
d5cfc2357bcd4ffa8fb7891b25cd09f3,123,100,23,Europe,22,604.32
d5d7858ba6d64261ad5389ff196284d2,135,111,24,Africa,22,805.74
d5dbca56726e405d92f945acdaa383b9,136,91,45,North America,20,881.43
d5dc776cfc9140c7bf08127cddf0029a,364,346,18,Africa,18,2715.24
d5defd9fc31a4e02a68c6eaa3f76770b,83,50,33,South America,17,572.72
d5e0dcb8118348e38483e4164cd81655,221,189,32,Europe,22,1827.5
d5e107ba0e8048869f52376919446df1,44,17,27,South America,27,350.1
d5e274714ee24d32bfccb263d6496629,365,335,30,Europe,23,2321.36
d5e33067126c45daa6a7372a7616da6b,365,363,2,South America,18,2448.74
d5e4fa2a35f5442384c7276646a62e95,245,201,44,North America,21,1828.46
d5e580b71f064da188ea8fdd9d12b7a2,109,88,21,Oceania,17,796.67
d5e8b4d54fbb4bed8b8890ff1754a560,292,248,44,Asia,15,2116.17
d5eae0ba6c2c4df18cf2f2d8d124f201,284,232,52,Asia,19,1379.51
d5eedd9c8af24bbba0265096b76e28b9,270,225,45,Europe,25,1236.45
d5f0708d30094c17944544e61a12e0a9,169,146,23,North America,15,1452.64
d5f107e53cd14875bf34e34fc4ad6581,162,136,26,North America,20,1902.73
d5f27ff9a62f4d58a6193b7ebc164d4f,210,185,25,South America,15,1554.33
d5f74725c23b49879409807ef74df6bc,173,125,48,Europe,24,508.37
d5f9edd123e74f8fb8c29b05ea9e362c,64,44,20,Asia,16,432.3
d5fa4562ad9e4c4c8de25580c3896f93,345,320,25,Africa,23,2977.32
d5fa70b3aa104ad8b3b0ad82b5f4c602,327,308,19,Oceania,24,2648.26
d5fe152fc6fe4affbcaf8bb29ad73aa4,87,36,51,South America,17,714.68
d5fe5a0b089947a48358f98f215369ee,175,147,28,South America,18,1477.9
d5fff33f42424e0b980f586372312750,198,170,28,Asia,18,1368.36
d600dfa698c24875905c0d6c30991a90,223,190,33,Africa,25,1265.01
d6014b8a73b64f0099408865352497ef,137,88,49,North America,19,612.66
d603412132c64988bd9af4b73c858929,55,27,28,North America,17,255.97
d603c4f0b9c846be8de96c4b8fd6f9b8,258,218,40,Africa,24,2015.01
d603d34311be4450b5c414c251506314,229,181,48,Oceania,23,924.62
d604098451f34e7ea45de0fd7484eece,365,324,41,South America,18,2498.16
d6053eb602b44724a5a83467b466a61c,52,2,50,Europe,23,243.15
d6058332daa64e5ea89c9534835eb342,296,260,36,Oceania,21,1487.68
d60a2ac242024a8ea5595ab5e33caaf5,50,3,47,Oceania,17,373.32
d60a6ec1c5fd4bfaa8ab880e110ed068,237,210,27,Oceania,16,1587.62
d60c49d5ddaf415a9692baa8955799b7,108,81,27,Oceania,23,664.5
d60d13303ac44491a08f1797189753d6,215,163,52,Asia,15,1080.23
d60eeb8009734a8a870233bd4ce4ca59,198,171,27,Oceania,17,793.31
d60f88ac434244f3939013c767d2c648,86,45,41,Europe,22,897.95
d6106d29725a4686ae313f6a7139c4f7,195,172,23,Africa,20,1256.9
d612f3db4fe7437090dc3fec5d7c833d,213,179,34,Asia,20,2445.84
d615b555c05248dcaceaeda0ed54e0f3,167,115,52,Oceania,15,1057.9
d6178b29eb434901ba2594506babcb7d,364,326,38,North America,24,2126.47
d618a74f42d341538b9dec17c0f63ff0,58,28,30,Asia,19,354.3
d618cb24cd6740a08fc405936956634a,203,152,51,Europe,21,1151.05
d61a5f4fa6a741059125a066fffa92a1,330,308,22,Oceania,15,2635.35
d61c5ef4df3e485fbc36b9a9e55655aa,227,179,48,North America,19,1435.29
d61d75fb701c402a8d43788d9c8092a3,198,174,24,Asia,20,1891.99
d61e39628a734c8593e36bedf29f7e59,242,200,42,North America,15,1784.21
d61f0b0df07c4c9da3d2a0f2445749c1,46,5,41,Africa,21,420.93
d61f11961d254660989c9eaf37f26224,148,126,22,Oceania,19,851.51
d61f4e66989742dcbd3d878243a105b0,365,364,1,Europe,24,2224.33
d61fa26426b542a69d7068f3303fe9ca,265,247,18,Oceania,21,2041.02
d6202d57d5bf4eb28bb8de5f281a2029,254,212,42,Africa,25,1079.74
d627e54fe55446db9921f9455469ee03,82,53,29,Oceania,22,663.49
d629ad4182874b459623c614ad09a5a8,315,288,27,Africa,14,2141.82
d62a300da79a492bbd56ea3b1873a070,161,125,36,Africa,19,1139.84
d62e71398ee84c9aa14b95cd81425045,288,281,7,Africa,19,2595.73
d63012716353489ca117b1230a661b85,264,226,38,Africa,18,1918.8
d6305c0b54ef4867808d7ad8536080c9,249,202,47,Africa,14,1240.72
d631fc7f1cfc496daf8b1ee51b6377e8,67,46,21,South America,22,621.94
d63238194e924519aeaca0c453de219a,142,91,51,South America,22,717.89
d633372ce05d40a5889bb6f81676aaef,340,322,18,Oceania,15,2637.55
d63413bbb01f43f485a5c436f8de0df4,60,29,31,South America,20,247.48
d6369b3fd95a439e9591656c8a586627,192,170,22,Asia,17,1962.91
d63f3ac2d95a499a8e1dc0530da1f0e2,268,227,41,Europe,20,1611.18
d640ed83628345e0928f6512ae83e187,152,104,48,Europe,17,1114.08
d6445dd8d92949df8d86b7e67cd388f9,298,265,33,Europe,20,2081.74
d6460b3d54d54c3fb2d3232230f31643,339,305,34,Africa,17,3441.87
d64724b168274c19a33849c0ecca08a9,162,132,30,South America,19,1288.27
d64920df45394644b316aeee22b2d342,283,246,37,Europe,26,2350.98
d6492945412b4f5db4c9b7365de53ef5,214,167,47,Asia,23,1109.32
d64949301ec94151af27be54f27ed9d5,205,174,31,Asia,22,1884.86
d64a3492953544e981d8efcca0ce6e37,162,136,26,Africa,18,1042.65
d64b9098e908438fa420aff8b30f2447,226,172,54,South America,20,1192.78
d64c3da923be45a28a7d36756e397367,365,325,40,North America,14,2035.74
d64ccb85263e4507b7ff1edb5bbecc76,337,305,32,Europe,18,3110.87
d64dcbde9ffa42edbb48225ddb891f55,345,306,39,Oceania,27,1712.24
d64dcc63b3624b568935a1a7e8ac4346,35,2,33,Asia,25,580.3
d64f6ab91f92478f92dbd37f39bba654,138,112,26,Asia,20,1089.51
d64f959560cc4759843d98fdc3ac2db9,358,342,16,North America,18,1675.19
d65035ff7dde4bc79e5adf0786e7106b,288,248,40,Africa,17,1167.35
d651fc10a3c54f8fb2dbf95f2441c9b3,251,224,27,Africa,20,1863.3
d6532ba4acc04500876413e346a3f12d,302,260,42,North America,23,2419.89
d65350c345564bc6acdda12c19925cad,242,196,46,North America,18,1775.45
d6545d46355445e6a9fe167a448a20e3,274,240,34,South America,13,2001.93
d65463d2ffbb47d0931fb3eca2be2c21,74,40,34,North America,18,415.21
d655021ffec44379800769a29a2a947f,176,124,52,Asia,19,1518.21
d6577b3f94d94433b4d740873e08395a,189,157,32,South America,19,1344.17
d6583497826845a7b59a50321522569f,263,222,41,Europe,19,1816.02
d65925031600469c949f7ee7406be2a2,364,324,40,North America,17,1945.44
d6592f8132e44b19971553b1f9d395b9,163,132,31,South America,18,1397.53
d6597905df6a486ebebb9eda813f3ae2,365,362,3,Asia,17,2191.17
d65fdb9892f14abda72310c90702def5,321,281,40,Asia,16,2488.6
d66043447ff04d459d74ac9c5d1148a3,134,93,41,South America,11,605.02
d6613d1e1fa7431b92623aa58c596d89,287,260,27,South America,16,2097.2
d6673d4de46a450a860b98f27668bf73,87,61,26,North America,23,738.28
d6679cff9e2149f6bd02c12b7bfb6aa3,251,203,48,South America,22,1914.4
d668db1b4f8f4787abbf7fa5d9a09e30,287,250,37,Oceania,23,1562.59
d66c3508cacd463c964c9fac02c22156,291,269,22,Oceania,21,2482.58
d66d09716c4b4217b494f57dac8a83a2,89,59,30,South America,18,472.23
d66f87a8c6b449e5a4c24191dfe06c43,274,236,38,Europe,17,2075.29
d66f8c71ad5e43d1932e5ce3e4cfb2d8,266,231,35,North America,15,1736.18
d670620ec0cc4bd4a20951edd5f4344b,364,308,56,North America,18,1068.12
d6722962539442be9409e4ba6f6d55eb,231,175,56,Europe,15,1635.23
d673bd1a042748dbb26bcca394995c2a,358,335,23,Asia,18,2711.77
d6740bf24ec740b388a955cc7268b0fa,178,156,22,Europe,22,1391.33
d675a1d390b24cb58bd2aca7b158ac46,125,67,58,Asia,17,324.63
d675a996128c4b73b5c5380930743cec,245,221,24,Africa,16,1568.94
d6760d15a91d47a7a98ef1e08a7ec3e5,84,58,26,Africa,20,913.78
d676371c7a61442d846bd483d3c5c582,144,87,57,Oceania,20,1081.06
d67705baa152406f9402d7ff9ecfeada,137,102,35,Europe,24,551
d679d51407af43f8b48e8c6c4454ceeb,105,63,42,Oceania,18,423.32
d67a3072328147a288bf8ebd87e7b2c9,216,167,49,North America,22,1428.56
d67acda73db14135af9587972034c986,226,209,17,Asia,22,1594.2
d67c224b6312449dbb24e34e2cdd924e,363,315,48,Europe,17,1703.62
d67c943d389b4b6dabc5225cc84d01b2,172,121,51,South America,21,956.21
d67cdba0fcbb4bd7b6cd1fac2adefa6e,364,335,29,North America,19,2042.85
d67cfea77d414b39bc918df970639e0e,365,328,37,Asia,19,2062.87
d67d03233dbf4674bca9909864bc9ad7,241,226,15,North America,18,2252.62
d67dfbd09bc24cf4a6e952c673d29388,219,199,20,Europe,17,1580.31
d67ee4e890eb45ba95059046f6692609,300,273,27,South America,21,1689.13
d67ef7c573b5438f8baec36c0cef497c,281,242,39,Asia,22,1892.27
d67f6f50bccf44babb1c4294c149a66a,46,4,42,Europe,19,277.58
d67f987beb634f34955aa8b5bb6df4f1,219,195,24,South America,18,1716.04
d6806e0a5d9946a4a5c4a3a3c311c31f,219,184,35,Oceania,17,1497.73
d68160c80ab448d4ab02b705ea5bb189,365,338,27,Asia,19,2765.69
d681f3d4c79b47f0aa64da68490b537c,111,90,21,Oceania,22,985.03
d6838aebfc0a4d2fbd2ddb44642cf8e5,223,186,37,North America,19,1687.51
d685a4fe01eb43fcb86850513d781917,318,272,46,Europe,17,1676.94
d6861b76729d4c9f9de4f2394fa043cb,196,170,26,Oceania,21,1493.18
d68651abb99744a6b1b7aa55ab850798,331,292,39,Africa,22,1711.66
d6869625100f4863beb9837e9c0c6efe,309,274,35,Asia,21,1675.38
d686e55c4bff48e5b35fa07c975965b4,365,361,4,Asia,13,1954.25
d687ddf9c53c4d6e88102935d2ba66ff,365,339,26,Asia,19,2111.35
d688857802ce4344b538fd444b71e853,186,143,43,South America,17,648.05
d689171468474e469cb599e83ed4733d,62,40,22,Oceania,23,584.28
d68a940bb8e641a88884d3d4e8fd2d67,323,302,21,Oceania,21,1755.2
d68b78ca44ba4573998531ca256fb980,49,3,46,Oceania,26,83.08
d68c8ea88eb34531b83e487f9d8de660,109,79,30,South America,20,655.99
d691de2fe5dc4516be862a56002699f5,157,104,53,South America,22,815.28
d6941781564b498c963ae7294502f2f9,200,169,31,South America,23,1491.44
d694a8154a254ca9a1e685b9e9671f40,285,222,63,North America,16,1442.97
d69596bae36541e19b3a0c8fe542610e,284,235,49,Asia,22,1412.86
d696d286bde84369b7c08a56eed8730e,154,93,61,Africa,21,581.9
d69865699b654da885136bf1849b8db5,294,268,26,Europe,19,2555.51
d698685a5314409e9bc1f7b37e172fcf,322,287,35,Asia,28,2261.33
d69c267cb31140868cf453131c138685,136,114,22,Oceania,17,747.56
d69e78f4e55e47b4a57b8e3f4014a30e,108,61,47,Oceania,23,529.79
d69f086bb2b44d2093c226ee1e5a7afb,103,57,46,Asia,22,463.92
d6a1e5824f28465691a00c847e4d3cd3,295,265,30,Europe,16,2413.35
d6a5d3c79631439cb688174f31295e18,166,150,16,Africa,18,1196.35
d6a5e7e3e6a04b6c9ce2060b6c354468,200,174,26,Europe,18,1659.82
d6a840ac3b59467bb7d76e3c12facdae,327,291,36,Oceania,19,2666.7
d6a84e65caf242b0b01c569d2172544a,121,87,34,South America,26,801.83
d6a8faf4bd0d4e6382ab1caac4dd97f1,289,249,40,South America,14,1919.71
d6a9f40fad884fcaa0687983a8465c22,167,131,36,Oceania,21,1309.5
d6ad2d91b93e4b15aeaed63b2f8012ec,39,20,19,Oceania,18,174.22
d6adb48793c6493cb6405b5baa8d9f98,265,222,43,Oceania,20,1227.9
d6aec6ec072646fcb680ba05cf24f9cd,245,192,53,South America,23,1292.51
d6aecc1c51be4140b83d453b69f4bed4,87,54,33,Asia,19,1042.85
d6afa98484274a46aa1de823b306a3fd,317,288,29,North America,20,2474.31
d6b0c027e6c94fe889024346bc46cde9,357,330,27,Oceania,16,2744.85
d6b1cceea4594bbe860cb1f1938dc961,116,87,29,North America,19,493.55
d6b41d0dab0a407eabf52fe7cd02b53a,92,66,26,North America,20,1041.98
d6b5865b9661409a961e05b70c729533,364,351,13,North America,20,1734.39
d6b5a92a29e24b1887bfab0ab97b95cb,209,168,41,South America,23,1087.95
d6b64606ed424516a5dacc4e0ed83ecf,301,250,51,North America,20,1507.81
d6b70d4a493a4e578138ef318e2c066f,76,40,36,Africa,25,600.53
d6b7506102fa432781d2bce94240b17e,201,160,41,Oceania,17,1733.89
d6bab465574045449db5c5a64ff82613,338,288,50,Europe,20,1788.09
d6bbaa6df42b4465aa5dab6a9ba2f79b,159,110,49,North America,14,762.23
d6bc9dc8fec449849bbd85a387d0be62,257,216,41,North America,21,2361.94
d6bcbf219ac14cecab3c2fd3d462efe3,181,128,53,North America,18,586.97
d6bce97b9eb54067956c0da85411a74c,270,215,55,Oceania,19,855.18
d6c2a74156d543fea06e87770502b6f9,232,188,44,Oceania,22,1201.9
d6c2dc8203ea47d4963aad9db3553d8f,363,337,26,Africa,18,2306.01
d6c4b180eb3e4f96b58dc25b50084893,111,78,33,South America,17,609.46
d6c5c62459f440d38ebc005b44854291,365,330,35,Oceania,19,2943.76
d6c741d745b840f98863765ab5ad5d78,339,284,55,Asia,20,1319.38
d6cad69982e74266b0c9237e36f05895,159,124,35,South America,19,947.48
d6cb602af2e941468c102bea88ff7824,169,134,35,Africa,17,1307.72
d6cbc2f59ecd4fb59f24508973b80c1b,82,42,40,North America,22,580.68
d6cbd3b3d78645e6b34c0d88aacdcd1f,324,306,18,Oceania,19,2632.94
d6cbd8dd5f0d4bbe87c62a67d7f7f72e,185,140,45,Oceania,19,945.88
d6cde0deb8804907a8dfe672341158b9,175,143,32,Asia,14,1378.12
d6ce5877592f46898957fc9d13373824,243,218,25,North America,20,2028.77
d6d3b7cb678a4fb98e98e6c85ce4240d,315,268,47,Asia,18,1541.72
d6d523a62aea4ec7bb51bf28b14babc1,299,257,42,Africa,20,1620.27
d6d76130de224811ad3e75a6398a7f30,190,159,31,Oceania,20,1454.35
d6d9003083984d2e856ddfcaec69194b,149,134,15,Oceania,25,848.45
d6da4c9b70ba41f98ea6a367ae0f26b6,215,178,37,Oceania,25,1157.88
d6dac22351f341038eea6969e74ddfcb,116,83,33,South America,17,887.83
d6db8b1a96b343b0af930b8fe8682116,284,224,60,Asia,21,1607.75
d6dc0f5b69d3414ea3c0347a2ab29d08,326,300,26,Asia,21,2215.11
d6dc471c9e3146c2a3e1f5ab4dfcb27b,286,248,38,Africa,19,1911.96
d6df399a571640288d570f7ab60b7531,260,213,47,Europe,22,1605.5
d6e018acd73c4e8182e62275f7090dd0,211,165,46,Asia,23,1097.57
d6e03a5989f546f3a58a45ade5541361,77,44,33,North America,21,574.84
d6e34b769d7b4531bf773981ca567c76,365,339,26,South America,18,1728.81
d6e747851aef4da3aca104ff82bd5177,53,16,37,South America,24,264.98
d6e88e32af874014a17a07be2528308c,324,277,47,Europe,21,1594.97
d6ee5d26a7b8434fb35e000c5392c284,247,201,46,Europe,21,1579.42
d6ee70622c994836aca31220f145b96d,134,86,48,Africa,18,579.49
d6eeaf74c1234dbd89b3d921ae358450,282,260,22,Oceania,20,1791.92
d6f022ea85384334b68be7bc6c2ce49a,34,15,19,South America,18,227.8
d6f2508f8a734ba495509fce496ac050,284,263,21,Oceania,22,2011.36
d6f3726d412447c097acdbeae461fc24,243,228,15,North America,21,2228.52
d6f4dbee823e43cc949783d3bf60e057,39,10,29,Asia,22,397.72
d6f5696cb05942c1880c22c1a485bb56,101,76,25,Oceania,22,1214.75
d6f6164d25b7442ab8e62756f17bff96,45,10,35,Africa,19,568.09
d6f6c4d8f6a740ff89068d3e09f19e05,78,48,30,Asia,17,722.71
d6f720db52934d039b45e319510ae78b,253,217,36,Africa,16,1367
d6fa4b107cc54f6488fb232f247a44c0,337,299,38,South America,23,1785.19
d6faf8cf6c944d4d99f6a2558558a706,365,356,9,South America,22,2567.1
d6fd5c2725914335946ad0ebd42bd897,364,347,17,Oceania,23,3656.64
d6fe1cf79eb44ac883d47c93899a0b7c,295,255,40,South America,17,1953.56
d6ff4de20e6e4ebf98d27368e143006c,169,133,36,South America,22,965.01
d70065684bea490380a37a39dc6092ef,365,344,21,Europe,18,2731.16
d701d84af01c4e62a87768c972821e81,251,210,41,Africa,20,1320.81
d7045a28a72f421e88a2c83403a6183a,163,134,29,Oceania,19,1415.18
d705a45e572f4399863883ac306b72d1,360,334,26,South America,18,2778.37
d707fc002e174fbc8d65511ddbdfa9d9,346,307,39,South America,22,2907.43
d70946bfbdf444e3ad5ecf4c28246412,250,199,51,Europe,20,1966.25
d70a9238fef84210b62e272fdcab9353,358,334,24,North America,13,2938.86
d70ab6367783406d8f59e4808c2b9dd9,203,154,49,Europe,17,461.96
d70cbc73e54a460684c0835a081583f7,321,281,40,Africa,19,2461.12
d70ea883249947ac961fb2e91326f2ff,177,156,21,North America,18,1556.74
d70f783a175a4dd7b973fd6bd78ea720,305,248,57,South America,23,1399.74
d70ff72060784c629cb22ea43707c489,288,257,31,North America,20,2027.96
d710b170b2a64a918b4477b0217ffc70,120,83,37,Oceania,13,954.29
d7120170e31a40df89f82cf72b82a7e2,205,178,27,Oceania,18,1848.62
d7121795ee9a4886ad6d612c0b8dbccc,73,21,52,South America,19,456.43
d713188c9295454fb1a5fa40d9e4a9b7,361,337,24,Africa,22,2621.74
d716fed7d9604c6bb05b20dda564f45b,82,37,45,Africa,18,640.25
d717c77decc84151a9cae60ebb8528cb,365,340,25,Africa,15,2955.48
d718070280c44376b46de6856fc86032,119,83,36,Asia,21,539.08
d71eb30e46074d5daf3d7d318ae9dee9,251,219,32,Africa,21,1586.21
d71f3225112b4e10a9567a3e03a3172b,180,151,29,Europe,17,1135.65
d722ea0e3db74d8e9867a95bf44ed10a,318,268,50,South America,19,1972.25
d72d73bd5543406281fae1b1f1bbebb2,74,41,33,South America,21,528.57
d72f1df7170643dd8d61f8f70c0a70dc,256,221,35,North America,16,1822.67
d7320b175b154d5891511be9fb1bd645,171,151,20,North America,21,1423.47
d732d92ee3564e3085ece28e4f372780,331,298,33,Europe,22,2841.53
d734df0d98bd467fb233826a1039e5e2,288,249,39,Europe,18,1512.15
d735345e8b604d44b284274a602467b7,58,17,41,Europe,22,111.48
d7357db6c0f749bdaaf383621402a60c,271,217,54,Africa,18,772.57
d738402187df431fa13a60a135d3e040,154,136,18,Africa,18,842.3
d739c0e9db9f481ba7a11bb7b23587ce,325,292,33,Oceania,22,2218.46
d73a5e2cd1ec407e95bbc874fcf2d707,365,351,14,Asia,23,1794.71
d73e3a7f3b5b4bef9677abc7d7086ed3,365,348,17,North America,14,3672.3
d73ff5bffc8e40f7ac4edc21233875d9,176,137,39,Europe,22,841.03
d73ffbfdbce1497dbe2243e3ed0a1359,195,154,41,Oceania,17,1515.69
d742ed2ab2174498b43a342fbd0fdd9c,360,332,28,Africa,19,2242.47
d74376ed60794d04816773cec79584f6,314,273,41,Asia,21,2663.03
d744b79df20f4c5fa8160c8288abe846,154,131,23,Oceania,19,947.39
d745d0f31a2b4656a5eefc22085d2cee,137,111,26,Africa,26,1191.78
d74691e15ce54276a7c634463dc5a42f,365,317,48,Oceania,19,2638.38
d7472038d59c416abc021190c1137e3e,280,242,38,Oceania,12,1894.51
d747995ed2d947938ec5e52a353a8b8b,182,161,21,Europe,19,1406.52
d74996279c3b47069fb12b3ffcb18be9,106,77,29,North America,21,522.95
d74b1c54649b4182ba2f30585bdd5ca8,168,125,43,Europe,21,808.9
d7501c307c454dc594729a20266cb52f,206,157,49,Oceania,19,1345.79
d75036f8d2ee443fb3ef3c094b966ccd,252,200,52,Asia,22,1257.93
d750d8d429bd425886a236528095a8f6,152,117,35,Europe,18,772.5
d752175791894556bf424ba0ddfe96cf,363,341,22,South America,21,2524.36
d752b5bb566f4e82a8bdf93956affd09,365,353,12,Oceania,20,2886.73
d75339bcda374b8f9bdd3f9b23afdeb3,132,104,28,South America,20,1348.17
d753932f7bd74d4ca3aad834376cd919,325,291,34,North America,16,1936.61
d754c02502b84aea91150a9b7b238270,128,97,31,North America,19,1504.55
d7568cea53fe4b378bb9ca4084058aae,297,261,36,Europe,17,1802.02
d756e42703fd46119fb07e520a507b79,155,134,21,South America,23,1260.03
d75c980247a34943985e1e1a1a4a86bf,40,13,27,South America,22,203.71
d75d2da475724aa9bf50d25ab2db35ff,91,46,45,Africa,18,632.49
d7660e3d8ce5449e970b98c4cab0f855,266,237,29,Oceania,19,1527.39
d76616446a874a62b4a11ee907be6956,300,246,54,Africa,25,1532.5
d7690991cc834f4fa8460316abac53a8,346,307,39,Europe,23,2213.11
d769c18ed61546e5b7d0c34764298ad4,247,218,29,Africa,20,2688.5
d76a12591b8f4d1b82627dd1db0c9ccb,282,259,23,Africa,23,2275.32
d76cddf5ebaf4c38b9a58609f3ef667d,164,143,21,South America,23,1720.03
d76e1fd71df64d8e82efcd51c0951e9c,216,189,27,South America,18,1672.97
d76f684d903e48d0ab032e210162b446,195,140,55,North America,23,1009.94
d77053b9da3d44629522f02d167976f8,284,270,14,South America,23,1742.53
d772d0dfa4064515bebca1d774b764c9,154,123,31,North America,21,1255.97
d7750fbcb9c442a593dce966cca4da73,191,155,36,Africa,20,1426.09
d778312c28e94f33a872a3211a561cbf,211,162,49,South America,21,972.06
d778f0e70fa14e8a8af8cde74b0d1e66,316,273,43,South America,16,2614.54
d77b3f7ce3164cb29eb2333113df078b,81,43,38,Africa,21,312.81
d77c3add007046f79bdb0fb253a488f5,68,42,26,Oceania,22,627.56
d77c43053db241f281ee8d917b010119,55,6,49,Asia,15,363.28
d77cccfcb10b4dc2a928a18814035f9d,265,222,43,Europe,25,1734.97
d77d009434be4038a426ffa91ca902f1,158,110,48,Europe,25,777.52
d77dbf747c1747b8aa15289b9dd18ac5,248,225,23,Europe,20,2623.47
d77e92bd7b9643d38ad70c6bfb02ca4c,69,38,31,Asia,20,513.18
d77ea33a42614637abaa346c61d6e272,41,16,25,South America,19,375.26
d780314a78a0426ebd04b3bb28070c9b,365,355,10,North America,16,2079.44
d782ab2309904f96b61cf89f24eccaad,364,352,12,Europe,21,1751.2
d78492fdb3704a4fba10000caf6b2c65,157,108,49,Oceania,21,1067.5
d786a417406a43789af7a842e153d5dc,184,135,49,Africa,17,1215.25
d7898e9147a24b769962b1362cf8b00e,55,2,53,Europe,18,370.02
d78fcba427824a589a1b45af71024c8a,330,310,20,South America,17,2572.45
d7910c22aff544a59c3384cd8526ef7e,365,350,15,Asia,22,1833.36
d7931aa8d28b4328ad4122fae4b22bee,127,99,28,Africa,22,798.95
d79634010053439889baed3838c6fec7,194,168,26,Asia,20,1591.77
d79654962667429183d1ab5dac442676,226,175,51,Asia,24,1396.35
d797a7d0528f4a34ab4e7ffaab91aa62,74,51,23,Oceania,20,973.76
d799e1aaf5774cf5881b0b7abe65ca52,107,80,27,Europe,20,1141.93
d79c1d8b1888402ea0798331b880d06e,34,1,33,North America,21,252.54
d79c2a7210f34accadcf1cb1b7389ced,310,265,45,Europe,15,2052.02
d79e556299aa4b4f995326e1f968febe,191,151,40,Africa,17,1065.57
d79f1a515cdb444084974125c34107ab,106,83,23,Asia,15,880.55
d79f1d3c2e0b4ef1ad1de18a7be1deea,347,303,44,Africa,19,2818.28
d79ff5734d2449bfa0617fd954110bee,283,244,39,North America,17,1296.24
d7a00280c6d3408a9b817278a329fe9b,106,73,33,Africa,18,849.3
d7a24a0e16ed4e9fbc6d026329105896,43,9,34,Oceania,19,260.63
d7a39356354243a19acd35928e190bb4,123,96,27,Oceania,19,1095.05
d7a51a8156f3434bab4ac0855a128bbc,364,320,44,Oceania,17,1854.99
d7a6e0f518b54d118eaad9def0b79c11,184,141,43,Europe,21,1196.66
d7a8143953f54b799a1843309571a7dc,274,220,54,Oceania,19,1870.44
d7acff26b21e4fabbdc133d254112572,243,198,45,North America,17,1113.66
d7aebb2ddb9d4ed1af4d7095f81fc816,128,96,32,Oceania,27,1193.05
d7aee6db580e4b92a2e6d3f523423660,264,210,54,South America,16,1126.07
d7b0bc863ea84fd488dd1df050604f77,275,250,25,South America,8,1630.29
d7b13d6fc7a9488a9bc37b37c8820055,365,334,31,South America,21,2438.31
d7b33ae0d15941d18ab7446396267d5d,285,229,56,North America,22,1612.49
d7b841df903545ecae7e320bb6f1ac9e,114,96,18,South America,24,1255.41
d7ba72040dd84968994efddef50891ef,115,73,42,Europe,20,910.17
d7bbe955ad174ea0b2d3599432d0647e,250,218,32,South America,20,2090.7
d7bc0e0a8cb2488c825cd7d8cc5da3fe,144,114,30,Asia,23,1331.78
d7bc5ae14ebb435cae4ab4de529e3f4b,348,302,46,Europe,13,2235.76
d7c12598e4b9404ca0d8bba97787e172,178,156,22,Asia,23,1457.42
d7c2aa43122340c98a81d58a33594694,333,297,36,Oceania,24,2368.01
d7c3daa4de68448d959139ace94cfe29,44,9,35,South America,22,289.99
d7c4395d7ade4b1693317a2fdc43915d,352,304,48,Oceania,17,2449.65
d7c4d81457824ca7adfbdb3575a9026e,271,220,51,Europe,20,1440.25
d7c6469dc34a4bddaaa8e4c1459ce252,76,57,19,North America,17,404.71
d7c747130f3f4b1fb47a73152c2fa885,365,339,26,South America,22,2122.72
d7c773fe514a4031ad20782583d5267a,133,97,36,South America,19,793.15
d7c7860f90264a3e8b0494b13a858fa2,328,297,31,Oceania,19,2078.11
d7caa8df9fd74c18a84c3a46dd3b3a8a,174,115,59,Asia,18,776.65
d7caccd8c88d463f9323ffaa255fc0f4,364,347,17,Oceania,22,2477.56
d7cb806fd5a244fbab3cbfa9511db683,135,101,34,Europe,22,1247.07
d7cdce74a5b64b23bf35c4a4f59a5d8a,349,315,34,Asia,22,2691.22
d7cec2f7c084469196ca17ed016d55eb,81,51,30,Africa,21,565.24
d7d0b29647204c3d8837147c6ea51554,187,161,26,Africa,16,1092.2
d7d2d43b25364cca9514d8319147390d,174,122,52,Oceania,16,1003.66
d7d551e2a63d477fa32651df191be84e,339,301,38,North America,18,1338.56
d7d6fd5810c74962bcd54aa3c8db1b78,336,304,32,Africa,21,2605.97
d7d709a7ff4f482a8fa62c23de440937,132,85,47,South America,20,267.15
d7dc6c8d9d654dd083e662ccc691e25f,122,89,33,North America,22,1102.6
d7ddb73d1cdc47e198be2a3ed5a5ae1a,193,151,42,Africa,22,1769.01
d7dde3a4bd164622b45132d494c58a28,229,174,55,Europe,21,1120.85
d7df889f68c347e0af557dd755e939c9,306,289,17,South America,22,1719.18
d7dfd2ec45dc41879b3922a2c7fe05cd,362,345,17,North America,20,1528.59
d7e03119441f4d97807288be65090bda,365,353,12,North America,21,1977.15
d7e19e586497462b8891eb387e550ec6,357,333,24,South America,20,3036.69
d7e37914af3a43f98f86b336ad6daf3c,256,224,32,North America,23,1739.45
d7e632858bd047648dfc606167579c36,136,92,44,Asia,21,1351.64
d7e98bd4224e4f0697ca008473323c9d,345,289,56,Oceania,18,1274.84
d7eaf7bd512e46608141faf572524b4f,277,240,37,Oceania,14,2409.32
d7ecfe6c1b5d41f0aad6126d00714f15,60,24,36,Asia,18,574.96
d7ed013a93e14383b705a11338daa8ba,159,103,56,Asia,25,852.67
d7ed883df8a74327bdc4d0304edb7332,158,112,46,North America,16,712.93
d7eef1d697304581a03333fc89c946e2,264,212,52,Asia,18,1748.21
d7ef9038e1764747a8ecf2dc766dd746,325,298,27,Africa,24,2967.39
d7f5ac71d9544d7eae1a8897b973d9c9,244,201,43,Africa,18,1678.9
d7f638991daa45e68bfb7eefc0b94008,364,333,31,Africa,18,2165.57
d7f7217025d7434a85490bc22231e8b1,111,80,31,Asia,20,674.17
d7f7f622bf7f4ba692c3a5ac49fa6b23,344,317,27,Oceania,23,2523.25
d7fa11c02c8a4e9b8cd210dde70fee88,264,207,57,Oceania,17,1136.54
d7fc55f1b97645b3816b776980c1b52e,46,2,44,South America,18,319.34
d7fcac8416134dae9f9b4d3a1c9b5cfc,163,131,32,South America,19,866.97
d7fdca55412c49faa485d27850722f4a,308,263,45,Europe,17,2444.74
d7fdedede1734e8e821d0bad6757288f,275,238,37,Asia,18,2062.36
d7ffa591c5534c24b534128a674f7144,174,142,32,Europe,18,1228.8
d7ffcb8d370a4d2a8ef75028ca3461c1,74,41,33,Africa,19,624.83
d7ffe083649b4342b5602c7be52d668c,152,100,52,South America,23,395.76
d800c3261ae144e49edacf7228a3b176,153,95,58,Oceania,19,781.4
d8025702a5624c50a29d05f74ce36bb7,365,359,6,Africa,18,2684.22
d8027d2f4c4642a38ba6425aeb5e13d7,47,6,41,Africa,21,294.03
d804f5c8f2db4a1fb5335bf2ab688df8,365,351,14,Oceania,24,2737.07
d806e1c2ca4a4c299946d56c1dd294f7,256,215,41,South America,17,1373.35
d806f3721e964338883c3b7eb9d4107f,195,141,54,Europe,20,779.99
d8086bd64cfc4c1eae53c39efdc23bc2,88,35,53,North America,22,482.89
d80ca78606bc46bfab47b53e1d2fead7,343,312,31,Europe,17,2617.35
d80d7e576970417492a3518e91c36776,343,313,30,Europe,22,2107.71
d80e3f30155b4dd8ac1be80256331813,119,101,18,Europe,19,982.39
d80ed9acf9e5485ead1faaee2f6660dc,365,355,10,Europe,19,2037.06
d8114bd565e04994a23c6b838635378d,57,31,26,Asia,15,221.56
d8117754dc144c0881428e485cd765a0,296,251,45,North America,19,1118.23
d8118543bef94ae3a21335b001863d3d,142,112,30,Oceania,27,720.06
d8137d9d98894148b9029e90cf66c049,361,317,44,Asia,23,2366.18
d814131032554e87b70270b91b44d5c6,129,97,32,North America,22,1022.97
d81686fa0e9943b3885849f9544970ac,161,113,48,Europe,19,717.21
d818436b86f2450f9e3e8ed98d9ed15f,294,243,51,Asia,21,2100
d818f565714c420ea7f3f46764547126,270,240,30,South America,21,1947.62
d81a8890f8904c37867382590472c620,106,70,36,Africa,24,644.32
d81babbce6264bf3a8c7844f1548502a,117,84,33,Europe,20,605.95
d81e5eaf3f104d4abc2e66472aac7548,365,315,50,South America,14,1137.06
d81fbc1c63934c11aa7e0902daaead3f,365,347,18,Oceania,18,1850.69
d82363875a3549c6972055a16b55cecf,58,18,40,Asia,25,275.36
d823649346da47279ace17d13c0901e7,344,298,46,North America,20,1982.8
d82462d701114c1f9baf7102d7f43fc7,236,215,21,Africa,20,2056.95
d8284d4ae7bd4f9d8eaec470f8106b57,122,82,40,Asia,19,764.78
d82b8a34458b44fe956b3620d88163ba,25,3,22,Africa,21,151.94
d8300386372b41f3aad9048648e430d9,132,75,57,Africa,21,392.23
d830f0510c45475a81bfaae46eae9a27,152,119,33,Asia,20,1816.96
d832fc33ee91444fbc369d408ecc3a25,48,26,22,Asia,24,322.97
d8333e8cb260415c869b3780bfa8a8a9,152,131,21,North America,21,846.86
d833ea1df33b44bd98a5839c2378871b,37,12,25,South America,21,173.25
d835a777d4d841ecb92f5055671d43cd,46,9,37,North America,22,371.72
d83630735688424c8973633cade55d2e,206,156,50,South America,20,635.89
d8385fba850349d28a2a92760a6c8f1d,201,173,28,Oceania,17,2060.4
d838fe704b884591ac3d87343082f3f1,129,107,22,Asia,20,924.66
d83c86edc9994100b7f01b862fddf92e,224,200,24,Oceania,21,1271.36
d83f656fb9b047ed985eb79501fa5584,245,220,25,South America,17,2323.57
d8428aefca0c486f9c8e04228442aa72,156,132,24,Oceania,16,1052.13
d843f50fcff149d18266f3e6f820409a,234,183,51,Africa,15,871.08
d845b23baa8044538c7de888ca749c9d,136,111,25,North America,24,1465.56
d845e6d1b2a947aa97bf40d5ec78e116,34,5,29,Oceania,19,421.08
d8460ca32e3a47208402e1ed8bb0e718,204,167,37,Oceania,21,1055.19
d846849556754f418d4004ca472f3cd2,113,69,44,Asia,22,1055.95
d846923205c9492296b3ada6f9442e6d,256,216,40,Asia,21,2298.34
d8480e39f3894e709fb40f5802033f54,147,105,42,Oceania,22,689.46
d84b644b00744fa08abf841c3240ce37,249,235,14,South America,17,2149.48
d84c15643fe5425697c540a7534b073a,324,283,41,North America,23,2310.07
d84c17fac19e4530880365e5caf9f607,364,317,47,Asia,20,1869.55
d84c9e95a77b4991a459ce204f4683b8,343,307,36,Oceania,21,1831.56
d84d8da91bf04057be83c83c55c7ffc1,361,357,4,South America,19,2619.61
d84d98eeda50461a8da007113098cc34,84,57,27,Asia,18,762.19
d84df566db6a4ab08b88fc0dcd6b06ee,184,141,43,Europe,20,1192.17
d853a4645b654c63a898903acfae8efe,229,178,51,South America,23,904.2
d854b8be8f5b4d46828aa43c1dc75b97,247,210,37,North America,21,1789.69
d855d801d78d4497a93d782ccd191ff2,266,234,32,Asia,20,1621.04
d859167a7e024a3c9c32ba8370bd018f,244,191,53,South America,18,1437.31
d859f1d6d3ae48c5ba97eb619072cb09,362,334,28,Asia,18,1959.41
d85a32053b2b4cd1a52cd0b20188e13a,224,179,45,Asia,24,1229.42
d85ba95888a443b1a99117992a86ab5f,214,173,41,South America,26,1628.26
d85c872a76ce44e286a18b646b8e7aad,342,293,49,Asia,21,1920.77
d85e0eb82c654a6287b3fc7622d4a49f,68,14,54,North America,21,307.08
d860703cb619478bbb752ce83ac698f2,325,295,30,Europe,17,3059
d8627b5efdf749ee85c572eceb8c2dce,143,106,37,North America,18,981.73
d8643b02fef948f3bf288c0e41a40c88,56,32,24,Asia,21,630.71
d864c165c7da42eab3b2e757427ea2fa,217,189,28,Europe,25,1571.54
d86510e66fb040f594c369348228ee73,148,96,52,Europe,18,831.69
d8666b7996634fe4a8045f8230b0a674,112,84,28,Europe,19,968.8
d866b5de0ec343469b58a50431f1d2df,142,92,50,Asia,22,1180.29
d8675627dc7141d8bec9a30544391722,299,259,40,Africa,19,2296.4
d8680b14561d41f885a6a87800757c59,292,248,44,North America,20,1432.12
d86842ab5ec544008160311f66f7fdc6,179,134,45,Oceania,19,921.27
d86887ebf3844d0fa6ec5f32da411a12,68,36,32,Oceania,22,496.6
d868d462d1364f1aa85f46358f709506,214,185,29,Europe,22,1473.15
d869c7575be24882a3455d213a265a26,167,118,49,Africa,22,1224.44
d86b65e9b35e41629d3a978fa3ff92f2,153,121,32,South America,22,988.9
d8702762c39249d0bd97e843c4aca363,226,196,30,Europe,18,1150.53
d87117ab5b594de29c82b21c6c0c7f46,288,236,52,Oceania,19,1345.97
d8729af67cf2466681e4a36557340f62,92,61,31,North America,19,666.49
d875884ee39e41dcb2ce1cd6f95a4080,122,73,49,Oceania,22,519.11
d87979658055449eba6cf02fa2ca2da0,129,86,43,South America,22,533.71
d87b6ec917ce4a65b4338e43952a7c0a,196,172,24,South America,18,1117.11
d87b82c2b4a5444ca027576836198b58,113,88,25,Asia,21,1304.54
d87c19feab7a4e2fbda7b25dba0461ec,335,284,51,Oceania,26,1221.34
d880ade94e7341c998684d1b8fa6037f,365,357,8,Asia,13,2658.93
d882d8c26b734d5686c7df06a0c0351a,74,32,42,South America,14,393.98
d883825341bb4c118e984c4f189799ba,357,310,47,South America,17,1629.94
d8838f5151e84e50ac412c81d2830436,93,70,23,South America,20,829.45
d886c9b88e5b428390ae6a1d89cbd191,177,130,47,Africa,20,1090.21
d88a6586076c4522b86bcfb6b9fae0a0,51,9,42,Europe,20,208.98
d8902947a9f94214a2859576fee8e1b6,361,346,15,Oceania,18,1893.68
d8910ad2d24e4094a6836e75293ed8e6,27,1,26,Europe,27,149.91
d8949dc30d414c8b891b232a6497aafc,310,256,54,Africa,20,1947.97
d8952897fd41451f86f28edcde6d3da6,361,306,55,Oceania,16,1709.77
d8956aa2fb3f46fb8ce4aa7c94152989,271,221,50,Oceania,22,1077.22
d896e50ddcfc40f8b2712c7a7c2569b1,362,362,0,North America,18,2563.42
d897d09fff5f48368c8c5cfcdbd7b3ce,364,353,11,Asia,24,3428.28
d8998847297f489f950e55adf9f8ee6f,183,146,37,Oceania,19,1594.56
d89e3374c7184f3ea4172aed8560e32c,225,188,37,Oceania,18,1441.16
d89f4f9e371c4cdcafbf944d92b15869,174,154,20,Oceania,26,1478.95
d8a0c143c68346ee99e30545c8ef1657,229,186,43,Asia,22,1486.79
d8a16096a1f44f938500369aedb90a44,249,230,19,Oceania,15,1569.07
d8a1724404484d4ab4400ba5262bb71d,329,265,64,South America,20,1317.49
d8a3a312728146bfaebc0d6600a00d7e,364,347,17,Oceania,17,2974.22
d8a660ad47c54f4b8e7c5383e3873b0e,365,356,9,Asia,22,1947.5
d8a6d130f6fe40beb2e7336fa588d014,46,8,38,Europe,27,490.99
d8a7d80acbba4042abd19987de8ae35c,194,155,39,Africa,20,1739.03
d8aa7cce180c4ef1a9f4339c0196cc85,243,224,19,South America,22,1910.81
d8ae4b99264f4b07ac6f9f8989da91da,238,208,30,North America,12,1669.58
d8b027d35de34826b3101ff048aa801b,190,151,39,Europe,20,1415.96
d8b0aa8123144de18d76e0b3ee632c9c,194,137,57,North America,16,812.81
d8b2a9ca8ffb42ab8b94894ec8425750,119,66,53,Europe,22,739.91
d8b45df0bf7048dfbe50bb43356f33cf,94,62,32,Asia,18,613.34
d8b584cf0b8a49b8a042f44c1153e5ba,237,189,48,South America,23,856.37
d8b876c0fe134e4fb8a0d5305637c0e9,365,360,5,Europe,25,2769.11
d8bae20e62b74f018a6e28ab9e134ecc,365,353,12,Africa,14,1837.76
d8bb892d70304fb5847de737c4c53875,308,284,24,South America,22,2777.66
d8bbb5b1d03a4fe680c133544c20f0db,98,43,55,North America,21,538.5
d8bef233c122474bbb14868fc1eaeace,82,40,42,Oceania,20,409.47
d8c255b1a89a42e0bccc35ec64b477c9,169,139,30,Africa,19,1749.65
d8c4987e654a4292ba74117139719f74,311,274,37,Europe,15,2049.14
d8c54b1ee30f4a73a339abb529a60199,305,266,39,North America,20,1868.22
d8c612fd6d8d4ca38e149bde52026324,321,299,22,South America,18,2399.36
d8c7b61af7514ce1b88603d323684980,121,78,43,North America,22,835.43
d8c92ec7f4a2405fbe14532101277418,37,4,33,Oceania,22,361.77
d8c938e46a6e455caf49a93250b01b1c,209,186,23,Oceania,16,1779.91
d8cad43c5b654ea691f296bcb6d0e140,244,198,46,Asia,21,1092.08
d8cb99a4db6b4e96838d9f908da8990d,314,271,43,Africa,21,2161.02
d8cc4a390c2b45f6a07508f1d5562058,106,76,30,North America,20,764.45
d8cc57db9479450994f61b4926d7551d,175,142,33,Europe,18,1203.68
d8cd9029064145a1a16165ff0284a064,216,168,48,Europe,23,1391.87
d8d003cd7459418bbd8134a6ffe1e859,202,180,22,Oceania,26,809.3
d8d03c2e4d7a4b05a9b96e70b940eb7d,363,331,32,Oceania,19,1733.65
d8d0528a846e4a9fbd388acaa759c6cd,175,143,32,South America,18,1236.62
d8d11a6832e046efb681af005d2df0e0,228,202,26,Asia,19,2429.14
d8d14aa958b844588b9727746264d793,185,145,40,Oceania,19,1377.56
d8d3140678e54bfa8817238dc4a470a1,172,117,55,Asia,20,638.46
d8d3ba6d931942d2b06ea9da6eea4f29,365,341,24,Asia,23,1757.68
d8d3bb3a6b8e4c52a1eeed310e9df401,36,4,32,Africa,19,417.33
d8d51a0a67ab46b5a54f05aa0dad449e,225,171,54,Oceania,22,1119.88
d8d66c449612425783dbf5d86726334d,337,321,16,Africa,21,3311.21
d8d77b2fb03540fdb95f851efbfa0809,319,267,52,North America,23,1561.2
d8d9ea4efac54d379e2659c0c7fd354f,228,186,42,Oceania,23,1179.88
d8dab8c69c09479aa851bf51c70c0fe6,111,58,53,Asia,22,561.62
d8db9f805dd94456a0d061f01c5fc4f0,309,277,32,South America,20,1595.03
d8df9a8c2c024c9eaf16200d4759ab38,64,24,40,Africa,22,322.3
d8e0193bb5054eae95a294b727d1da32,199,140,59,Asia,21,932.73
d8e30fce83da4996a015d969cd51bfbd,135,88,47,South America,20,825.34
d8e3c93cceec43e5a140b0abb4589862,318,275,43,North America,21,1513.3
d8e5f0cb49f846e5b08f334c01edcb1c,365,351,14,Oceania,18,2657.87
d8e6bc21dd414422b8177954a08e788b,305,248,57,Oceania,22,1903.65
d8e947d0de3d45869a46d7bb9d3511b2,362,328,34,Oceania,16,3131.97
d8e96d739d2d4e4c82fc364d43e4dc3e,329,278,51,South America,11,1532.99
d8e9ec6fa4e84c26aa007e9e4a2fef9f,57,15,42,Asia,23,283.65
d8eb6922b5a74b5d8bca281fe04d585b,278,237,41,Africa,22,1485.35
d8f00385a021436ba7b0c001458006d7,244,228,16,Oceania,20,2176.98
d8f08e91045e43bf9b5ee15ef839e52e,90,31,59,Asia,19,864.17
d8f1e3e175694937aee513331619b885,60,40,20,Europe,25,558.16
d8f288c7456a4c15b518b1bdef34a67b,248,211,37,Oceania,22,1365.47
d8f3b6c6548445b4a3d31236eaedd1f9,251,201,50,South America,24,1553.38
d8f614c6e9ee4268b88307a9440e845b,134,110,24,Africa,21,1079.69
d8f89719bf1c4f61985737b4236153bf,365,344,21,North America,25,2391.63
d8f95145fc22423e9e2345c6c151d9b6,160,110,50,Asia,23,688.86
d8faabc28ccb4c5fab8278f91824f6e7,59,34,25,Africa,26,490.91
d8fbd975eabc4edbaa18ccb8f546d6f8,250,228,22,Asia,21,1963.26
d8fc2fe13dec4aff8b78b3852a9679fe,277,224,53,Oceania,21,1375.26
d8fcaec7e328425bbe7193f70d4b64b8,356,328,28,South America,23,2441.54
d9006da3eab44fce9d3f6f3b1567e908,365,326,39,Africa,20,2532.56
d9026decbbb340ff938b5abff1523974,79,55,24,Europe,16,523.83
d902e5f85bbc45a5b991a1606f542dee,306,266,40,Africa,16,1630.16
d90563ed4f3444b89cd440efecef14b2,199,162,37,North America,22,1056.81
d905815bd98541ad91cbbf388253b13f,60,25,35,South America,23,580.48
d906d70470f94351806d2b6ccb76fddf,298,249,49,Europe,15,2275.02
d906e32f0eac41e0817932481b1910c1,320,294,26,Europe,19,1666.66
d9079d38a2a84ef98e19a13795df7867,280,250,30,Asia,19,2183.14
d908ce200a2f49769e47adc1d05e51b8,153,132,21,Oceania,16,1536.94
d90b075d0e6e4bf58c598febca5254d1,133,108,25,Asia,20,915.5
d90be70d74e7473484fd3600dd7dfcf2,58,36,22,Asia,21,109.31
d90f7a1568204f2fb7eedf26fcf20813,267,223,44,Africa,21,1144.74
d90fce7d74604d2bb9970333bb7bb36e,33,6,27,South America,15,147.41
d9103001cd0641f88481efac39c10f91,222,186,36,North America,21,1586.16
d9106eccc6d8488eafc75a6bf4dfc7da,241,219,22,Oceania,22,1826.12
d9116c04bec34042b516047cc568c500,340,307,33,South America,22,2534.66
d911ef7495904e06afd85d90e89f8bb2,258,215,43,North America,21,1808.23
d912a130f71b490aadd69a9eefddb30b,104,79,25,Oceania,23,548.02
d914724859284c6b9aeeb0987e678f41,214,173,41,Africa,18,816.15
d914bf0e48854befab012275554040bb,84,35,49,South America,22,294.31
d9170d42fa90494784c9ce8f3cbef651,282,237,45,South America,20,1688.78
d917808766124d4cacf0ffb4a7bb7fa1,131,81,50,Africa,16,417.89
d917db7803d6468f9318e5f3bf56ea7b,96,51,45,Asia,18,523.94
d917fed6d502452ab3a8099e09726a0c,146,96,50,Europe,22,825.63
d91a4e4f150d45e3835ba5f0f7da4885,104,82,22,Oceania,19,751.84
d91a56b767bc4599965995d6e278353c,124,89,35,Africa,19,465.85
d91bbaa888f04ba3a4dee18098f78e80,363,333,30,North America,23,2468.96
d91f0e5098264520a65b0c5ffaf516d5,261,241,20,Asia,21,2101.68
d92050d44cd4445099446d5b67ac1f85,364,363,1,Africa,21,2080.7
d922c4a4b10e4fc39d7132eb6ec4f213,276,240,36,North America,18,1914.84
d9267a452fef460d8c854c64f3626df9,83,61,22,Europe,19,727.24
d926b569b0404a98aa32acff52d9616e,36,11,25,North America,21,391.67
d92c3aa1e4424878852a0d6fdb3aa413,310,283,27,Oceania,23,2451.58
d92cd5ce16084b6a98e66cb7ee024a54,281,245,36,Asia,22,1073.04
d92e4a63d139431a9c2f4d5f09a0d60f,50,24,26,Asia,22,359.73
d93141c6c3e2425985d44c2c7deae651,365,339,26,Europe,23,1274.31
d932a76842664841962aec7a2d80efc2,31,2,29,Europe,20,207.62
d932f564bd214f1881195d9d26a69b32,290,232,58,North America,23,1584.05
d934b159ec4743a4ab20c3abc3884850,110,62,48,South America,23,712.02
d934b36698214ae29348948c4f29e9f6,161,120,41,Oceania,23,968.93
d936cfa084e4419fbe12a927a0c4479a,70,25,45,Asia,17,445.57
d936d9a14bc44fe3809a8094fbd9d583,225,173,52,Oceania,16,1438.63
d936f9b7f66449e3bb6f334f366e36d5,250,201,49,Africa,20,1032.28
d937db9535c94007acb404d3b6c911fd,365,330,35,Africa,15,2842.7
d937fd79511f40dba9ec06159436be87,82,30,52,Asia,21,324.56
d93a3b78fd664770b33462c69f8b1787,34,15,19,Asia,19,527.53
d93bb53e0eed4db0a9ca61fdab9dc1d4,263,224,39,Europe,23,1482.84
d93c1b8516184410a00c8b74e3ba60b3,185,162,23,Asia,16,1691.5
d93da3b59fb749df902c04f4cbcf4c4c,309,291,18,North America,21,2015.84
d93ee8091899449497806a9cd3d6b265,337,295,42,Africa,20,3046.51
d93fa9fda43242aa9b47ad326a34e9a3,154,126,28,South America,26,1232.51
d94092b9691445c294e2bf834b965391,335,290,45,Asia,20,1640.51
d942a8dfac11483496ed208ae93715e6,264,237,27,South America,17,2007.94
d943afa4d3b24df3875b2bb895cd5dc3,206,187,19,Europe,17,1789.83
d943c1de6d7247de9809962a8dc3043c,168,134,34,Europe,20,950.7
d9470a560f57429aa5e5e049aa93c5e2,274,224,50,North America,20,1755.63
d94a847f614043bd94a67bd8408a8119,341,317,24,North America,20,2125.53
d94b9cd043774acd9300ff58ffc9db4d,212,186,26,South America,20,2085.28
d94beb80d28c4085bc7b1a87025bddb1,104,70,34,Europe,20,691.42
d94d8097e59b4f23842d3b399933b8ce,153,119,34,Africa,22,1183.85
d94f39383a3b464abbedbedb7c90ebaf,139,108,31,South America,14,786.75
d94fc0c72fb9456b96618875c43385b0,137,96,41,Oceania,18,970.85
d950a805d50242ffb52b8bcb37d26918,365,350,15,Africa,23,2067.93
d954205f5528458e9e0cccb21949099b,82,52,30,South America,16,768.43
d95431c7616b440a9e16c73b9afe216a,79,45,34,Africa,21,394.92
d954968216c84c409060e6dbe3fbaa90,42,9,33,North America,26,353.84
d95585e378ec4fcdb29b1b25a34de26e,121,86,35,North America,21,1020.01
d95591b3b6304ab9b425736fa8ef7800,323,292,31,South America,23,2325.61
d956445744424a2a91ffbc7307a67017,191,131,60,North America,26,1090.01
d9568c2470164eeeb4a605b285b6b470,57,1,56,Asia,24,252.18
d956ca38425540bcb75d2b9b1b039d6b,123,91,32,South America,19,914.44
d9594f140701462b8dd4cc5be7371c0a,340,297,43,Europe,19,1426.22
d95a277d0bc74c9f8218f64dbfdc0c6d,208,180,28,South America,14,1726.67
d95a7ed9618f4d68946861a09c3abb01,352,318,34,Europe,25,2362.78
d95ab337c3c9417980f0140a71d45d18,114,86,28,South America,18,921.64
d95be3bb493446d8bafd8c1669ba3967,218,169,49,North America,22,1122.62
d95dd476fad546e1bc7f0ffb8b593de2,337,292,45,North America,24,1568.78
d95e36c9a7524142bdc527cd3b7c8e1b,337,282,55,Africa,23,2045.81
d95e5e5dc23a40db8cbd9518f1fb941e,353,310,43,Africa,19,2339.61
d960343413874bfe877d8ad9b9a2f036,363,331,32,South America,20,2005.6
d9616b43476a4e088b3c444a22a83e86,116,73,43,Europe,26,685.74
d9623933dae04c7a84b9fabf59a0148e,232,196,36,Asia,23,1812.38
d96430196ba54a5685417c7c3f42ad92,145,116,29,Oceania,16,1319.86
d96ade498e724f388f63b1cf9022d568,309,252,57,Oceania,21,2014.15
d96c4b7e71964570b370256d376575ff,258,237,21,Africa,25,2077.19
d9700ef1ef8b4adeb52516eda71bc4be,319,277,42,South America,21,1912.8
d97048ad57fe4629909b459f95ccf857,284,263,21,Oceania,16,2034.36
d97083cb115e4840b9385d35ea03a733,96,41,55,Oceania,19,450.98
d973c8b0487b43589001380843df8dcc,341,299,42,North America,21,2192.46
d9742998e241432ead851f039844d903,25,1,24,Africa,24,88.87
d977bd3fbc9a42e8aba8ec382c437184,189,141,48,North America,21,1135.17
d977d86a645f4cc785be1d59fd8891b4,70,50,20,Oceania,19,383.38
d97a0a316b2d44599f11005d763a7bd6,194,153,41,Asia,24,1163.92
d97bb6f2e9e848458d0c174eb2db6c0a,201,167,34,Oceania,18,911.11
d97e5055007d4e18a2c4e96dbeba2deb,235,206,29,Asia,16,1955.34
d9823efc977841839d4235a78754182c,285,261,24,North America,17,2221.05
d9834079d34d4bed8da4b12fbb13d333,54,27,27,Oceania,21,755.34
d9839a0bf4344ae884bb57f7a67d1553,363,359,4,North America,17,2635.37
d9889c1f27d04a879225a3d8824b4d61,190,162,28,North America,16,1513.95
d98b044d9d5e450a86b21b267f0129cf,89,48,41,Africa,20,651.55
d98d0dff0c8a4c52936994fb0e374418,257,226,31,Asia,24,1444.94
d98d301b9bdc4053ad3456350321a4e0,273,232,41,Europe,19,1876.4
d98e593b8e254daa915ff4f43394e0f4,202,171,31,Asia,22,1760.87
d9954e56f9ac4b2fbf3d484dabdf5dae,83,64,19,Oceania,19,923.9
d999ffdc086c42f3bda1c90d6d43c863,364,352,12,Asia,17,1941.02
d99a9f6103224153a57b98507725db0f,271,220,51,Africa,29,1155.48
d99bdf0809914bd689521383975c5170,255,214,41,South America,20,1622.27
d99e04b624994112acedc472b3ec4539,84,39,45,Asia,19,564.52
d99ff1641def4029acf317d47e0bd97e,338,299,39,Africa,23,2153.79
d9a19aceba1a41619eb7c2cbd471a0de,146,123,23,Europe,21,1049.75
d9a24605f7d6437cadc174761ef9d996,109,75,34,Africa,22,657.7
d9a3292cbf954e1ca9fbc87cdd367e0f,174,118,56,North America,20,605.29
d9a3a95a257947ac9d58c7d30ae24c5b,206,173,33,Oceania,19,1475.17
d9a85445120e4a67b22c404d6140c1a8,39,1,38,Asia,23,227.75
d9ac1cdebf7844b099c94006c604e959,77,46,31,South America,19,413.55
d9ac6de16bed4673ab4bc5cb81cabcd7,174,129,45,North America,28,1278.97
d9aca173c1494108b69d239e9934f152,201,157,44,Oceania,24,1668.25
d9ad8354394e42bbbc79fa8227b432d4,304,255,49,Africa,22,1698.8
d9adeca6b0bc4387b5c609437f3d7568,231,181,50,North America,22,1172.23
d9ae4140e83d48bab4b2415ee035d731,117,83,34,Africa,19,1263.81
d9b4054246e74de7bf92f737c70f3e44,294,238,56,South America,21,1773.26
d9b566a72408443a93f3054385f46cae,350,307,43,South America,19,1695.55
d9b62266afd346d7a18c709b94094480,155,125,30,South America,21,1184.51
d9b6c59af11b4e2e85a6f5efde675e35,64,37,27,Africa,23,314.63
d9b7c59297bf4dde8effcc8b8e61be8b,296,270,26,South America,24,2868.29
d9b8f5310f294b74874333628dd590a5,365,362,3,Europe,18,2955.41
d9ba4feb627e443487a3e414361fabb8,173,135,38,South America,19,1034.58
d9ba7befd83f46b7825d96a64c978ff3,295,238,57,Europe,21,1708.74
d9bad9b7401347b5a5b63162f2665596,309,290,19,Asia,19,2719.33
d9bcf4fc8aaf47bf8aa7e1d6ea84a5e3,161,117,44,North America,25,1532.58
d9c1310651414edfb4ea4317bbf4e1f4,359,315,44,South America,20,2615.48
d9c3da105da34b87ac7368ddafa36c18,135,101,34,North America,17,916.1
d9c5eb0539ac463daa8ffcd215574d88,228,175,53,South America,28,1417.06
d9c644586854495cb49914bdeadaef4a,355,304,51,North America,20,2004.68
d9c74591a7f2477d9b3dcedb068103ab,245,216,29,Oceania,22,1990.72
d9c812618e5b4b5198871dcb8ff8b4bc,275,247,28,South America,23,2379.24
d9c9051edc8e45b394224529b0521e0b,279,257,22,Oceania,22,2772.22
d9c93d73383a4b45892c1a3f370f9849,121,95,26,Africa,18,1204.25
d9c9556310cc43e3bd80453e9bb43875,216,164,52,North America,20,1218.27
d9cb0c974912411e973883559dd3e219,229,187,42,Oceania,22,1808.91
d9cb40925c0443acb94ab60af70da2c0,279,233,46,Europe,23,1540.25
d9cbe29061264cefab114181c7c43f47,63,14,49,Europe,16,705.24
d9cd5026f3c54c1ea7a83d34680a1efb,135,87,48,South America,21,411.12
d9cfc9d6803c4766847bab52e0cd155d,342,317,25,South America,22,2506.16
d9d1aecfca9942b497d119dd2bc0664a,121,94,27,North America,21,954.34
d9d2c581e8fc4895a75becd9fc5fc5cc,283,236,47,North America,20,1725.7
d9d3f1b8b67746b5802b2ccc5c7842f1,185,148,37,Africa,14,1651.89
d9d5fe73c81b44b9b848a2bae7e86e79,192,165,27,Africa,17,1452.38
d9d691a213ef4de5bcbf31cb601c6187,290,252,38,Europe,20,1425.89
d9d6f50b8ac94ecd923a9f06f21c3c1c,362,309,53,Asia,23,1760.44
d9d7ae04babe44bbbf82d73035bc4c46,230,201,29,North America,21,1572.24
d9d968567b684f18b8369c554553aece,58,11,47,Europe,20,237.14
d9da01358aaf4a1fad3089e6f5dbf42f,166,134,32,Oceania,15,1527.3
d9db0cb58d30432da6b514b44dcb85a0,41,10,31,Europe,13,110.61
d9dbe5c171bc431c89ded1deb68dd009,327,304,23,Europe,22,1935.61
d9dd07b365b44b6fb687b045d76cbcd3,67,43,24,South America,25,403.05
d9e022c791934ce7af7a3982d26c3518,25,9,16,Oceania,13,293.22
d9e201a4e9564f1aaf701aff28640d0d,196,157,39,Europe,17,1345.04
d9e2085a1feb4cc28edb45fbb0e9c333,202,178,24,Oceania,18,1332.03
d9e5d2aeaf37414499cdb2bf1c181148,252,231,21,Oceania,15,1912.67
d9e6dfbe5533478a92cb8691658fa342,126,101,25,Africa,15,831.95
d9e852b6e49b403e856c24eae3a7e027,157,123,34,Europe,20,1109.6
d9e85acea05f4702b6490db3baea2f0a,283,260,23,South America,18,2133.82
d9ea451b293a4d40b01d7c252d504007,316,288,28,Africa,19,2117.99
d9ea5af6985e4fb6afa3da893646d4db,224,190,34,South America,16,1598.18
d9ee707a8892474cb9ff723ca71c45e5,202,158,44,Europe,23,1535.88
d9f0f9a2b6c24e7b9d9e994d044d0a63,199,149,50,Asia,22,1116.9
d9f19b7056c44e3da86c0454bc4885a7,365,344,21,North America,19,1790.2
d9f4f181106a4898a03df08ebb5cc036,76,28,48,Africa,19,729.59
d9f7196b07e54f1aa1eed793d2756d9a,309,272,37,Africa,16,1695.78
d9f7834dd349408189eff15bd64af8cf,302,274,28,North America,19,2563.87
d9f824027cda45f58f8428fff49d2631,179,160,19,South America,27,1546.18
d9f8cfc2ac4043d2a0467ff5f1f9cf83,140,108,32,North America,22,1452.48
d9f9bc82e2dd406cbe99979c42fed78c,202,164,38,Oceania,20,1568.23
d9fa10da56db4934b5ca3aa0b801a602,245,220,25,South America,23,2325.75
d9fd043f91774c7790a5717216166cf1,225,194,31,North America,20,1564.74
d9ffa7016bc14e338a2fe03ac547a761,284,237,47,Europe,17,1495.6
da01706cc7b24f32bcbd7b59f46f1181,267,227,40,North America,21,1645.52
da02275ab164403cb0f0436a2724728d,109,82,27,Asia,21,670.18
da0296e0834f430cae9f83040db5a3c8,306,284,22,North America,21,2645.72
da02f2478d7a480484f64b06a5c5b8f4,98,77,21,North America,21,980.38
da05bb7c22e64f998d0f208434e04f59,338,312,26,Europe,20,2051.57
da05c340a0ed48feb5bf96247baee3f2,364,359,5,Europe,22,1773.43
da06bf0dab6242dd9b0c4525114fa206,99,51,48,South America,17,661.9
da07fe836c024037924527ef5b329200,352,318,34,Europe,19,2424.63
da081119638e4af9955189d9601627c5,312,282,30,Africa,22,2383.73
da081d8d551942fe80f504afbf27632a,364,319,45,Asia,22,1505.65
da0ea5ca8d5545219ab65ff7fd742145,136,84,52,South America,22,811.74
da0ec0e2b54b430491d92cadb601bb1f,365,350,15,South America,17,1582.16
da10673d86f2408b982dfb075b9b0da1,84,38,46,North America,18,974.81
da11291741d848688f34eb3e4711ea3e,73,41,32,Asia,23,408.31
da11ea869c1a4c7a8445b9ddfbd115ff,122,73,49,Oceania,19,519.55
da12a94f322a43d0b2fef1ad62b6c0bf,116,80,36,Africa,22,1016.39
da17291da9fc405683718f92e348b861,70,14,56,Europe,26,455.03
da172bf5747f43a5bb3b5a2e5bc95618,342,315,27,Oceania,16,2267.97
da17413803764b1f9dd97f17035d99c0,321,281,40,North America,18,2235.16
da183162fffa4da2b89f9f9e0aff2bbd,361,354,7,Oceania,14,2830.43
da18c707b95e440faef817126f6b9392,364,336,28,Oceania,20,2759.33
da1909375b14435494af3b9dc3221522,334,291,43,North America,22,1262.86
da1c9731fb5646fc9f08ea4c089f5cc9,344,292,52,South America,25,1605
da1e2f083b1040e7bafdf42176a79ee2,190,149,41,North America,23,1219.08
da1ec20a5e264fda833fc3582c872e3f,363,343,20,Africa,24,3003.95
da215cfa7c1543d28eb3117eda2dec66,69,15,54,South America,22,319.74
da21d085f75341b49d543c6e7c1a3aeb,144,117,27,Africa,21,466.08
da226f739ee342e0b3efaefe1cd223c7,264,205,59,South America,18,1247.92
da232aea24394bc3bf8a660fa2cb1fd4,205,154,51,Asia,22,1167.4
da26b3248a924970a8fc62a3844ce21c,157,122,35,Asia,21,959.58
da274dfacbbf4481a5c2b5c38417caa6,46,11,35,South America,20,360.09
da289f636ce1478ab7a6a306bef731e4,178,147,31,North America,18,1282.25
da2bead8d1f1421f97273122124023d8,359,333,26,Europe,22,2980.92
da302f93167d4d5ebc3e932a67a35da3,355,312,43,Asia,22,1974.45
da3098797bb048c0994a3581590df8fe,296,259,37,North America,24,1545.53
da30d5170f554935a8d5b00426fe815c,364,356,8,South America,17,2633.84
da3380b04b2242869aee47daa6f83f54,77,45,32,North America,19,740.47
da357d38031d42bd9fe115ae954ba6aa,365,364,1,Asia,21,2065.67
da3851251e914714889cdc47e832f20b,319,281,38,South America,18,2474.02
da39723431444c389cff830d9afeb5bd,132,107,25,Africa,26,621.81
da399a2788b54644beed00b183a9179a,365,348,17,South America,20,2402.3
da39f2a9b8454d4e99ee053ad6d58dd0,198,149,49,Africa,25,1027.84
da3bee5e51e6439eb09f43e2b9f1aa5c,105,69,36,Oceania,22,571.91
da3ca3b7e53044ae9ee05f69b235e912,130,84,46,Europe,22,789.73
da3f384f495b466bab0e74bfa1c25523,124,108,16,Oceania,23,922.86
da4066c4207b481d88bed5e469bef6c9,365,336,29,Oceania,17,2481.83
da41a95201284759958b1b28c834569d,365,365,0,Asia,24,2725.6
da427c1191f143bfbde02b6bce611299,158,117,41,South America,15,631.82
da4302f87a2d4b099be98026eb78a64d,93,37,56,Oceania,19,489.32
da458f96472c43ba8d567df4addf8026,338,316,22,Africa,22,2394.96
da45adfde33b45d6bfe579b0846116f7,129,91,38,North America,20,848.32
da45d066268545ca982b432a4cad9cf3,344,302,42,Europe,15,2093.07
da46f05ad213405ab5723d37f7d430f9,118,74,44,Europe,24,625.72
da48b88c5c1d477f98bc7fd32bc63479,104,66,38,Asia,20,710.47
da49f2281b0242a6b855119c95a0472c,171,129,42,Europe,17,922.09
da4b06379a064b18903ef45acfabb460,51,34,17,Africa,19,520.43
da4cf81aae424658871759d407ed004c,293,274,19,Europe,14,2652.45
da4d5bcb932e4c268723550f98c1f797,335,307,28,Oceania,18,3286.58
da4e03d958a94d5fb32c84869c8cb7df,342,320,22,Europe,18,2946.26
da5086d421a94f68ad9b31335bafcf8f,343,292,51,Asia,17,1391.73
da519a705c7d4df988c5d30d156f7e9f,77,48,29,Oceania,16,540.89
da53584078554a51ae6451823284c3ea,109,62,47,Asia,22,624
da5417a55d6f40c795029ffd2efafe24,359,307,52,North America,21,1863.85
da542715277c4b1e8cdcccecee356c02,87,34,53,South America,18,269.79
da5710729ab14073b82b04b3e047cca7,32,1,31,Asia,22,224.57
da585f8d4df543a182c1ccb1d668c730,222,201,21,Oceania,19,1669.64
da5877acbe7641bdadb73ca9fbd96682,127,90,37,North America,22,436.14
da58c539ab554ebcbbed6373708f4f63,365,327,38,Europe,16,2323.13
da58f25bf5a9417193810fc6354d595c,291,243,48,Africa,19,1614.83
da5943088304471385acaa12e38462ef,142,115,27,South America,15,1230.84
da59e1c7402849c1b9b6548ac7abdb18,365,343,22,South America,19,2759.44
da5b21badeab4aa49ce17c54bb108f5e,275,257,18,Europe,18,1815.57
da5dd567650c47eeb16b2cc54a2856df,100,49,51,North America,20,349.96
da698760c21b4249895d86ea962d7645,73,25,48,Europe,19,288.84
da69b536b0f94599b570bb1188432257,160,129,31,Oceania,24,899.49
da6c9b0dd5bd4d4f83232d5d63190321,117,76,41,Europe,21,768.26
da6d7f3976bc490799387ef9245c7c59,307,256,51,Asia,26,1894.25
da6db9905b1646e296b38a4643e12a0d,102,84,18,Asia,22,764.8
da6dc346bbb84881ad92a2e4fa86ebdd,203,158,45,Africa,23,1148.99
da6fb8a1340843079ca8a3c4dbc304ac,330,281,49,Europe,17,1898.85
da70521c7ff24dc6aae622549d53cfce,223,171,52,Oceania,20,682.31
da7113fea8b349c4a9c1c49b908f547d,365,327,38,Oceania,18,2393.84
da73f6049140486e979c944374be9905,61,13,48,Oceania,21,317.28
da756d99c5f74f438421bc80576f7f69,310,280,30,South America,18,2383.54
da758335e57b4ac19ee53a4c317d9344,92,51,41,Asia,21,864.23
da764de2d3674d92b14c519e50439aea,314,264,50,North America,21,1414.6
da7794a40d164bd888538f1888279bc4,153,115,38,South America,26,1459.11
da78693b98df430d88d5b1bab2f7c07b,335,296,39,Europe,17,2797.47
da78bb30a0184add917608c059abcee7,317,277,40,Europe,23,1898.39
da7b5fd765104c43b783c832b71afb79,327,305,22,Africa,23,2214.87
da7c1605da4445179e35be16a249aefa,289,248,41,Asia,21,2009.41
da7ded031b3e4e388a2a7899209e7514,244,213,31,Africa,23,2248.82
da7e292e76c345008a6b8088f251f655,219,170,49,North America,21,1402.03
da7e7ff5e1f74ef984c7ef2d54b3e55c,347,310,37,North America,23,2085.42
da82db42fd8f42759c06a6ef388c940d,189,155,34,North America,23,1698.97
da83c72684ca47a2b00f5508c28852bc,63,17,46,Africa,24,548.38
da86276d2757434f9913fb10cba0f852,332,298,34,Africa,22,2808.12
da87e4887ec94a85a20a1243a8eeb597,114,57,57,Asia,24,648.74
da8c7620b5064301a448eda9f7489629,312,288,24,Oceania,21,2328.8
da8ccaf1901a4fe688af31d009ed2eb2,305,245,60,North America,19,1902.39
da8d5e43ea05460bad181c40e52de79c,134,89,45,Asia,16,528.88
da8f07a743704f7e87669c29b96db4a9,336,298,38,Europe,22,2282.72
da90412f88ba4a2ca6a047b355a2c40b,53,13,40,Africa,26,298.28
da91c5d28db94a8389ddbfeeeb6c661e,102,59,43,Europe,16,612.7
da938b2f3fe24d3bb7dd7b6cca2d07c6,53,28,25,Oceania,18,614.2
da96596bd9724bdab27e53783028ac70,227,168,59,North America,17,882.34
da966a9780e64e4a854de9fd5f0a7814,291,252,39,South America,21,2059.88
da9a157eb0644a539dcf240cf8f32d3b,98,74,24,Oceania,19,688.91
da9d616691a946678728ef4f0bde1219,58,20,38,North America,18,201.54
da9e18d42078404784a9e7acdd190409,332,300,32,Asia,12,2119.44
daa1f19d738443d9a4513fa3cb9b17a3,365,363,2,Asia,22,2857.96
daa30b163acb4f5fbeb64bb96e3fe5a8,227,182,45,Asia,26,752.18
daa38e9642694ed48066ea7f4111c88c,208,163,45,Oceania,17,840.22
daa4333ca5674644b729b03027da3da5,352,323,29,Europe,22,2775.13
daa44c60406248708fbadb00a78602fa,47,6,41,Oceania,16,326.72
daa73fe3a5f9444e8487c40ebd074b2a,191,145,46,Asia,22,1126.58
daaaf17570a1427e8851a48a3b172ff7,358,319,39,Oceania,13,2219.96
daabc8f537f64015b80d51c59b056bfd,330,293,37,Oceania,17,2093.23
daacdfb581e64e5aacc546e4481d79bd,363,349,14,North America,19,2194.93
daaf565623c14ee49b9df5c871905ce9,246,198,48,Oceania,16,964.58
daaf6a2f77de4f83ba341574cba8a054,165,126,39,North America,21,561.29
dab16e5e97354dffb78c9cb18cbf13b1,49,9,40,North America,24,351.89
dab38ea55d944f0bb1b4cf1b067214f6,365,351,14,Europe,26,2816.86
dab70d0ce3554a27b808f5718950ead8,156,101,55,Africa,23,437.26
dabe5a2f3a794a059d34053ea4f3b607,172,131,41,Europe,25,1024.28
dac14ee3f9d34d8db06d3ebe2fc22670,74,42,32,Asia,20,748.56
dac2bd2178494bd3b461e47eb209c4bd,213,164,49,South America,19,1112.25
dac2faa6f1ef4a2a93ab21ee97cc8b0d,364,345,19,Africa,22,3015.64
dac33919119f429ca3e201a4b13d1f0c,47,5,42,North America,24,167.6
dac45f73faf04edab327860a3eade6ab,345,306,39,North America,13,2130.03
dacadbb5cfce43338afa86a63421b6a5,355,304,51,Europe,23,2291.9
dacbabc61efe45d08fcec32b2fe928be,346,295,51,Africa,16,1712.67
dad16c47746043a1b73db92f26bd8332,365,347,18,Europe,20,3013.23
dad2f3c517e349728638a454889448db,323,298,25,Asia,17,2488.83
dad35e0af620441ca6ee63fe6570841e,294,272,22,Africa,18,2141.44
dad4f4daac21445caa88dd7bcdf48516,257,235,22,Asia,19,2350.49
dad63bc0c02b4cd898f0583ccb2bb7b5,185,138,47,South America,19,414.55
dad659b456d44cb29afd45a541007dd4,345,317,28,Europe,18,1757.54
dad89d345d7242cbb7091a7adeee6c27,345,308,37,Africa,20,2426.05
dadaa4071a8243889b8bd652a4bd402f,364,352,12,South America,20,1992.01
daddaa2e537d4613953d8f838e4ad112,76,27,49,South America,28,154.61
daddca9bd7e14b3e8a7240f58566d1dc,271,242,29,Asia,16,1964.68
dadf07f551cc4145bced104647cd7679,113,70,43,Africa,18,886.97
dae322b8cb3445eeb0e592af8c580ea0,63,30,33,South America,20,494.78
dae3474d1f4c479f88ca9a2c02f98dd2,307,271,36,Oceania,24,2218.81
dae45d7212734df0b919edf3d0ead411,334,310,24,South America,19,2410.14
dae50ed6dfe4490d81c306dfe46df233,133,96,37,Europe,18,962.59
dae52e890a624b86a3d571e88668d275,301,251,50,Europe,18,1507.96
daeb294e5ac349769e2bf344f9e9e741,159,123,36,Asia,19,1399.35
daec73ed7eac427980f246e1232c3cb6,230,183,47,North America,19,1346.17
daed45eee4e241b9addb5a8d833e4e04,360,339,21,South America,21,3067.61
daee4f7f73b24af49ec26c90ee5b3820,247,197,50,Africa,18,708.74
daf00e6a419048ae84adea1fb7e2e78c,44,10,34,South America,24,204.17
daf01b86dfcc4601ba89d50a0bfebd04,254,216,38,Oceania,16,1750.74
daf332ffede4417bae21ec31911cf954,55,11,44,North America,19,302.03
daf51700e51344b9b91a68e7f05e1a59,187,163,24,Oceania,17,1286.26
daf779fccb8e44cbb788b881e092d16c,283,243,40,South America,24,1450.13
daf7c5a3d6fe4f90a4b298eb554d4cf4,354,293,61,North America,27,1140.54
daf8783d2f7e4352b2a2d43395f0b181,77,39,38,Africa,23,400.09
daf8e1ab699e4538abebfb7b2e402522,188,166,22,Asia,24,1967.93
dafa62b169e4401ba051f7e929d9a942,52,3,49,Africa,21,180.63
dafb212c03da4cb0bd26cb9ccfc50ce9,199,173,26,Africa,22,1161.67
dafb408cfd2e4a97844d8bef54b0cd1f,312,295,17,South America,19,2399.36
dafb561f0f2f4f01803e6de448c30d0c,360,360,0,Africa,18,2858.82
dafc3da48f80421889bc9be2b35fdc20,291,259,32,Asia,16,2204.66
dafed34780ce42f39d6cb399a58db4b2,83,31,52,South America,19,444.77
db0215ce14444ca0bf8f811c86a7089a,70,29,41,South America,12,411.2
db024177268840bfbc562929fd6b0eac,98,46,52,Europe,26,570.2
db0410e00c5c45d48795b9dc1d9174e9,206,183,23,South America,22,1837.71
db04d031b3414d32ae94d8f2a3246bae,231,195,36,North America,20,1560.15
db04f1c860924e75a93718f637a530c6,195,165,30,South America,21,930.88
db08e79badbf4de0bf75283693807311,142,114,28,Asia,22,1245.96
db09ff431fd74dec85fb46455d91e1e9,282,254,28,South America,15,2173.33
db0a308200b84879baf6e256bb72176e,325,284,41,Africa,23,1641.07
db0b3de4a8c34dffb1bc27ad0fdfdb73,324,286,38,North America,20,2201.28
db0bad6e1c85470084915e6c672530eb,95,40,55,North America,18,528.01
db0bded5ecc843f8989556cb84b63d6c,365,349,16,Oceania,20,2765.9
db0e673885614e37b0f59ea7fb5af382,78,50,28,North America,20,788.48
db1355440d1341c89e5157a99d645c88,344,295,49,Oceania,21,1770.56
db1534f3871240bab0c40965359b1a15,365,354,11,North America,19,1960.37
db15745d57b34a75b64d0f6710f8c331,135,99,36,Asia,24,947.99
db19b0f479c0440a91cdfdd908a0092a,166,130,36,Europe,16,1135.33
db1a561736a64a88becd8a8cfbf7ebac,214,188,26,North America,23,1647.61
db1a5d62f33445e482720b97a1e59422,363,337,26,Asia,21,2402.62
db1cf112134a459a900ce0666a906ecb,364,357,7,Africa,16,2043.23
db1f0aeb55f44e4fa0b281f61afc1946,53,2,51,North America,21,275.92
db1fbfa5a993457ebd7260a3bc4cd82b,236,202,34,North America,23,1587.84
db20ab631a804810baa29f2a0f2a8c9a,345,304,41,North America,17,1726.33
db21f5e8354c4a3c896a6e39f63ddc5e,161,107,54,South America,24,766.65
db22751db19e4ef180f463b47a5fa450,171,147,24,South America,16,1042.77
db22902bb079440180a25410fb490394,238,185,53,North America,15,1067.11
db233cc93f9d4beda5942df287e4fdd0,196,147,49,Africa,13,993.97
db23454e7d54453491764ab06acb2f10,236,202,34,South America,19,1620.42
db26d4f0718949c3b2c8768b24aaa5c0,339,316,23,North America,19,2424.37
db27fb73accc4a88a36974c3569f8f04,364,346,18,South America,23,1831.06
db28c52e733746f393e9ff33c83a69e5,238,217,21,North America,22,1269.14
db2a6cff438f4d7e8aeba21836fd6cc5,229,175,54,South America,21,786.66
db2c0ca5afc846db99e00c6d9a1f8f1c,328,289,39,Oceania,19,1808.59
db2d46bd1f564924a7ac857641685c07,258,235,23,Africa,13,1507.31
db30d1c356464fa2a7169f3682220bea,86,28,58,North America,18,259.22
db32a86d977e455cabe2918907cf6b52,259,215,44,South America,25,1885.38
db34b444fafd4c528d5b77fb891af275,93,67,26,South America,23,1002.41
db34f364856044a2bdb7b43688e65f3d,278,244,34,Africa,18,1364.42
db353bd2668e4ca0b506203a1b7b1453,283,239,44,Africa,26,1199.91
db3698f6d94941f09f320fe0750e6401,126,75,51,South America,24,538.22
db36f6b6c0f44462b491177cff2fc5fe,219,160,59,North America,16,773.28
db39f329cdc44de79a34cfd70818b123,299,242,57,Africa,23,1941.05
db3cc9d26d8449c1aca8f40af1e9dcde,60,30,30,Europe,21,207.35
db3d20a81d6446ca904944dc960a76df,289,266,23,Europe,15,2278.05
db3d6eb9c894470e9dd7b22d36217c49,206,159,47,North America,22,1298
db3ddc0d5c7041eebd06e254616a8c5e,116,87,29,Asia,15,898.5
db3ea99473bb47fa9c27c79161c9fac4,274,225,49,South America,17,1473.25
db3f20a5b90b40389129ffb592040198,265,226,39,Oceania,21,1438.37
db443054d24644a4a664252ce94a7f44,353,330,23,North America,20,2599.53
db45209bd190489bb1231c5d1a1e1004,123,90,33,Oceania,20,721.55
db47e529f2424f518fac9654dd96df7b,351,330,21,South America,21,3013.81
db4813732769470bb8c4fac1c35fd5f7,222,182,40,Asia,16,1460.15
db48a4ba759d4249999e3c6aae31a3e7,246,206,40,Oceania,22,2266.96
db497eb7e502413f8c1730d75468cf48,138,98,40,Asia,22,1177.54
db49ba9cfdaa437d8cf0cfd0d2f7244c,83,36,47,Europe,17,582.75
db4b314d72e242beb7f0b97d21566ce5,247,224,23,Oceania,17,1833.57
db4b7049518043e29e7cfd9286108b6b,362,360,2,North America,20,1977.93
db4d8c5837d04513beb9c03b6f85289a,283,234,49,Europe,18,1482.77
db4fde57b1514995ba44448a92cad513,324,281,43,Europe,15,2296.84
db5115fdccd94f5d96e9e8646348f822,125,94,31,North America,21,785.37
db514a343ad5411db494c4925d5f0c57,135,115,20,Africa,24,1301.58
db51ee80706a49fb97bafe991219e85a,301,270,31,Europe,20,2898.32
db52f7140e3b421ea44de9940e432364,126,80,46,Asia,17,1149.09
db54c335380c4c4fa505c26d36994288,269,231,38,Africa,22,2264.44
db54d4ff45f1413b91cfbe72e9fa284e,98,48,50,Africa,22,352.32
db56583a7b0046a89fefb2d79d23f530,364,327,37,Africa,18,2722.07
db585ddf56904442b287451608ee067a,365,349,16,Asia,27,2854.2
db5a4e2166934fed85d807e7ae4ad5ae,354,301,53,North America,22,1762.31
db5b46b667b74978b199bf4a3f86a380,347,316,31,North America,12,2994.04
db5b55dba24e465c897b7bae26ee9115,156,105,51,Oceania,21,958.63
db61897fa205400ea1eaf73145cf1ba1,143,94,49,South America,16,1056.86
db61b107c8ad43fbb31a4c3a0c1b697d,283,248,35,Asia,20,2076.16
db61f60d17054ff6b5374b5dff6ce97c,104,86,18,South America,20,911.92
db62c5852d374f3b9988df109b42fe89,306,275,31,South America,20,2343.47
db62d5f7048e4449a16c08de03d47e70,189,153,36,Asia,20,1357.96
db63cf6e8d2845ab80c1f64cb9f2e2e8,196,163,33,Europe,17,1307.71
db64a155f64f4e958c60ed0a3ac66165,320,288,32,Europe,21,1911.34
db68ae6c1e5544aebc2986346fadcaaa,311,269,42,Asia,22,1480.49
db6b0f7758644c939cc3ec816cb1b5f5,276,240,36,Asia,19,1503.76
db70b3ca9aea4b3f82825dcb8cd35f60,86,56,30,Asia,23,922.42
db71087ae4144217b3673dcc74ead4f5,152,125,27,Oceania,22,1116.17
db71f554f247423a8aa3899465683c69,198,150,48,Asia,20,972.86
db7478a883a54ae581e88465fb801e0e,333,301,32,North America,21,3046.13
db74e0b7c1824843a2ded588c45124f7,115,76,39,North America,19,1150
db757bc5396c4c4881e2e1e6890874a4,94,46,48,South America,17,235.04
db76083a862f40879e2d9d3a7c3947e8,129,84,45,Europe,27,640.74
db77c4c7c0324ea3991b73590c82f21a,53,10,43,Oceania,18,298.92
db7c502aedba461e8e24e3889aba2966,365,349,16,Oceania,17,2607.51
db7d035b781a4f8ebccfe5b18ab49d6c,332,297,35,Africa,16,1657.44
db7e6fe1faad4fe39b63e12431ae2524,115,85,30,Africa,23,830.32
db7ef9b8bc5941f6bfe2f46376696f05,223,182,41,Oceania,19,1245.76
db807dbf7c6f4224a0c8c62880cca1ce,336,282,54,South America,19,1735.85
db81f7867c5f4c6daad11d7ca30011a8,186,149,37,Oceania,22,1042.05
db856347afbc485eb920a897fb36c379,39,9,30,Europe,23,300.51
db87075f780343fc9ffb666461bd7c31,365,352,13,North America,24,3279.48
db8a30d6f5ea45c68349fd6e3b8d067d,159,132,27,Oceania,23,1228.59
db8a318e2c904c6ab2398184d980ba99,359,321,38,North America,17,2454.28
db8a3be82431446a8cafddf92261cec5,280,241,39,Africa,25,1541.6
db8acbd801ce4b708558f0cb3c39fd9c,57,15,42,Asia,14,89.98
db8bde00ae4f438ba9d0dcb09630c72d,225,179,46,Asia,19,970.22
db8bea6bf3c94f7eae81cfd29d6a87b6,29,1,28,Asia,24,111.11
db8db3404edb45af963cfb0de281bf9f,267,250,17,North America,22,2290.83
db8df371a3df4eaebbdac1db86fb0f13,72,38,34,South America,21,637.73
db8e5e231b1a459783c797bd4f8ee2b1,141,94,47,Europe,23,841.38
db8fe92419f14acfbd83300b25a349c9,91,74,17,North America,22,995.67
db9a891852754e2884be76e236d222a5,272,244,28,Oceania,23,1875.44
db9bf536342341559d4f7eacdfb2f836,234,189,45,Asia,22,1781.05
dba064bc5c5f45f6ac06c5ce88eb43c3,318,294,24,Africa,17,2488.97
dba1874297c14d5380210180922d4557,277,234,43,Africa,19,1613.82
dba1977975fd4463b19757258f6d39ae,293,259,34,South America,17,2765.57
dba325d3bfdb4d5ea69756fb3a04bbcb,189,153,36,Europe,24,1525.61
dba50033254243ccb830a3150bac3f40,126,101,25,Europe,25,763.25
dba55d4419dc4697a4758ab6196a057d,117,80,37,South America,21,423.22
dba649cbb1e14e8188e691e447006786,164,117,47,North America,17,338.91
dba7cc16421e44b38bcacd9983630655,125,95,30,North America,22,928.78
dba7e983a80645f4af9ca1224db0ff85,299,286,13,North America,20,1896.66
dbace70280b04542a7e52f4a6853621b,207,178,29,North America,20,1317.98
dbaf08d2959042e6a508b0b45fe247d4,145,110,35,Asia,17,916.09
dbaf52ef321e48c99d52f5a3bf16fc1a,335,307,28,Asia,21,2825.12
dbb0d4acfab3452284af9583e2a29dda,240,192,48,Africa,17,1399.12
dbb26a341cd8426cb92d05a83843ae02,364,348,16,Asia,19,2779.14
dbb38398e8ba4b54a6464ced5e1eaea2,56,3,53,Africa,19,239.43
dbb454e973f44763baf65cef0d50ebf8,290,262,28,Europe,23,2271.18
dbb46c73c6004b2a94f38b126239fa70,239,211,28,South America,20,2449.23
dbb5afcc308245768fe9819ce25c8c80,114,74,40,Europe,19,785.8
dbb6ab2398314ccd96b471be9d0fa142,58,3,55,Asia,21,162.84
dbb88bb775c349ddb703759e7fbc3006,309,266,43,South America,17,1741.31
dbb903e7dade46968bc12281f8616ef8,355,327,28,Oceania,14,2253.96
dbb9b7e135e942c6b26759575750ab49,156,128,28,North America,23,919.5
dbb9c3b53ae94bd4b8cd082fe0fcd27e,120,98,22,North America,24,1334.08
dbbd401c7b724cbe9fe4af0382b8620f,365,346,19,Asia,13,3665.36
dbc06d0a47bc4dc388fbd3193e854819,316,269,47,Oceania,23,1942.48
dbc29046d3c04236bf9f2c8ef981d70f,57,23,34,Oceania,18,667.95
dbc4104480d942cd9ca89af908c1f41f,75,21,54,Asia,20,407.55
dbc47d837765466a8cea50b80bff5994,337,302,35,North America,24,3047.01
dbc487cc8c6447d899fae3a17c359b96,193,171,22,Africa,28,1900.6
dbc4fe2fcb874fe8ac09a19ce1ed6b5b,204,149,55,Asia,21,882.41
dbc52b08393d472ebc24cd4493c82502,365,343,22,South America,18,2669.39
dbc55883758642119843086cc92c1608,256,213,43,Asia,19,959.72
dbc63a68246d475caba5555538cdd277,273,223,50,Africa,20,1366.88
dbc6e1efee164b2ca1c0f3ff45a42738,306,278,28,Africa,20,2302
dbc748ae39164f3389cd7ebc43e3405b,364,350,14,Europe,24,1689.41
dbc7f8501b424e5fa644e761f5d6ed2b,299,249,50,Europe,21,1416.61
dbc9a752aea04da7b7a8c96ec9046be8,364,353,11,Europe,21,2080.84
dbca0f15b11b4fb0bfa94472c405540f,324,290,34,Europe,24,2200.42
dbca77e5e53c4aa19beeff2426e74629,216,175,41,Asia,17,1391.78
dbcbb9f93ec24742ab667ca1909e7e11,63,18,45,South America,20,478.32
dbcd9ead8a7c43388ea39a218710f8c4,151,129,22,Oceania,16,1107.58
dbd169a6020941ff95f92d749c486450,311,285,26,North America,26,2266.05
dbd18e5823c44b39857f78362bb2b7df,49,9,40,North America,14,359.98
dbd28d97185d4b2fa4f7e207bb6d8693,307,284,23,Africa,20,2164.07
dbd2af7470d54668bf5704e23e6ce1c2,136,86,50,Asia,23,528.46
dbd544784028405aa7fc5310a254d6e2,357,309,48,Europe,24,2198.02
dbd641cc057143a1ba1fa8cfb1dc8970,347,300,47,Asia,22,2049.4
dbd74d7994a040ec8f149da2a2aefbb0,365,349,16,North America,22,2300.75
dbd8c024418b476fafcfdc65d6a34a51,178,145,33,Europe,20,1333.61
dbda59fbbe2946c3b3a9d0b540e8b179,54,30,24,Africa,16,611.24
dbdad28b0c46482fa7ed944546d2ecf8,70,23,47,North America,22,434.24
dbde24d713b647198f95a8c7e0450f80,255,227,28,North America,18,2151.28
dbde75effeb54803a317c810297d4d45,336,292,44,South America,19,2348.78
dbe02efc9b6d43c0b677eedabba9b1ce,152,121,31,Asia,23,824.19
dbe05249723049368f184e6d371cd176,356,339,17,South America,17,3042.98
dbe07ff0db48453dbf3cc77cbf7ddd08,317,287,30,Asia,20,2517.96
dbe11c7ace734af3842ef89d367ddd38,130,94,36,Africa,22,601.57
dbe24444117e41f28743ce6222fc4c66,167,121,46,Europe,20,1059.26
dbe2780821f5491790343539c1c18aa2,107,79,28,South America,20,928.3
dbe627d9afe044179cd8adec3df1a866,363,326,37,North America,19,2403.1
dbe7316943b64defa31ac335ba0ea74c,257,242,15,Asia,23,1859.53
dbe791bcbc494f5e81434fbcc488ea3f,350,316,34,Asia,22,2330.75
dbebc4df1f534b8091da56127e80d382,59,34,25,Africa,21,510.69
dbec0c42181b4475bcfeeecdc4cbc250,160,136,24,Europe,21,1148.96
dbf1853bfb1c435991f53435821465ff,221,170,51,North America,25,1012.69
dbf322f674754b849691a89d22956982,186,141,45,Europe,20,1102.32
dbf756c8342548159b51e0deda8084c7,202,170,32,North America,14,1433.47
dbf99777f48644b39629f7a8e9af2e8e,355,334,21,Oceania,19,3121.86
dbfa0e4cf2b64d879962963057dd3d06,86,59,27,South America,21,844.5
dbfbf992009d49768898e9d8a1b32856,206,173,33,North America,19,1245.66
dbfdef976ae64f3e942d3b91e6e353ea,229,184,45,Europe,20,1325.18
dbffe688c2564311b7ecf47f20398f74,164,128,36,Africa,23,1006.56
dc01ba9b56f0404aad4fd199f5bc6223,245,224,21,Europe,22,1900.55
dc024e26ec1d41a1aaf7c579d2b8fc43,190,136,54,Africa,15,909.41
dc02f899ca1b4957b2ada5d9c481a930,306,286,20,North America,12,2592.16
dc053f5d0e1341beb766b984bf21a14b,284,234,50,North America,22,1628.43
dc06c63e64604521ad43a00569943dc3,99,61,38,Europe,16,1059.98
dc079f6f1356436d8e85974095b17007,159,127,32,Europe,25,677.74
dc0889b1e6ef44a492550d5c60b7c0e9,250,224,26,Asia,18,1758.78
dc08941afed74b49b286023824bdb8f9,47,12,35,Asia,23,349.23
dc095fcd70d94767bf1bbd21f87eb85b,167,124,43,Africa,24,1068.59
dc0b12d6b8a94be4b7a29c048d49207d,67,13,54,North America,18,214.64
dc0b71b80d5b4358854045be4d652a58,365,351,14,Oceania,20,1903.99
dc0bcd60d03044c3a8744cc5dd8076a3,214,168,46,North America,29,1544.59
dc0c8cf7616244bb8ec2a0d89e61566d,304,256,48,North America,21,1928.08
dc0da51ef9f845ca87c56d73de232d83,248,197,51,Oceania,21,1061.05
dc0dc2f3d830474ab3ddb438299876dd,274,256,18,Europe,17,1755.08
dc0de2566c70412cb907e71116cb1787,361,342,19,Africa,20,2185.46
dc1031b51c724b17a21566560e14d1a6,360,313,47,Europe,20,1705.34
dc10f98b153a4a988605b1736d6f9a26,262,223,39,South America,21,1102.71
dc116e0b3ccb46218516dfe002d1f04e,294,253,41,North America,19,1469.21
dc1354551c7840a091ade5b685f52e12,95,65,30,South America,21,467.88
dc137280a13343089ad70cdab8487885,363,326,37,North America,20,2456.95
dc13cf5810ff46e48a8cf5e90fbbc57a,258,224,34,North America,16,1798.48
dc160f6e2a984911838bf3c67fb208e1,365,327,38,Oceania,20,2078.37
dc162fbac2a84e60b36c84e050a7b52b,365,357,8,Asia,23,1735.43
dc1832c836d449e58d03d5f831dde2fe,95,48,47,Asia,21,497.03
dc1b9b5b9e9945278c0ab85f89d8836d,253,201,52,Asia,16,1194.38
dc1bdbb24c624bc2bb0f585f0557a340,243,200,43,Africa,19,1555.25
dc1cc513fd2a4128a18ad2bf6fb95516,306,282,24,Oceania,22,2137.07
dc1da9ac4efe49ecb95e5ea76261147d,318,294,24,Oceania,17,2701.32
dc1f0a288fe34f96af62ef21f8358142,335,287,48,Asia,18,2344.85
dc1f5c3bf9304861b461ad38c3998ddc,364,324,40,Oceania,20,2537.24
dc20e13c9ed341f19738b4df4bf06a8f,301,259,42,Africa,22,1627.13
dc21fbd4ab634d89a0560f713cded904,142,88,54,South America,19,778.15
dc252ccf18a645bcad77610d04b1b3a3,75,26,49,Europe,15,394.99
dc2591d9b8264e86b6e581f467a98202,182,129,53,North America,22,1249.25
dc266a485f2b45b9b18c6745ce30ca2c,190,167,23,Oceania,13,1888.25
dc2737859bf0458480d026adbb6fdacc,151,122,29,North America,25,1263.66
dc27665ff34e476595d679e27776fe0f,365,358,7,Africa,20,2189.14
dc27c3352dd5481f865dc26acc8aceae,166,141,25,Oceania,17,1494.86
dc293e37919641e59d06e7ee746d7b0c,364,337,27,Europe,23,1373.6
dc29a147a25a4e67b233be4b214e7491,318,294,24,Europe,22,2247.94
dc2a7fd96c3e4f698343e902f2b55dec,364,355,9,Europe,21,3059.68
dc2aaafc05b04b6a89ce007b1fc6182f,88,64,24,Asia,23,670.41
dc2c778dbcd4448b8f6801313d7eb4d6,137,104,33,Europe,16,1464.71
dc3202f2a7b14e51980f58386ad994ac,346,299,47,Asia,20,2426.03
dc36dd900f2d49c985dd53ce53aa465b,53,4,49,Oceania,20,619.8
dc37329625e443e0b88f0aa6ec24fe36,238,195,43,North America,21,1005.7
dc3756f0be2844f6bff4792df0c6926a,243,212,31,Asia,22,1501.26
dc37e10dda4b4c078c3a8d6c7ef1c16d,365,351,14,Oceania,18,2789.02
dc3889d3f03946bd9d29ba60f83a0ffc,57,3,54,Asia,24,318.7
dc39270255234efa8fabfc502470745e,301,258,43,Oceania,22,1527.72
dc3a3d5e8e094371a37f1ac512d8e353,364,347,17,North America,21,2801.14
dc3ce81a82f1423d9bc97f99399f00a4,43,1,42,Oceania,22,341.45
dc3d77b487d94b23973b8e8c443c58f5,89,59,30,Asia,24,770.05
dc3d88dfa8c64ab9a08d08f7b0886808,207,155,52,North America,15,987.5
dc40687dc8394a649e9e6222a03f4257,332,306,26,Asia,16,2416.77
dc420686837e478c9b70b127cdf96c15,291,245,46,Africa,22,1881.9
dc42eab7463443b9a2a7e5dcb0b8a948,286,247,39,Europe,20,1648.78
dc4c9b9fe6c84020a0ce7e2715c36b68,85,41,44,South America,20,606.98
dc4ce70f8d244d42949ac669ac64805b,363,315,48,South America,21,1769.16
dc4daffc0cfe459da1d4239ba87e6880,229,200,29,Europe,20,1823.24
dc4e896d96324f13b5a7e8583f9b7056,216,184,32,Asia,20,1515.78
dc4fac28f79947a5a450f3f91b14011c,195,145,50,South America,19,793.07
dc50411ccfb14bbfa589eda58a2b7bba,216,159,57,North America,17,992.54
dc526007f0f44706abeed31eefc2babc,231,180,51,South America,26,984.2
dc53a9f61e4e41fba97ee01e9c0ce45b,120,81,39,North America,24,525.15
dc53eda332d84164ae48a476a99f5079,108,70,38,Africa,16,848.74
dc541d3538a44091bc3ab5da1b2301d6,114,76,38,Africa,18,649.99
dc5492bf09e744be8e9f78bc60a80f89,258,209,49,Africa,20,1290.34
dc54ce079e7441999e6cb217d913c6f0,348,313,35,Asia,21,1758.78
dc561fcfe30a4f28a444a1205e6c08a1,324,297,27,Oceania,20,2616.7
dc581ecb226a44fa828b60d4d352d524,317,277,40,Oceania,25,1980.63
dc59fbc5eb464b8f921ff0945556af61,165,118,47,Africa,21,574.68
dc5d5d32e1814c56a145ba6f4e59d4e8,311,263,48,Oceania,17,1647.44
dc5d76c3ab36499ca28a6aa6369fd657,364,354,10,Africa,21,3010.14
dc5db6117a504e46bd24c34ea86b2770,314,260,54,Africa,21,1538.82
dc609ae47e23409da5eb78c8fffa9291,202,155,47,Africa,16,2278.94
dc60aaa8c11d44ae839f96e466b12099,49,16,33,Europe,21,369.02
dc6a09322a5a40ed90e79d857b01a9d0,328,273,55,Europe,20,1764.56
dc6b4959286348858d43bf625e73a87e,298,252,46,Africa,15,1771.91
dc6e2f151e594fb791592481c9faf9a1,184,132,52,Europe,20,1112.53
dc6e7fc0395d43fab400aacc965faade,224,167,57,Europe,16,1503.87
dc72da1400a049a0a0d8e4d559936f57,344,304,40,Asia,20,2781.37
dc7320532d8b4cdda06aa5968188fae2,159,126,33,Asia,20,1086.61
dc75f2502a9b4d30bac11b58576392d7,188,153,35,Africa,18,1332.06
dc7701582bd3496caa2cea2d7c799779,209,184,25,Oceania,19,1625.55
dc7b3f59614a425ca2abb09bb504bbc1,96,69,27,Africa,17,957.67
dc7ecdfe7a05464187ce4dfcdb022d14,98,59,39,Europe,19,927.1
dc81761865f2476981285761a20e7f3b,179,129,50,Oceania,23,608.83
dc8313b845b94851884e60bdee9d2113,81,59,22,South America,21,374.14
dc83d20988584575b0cd7ab857873bcf,272,251,21,South America,19,1842.12
dc85232973174a4dbf75cabdf7b8a3b9,221,161,60,North America,21,854.13
dc85af29a5064c82a5ce77baf057fc0a,281,253,28,Africa,21,2228.51
dc86bd00fc5d4fab8d70ec5275f41a6f,290,273,17,Africa,20,2478.45
dc889ed9f19c4e8d9c14cb76b812ec08,48,10,38,North America,17,336.2
dc896803eeb849babe28bb0b33f7a6f9,342,318,24,Africa,25,2937.96
dc8ec1082225491fb3403a4ed0da2cd9,38,18,20,Asia,21,289.36
dc8eea8ef1b34d43a4ef078a8c02cb50,120,73,47,North America,14,564.64
dc8f312b0d82431cae13db59bec7a13a,365,331,34,Asia,20,1920.35
dc92e768ded04658bbdba33ddcaf7f2b,290,257,33,Europe,12,1559.48
dc965a215b3f4d0fa3e8bd4272063539,211,161,50,Oceania,16,839.79
dc96fe33fd574a37a0a5ed83a2935f50,257,230,27,Oceania,20,2813.07
dc97aa590dd940b79e60009a946d2ee4,331,297,34,Oceania,21,2983.92
dc99eb5a0214485d805353498c97a741,204,162,42,Africa,17,809.55
dc9a6dc668c64c948588c609bc3a97a2,61,17,44,Africa,24,388.16
dc9cd83cf65049fe8034a9a146047edb,146,102,44,North America,23,643.51
dc9cf127882043df8e7e8c007dc62205,69,35,34,Oceania,21,620.14
dc9d0d38d0f7405b9693d030ddd5def7,342,319,23,North America,19,2439.03
dc9da6cab1af4eff96966e390332024b,364,336,28,Africa,13,3350.25
dc9defbabef54137b95f1b80a8d3b41a,206,159,47,Europe,16,953.93
dc9f103305834155afb5c6410a7458bd,123,71,52,South America,21,902.13
dc9fbfa779484f22a4b6958415790dbb,365,355,10,Asia,23,2053.81
dca06a7fb5a544df8a098fdf73d1b6cf,90,41,49,Africa,22,649.46
dca2410a5a0a483ab0f1b863654a1644,271,244,27,North America,19,2184.59
dca2ce42977c45f4acc2db76e1a1791d,87,47,40,Europe,19,808.86
dca41e72d3784902b6e6976f5de10283,365,345,20,Asia,17,2862.47
dca65ca4a11f471988cb95a1164c2359,290,251,39,North America,20,1893.86
dca77f94d1dc4b8eabf3f9e575d3b24f,323,301,22,South America,24,2107.21
dcab9325dd0d48a3a615fe9aeae28c31,44,21,23,North America,25,290.45
dcabb3e306254973937bb14730d3abb6,174,125,49,Oceania,19,1062.3
dcabb4f63c964fe981c9de6804530cbb,112,80,32,Africa,21,836.29
dcac2884bbc74bffbd4896f7b568babc,155,126,29,Europe,15,1265.51
dcafecb0fb4844378ba2455c5bfa0fd0,365,338,27,South America,19,1923.8
dcb670258b9c4c77b6177a43c77eba56,280,237,43,Asia,20,1104.82
dcb6a9ca8d7f4d72aff0fec3947ccb87,276,250,26,South America,22,2501.54
dcb829c8933e414ba6ef8beae094d710,327,284,43,Europe,26,1897.16
dcb95e42c0d14fa4bddd0bcc7775809e,264,211,53,North America,17,1109.76
dcb9d139e7f648bc90b1fa4713a9e26e,364,333,31,Europe,19,1156.86
dcb9e0207baa4a9ea17031bcf638db8f,204,166,38,South America,18,1928.45
dcbbd2ea77ed472ab41c88cbd9054293,258,226,32,Oceania,18,1977.15
dcbc40c9c5d44af5b8c0ff35d52729ed,93,48,45,South America,14,184.06
dcc040618e2346558e374185a82dfd7b,228,206,22,Oceania,14,1520.99
dcc281c152fb406a820570d09f23dff9,154,115,39,Asia,29,1172.6
dcc5df70bfbb42aca7d9f544212d56ba,232,204,28,North America,22,2020.03
dcc884dde123452ea7eaeaaa7755804c,54,5,49,South America,25,511.95
dccb8543769a4356bded1dafcac4f12c,255,230,25,Europe,15,2051.52
dccf822f86c44200a7c87167d18f4a50,240,195,45,Asia,16,1400.29
dccfe1aba0c74334a827f039491a0b30,161,112,49,Oceania,22,914.65
dccff08754b4416e8fa33ae1bc82d453,344,315,29,Africa,20,2736.22
dcd1ab2ec06a434c9b31cb961a813aaa,364,315,49,North America,16,2400.9
dcd1fef6b4104d5c803e800579125677,364,344,20,Europe,15,1876.84
dcd337bf20f448a8a5d5d12a178f1bd4,159,131,28,Oceania,18,1576.1
dcd401d8535b43d9b3129fb2a370dfbf,326,276,50,South America,18,1639.36
dcd58bfeeaaa4f498b81830befc1411e,107,76,31,Europe,24,930.87
dcd5fa3f71be4936844d5951ea11c297,285,262,23,Asia,22,2440.19
dcd9d3dd9e6f4071bd987b05116acbc4,187,147,40,South America,20,1262.45
dcdb347dca3741a9a5f0b2376df99999,266,245,21,Oceania,21,2002.02
dce0d5f6dcda4524a36945fb1ae57b69,162,124,38,Oceania,20,947.96
dce1d523785046d5b98e0240a67a2730,296,268,28,Africa,20,2314.24
dce3c94069a648359cee8d42e088bde8,67,20,47,South America,20,405.82
dce43eeeb82e4163ad6319c3a570c98c,112,59,53,Oceania,18,481.95
dce4b5e057774ebbad1c27d078716fa5,63,19,44,South America,20,658.21
dce5323773244405bffab27d6c570905,94,57,37,Oceania,17,775.26
dce6a8b9ef254568832ac01d71f90401,355,327,28,Africa,21,2759.54
dce7bd25bdba458b9a0b7f1a769e2a79,93,58,35,Europe,17,1010.53
dcea68ce39f84afe82b9aafecdb73c4b,275,239,36,Asia,21,1482.35
dcea75a5b3c042589824f82f7979a86b,361,331,30,Asia,22,2034.83
dceb7609833f4f6896462115aba30ed4,297,250,47,Asia,22,1798.73
dcec927ab14e4a1fbd80cc8969a9f485,128,105,23,Oceania,21,979.1
dcec97d2d2d9441fbbcbfdfcebf96e74,219,195,24,Europe,20,1393.15
dced224892bc40af9882d88b30b20af0,149,97,52,South America,20,589.24
dcee022f74fb41b9886470121aafaab7,109,49,60,Europe,17,636.44
dcf0a4305dd848b8bc1f65c24724fe6a,90,60,30,South America,16,582.12
dcf0f4da4d3e4441b0278957ff3cfcff,365,334,31,North America,23,2016.95
dcf173e9c223499a9572c96e75cf321e,95,63,32,South America,21,596.28
dcf38a16ba9a49cea2ec6ee389410db6,232,190,42,Europe,18,2010.43
dcf396814eac4e0eb195355d88546a29,233,197,36,Africa,22,1388.76
dcf39cd2e3f244ae816a672f4dc7bbf4,68,17,51,North America,22,522.91
dcf429f42ff5404bb96cc9704336302d,139,120,19,Africa,20,993.85
dcf5526300094ed5accf395a79fee2a0,154,94,60,North America,17,539.9
dcf5ed97f1b74b39b12e92ea14134def,218,169,49,Asia,22,1116.47
dcf71bdc8a0d4bb4a427e13a770b1b54,64,13,51,Oceania,19,529.54
dcf81bb021ca4e99a460a86a047d31e1,143,101,42,North America,24,813.67
dcf8cc102b5d41fa92b5b4c2864bbdb3,329,282,47,South America,22,1372.49
dcfbeb93e0c041a38b87002a5c62ecb1,365,360,5,Africa,22,1648.86
dcfd0ca2de244cc19343f632189591fc,352,319,33,North America,23,3364.71
dcfde5aceab04fde88e573467ebcb8ca,199,161,38,Oceania,26,2007.9
dcfe64eb04ba41cb890dfe8f70def9af,247,212,35,Asia,16,1793.19
dcff22b3265d40c3813fc7bd2d513309,238,211,27,Oceania,24,1915.97
dcff899d76864bc4acbeb44e8b0ac8fa,67,26,41,Europe,18,198.01
dd00e33460804b2d94ee0017b4161150,166,124,42,Africa,19,1252.78
dd022a47fe6649c89a2a4f80e177d1c9,320,276,44,Africa,24,1383.65
dd02310ce01741debb4248dd7980eb4d,325,285,40,North America,20,1734.39
dd02c46c2d8b4d448e5996f28b5e7c06,299,267,32,Oceania,20,1816.71
dd02c56f32464d778336403696888543,192,163,29,North America,23,1254.59
dd04ec05067d431893da3fe28a27d989,109,66,43,Oceania,25,571.01
dd0624a61b5d469eae2cce781a37e31d,43,5,38,Asia,23,175
dd07f5524e80442696c9aa7911eb25b5,357,330,27,Africa,17,2124.49
dd087a0a82a1444289fdf4a193ed59e1,188,162,26,Africa,20,1870.2
dd08ddcdfa514559b0029230dd61adbe,186,141,45,Europe,21,819.37
dd0b2441f13f461b91f5c8aa3478da49,194,155,39,Asia,14,1183.07
dd0bc2f98e4b42239ba53037c8d144d5,364,343,21,North America,20,2140.71
dd0c6d9ebcaf4c9ca12ab85338878805,233,204,29,Oceania,23,1926.64
dd0ca201e1994748bb5caa370d5e7a72,274,244,30,Oceania,17,1573.15
dd0f36760cff4dd9a02cb56d3e12b208,326,284,42,North America,21,1701.98
dd0f3a512ad84333b4f3205d5ba119a4,183,132,51,Oceania,19,423.76
dd110221a66541adb51e88210ee94cf2,78,46,32,Europe,20,716.3
dd13a6c5164045b6a43d435dc7d93b5b,193,150,43,South America,19,654.42
dd147176c7524b3a89179839792f8e67,100,43,57,South America,18,683.94
dd1984b8959f4f098e9a5fb7b56b72e4,113,90,23,Oceania,23,1158.79
dd1abda2c217435ebe3afd0401de75dc,365,332,33,Africa,20,1744.46
dd1be4cca52141cea3d1cb818ff3f915,316,283,33,North America,22,2322.53
dd1d773c44584630ac4dde003da9f9e7,76,34,42,Oceania,23,628.66
dd1e145c8c05401e874bce3015cde39a,96,43,53,Africa,18,363.45
dd1ee2c3b11b4ac0bfd976e58c1ad91a,305,283,22,Oceania,20,2533.58
dd1fb8b8b8cc4ef8bda65926cd6d1211,43,8,35,Asia,24,116.71
dd1fd0b6ec2742cf956e02efe9d576eb,52,22,30,Europe,21,295.7
dd21874db75d4e50800475710f47162a,307,273,34,South America,21,2353.23
dd23274065b9453d966f99e51c9a1147,60,32,28,Oceania,25,583.65
dd24c1bb108d4b5eb2c3539ad553999d,337,298,39,Asia,21,1674.51
dd257a5854c9403aa01f3c07c5971809,275,234,41,North America,15,2025.13
dd2711d001da43ad84c93eaf2b183da2,338,311,27,Africa,22,2205.39
dd2a277994aa4a48984b7f2ff7def79b,332,286,46,Europe,19,1326.29
dd2aaf2af6a1428599a921f4e1a1b403,201,154,47,Europe,22,1471.2
dd2b58e9957048d18feda32666f2fdf9,365,364,1,North America,21,1683.19
dd2f2ccc0a5647198d43841479774a2b,167,109,58,Europe,18,1429.64
dd3028533d4849128935482d0511425b,154,133,21,South America,17,1052.63
dd314da3d30741d2b5000781e729c115,365,340,25,North America,19,2051.2
dd31e27658234edaab3db1c17dbc3a8b,249,217,32,Africa,20,1583.15
dd32264d092c43dc823090dbd5a69ba3,189,136,53,Europe,20,652.44
dd340945bd5149838b0bcc97e0fc86e6,49,18,31,Oceania,15,352.51
dd3497df73ca430581ab6578f0d2277b,187,151,36,North America,20,1446.11
dd35545a716441bcb8ae5055410c82d2,365,330,35,Europe,19,1355.89
dd3577303c5f4f07b755a2444d5662f7,350,331,19,Africa,16,2450.85
dd36f66593de4e30948c4c5086856f52,202,164,38,Oceania,15,1264.14
dd375d2d93574a33b68d4ca854c456f0,218,192,26,Oceania,20,1127.17
dd3a3f3ad7294e6cbe85bdd1ed13ba62,140,98,42,North America,18,1274.32
dd3a72aaaef74039a44d269c7b92b1b8,48,25,23,Asia,22,315.73
dd3b1ede5b9a46938f3802247c356af6,365,337,28,Africa,18,2677.52
dd3da706a0e84a87a4833ac23a03400a,270,219,51,South America,25,1118.54
dd40a2adb9b34d25b2c569c93505ac43,319,273,46,Europe,19,2020.53
dd40ce1c844a47759784e58616355d46,99,48,51,Africa,21,356.56
dd4157045630488ba35c23246c827096,365,346,19,Africa,23,934.02
dd44b0df782742028208ec6276d3eee3,365,325,40,Africa,18,1944.75
dd473f3fa81945f89dfd22c6dc53d1bd,286,232,54,Asia,23,1785.39
dd4866ed110a452cadb169c70f6124b4,62,17,45,Oceania,24,271.73
dd4aa9eb1fc34c78b036fb7f5107b450,89,68,21,Africa,20,821.3
dd4bab08eb9e49ceb8800c11789ee4de,76,32,44,Asia,22,316.3
dd4cd712511745359f5511e1fb38d45c,143,92,51,Oceania,21,948.96
dd4d66a54c5c43abb2e7ddf85c56d2e0,66,46,20,Europe,19,389.39
dd50999c53054d8c8a3ca4c235f6c94e,181,124,57,Europe,17,1259.11
dd50c7b9ae70440a8e61558039338d46,364,348,16,Oceania,17,3201.14
dd51911885f3467fab996a6d941a5ede,363,336,27,North America,19,2244.55
dd557c6550de4f0d9a95a369667e3cd9,174,113,61,North America,29,877.08
dd567b17911845ebb90f0835b00770bf,326,305,21,Europe,18,2957.79
dd56a14db3e249529ecdf8e14ea6df30,354,325,29,Europe,19,2210.86
dd57797a69ef479ea1b27a3af4616957,346,318,28,Africa,19,2520.18
dd58a3d84eb848049d2abdecb6d00747,257,239,18,Europe,17,1620.86
dd58dbfb771744dc9e5a9685dee2797e,271,216,55,Oceania,22,1163.6
dd5aad63e62242c5af27570a0c34eaa6,222,197,25,Africa,27,1574
dd5b0490911f477ea7c28f53f35109d1,365,326,39,Europe,21,2478.19
dd5b9e05159d469f9f75bd4e9e720f80,356,301,55,North America,16,2258.84
dd5c08dbe0e445e3888c01217effa085,130,90,40,Asia,25,1013.67
dd5efd02acf24d159b270b6924e403a1,365,324,41,Europe,24,2435.48
dd62df5e6c654a0aa5080ab06f9f6ba6,182,147,35,Oceania,21,924.65
dd6395957ed647e79992185098598b9e,279,257,22,South America,17,1775.44
dd667cac44264d60b955a91838ad8720,55,19,36,Africa,21,427.77
dd694b6ae6df471d88fd04ede4dc95b8,269,237,32,Africa,20,1827.25
dd698b79aff946dc95058b555d2df40f,307,263,44,North America,23,1584.27
dd69de8fbd124ba1ba567a1ecda42536,365,332,33,South America,22,1813.91
dd6a8b48ca594532b4e1d2e2ab9d364f,214,164,50,Europe,18,1116.27
dd6bc7693c894ad6ab805760d053ec81,211,177,34,Europe,19,1795.78
dd6c995b72d440a7b3df010f9b8cb11a,109,69,40,Europe,25,1178.3
dd6f71f5c6164f57a48dfa31a4a87f3d,210,193,17,North America,21,1603.39
dd6fff2d73f44bb6918b1a5b3dff6b4c,158,107,51,South America,23,833.19
dd744012f46d4b17b37db161169bb8eb,317,265,52,North America,22,1274.5
dd772a6bcd0b4197bc6c6c90506f1d99,365,317,48,South America,21,1989.02
dd77786181ee439b9cab61b5f9947166,364,327,37,South America,24,2004.83
dd78a24cab884a528663ea0e463c8e0c,364,364,0,Europe,22,2679.56
dd78a3d9621e483ea01a0c9cf60968df,62,34,28,South America,24,196.11
dd7a886e9c424752bbce060e683cfad6,88,34,54,South America,18,458.37
dd7ab8ade29d4bbd8ad3b236ca37d391,127,79,48,South America,13,487.08
dd7abb6b364d4c9cb61b945f61aebf27,201,152,49,Africa,19,1371.21
dd7b0dde0477491d80c86b54e27a6c43,171,144,27,Oceania,23,924.59
dd7b2888d10b4ea1845eab227734aafa,365,327,38,Africa,22,2104.6
dd7be922a455424a99301088add3d576,165,130,35,North America,19,2301.35
dd7d36ac650a4c79903af0b37e61d285,365,353,12,Africa,23,2033.89
dd7d4f5236d940669479c7ddabecc75a,159,131,28,Europe,18,1204.05
dd7de5ad1d714e29babbe6ba35590a8d,68,39,29,Asia,19,1124.42
dd7f76fe1d19426cb02b9c266fde7680,212,163,49,North America,24,1197.11
dd80e75d227940df96b91e6496053cff,242,226,16,Africa,22,1492.58
dd821030bf1e47038344199d77ebaeed,132,92,40,North America,19,967.34
dd84587b2f574c94891f4c94c5fba801,321,282,39,Oceania,18,2441.7
dd85aa4b19a6428cbdf744186b13fa5f,220,184,36,Africa,20,1494.06
dd869975843e4259834440b7d307c9e5,365,325,40,Oceania,20,1632.03
dd87511f45bd4216a319d44ab78e9827,311,282,29,Oceania,18,1991.85
dd898f4375344afd8a42b6872bad68e9,352,299,53,Asia,23,1977.55
dd8acd6fc82b474da944f307471fd60e,324,283,41,Africa,21,1591.27
dd8f37d7de414998aaaf6732766e54a7,146,122,24,Oceania,16,948.45
dd8f51da566e4cada4a4729b027186f9,252,217,35,North America,25,1368.54
dd8f6f15473f40df8e438690f25d3c32,85,51,34,Europe,22,398.82
dd92d934a5374c68ba57516a447bd6b0,148,124,24,Europe,20,1305.27
dd93cfb4ffe44eb7a61862bbb2c72b1b,326,297,29,Asia,21,2477.77
dd9484b44d4049bf94095acb14de9147,63,41,22,North America,20,500.56
dd949c6d065a46049caec08e866133a2,89,39,50,Asia,20,568.16
dd94d04ba0774878b257fa5acd71a6fe,221,162,59,Africa,20,1492.08
dd9985ff1e7341b2a9f71a2eb8e18c76,146,96,50,South America,22,948.84
dd9a56875fba4fb1854672efe12a3227,95,61,34,Oceania,28,796.73
dd9a8cbbd2554339aa61301e7f8d1299,254,220,34,South America,21,1607.33
dd9c630bc24a4ec5a3956f9fd0f0a4b1,361,337,24,North America,16,1580.51
dd9d62147a7c41c0afc235517a0e680b,161,123,38,South America,21,922.22
dd9e5313553d4b7c87530ccf4e1f3fbc,57,37,20,Europe,19,351.78
dd9fa94914a345129a578987b2b9a5f7,150,97,53,Europe,18,933.62
dda011c54a87445cb648c69c516a25a3,362,320,42,Oceania,20,2323.75
dda2b135c2c544068a3d7007ff2c5f55,240,191,49,North America,18,1392.67
dda2ba25980d492ca14c3a4fd7c6225a,219,182,37,Africa,25,1726.5
dda329569a7843c4b56d243bf4b7af18,83,46,37,Europe,20,401.8
dda32b37a3064186a63ffe62904a3bdc,242,223,19,North America,27,1123.03
dda3ffc15baa4baba871a170401d6a25,105,67,38,North America,18,527.12
dda43ce79eff4122a2953bddb992b5bc,173,130,43,Africa,21,1046.3
dda7921aa4ad4406bdfb396b06ee5b12,95,41,54,Asia,21,621.88
dda8e0a601cc43f9ba0751dc9c27ed92,365,334,31,South America,24,1961.19
ddaaa7ec152a428f8ade15593d964c1e,209,184,25,Asia,17,1308.62
ddaaf1f1db6f474598794fe5bcecee46,150,104,46,North America,20,492.7
ddab2b27f21241c5a00ba9ea29142385,358,322,36,South America,16,2049.19
ddacd33a499f49e1927273774038011b,212,177,35,South America,16,1653.12
ddace5755d0f45d6bc8175c28522042e,359,334,25,Africa,20,2835.46
ddad1c3854cb48baba64bf86fe074d00,313,260,53,Oceania,23,1526.1
ddad96136c02484c828a158226f5d4f9,362,355,7,Oceania,16,3617.61
ddb05ef848e941ba94fcdfa6652e3608,320,289,31,Oceania,12,2001.47
ddb084aaea1e4c0a9d6137b4cbe21d1e,148,109,39,Africa,16,1175.25
ddb268395e6c47a99a4b829e6363e6cf,302,245,57,North America,24,1836.4
ddb318482d7948ee8a606bc4279a026b,231,185,46,North America,19,889.38
ddb36fb3655b45109ae48ecbf568d701,328,284,44,Oceania,20,1183.15
ddb39b09a1f044cfa296dc1a8b84062b,365,307,58,Europe,20,1838.66
ddb3e04e4d9543fca6212ab0fa909411,75,40,35,Oceania,14,410.86
ddb4a5814cfa45fba8811af263c5530b,75,51,24,Oceania,20,927.25
ddb52b822e2e40e4a47fe141e8e0e409,363,347,16,Europe,21,2889.51
ddb6b33acf494900af9cc938517588c9,365,353,12,Asia,15,3370.14
ddb6e56e2ad0443ba30759c166b35ee6,204,161,43,North America,23,1220.16
ddb73a4bf1934d518ba4dbfd2b34b56e,56,25,31,Asia,21,455.81
ddb8879a794240d8b816928c76d6764f,365,348,17,Oceania,20,1972.1
ddba1cea4ec6401b82ef45c441a8c0d3,286,251,35,Oceania,19,1832.17
ddba8d5bc9454f3a8b8c3624766b3cba,141,93,48,Oceania,16,568.03
ddbda79cba9546f29dcce04a1c90cfd3,345,330,15,Oceania,21,2626.4
ddbdf661269a438aab203efd7ab7754f,225,171,54,Asia,18,1162.63
ddbe6542066c428ba7aec7c90dc9aa43,163,138,25,Oceania,19,1292.79
ddbec79b586c499a8df161de638fee0a,305,285,20,Europe,16,1979.72
ddc04c94c83b4b86be59094de12e7ddd,365,315,50,North America,20,1704.11
ddc157a11f0340ab9ab4e07df28305a1,267,222,45,Oceania,22,1095.11
ddc4333b7e93410488ce0966f99c0a9d,175,131,44,Oceania,22,585.19
ddc4a7f376694e59ab187c57e486091f,345,305,40,Asia,18,2784.44
ddc565792c574e1b991f6b7c749d8667,143,117,26,North America,27,1556.83
ddc5d61b45ef433594c95909659ec5bd,227,201,26,Africa,21,1554.66
ddc62caf53ad4e8da113f8452581c9f3,43,12,31,Africa,20,203.16
ddcade56952f413fb432557fd0034435,333,281,52,South America,21,1299.99
ddcc0b374d904f1a9f76a539be4095bb,88,37,51,Oceania,19,238.38
ddcd566c08d340918df46aded2214941,107,55,52,Europe,24,711.04
ddd0018b86cf4ec794f0b49c897eb0b1,71,26,45,Asia,24,419.64
ddd1da697ad640bdb7661af4c9130c4c,110,74,36,Oceania,20,949.02
ddd234a29b3641ffa2a4805d2459332b,64,31,33,Oceania,23,343.87
ddd26e2b281941e78e3b5170557b8456,284,234,50,North America,20,1282.12
ddd40e0885a441908885939ebdba35d7,235,218,17,South America,20,1675.01
ddd41ba175b64cd8bfe379db2779a072,201,153,48,Oceania,21,551.9
ddd47d114dfe46bb8ebb390d62cab4b1,330,294,36,Africa,22,1824.45
ddd5d86cfbfc49d0a6e0d75f5e2f458b,83,59,24,North America,22,511.13
ddd859c264e64bfa89ae514723c167fd,326,292,34,Asia,22,2085.37
ddd97150f64f49cfbc5dd29c6d9ae418,196,163,33,North America,17,1495.64
dddc3295fd0c42d084133b2c2ad892b9,220,194,26,North America,23,1500.82
dddcf6e77c90470db1694bdacee024d6,144,96,48,North America,21,838.39
dddd5f5665f04f36a29aeeb59168a47a,172,146,26,North America,24,985.76
ddde634de42c4fe080d0dbddc0311039,161,136,25,Africa,21,1353.65
dddf905f9289447e899cc3938c20237d,143,104,39,South America,23,962.39
dde23cb453074b86b68a5cadda6f0de6,174,143,31,Asia,24,1051.26
dde5ff455bdd4ab3b92fe6ff3662a94c,219,182,37,North America,23,1317.8
dde62f8b08f44e42a8f6fc8aabf1b4e3,101,60,41,Africa,25,585.83
dde6303cf7ba45c1a94592a45f97bcfb,172,128,44,Oceania,19,1302.17
dde76ed6d611446b9260891164d7b6f5,349,294,55,South America,13,1986.11
dde77cef8e2047338700dd958468b554,262,241,21,Oceania,21,1725.93
dde8a82b13b64d5e9a463e30f3e89841,73,48,25,South America,14,423.98
ddea3b10640145e59f284e8b5af9cffe,196,146,50,North America,23,1180.08
ddecd551227341398aafa86935165bdb,284,252,32,Oceania,22,1661.02
ddece5de0427498bbe6f319202bfe5c4,53,2,51,Oceania,21,411.24
dded65f46c0f4e80b9d1f7da6cb8dcc3,275,224,51,Oceania,23,1515.54
ddf018549d924c35bd39f89198e1d3f6,365,354,11,South America,21,1510.45
ddf1b8f511f442d2b943c26c9f9e2a11,39,14,25,Europe,18,253.81
ddf26d6a8fbd4915b5b875083581340e,142,99,43,Africa,17,1130.14
ddf2ed673b92413bba1dc0e46e8be7dd,67,23,44,North America,20,375.13
ddf33e17ae204b3fb0f87f511b7ec7ca,229,217,12,North America,20,1506.22
ddf4a054993a4837b9b1053790daae3d,117,73,44,Europe,20,616.55
ddf6376533ae4a3d88ecdabf177644ac,174,155,19,North America,25,955.49
ddf67edf61c34721b6f0597b93210ab3,296,256,40,Asia,18,2539.58
ddf7026f236c423da0dbdf8d91895f81,321,278,43,South America,20,1881.9
ddf71391938746179c1d507d248e82d9,283,260,23,Africa,23,2325.62
ddf8df47b8ab48fba300111471003444,72,51,21,Oceania,17,433.05
ddf932cf178740eb8e811e756e75a1a7,363,355,8,Asia,19,1676.62
ddf97636120e49329e52ccbec84ab9c9,348,298,50,Asia,21,2379.87
ddfb124b834c4e6e91a979e749e6ca97,141,88,53,Europe,18,977.94
ddff18761a6c480a94f54eb58b919eb3,211,166,45,North America,21,1223.44
ddff63f71b0144fb8fd82b1327f48f89,326,292,34,Africa,20,2190.63
de00dbc8b20543279756ec57e605b5f5,237,197,40,Oceania,18,1101.14
de034fafeb0746b7b5f1b59f718755a1,121,73,48,Oceania,21,626.86
de08a6df248f450f81a7757565e737e9,362,354,8,Oceania,23,3355
de08db5db2e84a3abf3c075964627b87,262,199,63,Oceania,14,908.45
de0a43b29af04cd0aaf2eb3d1b44a850,248,200,48,Oceania,12,936.26
de0a825676cf46b385d6be944fd2ef34,40,7,33,North America,26,327.95
de0b4519a8c943e18cd8197e945b62f1,257,218,39,South America,18,1520.39
de0eac48e8594d65b13867ffcd334d67,178,126,52,Asia,19,747.17
de0f135a325043d1a4be7f7e1227d120,74,50,24,Europe,25,484.96
de0f661646014f2ab14225562ea132b0,41,25,16,Africa,21,423.67
de1419b2d408493086a299b9972c7786,48,4,44,North America,18,537.26
de145ff66e044199a38b771d1e561874,364,349,15,Asia,20,2188.29
de15da5d9a2347fcaf20252383ff276c,239,214,25,South America,25,1727.07
de1795013b7b4d9abf92823b22a7ae9b,175,147,28,Asia,19,1733.92
de197377693443e6bfe6b5535f87f85d,333,282,51,Oceania,18,1380.16
de197f32ded0449cb9e71055cf943318,189,159,30,Europe,22,1530.4
de1c329e04e74b359012873390b58d26,155,123,32,Asia,22,1447.21
de1d371cf4d74f0598c024e1bb56bbc0,206,184,22,Europe,19,1272.88
de1de630064a4e78871d493bf6297f04,365,359,6,Oceania,22,2032.53
de1e1b9a9f1345d092558caeaf32571b,242,218,24,Oceania,21,1627.21
de1fd9b073f74bb3b38ce00168b7977e,230,199,31,Oceania,18,922.45
de24d5e7f7d34eb6a1cfcd8003aaa20e,113,91,22,Oceania,23,904.69
de24e121f9a14febbd8364dea03aa9bc,187,131,56,Africa,22,819.89
de25b2cfe8704850b861d92d8583c3a6,365,354,11,North America,21,2240.37
de264f1d463a42deb40d4db699399910,81,49,32,South America,22,566.33
de27b3fbe9c242e682ce539208032413,295,271,24,Africa,17,1871
de281a48eefc485db5a7aa2ed688413a,234,208,26,North America,30,1493.32
de28f3ae10364f43afdb9bc1e1c784e0,341,301,40,Oceania,21,2091.24
de2a1f28c160416a8c616d586099a9bc,352,307,45,Asia,19,2205.71
de2c816342de4729bbc935d0d14bface,356,317,39,Europe,17,1680.77
de2dcd0774b94ea28e748baa54023fb5,309,254,55,North America,22,1294.01
de301449ac4d477ab942ddcb9165b3dc,221,196,25,North America,14,2234.3
de31601ed472491b88814ca8d75883a8,59,30,29,Africa,20,487.43
de3314721e6f4d6d8287944c3aba196f,289,259,30,Europe,17,2260.63
de3368f1f5b34544a634a4345126e1d2,283,241,42,Asia,22,1485.52
de34a3c2e0c04529a8084a25e8e6e4a2,365,347,18,Europe,16,1865.31
de37204672424c87be5cdfe8097b71c3,365,327,38,South America,22,2084.47
de374314b4864163b1058d3b0d585b8c,36,11,25,North America,25,288.54
de37bec5ea194180b230431e7ce9355b,131,88,43,South America,23,954.82
de39dbbbbae24037a32876eeba84ae48,268,224,44,Africa,22,1657.09
de3b6d9544e147a0b67afc187852d6d4,362,345,17,Asia,20,3025.73
de3f056314654e8d842069682c35157e,365,343,22,Asia,24,2084.74
de41ed4cffb24d268ff043ba72e2a3e4,98,58,40,South America,24,820.33
de43328ab30441699cb9ee6aa0ec8cce,193,150,43,South America,18,945.71
de4375ce677c4883b3a0a792d8a56fa9,200,177,23,South America,18,1706.92
de44a05acacb45f48717a814d60bddd1,94,50,44,Oceania,19,525.05
de4664c87bfb41faa06bf86dc639b43f,48,7,41,South America,21,534.2
de47c8db3d964eabb29c53b8702be31c,62,11,51,Oceania,19,161.6
de4920ba7e7f44b088679112b2979790,182,149,33,Africa,21,1306.35
de4a7b0fbe5543e0aaefb79841ed54c6,356,337,19,South America,20,2379.47
de4b2e70f23541af87db533459a123a0,192,138,54,Africa,25,1120.93
de4b7e9277494537a700c716d54f02c7,201,170,31,Africa,24,1512.88
de4eae6241dc4010a426d1066dd07634,214,189,25,North America,18,1558.77
de4ecd2d10304e1bb6e0c8feea430083,347,289,58,Europe,17,1821.49
de4f33f2d5394c4f855bd317b28d354f,135,99,36,South America,18,852.72
de4fc5e2f8b04b36b0348d7f84876cf2,297,250,47,South America,21,1761.03
de4fcfc83dbb4b4e9a4e22c403d53099,151,117,34,South America,22,800.07
de52b95a7f0a4da7b08649b530366917,139,107,32,South America,14,945.56
de5579846d2443888153f43d969d2231,121,97,24,Europe,20,744.39
de565befe492474ca9d05c658b5094b9,347,313,34,Europe,19,2726.51
de566ba9285949f0a646d355cf831e1d,135,98,37,Asia,21,1240.13
de5ba3f5435e4819b54a529bdbd3a2b7,365,344,21,South America,17,3507.65
de5d837bbd5c42fc9fc6533c76ea4e4e,296,264,32,North America,15,2257.57
de5da814ba1e4db4b89212218864bd79,225,203,22,North America,20,1878.66
de5f7d6e322b49919720fb7a7c0fb8ab,224,202,22,North America,21,1667.31
de63e834e87444a1be13a7c379d9425c,337,301,36,Oceania,17,1553.69
de6668769c054501ba747ce2f385e2d4,63,37,26,South America,22,649.84
de67726d09134022a2237fa8d70e2d26,106,67,39,Asia,20,604.39
de6b0551296e44deba2110cb4acc88b7,278,243,35,North America,21,1558.43
de6cd1c2548d40cda769d9cd3857b6d8,179,144,35,Oceania,16,1118.24
de6e281d3f4a48ff93c810214ee180d5,168,124,44,South America,17,1139.93
de714e43448548cf99c580d7a7f580db,261,224,37,North America,19,1263.29
de7160a452c6408dba5ce29021da2b01,61,29,32,South America,16,169.48
de723cbfc35e4e4c9ab8a56d6340ee60,123,96,27,Europe,24,1036
de7761101c684fbc942d641647e6627d,91,59,32,South America,21,297.66
de7b25804f274b2e825f26b617d72d47,199,156,43,Africa,19,1239.75
de7c33f36981426fbeff9bec11264698,113,90,23,Europe,20,720.41
de7c73b5c2484201b031d8e4f623d557,337,289,48,South America,16,1751.21
de7f113462524836845925ee5735d6a9,93,61,32,Africa,19,643.28
de804ef488bf4625a3a92d773be4f86d,116,63,53,Oceania,20,408.88
de80dbc9a73444edad4dcd779d251a16,228,195,33,Africa,18,1744.91
de81930b5b224fb39fd4f4b2c4d926eb,110,52,58,Europe,18,549.86
de819ef23ad642e58d7d5fbb7efd85f3,71,34,37,Africa,22,539.33
de85ba1d13fe42ef84db993cd7c32a30,124,65,59,South America,17,461.49
de893d91408745a7b549c7eefd43da33,145,115,30,Asia,22,1404.34
de897eb5076344099085cdc2f08e908a,91,57,34,Africa,21,531.1
de8f1023dc8b4ac988cb2c84966b7ae5,59,41,18,Europe,23,281.02
de90bf6f59eb40a383c22aa18f89d58a,365,360,5,Africa,25,3306.11
de9138dc6b84481f9ed1e592354102fe,85,61,24,North America,18,660.75
de96b7ab1c264d82ac01ca4502a82fe7,311,268,43,South America,21,1517.25
de97d23995304615a9928100566393c2,266,207,59,North America,21,1409
de9909733ccc4b639a1740ed82ab5434,270,216,54,Europe,21,1203.49
de9aff4786334c628c7c835ed9f28ff5,57,14,43,Asia,18,458.13
de9cd509eee84ee79cfafdcd367e9c04,90,67,23,North America,21,764.76
de9da2c0173a4e3bbd5050d123032b4d,287,256,31,North America,18,1798.38
de9e0a439a85452cad1a975f4bf76fe6,282,260,22,Oceania,18,1142.33
de9f5d000faf4b5cabc2c8c50db38f07,172,130,42,Africa,22,894.58
dea5e93d46534f359e28934fcc39d434,81,48,33,Asia,20,445.32
dea5f5763e9d4b1a86975a4b02ca1946,191,153,38,South America,19,1426.2
dea819cce2b34cff91b87a3b02fae8a1,154,119,35,Oceania,18,1014.92
dea93c98a3154168b28a38981867ef08,270,232,38,Africa,20,1308.37
deab129f92ac440f984d1e92f7e99488,300,261,39,South America,15,2016.25
deab2a91a79046c09192cb88dc0e4fae,65,22,43,South America,14,238.98
deac601a304d4041a491d64eea627a5d,161,125,36,North America,16,1064.42
deac749a78ce4dada6f9cfa987469699,62,29,33,South America,18,822.55
deae55b2e8ef434d8afd3ff6b98d3151,166,120,46,Africa,22,610.64
deb0004cfbd642888aa621520fcfc6c4,321,281,40,South America,19,1649.72
deb00c36da664829b161d6a5535d0b9d,128,97,31,Asia,24,898.78
deb1632d764d44d1a9c8d35398816c58,103,84,19,Europe,19,624.08
deb7ca26455149f684409f36ef1d5303,216,196,20,Oceania,17,1544.31
deb83cfab2ba4c0a8e1cf857f7ec77cc,304,273,31,North America,18,1272.45
deb8cb0765ed4018b02ba94f9ab36166,301,258,43,Africa,20,2343.52
deba75c7fc9a492d82bfae50db86d788,267,245,22,Europe,22,2082.57
debd03ca7f3146e3b52fdc7a0c695798,169,131,38,South America,17,935.5
debde856085143889c4e6a632f543b17,364,334,30,Africa,23,2554.5
debf55048b8247f2b722f6117323edbf,65,39,26,Europe,25,486.7
dec0c931e379423b9790dccf5a876fcc,362,335,27,Oceania,24,2921.99
dec3a6e9002d43ab85f6d62374cee572,54,28,26,Europe,21,741.82
dec3b24179b84ba9b0697af587513cef,195,144,51,Oceania,24,825.9
dec47d02bd3b44b29cfb06d04dbefdcc,95,47,48,Asia,19,446.3
dec48fbe6e0f44fc8bd5b7e29b13acac,201,148,53,North America,23,1100.85
dec54a588ee6469296e5d4ad55756891,34,13,21,Europe,17,278.93
dec5f270404a4a6797486262268a791c,151,97,54,South America,23,717.7
dec8728a913a4566bf6c904b08659f5e,150,104,46,Africa,21,727.41
dec8da24501d4c2591640f395fa78124,118,68,50,Oceania,16,516.46
decabc91379f43e694da767771df4f29,309,278,31,Europe,23,2018.77
ded249859b254734b94b0c2c47898745,84,49,35,Asia,18,1005.6
ded3d79c50f5425bb33beabad9887e1f,246,199,47,Europe,19,1187.76
ded4476901234109ab806bfeddf4b03d,52,22,30,Oceania,15,383.1
ded5232d4eea479cbe11aedc45af52ae,231,201,30,Africa,21,1916.89
ded7672725b24e7aa697d28436022de8,365,352,13,South America,15,2483.72
ded930f3cada4f94b0d74fe933394065,236,210,26,Asia,22,2536.99
ded994f2d72e4f2baf1007dceefce5df,358,321,37,North America,22,2766.65
dedad66eb95249a2b7a5204d495b7687,273,226,47,Asia,22,1928.19
dedd968a0855480f93a69c0d3e561e4f,316,253,63,Oceania,23,1988.58
dedea5e254fa4ccda76d44dab5c64a97,187,133,54,Asia,20,842.72
dee14654324e415ba358fff1cf88e98d,277,230,47,North America,18,1286.44
dee4382145144e6696a402ff9f893cdb,78,45,33,Asia,16,470.45
dee5710ece1a4790a0e08e6f2e1cd611,361,359,2,North America,23,1989.65
deea5f76e1f442908647ce62014bbcdd,62,36,26,Oceania,20,316.78
deeae879c0c0416fa1ca7e873ed8dab0,144,119,25,South America,23,1137.43
deec22a1b94f495c96d368e15f303d42,147,118,29,Oceania,24,1473.8
deedaef6d8d2415f864d3471c5067db4,33,10,23,Europe,17,202.57
def041abae1d44c6a7ef4d5743ad947e,353,330,23,Africa,16,1862.26
def0b47bc5a3472480acddb12cff4262,242,186,56,North America,25,1081.49
def44089b36042c0b8fe1014279b786e,276,237,39,North America,17,2294.66
def46e59719a4398a6f42781b2d5fb53,67,48,19,Africa,18,315.85
def546eaed144a1597c33bf4faf52893,306,283,23,Oceania,14,2200.15
def5b252665f461a95c7a390e99ff5dc,365,362,3,Oceania,23,2901.73
def6149e35bd4de5a8da2f7582a7de82,295,255,40,Oceania,22,1526.15
def7d3506f824f50a8217fbabad1a9a9,135,89,46,Oceania,21,932.63
def885c85ff246f7966b0341a975b59f,365,357,8,South America,17,1742.6
def8e5446d8f4cda9253eefdbac311af,365,327,38,Europe,17,1978.79
def994f0a0f647bd8dd1a6da4675d241,267,244,23,South America,19,1864.4
defb2cabf6e7484a80d2ef3c22693a3d,315,289,26,Africa,17,1809.64
defb6741989f4493af467db58d4cf5fd,175,142,33,Africa,16,1207.92
df06b9d871f94a828a306c2de278a18c,68,44,24,North America,22,354.81
df09b970240c4e98981d8bcc6e27d90d,365,351,14,Oceania,16,1665.72
df0a3aeb14c04ba891424301f34c30ba,355,310,45,Europe,19,1832.13
df110c4087834de2a477fcd211b9150d,213,185,28,Africa,20,1658.03
df1151581f6546d6b71c3ca8bc9e47fa,63,27,36,North America,22,363.9
df116d39d12542ae838e82a271eaee1b,318,276,42,Europe,19,1959.45
df12ce28811c491a8bfd9c89ed931706,333,293,40,Oceania,18,1525.61
df1409d4970144dbbe241a22126ce508,122,82,40,Oceania,23,562.92
df14ac6b220d4c968281560734c35bd3,246,212,34,Europe,20,1373.52
df17162c70cd49da881472c905e6294e,309,288,21,Africa,19,2012.5
df19c4657b844d79b5b0598477b2cbb8,36,1,35,Asia,25,408.98
df1cffe206bc4165a8fa2fbcfe4b1c45,144,119,25,Asia,23,1315.15
df214bb18b6848a8bed3c6afb89fef8f,104,74,30,North America,24,717.89
df21bcfe1039456b9f172f78be820228,71,17,54,Africa,19,312.79
df2340ae4e67472ebf1e56d90ae16834,98,64,34,Asia,18,468.41
df26451b56984473bb378f8e1d33a0cf,234,193,41,South America,20,1525.33
df28d18448c3466a904f7e61a9812dfd,235,213,22,Africa,21,2005.56
df29a2b87f0c4e449718b77c6b926e0a,247,214,33,Oceania,22,1794.55
df29ce39189440dd93725f82d9070698,233,215,18,North America,17,1510.64
df2c62776b524d3aac747f4fb90dc15b,74,48,26,North America,24,433.03
df2d003d48f7468c825a851bed88182c,50,32,18,South America,19,342.25
df316124940b4b97adc7ff925e9ae6a4,269,227,42,South America,19,1465.95
df33116258944e03aca6d33a8ae3f2ae,363,351,12,Europe,21,2087.22
df3363a761d1444e86509a0faa4aa69b,157,137,20,North America,20,1452.46
df38c2bc362f401e93911e4ad88d2f0e,147,121,26,Europe,21,1297.67
df38e476e88443d993bba1188e48c040,82,38,44,Asia,22,492.43
df3bffe872c2432bbc5ad3621c90c82c,285,268,17,Oceania,24,1710.88
df3d4b1169dd4212911acf6b68598e22,359,333,26,South America,19,2639.05
df3ed69c82b9453888554aec72095d3f,281,243,38,Africa,19,2237.79
df3fd8f3efb946209f0eacd8df1973b2,292,250,42,Oceania,21,1931.09
df40b37fa72049b4b639f5b5cc006700,258,212,46,Europe,17,1125.3
df42d0dc3deb4c72a5835992888d3d6c,149,136,13,Asia,22,1437.69
df43a0e1929c4c5da64682779af6050a,285,252,33,North America,26,1487.85
df446adb114044099119e8964d4d5662,176,126,50,North America,22,992.75
df4624f9a44b4359bf44d9893020fe6a,265,209,56,Europe,15,1557.16
df46c5b109f447738c06273ad0f72fdd,281,241,40,Oceania,20,1893.2
df4c260af8aa4d87a0e3846def3076b7,311,285,26,South America,15,2379.24
df4c9b4b6d564a56aa707d2603c290b3,245,197,48,South America,21,1164.98
df518b262c1d4030a7590b46ee3c9584,337,305,32,Oceania,21,2064.1
df52e3b8d9634e8da45233a7675a3d32,130,82,48,Asia,21,792.65
df530bc96cda4bf98202a09974cf223d,356,300,56,North America,26,1996.25
df536183e81e4a66825ed0e7f2e91103,364,331,33,South America,12,2500.67
df5374106f6d41f491ca77114d5c9621,71,24,47,Asia,18,394.3
df53ad1f9d9d4968a1094b57de880d40,254,216,38,Oceania,23,1779.61
df5407a1abef4b4dba290863ad38a880,116,65,51,South America,19,729.87
df575c93c4bc44c4a5032cd93b55939f,300,245,55,Africa,24,1392.62
df579a35d5fd42b7828004bc1dbea87c,260,208,52,Europe,21,1071.02
df5990399d34471e8414b2a8f0e4bffe,212,186,26,Europe,23,1702.95
df5a53c2b102443bbc8f2b48df12806f,42,17,25,Africa,18,233.6
df5ab03aba5b43a9aad5181d59d304ef,301,257,44,South America,16,1431.69
df61865fb16348b394459ff9ce3a3c4a,193,147,46,Asia,15,1216.46
df622ee7c1fe4a26995a6a69ffc20d2a,230,174,56,Oceania,19,922.11
df6351c840c04584be85fbb7b5f53b1c,344,306,38,Africa,19,2228.32
df63dc294700475cbe1104147340b0c3,365,361,4,Europe,27,2082.44
df642b78526549fc9c96b5ffde6f199d,63,25,38,South America,15,158.61
df6513d3379247569d7e753d724e7f5f,342,311,31,Oceania,20,1907.07
df6675da924f4582bf73532f18736018,178,158,20,Asia,21,2022.88
df6815a2b5cc4d7bb2e3c1d5576fc2fc,122,69,53,Europe,20,465.21
df6839c7144f493d8e3becbc97bfe628,312,284,28,South America,19,2202.12
df69607b302e49299db16b3632191157,156,95,61,South America,22,1250.35
df69e4579bb4431c82eb29275e796048,309,286,23,Oceania,20,2327.12
df6a3119499f4809a5256d8ba428259c,248,223,25,Oceania,16,1505.32
df6a658b472b4d36bc43bde4795eb799,293,257,36,Africa,18,1895.27
df6b799c39db42c7ae830df7df4789c2,219,172,47,Asia,28,1130.38
df6bef0fa8ec4753a6d5e325d71e8456,214,194,20,Africa,19,1485.45
df6f130dc618429e81a8325d48b87c69,228,174,54,Europe,13,1260.63
df7060305f1b42788e12f4570aa39439,341,319,22,North America,23,2770.91
df72cdce36ec4c9dbf1d2b74abcc8e6e,162,111,51,Asia,22,730.52
df73f61a5fbf49b5ac8dbbcae62d85a9,365,325,40,South America,17,1922.51
df7554251a4c47468149579ac23541a9,246,200,46,Africa,17,1446.13
df76013495d94e79a3a733d876c6bbe6,132,88,44,Africa,19,1225.3
df761319463f47acb12640a23ae9e004,133,91,42,Africa,26,1189.79
df797fa117da42b5b228990b5e05b14d,56,29,27,South America,20,394.94
df79a0e19b6a43829403ea23d1528b65,365,356,9,Oceania,18,2008.68
df7b9bfc45654a5d8c70f17f99d990d3,184,163,21,Europe,21,1753.52
df7d52bd2e024da780d9b3246c8a9009,228,177,51,Europe,17,1300.16
df7dc30c48a5411aa5e6863ad9892359,61,24,37,Africa,19,317.25
df7ff0b82d054d81bd0ddc88c05f8f73,307,276,31,Asia,19,2339.2
df803854026448a5a4b22b5130013751,347,295,52,Europe,19,1763.01
df80996d196a4378ab6f0338fe0a0c32,297,265,32,Asia,21,1637.72
df81073aad7149fbb8fd9e682f6f568b,365,361,4,Oceania,21,2437.01
df82a359c460402d9f19c24b10dc2226,161,124,37,Asia,18,1206.38
df84159df6ae4092a24635ec0a097796,109,79,30,Europe,19,821.85
df8626917de7499d8819061540bcd507,286,236,50,South America,21,1675.49
df873562470e49baa69f84fa066bf3cc,61,18,43,Africa,24,728.74
df8775cf407e48d9bc7439b54656d330,71,41,30,Europe,18,472.34
df88488c6d0f4fd89268f5cb7e66bcc5,347,324,23,North America,15,2688
df8b186a071542b3b9dd7932d9500185,173,117,56,Europe,18,1061.09
df8db3e97bd44b7699161da8c9f89a13,365,350,15,North America,19,2126.44
df90ad9672614afbb9f33c9c29a91c52,184,162,22,Africa,18,1264.17
df90fba2066b40f0b01c307cb73b17a8,266,211,55,Europe,21,1096.28
df91493de87a411a9508582da5db0b04,244,200,44,Europe,25,1359.96
df92c9e0001c4486842aeb4cff830d1b,276,240,36,Asia,26,1778.91
df96ca13a3c44a75abd290ac073a8a79,365,351,14,Oceania,21,2733.85
df997078d6a24a24b71db752487a05d6,361,328,33,South America,23,1758.57
df9990eab80443c5ab8e874b1c865134,221,188,33,Africa,23,2181.49
df9e127e56514305880fc5cbcee19f68,319,280,39,Asia,18,2087.91
df9f3abf1fdd4eee9fcf6af7b487673c,145,122,23,Oceania,20,1229.47
dfa01266218343299f8be974b9d6efae,164,129,35,Africa,22,738.57
dfa172ca2c254c589a0e22d68e4c201a,329,289,40,Asia,17,1873.18
dfa313c7d995498497f5afddb0fb6675,251,218,33,North America,14,1557.98
dfa34226904d42f4861c084d27ed1fe3,361,335,26,South America,16,2257.46
dfa41f7f02304f5dbc6f25d33397c5e1,68,25,43,Africa,25,201.41
dfa466afde53422aba31d0a862e56a06,187,150,37,Africa,19,1298.47
dfa75d52a45144169fa3f98f71dea8fa,38,12,26,South America,17,104.74
dfa7c2630dc848f3b7bae056f55231b1,365,353,12,Africa,22,2988.46
dfa88fd96f3d48f6a680ef3744a16d22,256,237,19,Oceania,23,1752.78
dfa89b1486de4a4abd5a5fd9351a9e33,189,155,34,Europe,19,1608.88
dfa96887e95a40ffa49b27d2a62eee6e,323,267,56,Europe,18,1877.02
dfaa79a62a744afea971c4b174a4fa4b,46,1,45,North America,24,44.38
dfab9256cc7a408f92ed03d206c559b9,200,172,28,Africa,20,1211.03
dfb0eab7d2e44be7bde1ce1bd7b68967,149,101,48,North America,20,918.02
dfb16dcc4bbe4d1eab19f76992a64ef2,162,138,24,North America,21,967.32
dfb44993a7904639a08fd190c7752ef8,317,275,42,Africa,17,1585.51
dfb57638b93b4df9a2586ec64c4405ef,26,4,22,Asia,25,275.99
dfb59ed9feb14c2783f80f96308a8f9a,182,156,26,North America,18,1219.79
dfb71b3aa0ed4a2695a146837af288d4,209,176,33,Africa,21,1472.66
dfb85684eab44af68d15d012b6b0d938,50,4,46,Europe,17,190.2
dfb9318440e64054ac224bd675e917d7,308,284,24,North America,20,2753.13
dfb96bf3722744278830bb0e4895ac0c,216,180,36,Oceania,19,1402.35
dfba73c7c3114bef99a6ca4c74e4df11,107,60,47,Africa,16,684.69
dfbda40d8fac407eb0dff8ae809b6a98,277,226,51,South America,20,1471.4
dfc1399a99bf48439478788581ee1497,365,347,18,North America,21,2622.55
dfc13c70f33a40398117e5eea73e0afa,323,288,35,North America,17,2930.73
dfc1d3751d834ac2b4b5ac798b5e34b7,335,288,47,North America,20,1514.72
dfc21180c4c1400ca97facc82c3892e3,56,34,22,Asia,19,320.9
dfc3fce96e304b6d8c5549e40256d902,347,323,24,Asia,23,2707.79
dfc4346129a64a38a0947b04d6e4b103,356,330,26,Asia,17,2139.39
dfc65f9f59724631b14bde9b7fb41a77,108,56,52,North America,18,458.29
dfc6ed4968d24448827c54c61c60a5a0,265,217,48,Oceania,18,876.64
dfc8c9e765d04dca9f1cb68a342ec8f9,289,259,30,Europe,17,1758.72
dfc91136ea864ea682728ccdc3b4f190,96,82,14,Africa,23,1236.22
dfcd313462d14994b584e456b2b49b08,163,135,28,North America,18,1459.73
dfd09c103c684f69b9c24b73ec664c20,137,109,28,Asia,18,766.5
dfd21359fa50444caadf9b91d37a96ef,261,238,23,Asia,18,2150.58
dfd2cf51f73d45078e6a9bccd8c49d9a,336,286,50,Asia,18,1627.66
dfd3041848464deeaf561ea42dee4588,361,340,21,Asia,14,3227.2
dfd63de9f19344fc9a7634bc3e9e2eac,60,8,52,Africa,16,198.16
dfd72ead33c946b88d574e7a3c6e78ac,35,11,24,Asia,22,186.36
dfd79aade5c34fe8864c84502944e0e9,284,233,51,North America,25,1248.31
dfd93bdb45f24161ad1c2255fb78e29e,365,331,34,Europe,26,1832.27
dfdc06820b274fc4a8cfd80fa9f7646c,357,330,27,North America,16,2651.84
dfddc6a28f6a4f4eb2fce9f55c5f28e5,290,238,52,South America,17,2137.15
dfde0cfb701c400aa31ce5e697c01989,185,152,33,Oceania,21,1418.69
dfe0036c8ae840ba8d4f2a9f055591e5,108,63,45,Africa,16,321.15
dfe01fd1dd504e65bbc4310b5d1b9898,365,343,22,North America,23,1491.18
dfe2a4f39efc4b07a1ea9a07ec8b05b7,232,207,25,Oceania,20,1818.94
dfe45e3e503a47719d41191fa80a8dab,294,269,25,Europe,22,2509.51
dfe48e40486640daa9dffb7bbc7a0a46,244,213,31,South America,19,1756.18
dfe48f2bf9494072a39e65c9efae5441,346,321,25,Oceania,24,2612.71
dfe768e07b8848648946035a3c147b55,342,313,29,Europe,20,2432.71
dfe7fcdf06fe47038e04b16f10949956,74,49,25,Oceania,21,633.85
dfe905a55c7f4267b5179ff750cadf37,221,191,30,North America,16,1634.63
dfe96cd3038e40e2b3d510381b20cf79,333,292,41,North America,27,2081.25
dfe9b8454c5e4caca63e1c5bdc52c9f7,48,19,29,Europe,22,312.7
dfebdb00e051446584413dcb3c48f4de,228,178,50,Europe,20,977.31
dfecf81bf2054dc28edcc72db1a3b5e7,88,40,48,South America,23,305.18
dfeec09f2fa74840bf46812e5e2dd55e,233,188,45,Oceania,17,1790.31
dfeef2e8a3484fc29d0770babbd216d5,117,92,25,Europe,18,996.4
dfef337767fc4193a1cc87c48d0e1406,243,186,57,Europe,24,711.36
dff05b5e24e8485892b9fb9801c0e9a0,72,39,33,Oceania,22,798.24
dff2830ae5e14262843b128da9524f0e,101,65,36,North America,19,698.23
dff7388bcc184914a2c6d6d5ccbefc3d,53,27,26,Africa,22,316.01
dff7f6806d1043c7be86ae60c2c47d8d,240,210,30,Asia,19,1610.66
dffb42805c944ae39c812d8aa7b2fa93,113,74,39,North America,13,726.88
dffb63e14cf142b3920a2318331d57bb,307,280,27,Africa,25,2366.92
dffcc456622d483cb15d301366efcc04,121,80,41,Africa,21,488.52
dffd6c01ed0c4e9f81b6452ce8fa1a20,164,112,52,Europe,20,995.22
dffef1db6c7e438c8fa092fc58055d0f,67,26,41,Europe,18,692.37
dfff31cb955147edb3b68f8100b1d26a,136,88,48,Africa,21,661.12
e0004d8bbfd047c595b9e4689dafc633,321,277,44,South America,19,1474.63
e002347d9d9b401aa17ceb1e4693cafd,236,213,23,Europe,21,1507.02
e004e4f498f347a3b5ab215d1a9d051a,121,104,17,Asia,17,893.68
e007a0e642954ba9a9890d275e5e9cd8,365,357,8,Oceania,24,2222.72
e00959fa75fb4e85bd7d1219e8ab7726,226,186,40,Oceania,22,1392.61
e00a3ccfe7a44a2294cdaf8065ec0b46,173,152,21,North America,20,1252.19
e00baff3135b4625abad428efb33eb96,102,61,41,South America,17,669.18
e00c0272883d4819a6a029e3b3e7cc7e,172,145,27,South America,19,1165.57
e00cbe7b8f244ea6b44a7eb6919cbdb7,137,93,44,South America,26,963.49
e00e8e3cb4b046caaf9ea8a6964c22a3,201,163,38,South America,15,1445.89
e00f15061b894b6eb2991629f7a31953,206,182,24,Asia,18,837.08
e00f316bcd584ca78c8d7a98e019ac5d,365,335,30,North America,21,1460.99
e0109232af1d4b7ba483d209f5c0ac09,209,164,45,Africa,24,959.45
e0109ebd8ce944129e27b0361a340780,69,36,33,Europe,16,448.29
e010ac2fee174faa99e039094470a895,317,257,60,Africa,25,2030.58
e010acd26ebd46cc86cb0d8ec985bfe8,159,132,27,Europe,23,1262.42
e010f724985f41fbac632ca8ae899ab9,324,292,32,North America,22,2778.03
e0126ec1db3346f986630135240394e8,308,274,34,Africa,17,2211.95
e0145e36c7114218937b4fedbddeb13a,142,117,25,South America,21,727.76
e016275c1a704fda8ecd8089c2845c45,83,58,25,Oceania,22,806
e0168a1535254fdd85d1b1c38846ea65,91,47,44,Oceania,24,583.9
e018eaeba39f4de3912487718d9e1a3a,201,166,35,Asia,24,1386.15
e0196b78acf748138c89bb9deca3fabe,152,100,52,Europe,25,508.07
e01a172ae3e048dca408c9135835157b,200,162,38,Oceania,23,1088.67
e01e787a62a349d99fa637d3bb5d9c8a,280,229,51,Africa,18,1467.56
e0227c30359c40fa8438b2ccdaad012c,244,218,26,South America,26,1941.65
e023c6348a654c3f866121b8effc33e3,236,189,47,North America,19,1625.4
e0260559be294271be18a570cac438a6,189,168,21,North America,23,1689.53
e02720357d9a43308c02194b2dc0cafb,230,170,60,Asia,21,1423.94
e027af26534442e0ab82cf361fb621f3,67,19,48,Africa,21,514.13
e02c9219979f4db8b7557c60b47ba92e,145,116,29,Asia,13,1182.95
e030bb83c46546cc8c2614b1e75bcf39,245,214,31,North America,18,1437.03
e031860b40e24ffb8a4dbb8fdc4c6af9,335,291,44,Europe,19,2969.75
e0331ddce10d460d876b69f6af54b9df,211,182,29,Africa,16,1509.26
e0334e2429a94d74afb0e88a483e4be2,160,122,38,South America,17,904.23
e033dafeb36a4db6b3d868db05942325,340,298,42,Asia,16,2290.96
e0346fdbe2a34312889628bd80801322,364,335,29,Oceania,21,1534.62
e037057c276f45a98d5db2e4dd663678,48,32,16,Europe,20,472.92
e03777b6530a46bca9e695815f846cd4,348,326,22,North America,18,2246.9
e039f2acd76f46ffb7526eeda1f1a046,47,16,31,South America,19,289.67
e03deb8efe554b749fa2347caf161192,221,197,24,Oceania,23,1802.87
e03eaf09559a4d5f8e3ccecadb010c36,318,260,58,Europe,20,1204.3
e03eea56163f4a84bd65a74cdc0e41a4,58,13,45,Asia,20,561.66
e03f84a67d3540a9ab3bd6157ab43292,285,243,42,Oceania,18,1537.43
e042177cf7bf467f90e13f7c85e615f4,66,34,32,North America,21,414.71
e044acbfa5db4ab4bbb11089acdca751,121,85,36,Oceania,15,1053.45
e044f18dcc334a12b098942d80b42c6d,334,298,36,South America,20,1670.1
e045be1f2103423b957dbed21334f8f4,267,238,29,Oceania,23,2615.31
e04a2223002f4ea3a9cf8e3d29b0beb5,222,195,27,Oceania,18,1110.58
e04a25c519994548b85e971fb981ad25,187,161,26,Oceania,26,948.04
e04a29a567e546c2b6f63cae9ccfdf4c,54,10,44,Europe,19,537.12
e04aa90409e44dc8a0fcada525a2da65,364,343,21,Europe,15,2703.37
e04d575abc4e47d0a5eab05e3bc14f78,116,61,55,South America,22,590.36
e04f5d0ab75e49f4ab46820c83533113,326,299,27,Europe,16,2336.48
e04f949f2b954bf9a5b4cea0a926590c,62,23,39,Asia,17,196.78
e051aae63e4d40f4bd6ee75304f9f42e,255,236,19,North America,23,1902.69
e052973b65594bc8a0def5cd98bb7262,127,69,58,South America,25,510.67
e052cfd583a7417db992d34e46adf26d,78,48,30,Oceania,18,737.52
e0532ec4bf56493a8d6819b851de6504,99,55,44,Europe,17,905.07
e054be2e73f547159ff188aa80e936da,316,289,27,Asia,20,2655.37
e054ccbad23a4d0b9b4bf1d353a4a96c,159,131,28,Oceania,21,1230.58
e055ffa1ad5e4736ab6cc2cad58c427f,133,91,42,Africa,20,321.92
e058f0070ea54e4fa354388acaad09a7,70,29,41,Europe,18,273.63
e05c282e36e141abac3f1f3f9fa8628c,158,121,37,Africa,20,970.04
e05c8328f3e341feb25feaf3b0ba57a2,81,45,36,Oceania,21,442.67
e05cf557b53c41709176f4d42bf26f65,259,218,41,Oceania,22,2089.43
e05d852a309d43b19eb5624b40696836,183,146,37,North America,18,1311.84
e05ea8c42d334a72a1a4afd110598f82,355,316,39,Oceania,21,2928.75
e061cfee6b2c4fc0846bcea4cadbd91a,341,291,50,Oceania,15,1650.1
e06239e29dad490895243d66348498d9,162,120,42,South America,21,1396.62
e0652d09f7cf4906b43c1ea7a791c81d,203,168,35,North America,24,1549.61
e06635597c5a495c885986cb78a65456,215,174,41,Asia,24,944.97
e066d01ff7664ee08e1f7b71fe950c7c,284,232,52,Europe,19,1583.31
e0676fb6442642bfb2d05c18933d1204,336,318,18,Asia,20,2717.52
e06dca01525b4c8390aff3723308e493,294,271,23,North America,24,2037.49
e06f0fbbd80c4367b0a5cd5d61be9786,204,163,41,North America,23,1171.32
e0706ff281c2478898fa277c30494956,312,278,34,North America,19,1409.59
e07087c0f67546e4805d3f257e294258,358,309,49,South America,19,2029.04
e071a1d6577448eb85b0baf8c4029a4c,62,41,21,North America,20,654.07
e0726d8ccc164f63b38445aa164d8580,129,90,39,Europe,21,1002.4
e0728e0d872d4b4299c0d553837a159d,98,58,40,South America,16,544.68
e0729cdfc6124633aa7abaa6a4a4da23,162,117,45,Asia,20,1316.04
e07762a736a54acb9dbd1f11a1b5a1d0,336,295,41,North America,19,2212.69
e0778893c1c94db5a0c40331546008cb,96,77,19,North America,25,569.13
e0794a9b698f469394a77ec483f7e3aa,264,248,16,Oceania,15,1828.28
e079bb23f57e4bf790d5a05eecc29669,71,33,38,Europe,22,470.33
e079c4c6034a47c9a740af1f96b16b36,260,232,28,Africa,23,2144.23
e07bfb42b5394fb4b5b62c827ce77f89,365,327,38,Asia,23,2010.1
e07bfbb516df4bff82d0534c49ad4554,220,182,38,Europe,23,1178.05
e07d76167d674b5daab53bc99daf9565,250,234,16,South America,21,2098.58
e07e95d5ff6f4893b3594c508b55b627,49,9,40,Oceania,18,214.49
e0816e4ee45b4b1e8e374ef5661ee26e,143,96,47,Europe,20,361.66
e082a045004a426891d413abe629b770,237,195,42,North America,18,1108.77
e083083452154b7abdd9e5f09290f487,166,141,25,South America,24,1342.61
e0843c5142c340218ca8cb939306690b,239,191,48,Asia,20,1451.8
e0853847c50549d7b54832b044b0a340,129,79,50,Europe,23,569.31
e086bb1fcde44594a3e8d8448e286bb6,162,113,49,Oceania,21,1114.8
e0879f4cd4f342ec8d8c8f7552001edc,95,50,45,South America,19,1087.67
e088a0061f6e4cd5b7f44333fa367d34,43,6,37,South America,19,366.05
e08958795dca430d8017f65461da5abf,101,61,40,Asia,19,1025.56
e089cda8a80a4ed8a87cc1c2fbf444ab,332,282,50,Europe,19,2081.82
e08a2bb8fb2f43b182a9aa09af7c7110,201,150,51,South America,20,1095.16
e08c43ce32934cd19a64462bf4d592b7,130,76,54,Oceania,20,640.94
e08e74ff3e064158b19a7850a8559917,141,84,57,Oceania,25,699.37
e08e77db5364447e929961a3fc27bd64,254,224,30,Africa,18,2275.15
e0911560939147d7b9a484afd46cbcd0,258,206,52,Europe,23,1059.72
e095bbfde6bc44a1947bfc6e9766f68c,290,271,19,North America,22,2617.26
e097c0b231bd4e8285e4f51e07703fc6,360,331,29,Europe,21,2133.02
e09b09560d954798aaabcf27309de212,263,218,45,North America,19,647.56
e09ba15ce80d4390b8a3248e53f261b5,87,60,27,Europe,24,784.3
e09bc27223c8435d8b4ef9a79298eee3,230,180,50,South America,23,1251.82
e09cc699f0904abe8363280cff3b0cfb,143,107,36,Oceania,17,661.52
e09d22fdecbf475684d4e4d800bf516f,363,357,6,Asia,20,2834.17
e09f41a63212462fadcdfcc464e14e81,126,74,52,Asia,19,538.6
e0a03cbee89a4ab3b62b4e467afa8b09,292,247,45,Oceania,18,1911.52
e0a077dacf7a4ccbaeb378298bb4a685,365,333,32,Africa,17,3084.65
e0a23a0b6fdf46129d099e80b0cb094a,364,337,27,South America,23,1293.71
e0a2d8835ac24b7ca3b02782f27e0447,317,301,16,Asia,18,2485.49
e0a4423792374dc3960892f80c937de5,255,202,53,Europe,19,1884.93
e0a532661dcb4032908a2e235d4facaa,364,361,3,Europe,22,2467.6
e0a760d42d874940b859f7c701bac8f3,340,315,25,Asia,17,2529.41
e0a8028d0d8a43ca9545ffb16286e638,295,244,51,Africa,21,1417.28
e0a8049bcea14a68b669d8ba522feb19,226,167,59,South America,22,969.61
e0a86794a5234f6f8fbe99ba87ad2dda,62,21,41,Europe,24,606.98
e0a8be7a85274e4e81a588162f59bb6c,336,285,51,Africa,19,2212.5
e0a9c9a0a19745048cf63b97191ca4c1,177,143,34,Asia,23,967.97
e0aadcd09562462785ae9f4b49beac31,26,10,16,Asia,24,310.96
e0aba6c4d9a34d5c9c063261549de669,160,111,49,South America,17,477.3
e0ac8a12b4a14819a5b3d877e4222d4b,285,237,48,Oceania,19,1544.58
e0acb8354e1449929de9b1e4f4ecd00c,85,38,47,Oceania,17,354.73
e0acd8aff9b94486bef3cb8bdf6ab606,354,325,29,Europe,25,3213.83
e0aeecb4f88a43699b1a437806615a42,205,169,36,Africa,16,892.24
e0b15f36eae24e3697c3d6eba2818a9a,119,100,19,South America,21,450.41
e0b1751773594e8682491f0041280fff,238,198,40,Europe,18,944.45
e0b18660fad8416592a14ae3c24baaa8,77,25,52,Oceania,18,154.85
e0b2b9b6187f424aa08d3b7c5cc76246,113,91,22,Africa,21,969.43
e0b55ef77fd246599ecf59e10beb38b2,104,76,28,South America,23,649.97
e0b8727960eb4caf8c96a3fdbe4d09e0,365,337,28,North America,20,1265.88
e0bb6133ac9e4a159f431d3c7ae2eac9,190,136,54,Europe,18,680.61
e0bb6fefd2264e279fef5d33aad13204,286,248,38,North America,19,1954.53
e0bc29bef7064c148d639a37ceb7ce7e,69,31,38,Europe,19,335.61
e0becb6dfee443be8ac8091ffce809ee,356,329,27,South America,21,2806.21
e0c0556240f944e7afefaf979a88ab5e,281,233,48,Africa,25,1687.21
e0c223dcb51648b39a7187c291bd7f08,235,187,48,Africa,21,1397.85
e0c26e02a7d943f49e7c5746e720e2c0,223,189,34,North America,22,1846.29
e0c542583d31429ca8061d7a00595444,364,355,9,Asia,17,2679.87
e0c8765a1c0549e3988b1c392fc2886e,365,356,9,Africa,18,2550.58
e0ca4078d6e14a49b71ab141659b379c,333,321,12,South America,22,2651.51
e0caed7b78e3415e8ad20ab6fdcf8ec7,39,14,25,Oceania,17,275.99
e0cbdd4fd9494a1a8d73505fd0bdae08,261,221,40,South America,23,1740.42
e0cdf92ac82d4ce4952b9cbc952326e9,365,344,21,Africa,17,2801.69
e0ce20f81a634ba390e82a23f006c919,62,13,49,Oceania,21,659.03
e0cf38a2ab734f2a90d3ebeb0ad304ca,136,98,38,Europe,22,1018.27
e0cfb78fe178448aae462ae8f20f0607,99,43,56,North America,13,244.99
e0d17146acc448eb8f48e8023181bf56,345,306,39,Africa,16,2744.69
e0d2592b22484d4ab837a9be6a8d10f4,365,363,2,North America,19,3226.25
e0d52f61056643ce896b0d911fcb7547,133,83,50,South America,23,1153.43
e0d725ecd4d04d59bc012629574806df,156,119,37,Europe,24,1597.88
e0d86ad9c8e8400b88ec00dadc81c955,278,232,46,South America,22,1826.76
e0db131948904b289d846d4eeb3c7e00,360,312,48,North America,26,2070.16
e0ddf0d47bc9470cad4c03eaae4d794f,167,112,55,Oceania,20,866.26
e0de7e3132454079af667ca0ebdca634,77,44,33,North America,25,593.17
e0df638e51d94a749ae864d5513a164b,312,279,33,North America,23,2515.15
e0e03f9a72454b8e99be14eee8091c81,365,350,15,North America,21,2577.3
e0e1024ca1cd496cb20348bfe6d52c56,156,129,27,South America,22,1276.59
e0e25bbb6733421abe4053b8f622e285,184,138,46,North America,18,564.55
e0e350fe119a4808baf42a60ebaa49ae,306,257,49,South America,20,1131.77
e0e3a68f456b46bfb119ff37a5b8b80b,101,63,38,Oceania,17,487.79
e0e3b08820b5486a90b079046e1ab4b2,323,273,50,Africa,20,1597.48
e0e3f865afd5412fb763bf8e6e5425ee,190,155,35,North America,20,1339.88
e0e5eb02937d43afae06a2a5d92f74dc,194,146,48,Africa,20,876.42
e0e7c4027ad0481b9fd1ff465aa59ea6,197,173,24,South America,19,1472.11
e0ea59768df24e72859d56203cebeb36,354,301,53,Oceania,14,1365.74
e0eb7572b64942e7931fef9674be4c51,135,94,41,South America,14,779.26
e0ed299b8faa42aa81152f6fbb837aa8,129,99,30,Oceania,18,722.2
e0ee6f5f222b41059ca4d9e35953a014,105,51,54,Oceania,22,524.37
e0f145c980034402b2777de3ccba08e1,248,206,42,North America,18,960.25
e0f1a5fc8c4b4b63865ced21ff63b021,104,49,55,South America,24,601.92
e0f41b9258234c83a954d31a3350ffbc,84,52,32,Africa,25,504.54
e0f5f20561124277886f8c37a70c4786,238,184,54,Africa,21,1268.01
e0f6b23b13e94ee5a55e1753b81116cd,68,37,31,North America,18,559.58
e0f6df298de84bec97430731ce61b1ca,193,164,29,Oceania,24,1424.29
e0f6eddf2d81433cb0b2849de6da0a0f,365,353,12,Africa,24,1213.66
e0f7314d7b1b4caa8f9b0879a8d52cb3,303,274,29,Europe,19,1869.22
e0f887ce41104a388f4537237c7c5d88,93,52,41,South America,19,360.23
e0fb9b0f1e684c9f832f82afb1dcb442,138,97,41,South America,18,1149.96
e0fd0cce3802489aaaa7ffffae41d34b,274,239,35,Asia,18,1647.99
e0fd6e306c9c41cda61563d28ba72ed2,365,348,17,Europe,21,2054.83
e0fe7977aaad4b92984b71da26e9b5b3,93,70,23,Africa,21,895.05
e0fe7c53bedd45b3b0a5458fe1f61955,77,50,27,Oceania,17,545.91
e0fead516aca40a89a80239f512ceba6,268,225,43,South America,23,1490.07
e0fec33d1b01452393815979bed50711,237,201,36,North America,19,1740.37
e1051827e7de4691b514b650ef22f9c1,75,54,21,North America,21,549.31
e1057ec1109549f38c821628e95dfbdd,228,193,35,South America,19,1648.78
e10873460d514337bb2f2a0b8e40a894,112,61,51,Oceania,22,451.77
e10c68207a184caeac1bd293801cf4ba,365,355,10,Europe,19,2542.15
e110754ef9d8477aaf9e13f63cf64d5d,157,138,19,South America,19,1106.71
e11297dd2c8c4b4f90981d25807dab93,243,207,36,Asia,21,1940.92
e112dad95b2f41c7bf912176ef444258,274,227,47,North America,20,1709.89
e1132a9b113a4644bb5d95779306e6e1,237,178,59,South America,18,1333.19
e1136540d4d84d738ccab60757a5927a,100,73,27,Asia,18,543.79
e1184d047ed04d929b093fe0f49c2772,121,96,25,Oceania,19,1105.96
e119269cba864f25ab37f6c1512f9f92,187,163,24,North America,19,1528.9
e119ba5f704c4099a439567ec1725f2b,116,76,40,Asia,21,1178.93
e11a3c2979d643019dfa520338cbec68,258,218,40,South America,14,1587.56
e11a70fadaf54dce94a4ff5333befaf7,309,278,31,South America,22,2579.61
e11c16e10e1647b28234139566fe1ab7,227,185,42,Asia,24,1524.51
e11cc08d4fd54458b2180f8effb88f91,191,161,30,North America,20,1154.14
e11d0074ea7e4279ad44631fd8a23fa7,102,75,27,Oceania,17,1343.56
e11d47c31ffb48ee8a44055aed596e52,154,134,20,Oceania,19,1424.91
e11ea2ce820e4ec38d03c4f0f02d9f90,278,255,23,Europe,15,2429.65
e11ea3f047ed48f38f96f1f9c3a188e9,72,22,50,Oceania,19,368.2
e1203eae00e94e0cb4c07c32f92e0fd1,131,107,24,Oceania,22,1438.13
e12260db3f144d65baa0ef7116651241,162,136,26,Europe,19,1576.04
e12372abe2294253a94eac6917276164,192,157,35,Asia,22,1943.89
e1280e3b3fec499286b6db4424bac19d,210,193,17,North America,25,1993.83
e1289cdc91cc4e71a66679a053214938,175,128,47,South America,19,1030.96
e128b919e4ba4f889220bbcb28405b4f,147,122,25,Oceania,16,757.55
e129ad17b7e54546a76cf6af136f847b,203,165,38,Oceania,22,1769.17
e12a1d4215744cfe85e3c4305f0295d0,196,169,27,Europe,22,1644.44
e12a94689e9e43b4b8fbc2d7cad2064d,365,359,6,Europe,22,2140.73
e12c0514f01242ffb7ed1aded6446199,348,322,26,Africa,20,2309.64
e12c44aa8c4941dd829389656fd20fca,62,23,39,Oceania,19,627.83
e12c94fe4fbf405ebf30537f0fce8b75,206,163,43,Africa,25,1171.1
e12e537f8ca94e6eb44c93e48421e69f,143,92,51,South America,25,790.14
e12eefc037df479ab1a6598a6e473aa5,339,299,40,Oceania,20,2770.22
e12f4786902f446a9e9002df473c8ebd,222,178,44,Africa,19,1059.16
e12f47e30c534c3cabe99f1fd0e39aa6,256,223,33,North America,18,1673.06
e130354006ea4199a77997b62b5d7c53,50,14,36,Asia,21,539.64
e134c6fb47ee47f0b42df496025ba585,260,220,40,Asia,23,1479.83
e135bb8fa9494ce8a1f376c4d697a668,263,236,27,Oceania,23,1273.13
e1381e3193614dbf8a2cbb133e87a0c0,187,141,46,South America,23,1199.91
e139d42ead8f484b9b25019a8af29991,301,277,24,South America,17,2470.49
e13bd04fac4847b598fc1b8e68fa9a50,335,316,19,Oceania,19,2789.32
e13c89d53372486eb305011ad4b483f9,356,333,23,North America,22,2579.24
e13d2d091ebe41e389a52523764fa0c7,364,363,1,South America,19,3413.48
e13f9616c7094dd88cff82a4c2051ea8,192,142,50,North America,20,1317.28
e142f3ea348f4dc2a8771a1d881fc574,310,261,49,Asia,22,1350.05
e144b4819e6d4c9ab29ade4c56657782,269,239,30,South America,22,1809.72
e145e8b4837b4d20bade39075445b540,364,353,11,Europe,17,2150.68
e146f8d823394a11ba444fb627fd1790,295,252,43,North America,19,1672.22
e1470ffa48b34b9d9a36ea8c680cac1b,209,180,29,Asia,19,1396.35
e14e8ea86dd040838dcb5e23b32b818d,330,277,53,Asia,15,1348.4
e14e9e29ca7346cd9e0aedab3dd06022,338,300,38,Oceania,25,2397.96
e14f8e4f5a3a417f93fedebf5bf10469,334,279,55,Asia,23,2314.76
e14fccc15e6c4187805ba27197e8125b,108,70,38,Oceania,16,675.85
e15050e2f9194b15be856101bcf083cf,295,275,20,North America,20,2470.77
e151459e87ab491ba60c3c17ae0ff090,316,270,46,Europe,24,2090.54
e151e60cf1054e3b9e5ffd159d65295b,204,178,26,North America,20,1953.77
e1522ab7213c4a7daf82a32274ee71ef,105,45,60,Europe,17,723.37
e15511255b02495989464080fd09adb9,164,122,42,South America,24,1035.3
e155d3da407245179bb87191536478a9,218,195,23,Africa,21,1885.86
e156cd267c6d42e8bdc4bd18caa340f4,349,313,36,Africa,22,2028.14
e15b352c20104d639c898cfc87d778c7,222,175,47,Europe,19,902.73
e15c36ff2eab4317aa9d1200a4e5ebf0,103,71,32,South America,24,213.56
e15c4f8543e84797adc5e2f323ec644b,147,111,36,Oceania,26,704.93
e15e02e10e094cfeafec6cc1f007c23d,328,292,36,South America,25,1973.42
e15fe244901a4f5daa814114a48b7550,365,353,12,Europe,20,3447.49
e1602a0ddddb4da4bf687ed30fb69877,245,197,48,South America,17,1308.23
e1604710eca6430fa60d0e139342f779,247,207,40,Africa,17,1602.06
e1605909d9cf42be9737b82f94d6fd55,222,180,42,Africa,17,1438.17
e164360559cb458cb097c8ede02a004c,114,87,27,North America,25,565.86
e1672d63a49b4fcdb9df0e11c0d7c67c,223,178,45,Asia,13,1501.21
e1686f5ad18a4da08bd022dd08ed13f8,363,318,45,South America,19,1756.69
e16a14a548184d548f62167ce43037ff,364,335,29,North America,17,3085.6
e16ee801a69d4978b9d3511fa6331cb3,119,62,57,Europe,25,678.83
e16f0586e7d647a5b766d03d436235f8,234,211,23,Asia,20,1844.73
e172903f91084e4e99cbd29c4b092d7c,332,313,19,South America,27,1967.03
e17572c7b2d6410aa2f38860b82350c2,40,24,16,Europe,20,347.17
e177450bf73f4251b024dddc6f308801,295,267,28,Oceania,17,2536.63
e17a3a63938c4f11bc787739307b08f5,159,136,23,Europe,20,1110.66
e17bd80a73af4be5aa961b30d369dcbf,208,188,20,North America,22,1776.43
e17c450b3c5749a1ba3039a7a20d902c,365,342,23,South America,19,1744.46
e17d961e6ead4dfab83f7d058fa3e093,180,158,22,South America,18,1307.07
e17e61cf4ea34dc98ac68350fb08602a,365,347,18,North America,16,2901.49
e17e8e50bb174610a7b90ea393cc7ce5,306,291,15,Asia,20,1826.79
e17effe5d16d4504b15cc504e0966fcc,324,277,47,South America,21,2710.33
e17f618fa87f4820913f61c15ae14f2b,63,20,43,Africa,20,260.77
e1802e9049be4939b21efd8e39160646,133,93,40,Africa,14,1145.12
e1816df98a394201a79717e072a8c073,263,207,56,Asia,20,1284.9
e1821184349341c5a27037a73995277d,209,156,53,South America,21,1030.02
e182f89b7bca46e2a433dc44c93a8b00,187,149,38,Europe,15,1528.47
e183b2c843674e75bcf0144d78cfa053,365,325,40,Europe,18,1774.08
e183d6a5e267443d8956972d7a202d54,209,161,48,Oceania,19,1078.36
e184cdf5cba041a7bf32950dac72c22e,364,344,20,Africa,25,2244.54
e184e3e3dbc64b36a1c492ac782357b1,67,38,29,South America,19,327.18
e18824fe32d7459d86da590b3b1845f7,268,220,48,Oceania,22,1562.86
e18845442d0f46928658b28c39e44a99,233,206,27,Oceania,21,1911.67
e1896e6e952c47699da8c7a0fbecb952,41,20,21,North America,22,541.65
e18bd12febd645a589017cb3e87de36a,109,55,54,South America,22,466.01
e18c8f7ac59b4aa3904e8249165c525c,129,81,48,Europe,20,760.27
e18cb7ed3e8b4c6e9d810a80ea445d1b,285,243,42,Oceania,16,1862.06
e18df1bd4c7d4b3fb3afc6f7a5a8c83e,294,264,30,Africa,22,2645.04
e18df64d34a344a1ae98902e538fe206,301,240,61,North America,14,1670.06
e18e740a4ae04e7ab3fc664235aff04e,278,230,48,Oceania,23,1778.69
e19157f8214141c19116620210c835aa,362,328,34,North America,20,1154.76
e1940245d09a493b91da25cb546ebce2,256,209,47,South America,22,1585.45
e1951c0174c046bf80821a28fd0ae50c,123,76,47,Oceania,23,652.54
e196096296184c1dafd95d8a1db8069d,201,150,51,South America,15,704.84
e197194b989343b9b90c8b884d3822b0,274,258,16,North America,26,1511.58
e19996efdee942bcae0babefe0b0f431,178,155,23,North America,19,1091.27
e19a2b53192f4e17a54b709ebf638e0e,314,283,31,Europe,24,1988.06
e19a9cdb38324840b4b6c5b7cdef1707,93,59,34,South America,20,897.88
e19b3f7bd4ef40d0aa70336f3c241335,94,55,39,North America,14,640.82
e1a0074db8964ea982479e4adc916ecc,157,138,19,Africa,18,1032.56
e1a1d7e2222c4c6f9ff9cda5914ef482,293,247,46,Asia,23,2263.9
e1a21def2b18432eb116fbd0a264f8ff,263,240,23,Oceania,17,1761.36
e1a2e9e425f94dbf9c768bf162c0616b,118,83,35,Africa,22,870.9
e1a44251a9c7420380077492d7fb8a46,176,130,46,South America,22,1217.61
e1a5ff93ddd3466eb922e9e46d4df6be,361,301,60,Europe,15,2111.93
e1a646b50b5a49afa5bccaac615fb95b,316,270,46,North America,22,1231.57
e1a7d2b264e3404c84a7466c70eb585f,311,266,45,North America,20,2508.71
e1ac7786158d4165be33c1081871fb30,346,305,41,Oceania,22,2331.29
e1ae622c95594cf0b5e84a84d991771c,191,159,32,Africa,20,573.4
e1b131066d2c4e0887f181cdf26b0fb9,313,279,34,Asia,21,2626
e1b1e7a5805b43a2b49ba807741154b1,66,42,24,Asia,30,464.88
e1b36c850e004ba28ccf9d1370b62518,67,32,35,Oceania,16,495.86
e1b3d845e7a748ad84f7b63036aedf2f,265,220,45,Africa,23,1411.41
e1b61da92e464cba8d64e30e362ae2a1,155,131,24,Europe,22,1307.68
e1b71de97f394943802d29438559d8bb,289,266,23,Asia,19,2348
e1b8265e5fe745d1b953c4685a08a3ac,286,250,36,Asia,20,2341.57
e1b8b92497cc4890aaea675e5c204af3,126,71,55,North America,21,552.1
e1bb49ac4df248a3ad512116f1fb9909,180,153,27,Oceania,18,1228.91
e1bba3867bd74f47b6e9bb7b8d30652d,260,237,23,Europe,21,2326.23
e1bc0755d0ee4d19bb4bb759b0faadbf,57,5,52,Oceania,17,329.46
e1c0ae4e62c34359a9df6b85d5b4ed81,204,163,41,Oceania,15,1178.19
e1c26858785c49c4b5c79ac365121ae8,248,193,55,Africa,18,1491.61
e1c335605bcb4d8e92f2e23f75c4b7ee,34,13,21,Africa,21,170.67
e1c368f54aa449c09a919f2b40d6c8e0,362,345,17,Africa,21,2917.31
e1c3b3ed0d1b45f699c7255d91d5ecdf,149,138,11,Oceania,18,1433.89
e1c57aecc1774874afddc00a2bddaf57,103,70,33,South America,21,471.02
e1c59ab85d594991a2ff5a9e4789c4be,87,65,22,North America,13,510.96
e1c5b9dd18ee4d45b5451963f86cab3c,42,1,41,Africa,15,107.39
e1c88c55b151453090bbe4a888770031,200,168,32,South America,23,1284.88
e1cb8026a6a946d980f6f890fda18da1,294,252,42,Africa,19,1905.78
e1cc26852d9d4703a9b0104ca42fc01e,308,270,38,Oceania,17,1667.83
e1cd0b2331204c14840fd64c52d745b0,123,92,31,Europe,20,582.45
e1ce23f8e2e0440397be3dc9a8f07dd0,121,105,16,North America,21,1074.1
e1ce8f497e2d4e9a82ebfd1d8d7f77ee,365,341,24,South America,22,2000.49
e1cf0e6755e6495eab67df03bc079e79,325,261,64,Asia,19,1753.85
e1d03d7a4dff40e3ab246ca56ff91741,203,156,47,North America,24,850.15
e1d25af5a9184768896bb01f4b41625f,80,43,37,North America,23,555.65
e1d28b9d19b841dba496cdd65f0f8905,363,342,21,Europe,17,3094.44
e1d37b1e04cb4ca3a8cbac207de82986,323,296,27,South America,17,2556.35
e1d3acb7927f42088e002ec3f4bc9fa2,75,41,34,North America,20,414.36
e1d42f27ff244903b2e39dbee54c07c8,255,221,34,North America,16,1782.97
e1d5807746b040eabe7889b673fc41bf,342,328,14,Europe,20,2588.82
e1d5816f47c747238a68622f15c8f678,127,87,40,Africa,15,858.64
e1d66a2f99c04438aa53449a7a063236,199,161,38,North America,24,1458.01
e1d6eb2e30ed4dc5968f4a90002c87a8,138,91,47,North America,22,893.02
e1d6f69adc774e8eb528fd446dbf4ed8,365,333,32,South America,21,2491.84
e1d76eb5feed4099a531bdc020ef41bb,49,4,45,Europe,14,274.59
e1d81342388646e5beeeb449af6567f4,365,364,1,Europe,17,3198.7
e1d8f07d078a4aae8ff32c19530f4952,150,119,31,Asia,20,971.11
e1db713634934c498fb2c31f31a12b97,289,250,39,Oceania,25,1105.81
e1dc084c173747b6b86535befa598369,116,77,39,South America,26,946.53
e1de7a5e171a4480b73275a487dc1866,233,200,33,Africa,23,1462.75
e1df1e961f0f4e9baa4e94e49839fbea,275,250,25,Oceania,17,1390.48
e1e00dfdec804954bea136b0b5fff35b,172,119,53,Asia,19,561.82
e1e37a6267524194a669d51c3080a23d,151,116,35,Europe,19,459.46
e1e3e441823f4dda982b3b78d9aa56c2,203,152,51,North America,17,1125.24
e1e63460dc754faca1c5fd8b9d00aa39,80,27,53,Europe,21,484.63
e1e6b9ef500c44debde983076f80c473,110,68,42,Africa,18,1123.63
e1e7949030414539a116c2abcd06733f,305,280,25,Africa,20,2917.2
e1e828b9aec94b8e97aaab1e805d2ea8,295,259,36,Oceania,17,1781.68
e1e8952edf7c4fb8b93dc86f86abd7b5,133,114,19,Asia,20,919.89
e1eb62de09c443cd966cba2dd2377adf,327,290,37,Oceania,28,1873.66
e1ebb884090c4d0d8ffbb3b1da3eac2b,76,48,28,Asia,22,258.51
e1ed8e7f12044eb39d994ee4e52398e9,325,275,50,Oceania,20,1975.79
e1ee0f7507dc4f558351e522993e45ff,105,82,23,Oceania,22,574.62
e1ee9184638e4c3a9be8486242b8c19d,189,152,37,Europe,12,1431.09
e1eea06b3ed241f9a8bdd465cc70882e,224,187,37,Oceania,19,1596.4
e1eebec103a04c93b0eae915b18c7fa5,61,1,60,North America,21,255.22
e1f03b0bda7c449cbbf517245699dca6,318,282,36,Asia,18,1714.15
e1f50c54dbe649f3b64eec1cd18ea929,272,234,38,Europe,15,1755.26
e1f5f0c84e6d4017a42a2d2f9d3ca573,153,133,20,North America,18,1010.43
e1fa891320af4a219bdb7329afacc49d,49,10,39,South America,19,317.44
e1fab5fbc66b484fad91934169f6665b,279,243,36,Africa,21,1552.73
e1ff7780dbdb457b8f8aa3f282f9e9e9,325,274,51,Asia,24,1150.36
e1ff8b7b5b684b49845a3a192efda217,260,235,25,Africa,17,2838.89
e203ac825c9742beb4302f6a7d0a8408,178,150,28,South America,16,1192.43
e206e4fa895145a9886903748ff982eb,281,245,36,Africa,23,1756.36
e206ff69ed0647909e34f37b0669fcb0,140,89,51,Oceania,22,631.13
e20c0a8cea3343cdab2de49d1f530f01,245,203,42,Europe,19,1405.93
e2105a10f3f744fa88df69a7c0da31d6,204,174,30,Oceania,19,1622.53
e212a7fd517c4b2fb8b980d898aec0bf,239,213,26,Europe,24,1844.94
e215206881a74defad2b6d00c0a9016b,97,73,24,Oceania,16,477.39
e219f9e8d72441b8bd364b4d4a77ca2f,264,220,44,Africa,21,1094.3
e222c4cb021348a5b51d213c48a91c8d,76,56,20,Africa,22,416.07
e223ee3eb2d04581876457e9e49f267d,87,58,29,Asia,24,695.26
e2246cb5309742a28d65d084da86a180,197,141,56,Oceania,21,965.28
e224b4d11a234cc9be091c197055cea5,87,52,35,North America,20,560.92
e2257cf5cca44219872df3ab8ccb9809,224,204,20,Africa,24,1664.14
e225f4ce90af4b1d833c6140ad2395cb,365,340,25,Africa,22,2557.99
e2268e4d5db847978d0614a92c66b357,365,351,14,Europe,20,1875.47
e226f1ed4c804d8fb22bc8ea856b21e7,233,203,30,South America,20,1828.39
e2283321c0a94239b65b1882cfc364fe,119,101,18,South America,21,552.34
e2286c9fa55d4bcbae334dbc07a3dd42,245,200,45,Europe,26,1570.65
e22ac001d4464559841c389617c66cd5,48,12,36,Asia,20,356.89
e22b8c31ee194958bd8f1997eef52bfa,304,285,19,South America,19,2500.44
e22dbd4fc6e64d82ac94cf18960232c2,134,91,43,South America,22,524.86
e22dcbeef8454eb98ee3a5fc658eeb61,365,317,48,Asia,20,1297.24
e22f96a4aaa9472e8ccfbbe7bf4ac69f,171,139,32,Oceania,15,1170.57
e230e71c77984c35b9b8ad490c57bc3f,311,281,30,Europe,21,2199.24
e231f819ec274ded99a0979e50bb453d,223,175,48,Europe,18,967.39
e2342414892e4e769a7c54701473f9d5,354,309,45,Europe,17,1585.39
e23472e1df4f4e7dab4fc5120250f4e8,114,67,47,South America,21,1137.48
e2348349d0f6431ab1a12e5007d90ffa,148,123,25,South America,19,1431.28
e2356cd4ffe14dc2be28008df3e35770,334,304,30,South America,19,2847.79
e235ff9c4a1f47e4b73bc39f4b1457bb,135,92,43,Europe,23,347.68
e2376b377e2044c1b3f2469c724eedd9,209,177,32,North America,21,2039.09
e23880ef8b484bfa846f5f1a035940a2,180,157,23,North America,22,926.7
e23aa1da244c4cb7be270ba21ed91a28,222,171,51,Asia,21,1053.75
e23c61bbd75847709358bc20614d6095,364,353,11,Europe,18,3173.12
e23d0ce6d35f4afeab70912a86293da5,209,185,24,Oceania,20,1897.81
e23da83c2818448093e386d329a2c337,365,358,7,Europe,16,2027.81
e23fd43e199f44be817d4afce9f4a206,193,151,42,Africa,25,1361.64
e241112ccca346298688482fca1cffb0,291,271,20,Africa,18,2617.72
e241b228353945ee8da16bedb30d1995,194,150,44,North America,18,1448.8
e2432323489b460197d28e54c0c2fabe,124,90,34,North America,26,772.59
e243c4cb9ce2472bbbf2cd479c736df6,65,33,32,South America,21,369.5
e2449d98e8b64a5baab491b1b303939f,334,285,49,Africa,24,1450.2
e2467ed5694b40d39e88f3633f0660e1,54,16,38,Asia,17,509.44
e2487b68f3e04c56a6b0efbf99dd03f6,364,331,33,Europe,17,1706.77
e2497912e37043b8bc6f54ebf901a9de,38,5,33,Europe,21,290.67
e24a7732588841f384f0d4aad4836c55,93,65,28,North America,15,864.93
e24d1d17cfdd41099014e26910b56aa8,365,356,9,South America,25,2568.58
e24f7449ac544d0e86443ce6f0169c09,282,255,27,Africa,18,2370.04
e24f9c12df7044b0bb81c4ce0093e7d1,269,216,53,South America,26,1295.25
e250ff6d1ff74149b2712624835cc6a8,362,336,26,Asia,23,2689.17
e252ab3685e340ee8c8719be539700dd,102,70,32,Africa,21,332.36
e253be36b61f4674ade42cb54790f909,186,134,52,South America,19,753.49
e2568763cd4a4c1d83eeac07aca7c47e,321,280,41,North America,22,2504.72
e2569c574c72466dabfef4a37151b339,260,237,23,Europe,21,1916.41
e2577000bc164e68962a24147efb35a7,81,50,31,Europe,19,821.72
e25a1c9f143340c7b666e5a35eeaae89,118,67,51,South America,15,672.57
e25b3974fb99401fa65094e413dd73fa,191,176,15,Oceania,18,1470.13
e25cb917d0fd40a08e68376af77c475a,137,80,57,Europe,14,571.87
e25e0f09a26f42c2ab785bc992792abe,347,320,27,Europe,18,2992.11
e264160ebfbf4826ba70eaa5352ba2be,335,287,48,Europe,22,1565.02
e26620c0b1fe4b34a82421722059bfd8,167,143,24,North America,20,1098.52
e2665f500d364c4db94667942af93a4a,235,202,33,North America,24,2065.31
e266d2709b0c4fba9df4c43cf84a0d4b,107,58,49,North America,18,498.21
e26f5cfed1e64a6f8f308748a2ff531b,122,97,25,Europe,23,1048.62
e27249db7bc0430eb86e2b7c88a6de1c,332,306,26,South America,21,2028.45
e274ba883d014675a3f50a8a98d0448e,90,42,48,South America,17,615.1
e2753bb62e61403eaee37fefb2575947,252,216,36,Asia,26,1896.73
e275d62d3a3643d39b6486b360b887ce,365,359,6,Africa,16,2309.21
e27931719d8a4a979c180f3dbdf7dc02,70,45,25,North America,21,431.79
e27a20f4e4524b0db21dffdb6db9a00c,265,245,20,Asia,21,1624.09
e27d4851ef514230b529e162afedec9d,174,124,50,South America,19,724.53
e27f5a2457244728a13246b64c768cd5,80,55,25,Oceania,25,726.16
e2822665c0c0421cb9d21a9e68ec22c6,365,359,6,Asia,25,3221.31
e28506937cbe44bd9be4b98d7f0d0186,52,2,50,North America,22,353.57
e287693b890a491aa311c06545940210,105,73,32,South America,25,993.82
e287e005e88a42e1a91e6ffe19a07289,117,81,36,Africa,24,1307.71
e28917b72bc44143b796f4ead89b6f53,262,232,30,Asia,21,1943.23
e28a76b42ce349d4884cec29b138d146,284,260,24,Europe,21,2502.81
e28ac37251fb45e9b33e951ac66e034c,357,306,51,Europe,21,1937.69
e28cee8622cf4756b624c1f62cad02a7,229,180,49,North America,23,785.08
e28d552f4bf649cfb523fcd0ce6d0265,259,218,41,North America,23,1786.2
e28d7a5c9b91498e96c39b2b42ef00f3,315,286,29,Africa,19,2029.63
e28e709169b24da8a2d4eeab4b3b93fb,74,39,35,Africa,23,435.76
e290968b9dc34bf5a3cb63a064594f3f,365,352,13,Oceania,21,2046.93
e290e9e869874843a05cd7835655b532,357,341,16,North America,26,3164.42
e2914fe1ebaa428eaa94d12e77ac11b2,94,69,25,Europe,21,906.24
e2919ac2de6c4376b8531469312b016b,279,248,31,Europe,19,2046.65
e2991928d2b74b4391d218e4ccead211,224,180,44,Europe,20,1279.03
e29b2ce872634fecabe076a309e40fbc,219,177,42,Africa,22,1460.81
e29f3566d84e4bc5b4e4f5bbc9a70ae8,307,269,38,North America,20,1856.92
e2a231238acf4fcc994961be4b50a74a,210,153,57,Europe,19,693.2
e2a2687acb8c44798d684546ac5f5dcc,70,29,41,North America,21,597.66
e2a38062d09540b2ae148497cd44f879,96,50,46,Oceania,22,409.29
e2a431be5804479fa20b1acba4e34021,365,344,21,Oceania,20,3264.14
e2a74715d96e48c39106b9914870072f,93,62,31,Africa,20,524.66
e2a7e73d00bb4f899b8bdfd60c48a0dd,270,224,46,Asia,15,1020.75
e2a8853f002547fc89206cdb059f9a42,322,278,44,South America,20,2207.03
e2a8f8cbc5e94aa3a2879b1cc90f6012,358,348,10,Asia,21,2510.83
e2a93f42e104415fad8f33962016650b,362,336,26,North America,24,2335.6
e2ab794b11bf40fcbf7df624cec7b0af,304,267,37,North America,17,1556.74
e2ab8474f3a1475cb46147131732e5a6,176,123,53,Oceania,19,1296.01
e2ad949c2452469b9fa761104e0944da,320,282,38,Africa,17,1916.81
e2af6aa1af564ed48945c70a8a445347,88,53,35,Europe,21,263.19
e2af6d2bfd8c45088e8db2f3db262a7f,365,354,11,Asia,16,2682.75
e2b4c6c0478649d09add7baf42108c13,291,232,59,North America,19,1634.53
e2b51a72c27f471a9f1e90122171e856,259,210,49,Oceania,19,1513.6
e2b5b81600d44a15b4f3a91acf817f8b,260,225,35,Oceania,12,1688.43
e2b60af7c4c44e67aaf844eb0b2739d5,341,319,22,Oceania,22,3153.17
e2b8e0d4414243e882b7fef1e0109b86,86,34,52,Oceania,16,519.76
e2babb081dc14d098187bfe3da44440e,336,285,51,Oceania,21,1961.24
e2bb3ebdacf248a18d0228ab39860b5b,146,93,53,Europe,24,731.15
e2bce67fb7dc42338602bf694501cfe5,351,308,43,North America,17,3014.49
e2bce8cb42794fdca49279f280c6b2b5,239,188,51,Oceania,17,1226.06
e2beca6557324b4ca98d2dd79b4459e5,363,359,4,Oceania,17,2415.77
e2c0a5143c63418b929d913be260f17b,124,100,24,Europe,22,965.57
e2c0e481c98c41b48bdeca1a541eeebd,97,64,33,Africa,24,307.9
e2c46f9df5c6419499e4dc66d786ded9,362,318,44,North America,19,1981.3
e2c5e527a7be49c3b8d331e221749f47,101,50,51,South America,25,607.8
e2c63534d83c455eb9bc85d520d99099,57,18,39,North America,16,249.46
e2c63f453513486ab2d9dbd14b39443b,106,87,19,Oceania,20,1074.69
e2c72d8e9cb34913967f4f10a5dbf4f7,44,8,36,Africa,22,445.07
e2c8adeb8a0046dba0fd52f2a25eb32f,51,14,37,North America,22,235.68
e2ca04d59d604f708d3716b2b2d554f0,214,179,35,North America,20,1361.28
e2cb8a9b55564c1b9aacad3a459a6335,80,41,39,Asia,16,323.02
e2d060977eed410fb931b8eb97dc4de0,129,84,45,South America,22,559.38
e2d213a551b847298291969364bf7567,365,364,1,Europe,16,3150.54
e2d49725b6ac42c7b1519c52c6e0c0b5,362,336,26,Africa,21,2099.19
e2d600be44d34a0b9186a9f7b806704c,60,13,47,North America,19,280.53
e2d74ca88f764f48ab05e9ea6714a2a6,216,164,52,South America,20,854.33
e2d79f1ff89f4230862f5406d5bd9fe7,197,173,24,Africa,18,2225.4
e2d8adf77df94d0ca2b5f7b2df77b3ef,165,140,25,North America,16,1612.7
e2da7553d7eb4f2c898e9483bd2b1343,71,11,60,Africa,22,223.36
e2dbf163ea5f4ca3b9e6c78ba5b36af8,237,216,21,Asia,21,1614.56
e2df8460bad04162a7d311a8b5df077d,159,129,30,Africa,20,1250.86
e2e1f00017174402a892efc8e76b6dd0,152,129,23,Africa,20,1209.89
e2e471b65cbc499096656c579027139d,116,64,52,Europe,21,619.79
e2e5bdf74aaa450eaf7fa694e4b7b1ce,68,42,26,North America,20,349.14
e2e77a1b36b84c248a46be8dc4eb706a,251,233,18,South America,19,1937.73
e2e919087e9d4fe19cb2a4f675945400,365,340,25,North America,17,2147.38
e2eb3a11057a4121a9c03e5fe2c368e2,199,161,38,Oceania,18,771.01
e2ebb7f5a7ed48fe8b660bee4f40aca0,213,176,37,Europe,24,932.93
e2ebfdb626d348c0b482ab03169e710d,340,328,12,Africa,22,3493.39
e2ed62c6b36b4bccbede47dde7dca6a5,184,163,21,Africa,18,997.82
e2ed748bf0064b30ac474704a5011045,195,158,37,Africa,18,1966.55
e2ee3f2252f64207bfc93a9062697646,133,99,34,Europe,16,1090.56
e2f29ab28c80426ab63a5c9fcb0d1412,356,314,42,Asia,19,2558.49
e2f5c797249d44d2ae26ffcf1ed1fb18,289,252,37,North America,16,1763.33
e2f61d0f900044ecb2efe56e996b6c5e,83,53,30,Oceania,18,719.21
e2f6d1b9ed6c4011b5e0e2f08c24801c,53,21,32,North America,22,483.63
e2fb7355225045b68dbb14f7693817e0,99,62,37,North America,16,822.85
e2fc7364f98b47d0b7766adc756c9b07,310,272,38,Asia,21,2699.99
e301494716cd404ebbbf06ef9bd1d3ad,188,165,23,Africa,19,1177.97
e305862970f04f179ae2dacf693c7660,31,1,30,Europe,23,328.82
e305b295520b4c81bb2f0667071626f8,283,260,23,Oceania,20,2323.62
e30683e4db89411c92130125805f7a74,364,358,6,Europe,22,2908.18
e3096d3191734f2c988d397c82bcba49,230,201,29,Asia,21,1582.07
e30a04b8d88b4ee6b0ad859a86465561,146,113,33,Oceania,15,1064.15
e30ea8775b0b4e6b88b41d6069e8e024,50,24,26,Europe,21,675.05
e30f4f186ebb4f3b89d5e5fafeba532f,157,116,41,Oceania,24,696.57
e30f83de86cb48efac64426cadb55a94,82,23,59,Oceania,17,289.05
e30ff355425c4532a712c3033fc8d529,297,249,48,Europe,24,1516.05
e310a0fb207640c696e9467964d7420f,364,345,19,North America,22,2120.81
e3163e1f20a347af9feb04dbc9ba81b1,179,132,47,Oceania,20,689.75
e3165a25b4f249a5bd22fdf6c86fde69,142,90,52,Oceania,17,667.06
e317c54a3d264b86b50aba004feaa5f4,36,16,20,Asia,24,253.99
e3188064c3e6451483b38d62c1e169c7,71,31,40,North America,16,565.71
e3190e322a434101a136b4ff6ba013c8,153,112,41,North America,25,1248.52
e31a9753d8204372bddf728c513f2881,289,232,57,Europe,17,1924.88
e31bdcc868e849d5868204919ac15773,201,172,29,Europe,20,2058.7
e31dd3cad6244ba69ca641b76d3812b5,31,7,24,Africa,24,79.61
e31eccddbec54f13adf22e469c558eac,360,320,40,South America,15,2307.24
e320ddd9e95c45b6a4a285f62f9d316c,52,12,40,Africa,23,620.77
e323123ed68f4595ae0405605419a876,43,22,21,Asia,20,277.17
e323a881cfe24231837028e612d20d9f,108,80,28,Oceania,20,1017.79
e32842bc6de3407ea25da7198c85776b,365,326,39,Europe,18,1970.04
e3297c2d2f6d42b5ad193d6c09a8832d,122,107,15,Oceania,23,1192.33
e32becee66a442d38bfeb2c34766614a,196,158,38,Oceania,23,1034.98
e32ead66285246ce8acbe0e637647573,365,345,20,Asia,23,2729.51
e32f2c8d87e44db3a3b3628d79ef06b5,98,68,30,South America,21,560.08
e331387b6d444eb99428a36b5612a6fc,118,73,45,North America,23,574.37
e337d2072e854546896b6b0c6385f785,224,167,57,North America,22,1095.81
e337f2a732a8492eb38fc183eb166d83,276,226,50,Oceania,22,1861.58
e3396e69d7324aa3a38af1cf34a607b2,201,153,48,Europe,20,1390.55
e33b88b5e2e149c2acd6130d2f57225f,346,327,19,Oceania,21,2724.13
e33c688f5ec843499102629b918fc7e9,106,69,37,South America,21,711.6
e33cf8d8a0294c2aad295f61ad385633,196,177,19,South America,22,1479.14
e33de18dc6f34e038dd8ecb70678e909,19,2,17,Africa,18,238.04
e33e1171fbbc412499e6f1d98eebb952,365,342,23,Asia,18,2900.76
e33e14c4d1af43f98d2e572e1e562097,365,340,25,Asia,22,2870.56
e33effabccdb4134a6d11412a703e3b7,270,239,31,Europe,24,1416.7
e341b7abb00a4e7da04f6ec0e324b7f7,125,97,28,Oceania,23,1157.92
e3425c8e3df74a2b803304f5e481610f,365,330,35,North America,20,1845.15
e34433e9c6024d908f3586e7191f40af,292,241,51,Oceania,18,1805.39
e34a0b9eb6974df2aa7a346b9c271047,25,3,22,Oceania,20,177.62
e34b3a4753814a9d96dc7baf99487136,108,62,46,North America,19,178.7
e34bd464840e404eb4c18a223b624be7,255,224,31,South America,20,2077.62
e34d7f1aeae247d88d0952bb2fa7d6dd,118,88,30,Oceania,21,1349.2
e3501a5d04444513a339ed62918d883a,136,84,52,North America,19,793.4
e350fb9d75d642fca23aac0603b94c01,185,168,17,North America,21,1599.97
e351c402395c48f5a66cb58648b9fb2a,196,153,43,Oceania,22,1449.5
e35216d0531e4412b623be1fb5fc6586,364,337,27,North America,16,1818.99
e354d5b05d0e4228832159de71c613d5,170,115,55,Europe,21,1024.17
e3573fef6b6344ecb85cb26a94ac98f2,247,197,50,South America,19,1066.36
e357a3e738b847a78b81576c665a14ba,31,12,19,Europe,18,91.36
e359365573404a219b8a9d1f70eea85b,258,229,29,Asia,24,1846.1
e35fa7cdd89c46ba985c12726ba75fbe,147,93,54,Africa,23,612.53
e35ff37444a74ed98b24b84ab9047818,156,123,33,North America,25,1153.78
e360adc78fa04c7293aff478f282ee0f,333,282,51,Africa,22,2318.13
e3613f3361954348b79696f34f016646,120,81,39,North America,23,883.75
e36705a7c97e4d4c9cb73ec4a2ec4081,209,156,53,Africa,22,1104.6
e36f3e482e2841d6b64d3fbe1305263d,127,76,51,Europe,22,729.01
e373715b8f4f43f6bda500df6a680067,347,321,26,Oceania,17,2746.77
e37487657e7f47c2bb3d214e170d1c61,129,82,47,South America,19,757.84
e3748f74f9354e9983638b60db699fd5,206,168,38,Asia,18,1218.74
e374abaad88d448e9930a25ac351a0da,365,353,12,Asia,14,2655.59
e374d4ebdbf54c31aa20e0c8786a6842,330,307,23,Asia,26,2618.24
e375f0aa6e404c3ca612b438c5c9f065,365,353,12,Asia,20,1501.1
e376050c3c0f40d892741cba5e96c5a9,353,332,21,Oceania,21,3200.85
e37ab8b38c734e4a8959004f26c48608,364,330,34,South America,20,2982.92
e37ac756a4524d4c91d95a14feab9085,218,199,19,Europe,19,1568.53
e38022fee32044cfa7d6a96e60c49510,347,307,40,North America,20,2731.03
e381ca703e2541e483a19c2a7c3392f4,86,58,28,Oceania,15,586.52
e383b8206dea480a8ceff2d46ab54592,350,325,25,South America,19,3713.38
e3840d446af7403eaeef1d26b38b44e2,222,177,45,Europe,20,1458.39
e384585e61d040c288dcc1dea3adc8c2,364,333,31,South America,24,2383.52
e38463e2cf28475288be31ac1af61a29,152,125,27,Africa,22,1445.2
e38638b9e9cb4c0581a8668dbcc1a891,48,10,38,Europe,18,344.28
e388930ace4644628ef9655864683053,164,104,60,Asia,21,754.92
e388bdd0096843f2b73cdd47af520fe0,41,12,29,Europe,20,569.73
e38b354233eb4d37b45ca9234a859e51,362,345,17,South America,20,2546.65
e38b4065a6b643eabbec465bf0a0685f,142,110,32,North America,19,974.44
e38b916f69344c0e8b4813d0d8dbcac5,353,317,36,Asia,21,1611.97
e38bee2fc3444402af96794dbe7f728d,300,259,41,North America,23,2108.19
e38e9066f31744b79ae1ac9aff08bca0,146,94,52,Africa,23,872.03
e3916a4c48bf48868ab10a00a1d0c133,277,241,36,Africa,15,1881.23
e3918435f18c4006baf8d12ae478a226,101,70,31,South America,22,766.67
e393c49e353d46dea536781911dfcb5a,43,23,20,Europe,22,243.17
e39806bb929f4c9ea431ed8774e3ef9c,45,18,27,Oceania,27,197.97
e3987b7797aa43b69bced5be2ecb41a5,221,211,10,South America,18,1511.13
e399cff4c1ee4d66ac11b4fdd6cf82c2,213,188,25,Oceania,20,1770.93
e39a3627d58b40219c9b1995d832ae94,222,188,34,Africa,20,1642.59
e39a80a8abd4439eac18ca7a03d13d90,205,179,26,Europe,22,1228.67
e39aa99eec39467cac0be288364d4688,185,136,49,Oceania,19,890.16
e39bcfea81014d129969113523aaa6b7,320,272,48,South America,23,1786.62
e39c4e801a67499da7cb23337242c70f,362,333,29,Asia,19,1734.86
e39ed102dd6046dd8006555e44d3d52c,280,246,34,Europe,21,1461.76
e39fb8530620464ab4a7b501e1dc1304,354,313,41,Oceania,17,2287.99
e39fd32642514ace91b380e31d7c1f88,314,284,30,Europe,22,1778.36
e3a0ab6a2ca44a56be2da1cb6412c91c,196,159,37,South America,19,1325.02
e3a13cc7292f4deea160da9cce12f57d,177,145,32,Africa,23,1262.15
e3a2b85dd2414a369d303a06e4a23602,251,220,31,South America,20,1412.04
e3a364ac71bc4bf987a735e70523c27a,144,105,39,Oceania,20,642.31
e3a5a91279704d90bfb3f90ac0a2a756,164,144,20,Europe,21,958.61
e3a65003b9c548adae578145cf0c1d91,234,218,16,Asia,20,1342.75
e3a94259dd22452c96d0b7be144912c3,365,350,15,South America,25,1673.79
e3a9fee190a24b6183b3a865396761fc,365,361,4,Asia,21,3110.83
e3aad63a70134f478016a79c33b52050,307,287,20,Africa,21,2356.6
e3ab79035b1a4259a182c99fa0d0a0fa,185,148,37,South America,21,1451.63
e3ac698a37cb45679ba26c6e79a9ab50,364,348,16,North America,22,2245.16
e3adf46a4d3c43e892790c660288adba,258,206,52,South America,18,1196.46
e3aedff45bd6442082704cb5fa85bb5a,66,28,38,Africa,18,354.74
e3aee70b27744a50aec866d49248b0e0,356,326,30,South America,23,2718.09
e3b116c9a067423495c70fc2164bfc8e,365,333,32,Europe,20,2010.67
e3b2011ff0cf4b859e9b18499343758d,237,221,16,Africa,20,1783.74
e3b2097641b84c41b017aa2938c0971c,292,262,30,Africa,23,1333.1
e3b3996e598b43c4b3cedf6952934815,250,210,40,North America,18,1287.97
e3b452c3f1ff450ca959d8deb8d641f4,288,249,39,North America,19,1468.83
e3b468ea3b94493b95b43c20a0a31c29,192,138,54,Oceania,18,585
e3ba63fdf7254469a986d572e59f0f80,313,264,49,Africa,21,1184.27
e3baeed128cc479f83197ff03fd2bab6,129,101,28,North America,20,914.12
e3bb770ed8604d1da43ce2e687d1b51a,355,321,34,Africa,16,1849.36
e3bed1973de8407894395dda88f140f7,317,296,21,North America,21,2201.94
e3bfa985d9b94449957772a1f275a5c3,44,28,16,South America,14,203.31
e3c13e7b9fa34d23b8e3ff983a4a6c24,245,210,35,South America,19,1290.24
e3c7ce9b5f6841ea9ee0be76d3b35bad,162,132,30,Europe,17,1278.04
e3c8b72c2af541658e1c246854a7a227,205,177,28,North America,16,1116.03
e3c9fd64014d48a1b61af10545c839a3,106,76,30,South America,17,1138.56
e3cad755499146a38eb12394a5d8949b,115,82,33,Africa,20,802.06
e3ccd66d08ea4e369b2e1e4734103b00,345,291,54,Oceania,15,1599.55
e3cdc25bfaaf4dbbb34f9842469c3846,69,42,27,Africa,18,396.34
e3ce1eee891e4e35af7aae45ff63e358,357,336,21,South America,17,2599.91
e3d36ae1e4214ac2b995a4d4b00b313d,365,363,2,Europe,21,2141.02
e3d5565a1f73426ebe1194e5daa3c45b,171,116,55,Asia,20,1090.75
e3d5a86fac2d4fcab1b9c71a14c12555,270,220,50,Oceania,23,921.97
e3d5cab45f714524a4d72d460b99f9e6,365,346,19,Oceania,19,2174.19
e3d6bc58192d44f19b5a6059fa0978b9,35,2,33,South America,17,170.17
e3d7e91c47934f52ad1fa2b24b8a5080,81,24,57,Africa,24,505.37
e3d87442ac3849f6ac038dcd348a1245,34,20,14,South America,16,263.17
e3deb8a0a8f54813ac86c2bec8419b82,281,242,39,North America,24,1725.78
e3dfa216de654438896a6f8104a1abf7,72,30,42,Asia,19,232.82
e3e1d7c9254141f890968494be650969,108,59,49,North America,24,654.36
e3e2511fd5254385a56621694ff19095,335,305,30,South America,23,2002.27
e3e434426799492bba27d74d803c5218,54,14,40,South America,14,192.88
e3e68b7eecce49828f7c8e19e3dbb5bf,365,321,44,North America,17,1926.9
e3e708228be4400a9b35bc9e5c547bea,363,311,52,Asia,16,1825.44
e3e71ae8074a4bebb650ebf65c7b55a8,41,23,18,Europe,15,351.51
e3e8c753d50745798063c08824c29083,364,340,24,Oceania,18,2828.78
e3ead41e490c45589cb0fb092df3fe0c,319,289,30,Oceania,18,3035.1
e3ec5ba3dcd049068e515091343e5a42,267,218,49,Africa,19,1186.38
e3ee8510a11e488ea3153e9f0ab3088f,91,54,37,South America,15,733.69
e3f009f194f44b80ac837df02343fb41,341,312,29,South America,17,2977.56
e3f047ef17344a4b9fbd16b2d35ea86c,147,115,32,South America,18,1190.12
e3f24d6be57b47be997806748861304b,275,239,36,North America,24,2062.54
e3f45eedd48649478450310e9be97c29,297,260,37,Africa,21,2432.07
e3f480eef94a4b82b10d323c406b6ba8,282,256,26,South America,23,2373.8
e3f6a6933d10441ab2e234048b300615,306,289,17,South America,17,2978
e3f824041b97472891e81288b887fcbd,256,218,38,Africa,24,1368.44
e3f9f822d0cd43fd8f220bd5a83d34f9,189,154,35,Asia,13,1049.78
e3fa86bda1234463b5085ae61b1fec41,365,322,43,South America,19,1904.51
e3fa89f189724bd59206c0e3ffe36027,359,325,34,Oceania,17,2267.42
e3fd9c9ecaf6418c9b662544cc7ba1a9,277,236,41,North America,17,2032.29
e3fddca38555476ba1e4bea301a88e34,201,167,34,Africa,22,1541.67
e402e9ab60bf4c2c9d2ed483683b2997,102,73,29,South America,18,400.17
e402fcb0a5954940acb655e0b97f279a,365,325,40,North America,19,2263.26
e4034e3aafb945b5802f8510eba7370c,295,245,50,Asia,19,1620.08
e404b99fa7e64269a937c558481f9db3,281,243,38,North America,25,1258.23
e40557387fea498b85fb91ef194305a4,48,19,29,Oceania,18,336.75
e405889e6e11471d8d8b3fe7f42aab65,93,59,34,South America,17,505.73
e408e13325884960a4342b0471e54367,218,168,50,Europe,22,1048.59
e40a7fa1da314b2e950d0cdf0aee23f4,103,73,30,North America,17,698.21
e40abba297d04200b1f9c4f057a0f9aa,105,68,37,Oceania,19,755.42
e40adbab5d864392b2fef2eec8886ba3,108,78,30,South America,19,848.99
e40c6798410d45369e1ba31b355b522f,279,236,43,South America,14,1926.11
e40dde954a624864b39b45c16bf7f963,298,267,31,North America,14,1913.99
e410747068194dd9ad58130bebd4b657,127,85,42,North America,19,695.14
e41173a75dc24c2f947a58dd29ffd43b,133,89,44,Africa,20,812.68
e415fc9b014646c29d05f1e07d9259b8,70,47,23,Africa,19,330.84
e41847af630a46a9b810e4a22630218a,343,314,29,Africa,19,2709.02
e41aaeb5180d47d4b09873441f95a3c3,328,288,40,South America,23,1717.64
e41bba836ece482d92a3795a6a8ccee0,361,343,18,Europe,17,3285.48
e41c1719eba34e51994b6648da6bb6a8,192,147,45,Asia,23,1376.34
e41c8686773e44898502d0ef0d4957a9,141,90,51,Europe,22,946.62
e41ed36fc7964c56a278c8143c31745b,245,231,14,Asia,19,2094.8
e41fee06bdea458dae1ea16533a0d195,170,124,46,Oceania,20,906.19
e42235d882f24f32a422c38b21563aa6,289,268,21,Oceania,21,2527.66
e423187b4d8f44ec919d347e6b660706,332,283,49,North America,19,1872.81
e4243f267c8c4825bced8642a4bc708d,259,225,34,Oceania,22,2067.75
e42659c244124dd39a9fac32dce48784,220,173,47,Asia,25,1308.76
e429ee10103141e5a7477f850cf932b1,38,3,35,South America,25,253.59
e42a8b704032453b9c0f2eb3b1a48272,234,203,31,South America,19,2117.3
e42f5e396e964d9fbd614675f73585d3,363,350,13,North America,20,2833.35
e4300a0044e74929bd57bd146f9c90a2,277,247,30,Oceania,25,1400.53
e430e486976644399834cff9a0587c27,222,196,26,Europe,17,1276.5
e430e86184774c25b020d818355e8156,365,348,17,South America,21,3278.9
e4316dcff67e457596287dc31a42e32a,233,215,18,North America,17,1706.15
e4326f4237c646e0bfd39eac94eb6d72,294,265,29,Asia,21,2068.71
e43300e7224c45daac672a2e74879c0f,85,56,29,Asia,21,269.04
e4349c836c064b238d90ad95f08ef39e,69,29,40,Asia,19,795.13
e43a62c9f94c49a2af075eb83f5c74c0,212,166,46,Europe,21,998.32
e43b02e26654461bbfd8bea23f07fdbe,178,151,27,North America,16,938.93
e43be180e0e54e18a57a2ec700e4f48f,171,123,48,Europe,25,704
e43c90a0a7984faaa13631dced7d1944,328,304,24,South America,25,2013.67
e43dae22589a4fe5af71c9281db81956,87,40,47,Asia,21,457.43
e43f29d400a1423faaf467cad26af4bb,116,73,43,South America,21,1277.85
e4401ba159594cb1b7f8f91d15379eba,170,118,52,South America,25,1067.29
e4410a4d64a547bc960e3092fd1dc36f,186,140,46,Africa,23,1072.71
e4438f067de94dc3996f618a128f7da7,311,260,51,Africa,19,1792.42
e44421bad2e146449a06b710b8a3d57a,286,248,38,Europe,17,1872.26
e446913bd918434d98606221e4afcb76,209,192,17,Asia,19,1570.32
e4480675176144d3baea101af456af0d,45,22,23,North America,20,206.28
e44f4623b7e34ff0a13670c64cd028d8,81,57,24,South America,17,888.12
e45433b869e1404c9e7aca59a76c2688,364,364,0,South America,19,3189.37
e454996f96f6454eb587e48d08f58b47,266,220,46,North America,17,1469.99
e4599af4039b404099b7c890f903c8bc,140,108,32,Oceania,21,765.48
e45aa0dfb35042d7bf77414c40413297,233,181,52,South America,23,756.22
e45b9e3aac3e4a02b296482fde0892ac,239,194,45,South America,14,1388.55
e45caf2d33d34742a65f0313b0b7eb41,249,215,34,Africa,18,1935.81
e45d8fb8e3b3459e8e01109136e75e3a,55,18,37,Oceania,22,193.78
e45f906fee3847cb9ee593cbcf5e1711,332,310,22,South America,19,1690.63
e4603728a3cf41b79ddebc0acaafa425,365,337,28,Oceania,19,1575.12
e463fb5c97c54f9fb4f55e95893c28a3,210,168,42,South America,16,983.89
e46438903d6f42c98b688ae06dfe6770,184,161,23,Europe,17,1184.02
e4646f1c47934405b75c3b0c06c6542d,100,57,43,Asia,16,396.11
e4657e9c0e774668997e3b86182cc74c,339,288,51,Europe,18,1149.01
e465c407a07b453cb5a73488b1cce125,176,137,39,North America,21,1177.54
e465eb38ec2b4deda8d171b9e38957b5,313,286,27,Africa,19,1962.68
e46898b0f9a64c86b3f61f52d87d6393,173,139,34,Africa,23,1144.77
e4690357694747918ce7c390b14cc306,364,345,19,North America,21,2681.09
e46f10e6c6cf444d8c16139e8bfbfa45,83,58,25,Oceania,26,594.65
e47049690342498bad16db75acbe450a,355,313,42,Africa,17,1610.93
e4710c64ce95416f930bde4735da277b,315,297,18,Africa,23,2195.09
e475b902c898423eba5e31d5e6fd4dba,97,55,42,North America,23,559.49
e476220a3a214d56926c6327ce10cbfa,142,120,22,Asia,17,1110.86
e4774c1854784d6b8ec6ee045d243193,274,243,31,Africa,20,2113.92
e47814c242c740159f890d3790532c77,328,293,35,Asia,22,2152.14
e47a0d521679403aa99e354ff2735aac,142,92,50,Africa,19,755.22
e47a20699ddf482382e81ff4a871ac33,168,138,30,Europe,24,967.89
e47b48b287604d1fbf9d403b6d8884d7,327,291,36,South America,25,1894.95
e47f7a4c119246009aa9d7f9073b7120,117,66,51,North America,21,756.1
e480a52153d3484d81f161c1589f0e79,362,360,2,Oceania,20,2508.34
e4821b9e57cd4c26b20bfb62dfda4d52,325,283,42,Asia,18,1183.92
e4821f457f6a465c85aff0b5832745cc,339,305,34,Europe,17,2096.85
e48268ec6fb64bcaa28d46e2be4d3f52,302,262,40,North America,18,2534.79
e482962e32e54e6ab4dabf7ef8aa061b,52,13,39,Europe,18,303.56
e4852586cb6b4e19a44b74d82d551f42,203,188,15,Oceania,26,1593.2
e485392451a44f35833bb31db3f65e5a,361,339,22,Africa,19,2036.39
e485996008e14b8ab6ea8f818d8298d1,119,99,20,South America,24,1096.27
e4868b7e883d4f1294dfa2dc5e949251,242,190,52,Asia,19,1181.47
e4877499ddb74658a633bd0679051335,195,167,28,Africa,20,1999.55
e4877fcb756049daaf1c0f56058356a4,277,221,56,South America,21,1278.49
e48853e496ea4f3881753562261a80ea,143,101,42,Africa,21,1431.07
e48874ad20e746b58a7d2b61147e1b64,207,173,34,Asia,22,1585.06
e48899c72d4c4acf9e0821412d91fc09,201,159,42,Oceania,24,1353.13
e48971067568478690e741f4bc094599,168,143,25,Oceania,22,1051.63
e48987751f3c43369e414894ccec4afa,118,84,34,Africa,21,943.36
e48a80fcff8d463ba316582f9cdce779,209,176,33,Europe,22,1496.07
e48e97d1f2334bc0902af6465f46d416,365,336,29,Oceania,18,1619.62
e48f4c47d708411a8dd5af4a55b5c60b,303,252,51,South America,14,2602.98
e491eaed31b14a40a9816aa82acfd4ed,266,216,50,Oceania,21,1569.52
e49246e566cc4090a60379b0f3a65966,87,61,26,Europe,19,748.39
e49770a49c2e43a1a26d48cd18e266e3,306,288,18,North America,21,2221.68
e49bba12958943fa830af2dea465b909,111,75,36,Europe,19,833.16
e49dfc22f4494fcfabe753ea4c7a2fa5,122,82,40,Europe,13,773.17
e49dfec660f24fc7abc2fbe13beea34b,365,328,37,Oceania,20,2965.2
e49fa65df6ca4454b361dc6db0404430,188,135,53,Oceania,21,1113.26
e49ff8d5023447388ab670828ee15fcf,104,65,39,Oceania,21,545.06
e4a25b77a9474c34b5ee6c0d4f5a8bbd,190,137,53,Europe,19,1428.42
e4a27855d8cc4895a80e4b1f7a5a5f7d,223,177,46,Africa,19,1054.05
e4a64c9f7b0f4597b3ef7ac042926716,310,285,25,Africa,19,2020.78
e4a92cb3fbe34c66b1fdd20cc9ce793d,365,348,17,South America,16,2752.75
e4aa1896956f44088435ccc7edae2dcc,38,14,24,North America,17,185.76
e4ac0902608342068a7036d3e9424c0d,201,149,52,Asia,20,814.81
e4ade5d21c4348188c872db0863ccbb1,269,215,54,Europe,20,1848.06
e4af06d9af2a46a097e4b6a9fb0d4d99,354,299,55,Oceania,17,2010.83
e4af9f5075d041329d07fa250f87896f,351,330,21,North America,20,2876.23
e4afc53c8b8d4be7946915eeb095d62a,46,11,35,South America,21,283.14
e4b040ff15bd4c3ea33d3b28676f0bac,114,89,25,Europe,18,658.04
e4b24b1f0b0e438d9eebc232f49b1a3f,52,3,49,Africa,16,152.04
e4b25fa71e2f4003b72ec11744b24aaa,322,285,37,Africa,20,1618.81
e4b2e001c3be47e9adf410df9d4efce1,267,240,27,Oceania,19,2684.55
e4b41848de2b44cc9053519931dea2da,363,334,29,Europe,18,2795.13
e4b65282ab5840148402c7e55c5a4aae,39,17,22,South America,19,181.51
e4b7af0be8664f7ca54c38ccaf988ce7,78,49,29,Asia,24,295.99
e4ba732d623d439cb2a0c06df69c4df4,121,103,18,South America,21,1064.13
e4bdfc91e75044edb9f5ad84e8f047b1,81,38,43,Africa,16,217.74
e4c00c81dccf4a309fdb4c060bb31e15,229,181,48,Oceania,18,1278.87
e4c3759437fd4fd9a57a7f548b3753be,258,216,42,North America,28,2147.09
e4c87304c98844f394e1e11100095145,115,92,23,North America,28,1134.31
e4c8c0b0fbd54c67a0405067a374f824,365,324,41,South America,25,1900.81
e4ceccaee2504279b6f07ce22b8020ea,258,234,24,Africa,19,1467.22
e4cf63d9706542cba974d574fef4f6f0,210,166,44,North America,21,1456.89
e4cff4a924c44a89bbe4902ed8787837,265,237,28,Asia,18,2351.7
e4d01bcf243a4a3aafcaa718b8aa3e73,165,137,28,Europe,22,1295.7
e4d162756c6a466b86c90ed92e7116bd,224,169,55,Asia,20,1458.32
e4d16d4dae604dc7a768010604a7a433,154,132,22,North America,20,988.91
e4d218708b9b421db1a9a2409ab70354,365,359,6,Europe,22,1536.44
e4d47e23c74946bfb8007f02b5f82265,274,242,32,Asia,21,1947.99
e4d6175ca5864edba14ff6af7438aa34,201,153,48,Africa,18,1371.66
e4d78cf96e6c46318c600df5ca376eff,80,63,17,North America,17,332.96
e4d799f770454b14a07b1c3af0d1637e,277,239,38,Oceania,16,2009.85
e4d80116880542af840fe0375f5f0162,79,47,32,South America,18,401.21
e4d90f8dc02247008b8f07bb88f6f15d,109,67,42,South America,20,273.12
e4d913bac51b457098dfeb2b1e7d5685,318,295,23,Europe,21,2702.18
e4d9a223f29c4b77b6742d99a406cec2,309,280,29,Africa,14,1987.52
e4db57580f654ce895a0bdf79c771e2d,364,320,44,Africa,20,1771.86
e4db78ae96794f10a0deced00486f2e5,365,328,37,North America,19,2443.74
e4dbda269f604b52b7ff0779b3c584dd,262,236,26,South America,17,2215.87
e4dde357134c4ee393bd6ed42cb2af78,150,108,42,Europe,18,1429.06
e4dfae59f6944538831cac577562232a,317,299,18,Europe,22,2338.15
e4e15a7cf33545ee83b1c356d7052553,208,161,47,North America,17,653.65
e4e35efca91044bfbb4f7f2319386930,225,168,57,Europe,20,1314.58
e4e38ce864b74d5b87b185113a1593e9,343,294,49,Europe,23,1825.04
e4e3938e50704f55a44372185beac619,351,302,49,Oceania,10,1894.08
e4e5923527604d878baec5856cf63c84,99,59,40,Asia,19,552.82
e4e5e7150aa6454c9bcdf30add6b0ac1,103,82,21,Asia,18,336.83
e4e69d3d8a9e4190bde0b6bf191d7716,242,189,53,Oceania,20,1433.31
e4e786f0186f4939ac0483fe37434da3,365,337,28,Oceania,23,3020.53
e4e9a63a65c8406f977a071d678bdcf8,274,227,47,North America,14,1179.5
e4eaf433dad8439599535fb7c7894dda,174,143,31,Oceania,28,1398.93
e4eafcaa32694381a6b92b8dc76fa3ad,107,84,23,Asia,17,792.76
e4ecaabe70af4e5793a53f474f754682,85,61,24,Europe,22,618.48
e4eed612b44e4ac1bcd6a62459f0cf16,206,156,50,North America,23,909.94
e4eedc68f404470faa9e347e65312061,118,68,50,North America,20,553.21
e4ef445c4e5c47f799c676d2ec79cdec,87,58,29,Asia,14,1160.37
e4f0bfec56c04f25895f0bf143983bb7,265,211,54,Africa,18,1253.71
e4f0e0d81e744c008764c89855891c40,365,339,26,Africa,24,2595.17
e4f1d61f78a743549aa8f38e15a1e0e7,271,224,47,North America,20,1488.1
e4f3c5062b094a90bc425dc43e9ec028,294,252,42,Oceania,21,1822.7
e4f4fb99b202432b97c8a5275121b52f,193,154,39,Africa,26,1453.54
e4f69e72fd224d39a186ba3bc7b79466,335,296,39,Asia,23,2661.8
e4f750c91cf54cdd834a3eda8836b3ce,159,107,52,Africa,21,613.2
e4f819d5ee6e4db9b19e087309b1a29f,332,304,28,South America,20,2547.43
e501b6b7f83346d4b2ce29117cf11358,364,327,37,North America,24,2034.29
e5022a98d55e4ab7b238d6906cd64b9d,364,340,24,Asia,15,2877.16
e502edf452c24a1cbbd7ce04a661dedc,193,137,56,Africa,24,1148.52
e503913c42234358a63c2425c2c299d0,353,328,25,Africa,21,2684.24
e504eb0d0d6a41c6a1ca1ffa203052bf,155,142,13,Europe,18,789.13
e50682771aa24d67a621a0fa386c961a,171,111,60,North America,19,817.76
e50808a30238499bb79af06ec746d4b7,145,114,31,North America,18,1170.28
e5082164eff342fc9dafcd80ca1dfc11,265,206,59,Asia,19,1703.02
e5089efb84c94b119493e677d0ff0243,142,107,35,South America,19,702.17
e50b5a820c13423fa560e7cf6ee6dbef,118,96,22,Africa,23,563.71
e50bc71392074c22a8711c5aad45535d,143,91,52,Europe,17,579.6
e50c5eb250034450b9504481f0e60af7,239,211,28,South America,19,2099.39
e50d3f194abb42bf8568f77c1c03d92f,145,91,54,North America,22,990.11
e50ef527c0ec4fada2e36ad23a5357c0,315,273,42,Asia,22,1548.87
e5134f49c76b47728a923817c6ba4232,360,308,52,Oceania,21,1537.75
e5146c647dc349d189e4220f7e609a24,218,165,53,Oceania,14,1148.67
e5152985929f45a195c2803db98d7c69,198,167,31,Asia,19,1312.09
e51b04ac7ce043afb7b16539a4c80372,106,60,46,South America,16,1145.55
e51b622a64bf4af0befb020110ba1ac1,190,175,15,Asia,20,1250.21
e51f8a1028414dadae1a3b66c67efe40,270,241,29,North America,19,2482.21
e5205fd69a0444bcbfd262baa85e232a,342,304,38,South America,14,2435.62
e5209aa7cfaa4be285ca3956896eca5c,363,347,16,North America,20,3042.43
e5215d8e8549452887ae33957e62896f,244,218,26,Europe,21,1924.95
e52275e829234d3da7f5d56a35be19fa,118,103,15,Asia,18,920.17
e522b61388004ad2adb04aa0ddc9d933,303,269,34,Oceania,18,1862.55
e52586a1be6c469eac2107ae4a2add22,287,234,53,Africa,22,866.42
e526c1660bde499994691a8085cd3551,353,304,49,Europe,20,1668.49
e5278e4138144a6c927316daebc481b9,169,143,26,South America,22,685.8
e527ca1ee7e24aa3a11fed6bfec15d25,363,349,14,South America,24,2573.85
e5298b92a17a40ad9075ace8ee746846,329,291,38,Oceania,23,3001.45
e529e302ae52441f84178b0538a7bc7e,258,242,16,Asia,19,2006.74
e529e43a5b8a4259bae8c0b943b6eefa,101,70,31,South America,17,659.88
e52b4b912fbd4f2287d6bddd1f469bc4,81,52,29,South America,24,1039.17
e52c26867d0c421686ec5785af55c202,158,121,37,Asia,21,1167.58
e52c9de01e764f53a53c9f71fd6b8389,352,306,46,South America,19,1874.87
e5300021b1644287929ec9c8931934b9,149,114,35,Asia,22,1116.59
e53111bd4a7b4405bae73313a9639e4c,51,3,48,Oceania,25,311.26
e5317aac803147369e0ae9f4e7cbc257,360,339,21,Oceania,18,2941.09
e53600d17d9c49ed839c3d91f3ca76cf,69,20,49,Oceania,21,351.67
e5363931597349bf9de57082c81d46de,365,343,22,Africa,24,2824.89
e536bc654b424cee9a4e587d508d260d,194,168,26,South America,18,1627.23
e536ee0f10474f28a6562d06655aba26,230,211,19,North America,17,1795.56
e5388f644e3745d7b94ecff57f77202a,137,83,54,Africa,20,758.64
e539709a40c44a55b90f2aeed34194eb,357,307,50,Oceania,18,2087.66
e53a3aca7f2a4266b1c7214368147c09,365,357,8,Asia,20,1509.03
e53b9c214a83416788c8499ed04dc1ea,69,43,26,Oceania,18,645.68
e53c9e3af6284c22b532452101442178,131,86,45,Oceania,21,718.43
e53e28d10e1a4e9da0d4f98e3697fb75,221,168,53,South America,16,1020.64
e53f4610b4184fdfa30fbe9fa519c2ee,46,21,25,Oceania,20,146.39
e5407edbc03a4f36b39e11a586a5a49f,354,320,34,Europe,14,2552.93
e540a30fa5494324b04075897d92142c,216,161,55,Africa,20,1474.24
e54100af2e6b46abb1b281fede03d4bf,362,331,31,South America,18,3345.44
e54a51deb36e4ae1b1bda83f63ee389c,338,320,18,Asia,23,2060.25
e54b654450314481afa330a732cfe54d,155,124,31,Oceania,15,1332.46
e54c4c6e288741b28ff0c3a6f7a87d5f,138,88,50,Asia,23,596.34
e54c85390f2a4ec28c55e6832f298f36,137,92,45,Oceania,20,815.25
e54d4b604f874bae9860394d894ab129,154,132,22,North America,18,1345.99
e54e08e4398a4b0d9b4b5b3ac094b4d6,292,241,51,Europe,19,1502.11
e550a0992e3e4043acb62a8361449567,188,152,36,Oceania,14,1155.74
e550d95c39e74bc39793bf067b1ef43b,216,176,40,Africa,21,1337.77
e55261ef00f04cf0afb6d18e1c1c0f4e,238,213,25,Europe,20,1916.93
e5543a7b2f1e4816af8d928a65868a50,188,174,14,Europe,22,1599.16
e5578039c9164874ae792e85bd6fc5a1,234,180,54,Europe,22,1383.13
e559128603fa402ba00411803eca8b3a,364,325,39,North America,22,1701.57
e55ae8e95d52478b81f458b844ef9901,341,317,24,North America,18,2727.22
e55ef291c8b246c9aae59a6b4f6a1faf,231,191,40,South America,18,1236.25
e56274062584484b89f9b8b6145b1a45,198,172,26,Oceania,14,1665.02
e562b16219c24ce39ca5b7461ce9e66c,323,302,21,Asia,22,2002.64
e565c2817aa14234976a35c9e0b46ecb,223,168,55,Asia,18,593.58
e5666be7a20d46e688fd679d1e3ef3e4,52,12,40,Africa,22,691.75
e56a8113eb4d4dc383b85376f8ca954a,117,76,41,North America,21,598.65
e56e285493b54ef2aff575bfa2320c3b,354,337,17,North America,12,2413.24
e56f9488c141481b93a6462d89284867,247,193,54,Oceania,18,949.96
e570411232184883a7526b4bacd88bd2,365,342,23,Asia,19,2689.48
e57390307b424b109100b0ce049d210e,268,217,51,Africa,21,1257.41
e574d05f09a24881bc300addf3d7107b,302,252,50,Asia,20,1192.5
e575dee6e9e1427fb942caf228b2e39f,281,219,62,North America,18,1306.21
e5776d73b6b94e9f87ec53af964a7766,364,337,27,Europe,17,2390.12
e577f4bbe1904270b2ff8fdadab0f3e9,227,174,53,Africa,23,1460.62
e5789e6b7b934cd2b896ccda41057a3f,289,227,62,Africa,18,1931.51
e579378765b84b0db20d1de727464381,183,150,33,Oceania,26,1343.59
e57b5d100a0a46d7b024b602c9890f16,347,301,46,Africa,20,1543.81
e57e6a75e55c497fb1abc35763b853f0,111,85,26,Asia,20,611.54
e57f653d954440d6adbfd23074f9d1ee,249,194,55,Africa,23,1195.39
e57f81f54b124205ba5febb489b0cfd1,322,296,26,Asia,23,2867.73
e580db664dcc42fe897aa60bc8f70f57,241,214,27,Asia,16,1941.71
e5823bf41f2b41e9ad4dfaeca3b1b989,48,28,20,South America,22,541.87
e5823c95e7904ecc9c901b94ff764c30,86,55,31,South America,17,777.23
e58249e58ab24d6fb0f9ea862271b176,365,330,35,Asia,17,2946.62
e5842707657e449f851db468ed876dd9,63,16,47,Europe,24,144.57
e584e353a15f4bb28b46e0c8239a41b8,108,64,44,Europe,21,543.79
e585beae1ddd48f6b53e4bac7372f9d1,270,231,39,South America,19,2474.61
e58835936f3b4e1c94ffd087fdde7eba,145,118,27,Europe,17,1232.6
e5887a9e98f34f1490b4abe0f394c7cc,73,15,58,Europe,18,510.34
e5895580df3747a0b22f2dbe91fdbe6c,153,109,44,Africa,21,711.37
e58bc64cebaa424f90b3ab1205bb8e2c,357,327,30,Europe,11,3120.81
e58daf5bffc14ea58d262bc3d05ec925,178,136,42,South America,19,537.99
e58dfa30c5bb4ee7a0a35ed30cc7e183,39,1,38,Asia,18,25.34
e590c1a076764082b82586576597d9d8,353,315,38,Asia,23,2307.18
e5919941c05145158656ba5c7c1a3cd4,281,232,49,South America,19,1784.41
e591aa35cb3f48b2b451c28d98a27c9c,166,133,33,North America,20,1289.45
e5926d645ef2433daa6556ca7ea4ea9b,351,300,51,Europe,19,2045.62
e59457f150344a9ca487cbe326db9e31,45,26,19,Europe,20,342.43
e5951956e7064c0882b6989518d5b73e,146,120,26,Africa,24,1135.12
e597eb864f634e0f9677bf50c106e435,303,276,27,Asia,22,2927.48
e59a86eaebc149cb847ae061abae3d37,362,326,36,Oceania,18,2245.29
e59c8bf20a36481493988a950527eb5d,46,17,29,South America,19,558.24
e59cbae6c1a2442a8204798988b4a0df,76,37,39,Europe,20,492.93
e59d7b4b80f64afea5fcf9cf288ebe6c,179,146,33,Asia,20,1282.45
e5a0ab49cf35402495863ac4719d187d,205,150,55,South America,22,820.14
e5a26fc7c7c54472a8f250db8c474dd5,198,141,57,North America,20,1632.2
e5a28a0c15874cf980077ab0f7ba342c,99,59,40,Europe,19,588.1
e5a2dbd746b9415dbcf5f3cbdcaa9d47,296,261,35,Africa,21,2760.03
e5a35053788f42d88ad31244656fe1f4,258,200,58,Africa,23,1771.3
e5a55505de48423f8e27494312658d9b,151,117,34,Europe,20,1032.61
e5a56e732be44b78855955f1976879f4,327,294,33,North America,19,2398.11
e5a5ee3e98824d77bbbe4159b3995181,86,53,33,Europe,13,403.07
e5a818c7f301461d9a82ea6d0bfb7b60,267,228,39,Asia,16,1319.66
e5ac8980ea4f475b80385d063986686f,104,55,49,Asia,22,367.79
e5b328e7912845f1b2167147b0239c2b,364,323,41,South America,19,1517.65
e5b511772a0647199ac8823b9488906d,47,7,40,Asia,22,199.2
e5b626bc6ced41f18924a6db018ecb89,305,256,49,South America,21,1728.57
e5bb6b61f5114265bbc9257446397148,191,168,23,South America,21,1061.67
e5bbb530a9df483d96705917cb0d83bd,362,348,14,Africa,24,1653.44
e5c0443f3630446d9e80897d0086b249,365,326,39,South America,13,1934.88
e5c047efaf41429f966b16bc0ebc27e0,260,224,36,North America,14,2499.62
e5c07cdbbef443f7a54a6659647ad7a5,153,113,40,Africa,20,624.97
e5c69bb4d4f14c029e08f54157a47b2f,211,182,29,South America,16,1630.21
e5c903c6eb07417eacfa99356c732af6,155,121,34,North America,23,1190.15
e5c98934d15b4fa885a5ebc09a00bbc0,164,113,51,Asia,22,1099.34
e5cb0d67d3094e21895f5fead7fa3baf,80,39,41,Asia,20,853.71
e5cd2800790b40f1bc625d5d0f365425,338,312,26,North America,20,2562.3
e5cff86dfdc44a15adf1eb4e5dc5528b,221,181,40,South America,20,741.55
e5d0f243fe8b48398f5f26f2f65268a0,276,225,51,Africa,15,1474.5
e5d1466915cb4a969bb3fa8ac6b462b2,187,150,37,South America,22,990.85
e5d14b00ac124284b80006395815deeb,260,211,49,North America,22,1399.42
e5d300e1278d4aab8a218cd2bf42c546,95,68,27,North America,25,632.11
e5d6870ee6194c7e87021fa0ab8f611d,90,37,53,Europe,24,657.47
e5d7590bafd94c43ba2da227f9778f81,156,112,44,Oceania,21,1029.3
e5d8ef683cd642a9a53dd640893b016e,201,178,23,South America,23,1439.35
e5d9673408fa405a9f7019124061a2ea,313,286,27,North America,21,2484.82
e5da4e2b9ffc4511862a7378d95738d9,179,158,21,Europe,21,1992.15
e5da918e732b4df48b4604edf5d4c180,283,259,24,Oceania,19,1592.12
e5db49c50eb343c48225cac1a71b43c4,130,91,39,Oceania,18,366.2
e5df13964e244d3da2621338981307cd,263,224,39,Africa,16,2253.11
e5e2140abb5947b48448225d958e3f2c,40,11,29,Oceania,19,562.08
e5e2a99915ce4cfe8cf3da043a2335db,33,7,26,North America,18,433.91
e5e2c565d9514489a62d6700e4fbc62f,105,65,40,Europe,24,477.16
e5e2c7c5da3b462694ef8347550c91b6,210,163,47,Europe,15,1369.68
e5e85248a58c4511a14904a30a2d08ea,330,278,52,Oceania,18,1468.42
e5e86d897b2e4f569003bb16a95a0ee1,195,149,46,Asia,25,1266.07
e5e8cdd26ee146d6aaed13910f7d3865,165,141,24,Oceania,19,938.04
e5ea1d3a472e4223b5e63c296a44215c,283,256,27,South America,18,1815.08
e5eac973c90f42388947a439e47e728f,332,304,28,Asia,21,1698.34
e5ebe276c9534783a70397e58d78b3c7,94,41,53,Africa,24,500.2
e5ec1785114743469d0328fc2f287395,62,8,54,Africa,16,44.02
e5eea55cee194f5e8c74bc44a2fec925,180,131,49,South America,21,632.39
e5ef33325afb4cca86d95559fdd21cc7,201,179,22,Europe,12,1363.29
e5f1d14c8c7c4d7da2610d0834f45ffb,85,51,34,South America,24,790.81
e5f44c80868e4d3f84cfefafb6f61c0d,64,44,20,Europe,28,455.58
e5f6e9596bf544e6afd73477ce4a577a,277,244,33,South America,23,1828.7
e5f78e288fec418f801071b2fc7270d3,301,270,31,South America,20,2393.24
e5f95676cb924472bea2cf2432a6d278,266,239,27,Africa,20,1837.04
e5fb8de03eb844bab96e2675ec393d82,226,208,18,Africa,23,1517.39
e5fc74b78588435d9a68a7a5462dc471,336,301,35,Africa,21,1892.51
e5fcd39d3a7f44ac903d51126a2500d4,161,123,38,South America,21,765.95
e5ff1a466d7b4d20a1e92307e61bb98f,46,1,45,Africa,23,284.51
e5ff4e5d25384ad286c23c799406e0a3,316,276,40,North America,21,1977.37
e602af9d682341a29815dfea66e2e6cc,349,307,42,Oceania,18,1696.98
e6043d28370847ad825c5696666f758a,338,282,56,Oceania,19,1657.43
e604c3271cff4da6b0189b87274bf849,109,81,28,Europe,18,1161.47
e608047814724d199e59c2bf5dc1a9f8,365,323,42,North America,19,2035.79
e6082a7217e14f1e831a4e586965611a,230,198,32,South America,22,1810.74
e609e38813b844348b2d1467bf73e6e2,82,51,31,South America,22,600.1
e60abc4ed93f4e81aa0900922217b6c0,248,212,36,Europe,24,1317.11
e60d6a7ad55e4f54a6f58a1f2b9eea85,341,299,42,Europe,17,1542.89
e60e66d282934ae5b1186cea32937ebf,155,126,29,North America,18,757.04
e60f74aaac74469e80b5a88d9aaccef5,202,150,52,Europe,23,754.14
e60f9092667c4a04ad8c2eec0d82eb8c,363,313,50,North America,18,2024.89
e6104f947a804886bfccea1b43c64cbc,240,189,51,South America,23,1557.67
e610c3c9c6d545bb95d4653930b1fd85,106,63,43,Africa,21,708.09
e610d328eaac4c0fafcdf9a1b41ae9a5,345,321,24,Europe,22,2946.9
e61136b4c3a34e8a97ac765fe7dbcf0a,150,94,56,Europe,16,658.19
e612b07de88847529c2fd09ee875d5ea,300,253,47,South America,23,1807.73
e613686685804459b4d59271cd3085b4,316,287,29,Asia,21,2383.54
e614fa1aea27489eb047f6330f67f0f0,183,148,35,Africa,17,1392.98
e6170b4bf6ea4a61b97a4d9baa74fe97,263,228,35,Africa,19,1360.7
e6182bab0279407d99affc5c56d9eb4b,165,150,15,Africa,16,2126.49
e6195ed4a0c543c79f59942007d25101,246,213,33,Asia,19,1773.31
e61b6b57d3bb4580b5e3fce2ab43aba3,201,164,37,South America,13,1319.27
e61b79f8e4d2499ca86da4374e55adf8,354,317,37,South America,23,2526.58
e61cb444dcb649bfbcd61023a8dc315c,35,1,34,Oceania,21,215.95
e61ce33b9be54d98bf62a66c152b6029,145,103,42,Africa,22,1021.29
e61cefbd2ba740dda75352139b3500a7,216,201,15,Europe,20,1501.13
e61e3e3f4e104978a811541e9006dd3a,186,156,30,Asia,22,1232.74
e61ea635c7aa420ab91891e27087260d,287,237,50,Oceania,22,1124.98
e61efab1f9ab4ad1bc2e09892177eda2,184,142,42,Asia,23,1319.3
e620cd4bffa54a8bb0ca2e28ce61d2a7,365,350,15,North America,18,2870.7
e620ede77add4e89a7ee72e2462d7352,51,22,29,South America,21,313.07
e6227e9b3d1a49098e7b02083d88cc5c,356,306,50,Oceania,21,1426.46
e62704793d404ad69acd934dd1129e39,174,120,54,Asia,15,980.31
e6295aa8eab24be3a662caedefc751b0,358,311,47,North America,22,3221.37
e62bb21228904e09ba29d0425b829d9f,29,11,18,North America,22,332.8
e62c7726757348659dd70a37c02928de,39,6,33,Africa,21,353.74
e62cd28ec80b49d987d554aad57da45a,332,283,49,Africa,17,1394.7
e62fd59cf1ed4ff6912c622ab8ae621a,49,9,40,South America,20,317.08
e6307022fb44451488f7a511ea5efa4b,365,338,27,North America,21,2496.85
e63147a7d5514b46ae6e065b1baf45fb,51,31,20,Asia,16,146.55
e632d6efcd024ddfb13052e92aa999fa,365,354,11,Oceania,21,2674.03
e6361645939848c39d5c2d782b10260b,87,46,41,South America,23,944.75
e6362ddb4f8845e498525b4e626dd19e,222,169,53,Africa,21,1561.75
e639348d55ec4297b335c0fb63723418,104,73,31,South America,15,1383.95
e63b22aaf48e466b812198ddc73c071c,139,87,52,Africa,21,606.57
e63c15b8794b4b33b8d8e2d40e3d239b,192,146,46,Europe,22,962.79
e63ca4b0800c4fd19667e88f0c8dd0ac,363,363,0,Oceania,20,1673.42
e63eb680b21d4c13b97a6c0547215924,163,131,32,Asia,20,1379.05
e63f1aae591442d5b97d947b03f7f212,353,325,28,Africa,19,2549.39
e641d8fe98eb401eb679223051afcb44,225,187,38,South America,21,1210.7
e643aff36e5c407c9ea2b2cc0ba4cd78,363,335,28,Europe,22,1952.68
e643b185c2664d8b99fc76584f147d8d,77,45,32,Europe,16,578.48
e6440741ecd943c58e07493353a065fa,60,17,43,South America,25,396.77
e6471d6f4e564acdaa6e9980456d9b42,199,166,33,Europe,16,1504.56
e647a8bd76d24f8f8edc432d3bebc938,363,327,36,Africa,20,2965.19
e649ceef44ef4c43b5d6d4fe7bf5d894,98,62,36,North America,21,572.81
e64b77c421df4af2934d144f832ac3d8,231,183,48,Oceania,16,1154.26
e64d28cc22e0405194823f6273ac0e96,364,324,40,Asia,20,2442.64
e64f2c2c0f7a4537aa3837d76f7482d2,363,351,12,Oceania,21,2583.96
e65004c15a2b46909486717c0b1fdc41,179,145,34,North America,22,2029.53
e6510c478c3f4c9eb0a126088138d01d,196,161,35,Asia,18,1303.34
e6541e0b01f5454683d54bf9f32d3414,67,37,30,Europe,22,470.73
e65664ee10684f68bcfce113e9fea7b1,364,352,12,Asia,19,1745.59
e657d05feec34caebc61b005e8dc4aa8,147,112,35,Europe,15,672.88
e658e615835d4a4ba33c9c5c2265a062,96,68,28,Asia,17,782.81
e65f97d6117b469e866cc8b166b73776,365,336,29,North America,22,2774.42
e660992ff7fb472d97d6704f748970ec,78,27,51,South America,24,286.37
e661438f59f247c2986eebbd02edbd90,145,119,26,Europe,19,1197.88
e66246cd19e24986b578c47384457bb8,316,267,49,North America,24,937.36
e662fe79b72b412ab378bf5a77b3b71f,134,86,48,South America,14,837.2
e66316c1c5a34354ab4eeccc27908012,130,89,41,North America,21,336.14
e664aae9d89e44369d2815b13ef1cde7,124,78,46,Africa,22,334
e6668a13d58644099b21024278812034,365,352,13,North America,21,2618.89
e6670ab9a2734da4957560f1f0a613b1,277,232,45,Asia,24,1494.64
e66a68d304b140ba9c1952adc874df88,364,330,34,South America,21,2679.52
e66afe7f0d0f4874afae3124b4add413,78,23,55,North America,21,612.4
e66bc3d415184933a8b40a5cbf9db9eb,111,83,28,Asia,14,529.51
e66c6325196c4708a35915da3a0e7e8f,231,182,49,Africa,21,1026.27
e66f40855f5042c394f8220c11363e19,143,90,53,Oceania,18,713.05
e66fc66c0c4c499da49fc5c9602dd0ef,272,241,31,Oceania,22,1944.1
e671eeda674a40efb4752c00a88d0d8a,215,160,55,Europe,18,1007.27
e67223455735495f9827fd2fec926366,279,249,30,Asia,18,2540.02
e6748f9f60a1484f8def926487dcf6d6,314,272,42,North America,18,1739.99
e6768db5e3ef448c99ca2d4f60a2513f,361,331,30,North America,22,2826.05
e678e9b09b6e46008c3bff879a7f174b,255,230,25,Africa,14,2103.61
e67977d8452247a1987aa97801f29a72,52,1,51,North America,20,77.64
e67ca62c572a4cdbae6895a407e41bba,239,194,45,Africa,19,1918.82
e67d2f22d15747478d64b24232f91bc9,291,237,54,Europe,21,1820.38
e67e3f5038fd44ddb00a4b48220a2322,365,328,37,Africa,19,1152.38
e67eb33e03214def8218f24215bf316d,350,332,18,Europe,18,2889.94
e67f1a2e8c8e428e860865009b53b3b0,271,231,40,Africa,18,1574.62
e67fcfb5831f473b9b7de80edf372dbc,258,220,38,Africa,19,1820.14
e681e8fb73ca450e9f37bd69a367de87,126,87,39,Africa,17,725.53
e68265b81d1b40c98b0f7952228791bc,80,61,19,North America,19,467.9
e682d830dffa4777b7a6d672fdd3091a,328,277,51,Oceania,18,1247.6
e683fc374f2f4acc8fd83773503f7a6c,322,275,47,Africa,22,1271.37
e68474e725e444de974da6fe04273288,97,49,48,Europe,22,248.61
e68651ad2348489c8e36a72c62b71b7c,214,162,52,Europe,17,1076.04
e68808b2385447c39681c17f814fd6a6,313,261,52,Asia,19,2028.53
e688b51989ad422793447d98ab892d09,349,331,18,Europe,22,2652.76
e689242a66324844b5f44f732d1f69dc,326,283,43,Africa,21,2169.58
e68b6488d85d4efb9bd16915c0e3acde,281,237,44,North America,27,1874.72
e68c5e61cad44df7a543f62c0ae4a0a8,122,84,38,Asia,13,867.51
e68f369d39fb4678bd8688a7716d2507,355,331,24,Asia,18,2699.92
e68f6202ffe64174a76031993f4dcfd3,125,96,29,Oceania,17,960.87
e68f969fabd44b6d89442e4729de0737,305,280,25,Africa,25,2081.97
e692d03a7c4a4f538c91e87d4cd61382,358,333,25,Oceania,21,3209.69
e6958e2652b342048bcba6bcc9b7462c,160,110,50,South America,19,844.68
e6963b0abb394426bc42bc432e5a04e2,350,300,50,Europe,25,1650.57
e696945a42df4f6abe8efa87a074f4b6,70,23,47,Oceania,18,460.79
e696c17f000040358344b07ee159c5f5,361,317,44,Europe,19,2684.52
e6982fc3a9424a858dfd2b89942a5c1b,78,50,28,Europe,19,249.38
e6986008b7a840dbbe7ba97c272d73ff,347,302,45,Asia,20,2594.1
e6991b13bd804d61818506b13f4a64b6,205,162,43,Africa,16,1395.12
e6992195c9414a7aa69e2d16661609ce,164,133,31,Africa,15,1071.86
e699d98e3852443f942b75e9305b7484,259,236,23,Europe,21,2280.19
e69a1929e00c4d78b3b849609d2bc8a7,269,224,45,North America,17,1275.72
e69a9b80b9c04ef7aa0cf6b55fcf2776,364,343,21,Africa,19,2237.31
e69c897b9c8d4906bc99ed3f0f0e1a71,128,110,18,Oceania,22,1546.53
e69d405a1f5d4d3198a2452aa60900b3,155,131,24,South America,16,1291.17
e69e35fd9f2f40d7b84f4632f4dac574,193,160,33,Oceania,20,1356.8
e69e5c44c0434a648e06b099095d3cde,365,343,22,South America,17,1812.78
e69e6694019f4102970c2abbf7029e7a,205,191,14,Europe,24,2035.76
e6a01a53905a4a70ac83195deb56da91,176,155,21,Asia,23,1510.04
e6a4b06e1cef4d5d8abbad3083333286,232,208,24,Europe,18,1705.57
e6a4b5809e2b43baafc63a9d0e1ebfc0,365,342,23,Africa,21,1848.96
e6a510c6abd1495ea52611135707b380,44,11,33,Oceania,17,293.05
e6a57037f1874c7dad6ca765e9fdc0d1,168,126,42,South America,19,1150.71
e6a57648a24e44919116f292bd8507d9,295,240,55,Africa,23,1417.4
e6a61a318bec4123a4e4cd366a06e2bc,358,313,45,Europe,16,2662.73
e6a6adb801a2467f9d9bd6968b1ee1b5,122,93,29,Oceania,14,1091.62
e6a6b0fc749d40c6b4dffac3d4cebbb8,269,235,34,Europe,21,2289.35
e6a6c7ef67ab430280a133efed86b479,363,347,16,South America,21,1979.67
e6a75e02237e4ba1a3ac4ba17864f8a3,313,274,39,North America,22,1993.25
e6a84520b52740e7aaab380403d19a65,115,100,15,North America,19,477.94
e6a8acdd3db64b34bdab2917c7508c19,363,336,27,North America,19,1758.66
e6a8d00e5b264d81ba4c340ec1afc450,218,180,38,Asia,21,1354.26
e6ac6f26542f4f8bb5122c39e92a17e2,248,211,37,Oceania,20,2352.67
e6ada6f2c5b04b2fb246684764615203,263,220,43,Asia,23,1597.12
e6ae7e07db8e4f0ea623e644bb421736,79,54,25,South America,17,456.11
e6af126f30664990a0cc9647a4704ef4,90,49,41,North America,21,657.28
e6af7e5021dc4eac8f8666291993f60d,103,64,39,South America,21,1216.05
e6b008a35aad43af8034f511098797ed,319,281,38,Asia,24,2690.85
e6b06a05d0394d09849b6a983b75edb1,341,312,29,North America,13,2147.59
e6b08d7b1d1a4fc3a38d4035322978fa,246,227,19,South America,24,2341.46
e6b0e7b327ea4124b00c6a5276d705c2,229,177,52,Oceania,20,1245.95
e6b39fff8f344193974958034bc35cb6,239,188,51,North America,17,1158.52
e6b45fd87a8845d0ab071934f8c7a7bc,335,312,23,North America,21,3035.37
e6b58813c0c64b68aa4023f062315696,109,69,40,Oceania,18,490.32
e6b5a5a58a86494fa3c1bb8b033d2eca,238,213,25,Africa,19,2179.72
e6ba4bc155274c108ede1ec704cab4f2,265,212,53,South America,20,1063.52
e6bbb3b4301940079327452f9eed8f35,365,342,23,Europe,18,2660.72
e6bc42ca4237423fb7bb1014691fdd8d,269,240,29,South America,20,2031.84
e6bd090da94148f6b8d00b89077ec4dd,155,126,29,Asia,16,1189.78
e6c2647e2b7c4004982ef1f2962b656d,137,88,49,Africa,23,575.04
e6c27436d5294545ae329dab79e44220,178,129,49,South America,14,896.73
e6c2b7d6e4704ea69e3ac81bedbe1889,99,68,31,Africa,18,810.14
e6c3eca014c9406da4d7d42201f77f6b,123,73,50,Europe,24,521.34
e6c4ca333edd4074838da32f92d853bb,283,237,46,North America,24,835.2
e6c55ef303634e099b20a6af553e3777,360,322,38,Oceania,14,2745.99
e6c5f0f46eae49b7a1bc2dcbee9c3f76,315,274,41,Europe,23,1817.41
e6c6afb3fb994389a94012cbd0836af2,335,297,38,North America,22,2497.8
e6c7c2a3b0dd46bfa6deb9b6e8379d7d,167,117,50,Europe,21,1074.88
e6c8540bc18847289bf6ae4d51cce96c,364,319,45,Asia,22,1590.09
e6c88c89bb784d4bbc51d07845292327,109,78,31,North America,16,924.23
e6c99d08ee52437faee2708fe85ddab9,263,230,33,North America,20,1861.64
e6ca833ec26d44039065bc89839ff6ce,201,184,17,South America,21,1699.18
e6d077e4fa2a421bbab3aa56ad5f4abf,100,72,28,Europe,20,911.6
e6d2174678484e9a830971e21e1d9d4b,365,326,39,Africa,18,1724.67
e6d2f289e69248e6acbd9344357918f5,60,22,38,North America,24,264.21
e6d3209e91a44888a1ff1c8873dec991,283,240,43,North America,17,1113.65
e6d39194db56479d93ed66b13b628113,313,275,38,Europe,19,2567.66
e6d395ac9723411faa8bfe51e5819e9e,357,333,24,Asia,18,2606.87
e6d3c24cfb2c4a2290b94794954006cd,358,332,26,Oceania,15,2621.58
e6d65af5364c4bbdb1ac677c18a48c5f,364,355,9,Europe,19,2673.26
e6d6af95e68242a589263769c5fa2ef7,160,131,29,Europe,26,1157.82
e6d771fc317f4b0e8f05763fc08ee2bb,131,99,32,Africa,19,547.1
e6daafbd16c04faa8f74047f979a4c12,84,47,37,Oceania,18,624.53
e6dad66777014e8794cdfabdea2ff027,226,175,51,North America,24,576.3
e6db50608a154ee3a5412b9a4432074d,254,215,39,Oceania,23,1478.38
e6de838cebf9453db4df419a76f8a9f0,139,110,29,Africa,20,898.14
e6de9aff1f5549f6a180c1d6e8775c2f,57,11,46,North America,25,375.59
e6e01fdb5162470eb44502ca8a874fad,365,355,10,Africa,18,2641.06
e6e1ed13690e43869c649572850f3f11,161,128,33,North America,15,1196.39
e6e5422a562441bf9e081e1bf4ca5047,281,233,48,South America,25,1565.99
e6ebaeaf341f4be09047801947b4baa5,116,66,50,Europe,19,491.21
e6ec5e62064d4644897c076f6264c5c6,331,289,42,Asia,23,1854.02
e6f0eb858e7244bd96d4d6b13c41b9b0,336,289,47,Africa,19,1209.55
e6f2b61742b545ee9420a453a613b0c5,41,16,25,Europe,21,278.91
e6f2b79d01d74b2e991e840f6a2b1881,234,199,35,Europe,21,1680.39
e6f3944d752b4096a753fccea2f11e37,246,192,54,Asia,21,1030.62
e6faccaf15be4742bc0e6be8cb08a071,365,323,42,Europe,15,1695.17
e6fba50a99304e2b9d435aa0b323b112,349,307,42,North America,21,1520.06
e6fe357b73574c1d857eea09f7b27e35,364,327,37,Europe,17,1842.43
e6fe69a6f1f84408938586da75be06c6,307,275,32,Oceania,15,2371.41
e70166f6d65744638adb31c7f2af2f78,237,216,21,Europe,20,1835.16
e7035b18479143e39abada10189ef43a,73,50,23,Africa,19,372.95
e70438dba8b445a69cc5ed791738e087,365,331,34,Asia,19,1522.76
e706049a35c6484393bd536f5db346ab,212,193,19,Africa,22,1360.08
e7065d0dba934b64a69f7de187171d76,34,10,24,North America,17,326.25
e707a780562b4be0ad04ac827df765ac,165,124,41,Africa,17,1133.74
e70a32fe1008466e8e91eaa925f8ca92,148,120,28,Asia,21,1209.42
e70b76fd6db6444da78a829008d89125,60,11,49,Asia,19,388.96
e70bbcd70b5f4cb29f5d2dee59192502,292,263,29,Oceania,17,2438.25
e70c3c71f18a4461be73c9134925cf20,141,100,41,Oceania,19,886.14
e70dc8dfd6ff48df81bc8f86cf8ae9a5,86,51,35,South America,18,586.73
e70e0245d7df46479acbaf508801a53d,247,202,45,Africa,20,1350.43
e70f6310fd90486c984c1c934a75d922,107,60,47,North America,21,622.5
e716c310dbba4867856cf07a284bb3d0,241,216,25,North America,20,1928.93
e718e31462ca4525b5e37e41233b5391,329,279,50,South America,15,1715.29
e71b02f68cfb44fa8c9ee6941105ca86,178,133,45,Asia,19,728.84
e71b9a4668e9486b96c07c54d05c5952,77,29,48,Oceania,20,421.71
e71baf9f3b1b4816969a1914e5a189f0,349,298,51,Asia,13,1571.98
e71d09c4515049f49da01709181e5bad,284,242,42,Europe,21,892.39
e7216239f2a6440095129322216fba5c,181,154,27,North America,22,1508.25
e721f06ed51442f6b7a257a66fac1eb1,186,139,47,North America,21,1505.61
e72471613ee549438087b4dd251bcd5a,319,268,51,Africa,23,1214.04
e726e0ae44284036b31d73c279f93205,212,173,39,South America,17,864.09
e727714fd1d24932b589cebd251d5128,318,283,35,North America,18,1940.73
e728ee8492c44586a4e9b666a1c964f5,269,230,39,South America,23,1515.71
e72aee2d655f4237b935b05be4f3a3ee,131,75,56,Africa,18,685.02
e72c727ad767498eafba189e2f87538c,206,185,21,North America,16,1495.64
e72d3a4065b24882b34e7f12414e5abd,242,191,51,South America,18,1301.86
e72eddd512c2415f9b13df52494e17d6,342,293,49,Oceania,16,1354.81
e730635d0ce04faf85937812f595529d,365,360,5,South America,18,2386.42
e73108e85c4b4d8b935db4bb711c0819,256,204,52,South America,17,1174.09
e732930c0f2b4130b775afd0038a71c7,243,193,50,Africa,23,615.71
e735b2ded5884770a4bc5a7346cb411b,335,298,37,Africa,19,1810.82
e737add80a824fa9be432c1c2329a500,196,149,47,North America,24,1278.97
e737e777eb4b485fb5a3aa7c6285f2dd,215,196,19,South America,16,1505.4
e738d58c3e82459195e749581dbf8b39,268,245,23,Europe,18,1818.3
e7398e0cbca7483a80259524909484ae,278,226,52,Africa,20,1598.97
e739bbcc366b44639a9067036ce186f6,288,255,33,Africa,17,1953.44
e739fbe89b454ba6af7cc0ae8041585f,316,278,38,Africa,22,1930.45
e73a9fbfb1904bb1ab4b8c5180c5d208,137,116,21,North America,19,796.33
e73b00f1c8ac4627b6bf9470124ab151,250,230,20,South America,19,1836.3
e73d092aeac447ac90defa67557b7933,267,243,24,Oceania,15,1263.36
e73eafd8b6da47569fe959d55d03e74b,156,121,35,Africa,19,1430.89
e7458069de5c42afa11a1949c1bf3715,321,280,41,Oceania,19,1875.69
e7460e53caf14ecb849287ec6e355cc1,97,66,31,North America,19,872.8
e74626f752674fe4b919cc39a648fabb,41,14,27,Africa,22,559.41
e748515bc0fd4fc08d45136783c85715,188,160,28,Africa,19,1248.92
e748765dbede49c7b0cc734472e0ccb7,26,2,24,North America,17,182.19
e74878386b10484fb247a3a61b6caf5c,280,232,48,Europe,16,1255.88
e74a6c7eb89642cdb0453a940591e580,162,135,27,Asia,23,1323.72
e74adbc66b704e279c218f22f9ce9e25,155,105,50,Asia,15,740.91
e74d2d2b72b5492aa49d03575a57e4fa,333,294,39,North America,19,2005.04
e75018cf3fda4678a89347b143d5c654,188,138,50,Oceania,16,1088.44
e7512cd5d9ee4be19e914fef7566e22f,226,182,44,Oceania,22,785.01
e751bea431bc404585ae031a2a612c17,103,66,37,Europe,24,568.76
e753271140d0466188e38808db531df3,301,274,27,Oceania,22,2025.01
e7545a019e684c259c6412bfbdb22a3a,254,213,41,North America,17,1349.13
e7558b83583f4bd5b72ee28fa6fb5f18,241,214,27,Africa,19,1944.36
e7570d55b158411195913777fe2f2aee,59,6,53,South America,22,280.47
e75a0b7f72db485c9d738762055bcd86,115,77,38,Oceania,20,528.33
e75c9dce2a394acfa89092c2cce2e664,98,48,50,Asia,20,511.2
e75deb8c204f4423802005897b888b8c,260,232,28,Europe,24,2044.9
e75f9e549812443f9cbbf3a78be84752,365,323,42,South America,24,1597.79
e75ff7598bdf4092b4c1745e2487fde7,134,94,40,Asia,22,750.6
e761bcce654f41c396ad862b83e968e5,362,358,4,Oceania,17,2447.67
e76208faf8a6426782cc670bfbdd79f8,106,50,56,Europe,24,657.36
e764a34cf2a94d4bb6e2c5190247a7db,134,81,53,North America,24,1182.53
e764ac573c7a4fe9838b116914d96eca,361,345,16,Africa,15,1381.93
e764b4c9497e453fae2451778965f2dc,320,269,51,Oceania,12,1738.23
e765267afd544be79c31de98ddb5d53c,193,168,25,Europe,18,1898.31
e76584a03916432395a397f2f476e9af,365,337,28,Europe,19,2681.62
e767052e560a488cba570fe66cb28f49,145,122,23,Asia,22,880.07
e767c782fa33433196adea860d8e0429,310,257,53,South America,21,1396.68
e7688b6fb7b64d6ea804dbea26b1b9eb,102,67,35,North America,17,815.36
e76b1d04ee494cddaafcaaaf67b6a9e1,45,17,28,Asia,17,306.98
e76b355d41d34c00851033c7428aafb3,345,307,38,Asia,21,2168.45
e76c134c9e534dfb89c29e8e057a8eed,201,164,37,Oceania,16,1148.24
e76c4ef5a00b4493be812a592e9cef44,104,79,25,Asia,20,600.12
e76d73d56f884600be5f4c22b8eab1e0,78,55,23,Asia,18,344.87
e76df534fb70473ebe241b5b73a18c75,127,70,57,Oceania,17,1238.86
e76e67ad488e4573bf7938a8044fedbd,333,314,19,North America,25,2548.66
e7708f384783490e9e303bb49d0a4c29,260,232,28,Oceania,14,2112.69
e77121a57efe4c2980c3afbd93beabad,316,275,41,Oceania,22,2844.75
e771cfa4d9fd4ba194a7e0040de46664,184,134,50,North America,25,879.81
e772cb272c004741bc1a9381af5292f8,180,161,19,North America,23,1189.76
e772d7c312b94ac69b8ed00c09b99e8d,365,364,1,South America,21,2390.64
e773307866f841b1a4a08fb68c88999a,80,33,47,Asia,22,376.09
e7764b6c79744010bd4a90ebdca4cdc3,105,76,29,Oceania,21,863.84
e778e7c3050d49acac30f6e8c16d9b67,206,166,40,Oceania,23,1677.95
e778f2b890be44289f47b0c6faa5265b,352,327,25,North America,19,3052.24
e7799e03019647dc8f8c99aec1164c04,273,232,41,Africa,19,2341.62
e77c2bf1b3624cfdbe12ebf23a570f8f,211,189,22,North America,26,1516.43
e77c803a66864cdd8058c78392054cfe,46,26,20,South America,23,450.49
e77dfe0262a4496fbfa6ea0d6ddac309,177,131,46,Europe,17,963.85
e77ef04bead649cfb50df35b46e6e63b,175,148,27,Africa,16,1141.97
e781168b7adc49559e57102ff92345d0,252,221,31,Europe,20,2167.2
e782032c988448d6a711b367c1c7570e,363,325,38,North America,23,2032.9
e786acc777cb4253a9356dab1960a5d8,189,142,47,North America,21,940.93
e787c6ba7f774fc1a390f89f105ae289,204,175,29,Asia,15,2101.45
e78895e48d5042e0b1bc319511f05f92,310,263,47,Asia,16,1603.77
e78b20d1ccfe459b8f4e7ef811bf3ec7,163,137,26,Oceania,20,1410.23
e78e96c0d9594b16ae9e98811ed13c35,166,144,22,Europe,19,1710.71
e790d28dd1884d1fb6495ea9d27d2c1a,290,234,56,North America,20,1440.91
e7929835ef674ff7924b3338ce0112ed,247,183,64,Europe,21,1149.65
e79481525f4643029466a6a248353073,354,325,29,North America,27,2610.38
e796319b375740edb63d4617225dc094,187,162,25,Europe,14,1410.63
e796c0bf1eee4630bf3bbe885fbed2bc,230,202,28,Asia,17,1746.2
e796d9c1bb5048ec88406cc3ddd956d9,306,270,36,Europe,22,1989.99
e7975a3b24594a889bd3dae2b1e2892d,85,62,23,Asia,23,753.97
e79833bad28440268da37f2d72197099,127,74,53,South America,15,686.21
e799224c65784028abc1082844d27ccc,149,104,45,Oceania,16,1043.4
e79da353a2a6410d864c5a3651e9ed2d,260,222,38,Asia,22,2078.6
e7a437d6d27d47fea6aba23ed7192b3c,348,309,39,Asia,18,2479.56
e7a4b4047bbf44a8876fc95b7a24e535,317,262,55,Africa,22,1298.94
e7a6534f37e4468780dfceb7058a9568,205,177,28,North America,20,1262.92
e7a6d35214434c79bc8b8b22b18d65f7,291,239,52,Africa,22,967.01
e7a87b2a88c340379beaed0cc152ed60,219,200,19,Oceania,14,2559.78
e7a9200d92ca4e33b609bb456d2fd445,245,209,36,Asia,20,1442.27
e7a9bf9599e746e3ba4d9be767696959,201,170,31,South America,17,1586.32
e7abb71cfde04f2c805df6f08bde78e4,347,323,24,Europe,23,2093.51
e7ac4d5f8bb94c05b825a52406b7af65,298,267,31,South America,19,1579.96
e7ad292c0b594b039cd76c5992af5ce3,272,249,23,South America,25,2613.66
e7adb5e7e5144e1cbefa86e233f63fa3,315,290,25,Europe,25,1703.29
e7aff8eaf25344a5b758a2f4a2e30d63,323,310,13,Asia,13,2138.3
e7b02e6888654ba89463923c22ab9721,355,355,0,Europe,17,2748.76
e7b0ba0adb3943f587146262aced22c2,229,191,38,South America,24,1710.83
e7b3733829e049899f2af3145ca3d0ce,115,78,37,South America,18,698.17
e7b5962a4ca9410e905f04ab045d52d1,268,226,42,Europe,19,1983.44
e7b834dcec054be191909f724f0f6da8,311,271,40,Asia,23,2427.51
e7b86ac3ff294bb68c419674dce6ffb2,276,249,27,Africa,16,1907.81
e7b912d0d64b44a39f4837f7457baecc,339,295,44,South America,15,2131.5
e7b9880915954a3d9b10ba5e09432dee,65,25,40,Oceania,17,736.2
e7b9b7df13834e47991af9260bfc710b,362,347,15,South America,18,2520.78
e7bb57cb7bd34c309b502b04595ccbbf,364,344,20,South America,24,2273.76
e7bbbbda2de64d888f4959f3c17f4009,258,212,46,Oceania,22,1507.11
e7bc688eb73b47cdb5c4accc988e72e6,204,158,46,South America,19,970.79
e7bf3ada86224cb6b7640232f16fa1d7,280,235,45,North America,16,1032.44
e7c6101bd4c94b00915e59cf4cfdc27a,313,256,57,Asia,19,1385.14
e7c9346726b64adf89ab103f1a3b8899,316,255,61,Oceania,17,1450.21
e7cc3cd607fa4b4fb125ca64235dcb37,321,283,38,Africa,23,2052.23
e7ce689275ea4b6aa64994969e3ba787,60,16,44,South America,20,232.74
e7cf46fdc4e640ecb25be1a792140a76,278,234,44,Africa,19,1521.82
e7cfc7f0c1be4fe6a08db8da6f5636c2,273,246,27,North America,22,2435.79
e7d191310be240ab854aabb1d519330b,300,269,31,North America,24,2084.97
e7d27710108c4891964ee04b5245e614,151,112,39,North America,20,1339.16
e7d29fc301a54fe78d1c7c8d80735172,158,113,45,Oceania,21,798.87
e7d4d961558a4db68358a367fe6098fc,86,36,50,Oceania,19,773.91
e7d573e2507243c4b1f56f64fcc34249,198,146,52,Asia,18,786.48
e7d62eed6bad4107a6a12fc52ab08b73,284,248,36,Asia,17,1818.48
e7d67de8b6d24e50aacc84d5d5cf74a3,269,245,24,Oceania,21,1957.74
e7d70283dc4d4a79b9bf80b7b533112c,171,142,29,South America,20,1546.15
e7da4b9ce66c4e03a5e8641c9d8a80c5,78,23,55,South America,19,557.41
e7dc51f877164676bc882e4e7f00ca38,126,78,48,Europe,24,510.26
e7e00b9d292d4c9dbb1c9297269c22fb,365,337,28,North America,18,1458.03
e7e5fba1f6894bdf8385ee9535ac946d,49,13,36,Oceania,23,243.51
e7e7c1a1944747e6ad3f6a4d8690837b,308,285,23,Asia,23,1651.27
e7eda2612ab74672ba1561bece20fa05,186,149,37,South America,21,908.28
e7ee1d95763d40e0b314d136a22a3799,331,301,30,South America,20,2224.57
e7ef418491854107a759a548c2d9d282,328,299,29,North America,18,2410
e7f098d32d4a4ab7bb3b2e7a35ebfe42,278,236,42,Oceania,19,1606.36
e7f39b1e8e6b43478b3465e261f5cafb,160,124,36,Africa,22,938.9
e7f8b06cef7546d79cac73541515eaf4,270,242,28,Africa,18,2379.35
e7fa0808191c4104b36dbb5e159f2bba,220,170,50,Europe,14,1117.05
e7fb65574c03449db68b2502146c7856,337,288,49,Oceania,18,1299.59
e7fd8bfd944b4a6d8e8e158635bbef6a,266,215,51,Europe,22,1052.06
e7fdba97dba742c59105fcb2d185a136,41,16,25,Oceania,19,446.34
e7fdd3c43b624bbab681cd70f65b6abc,365,321,44,Africa,18,1356.49
e7fe01ddcf5143c99c34bfad6f5e6cd2,160,129,31,Africa,21,1475.12
e805e8a261cd451e96cf60d6c77ea9fb,251,224,27,North America,17,2306.69
e8060ef356b441df9629653e504b5f4f,177,142,35,Asia,20,1185.23
e8077641ef304832bfb7ccb23490de3f,77,29,48,Oceania,22,226.48
e80997f46dd14498ba5b1e8010c6e03e,124,94,30,North America,13,1256.72
e809bde064f54944bcabbcd302b7973c,198,167,31,Europe,23,1670.4
e80dbe7436544045933e57a4ca8bcf7d,220,161,59,North America,18,919.58
e80efa70b1f646aba9761e97da96ecda,173,146,27,Europe,19,1057.95
e80fb6b77a844ed9b352d404dc7dd423,239,200,39,Asia,24,1613.78
e810a78b74ed40b980bb9cff00d0065b,351,318,33,Oceania,23,2800.43
e810bdfa4ce54634be1b4cb4fa8b590c,343,318,25,Oceania,18,3011.25
e811a256386b4b5cbd9aec30535819da,341,316,25,Asia,17,2657.83
e81345df740843238239e32332893618,329,292,37,South America,22,2454.79
e81397b6061141a7a64164dafc7f0b05,77,30,47,South America,22,485.66
e81913a15d524e668d232462d0051bad,161,118,43,South America,21,948.51
e81a59d5e2904ef9b3fc9b25bad79edb,240,190,50,Europe,15,1460.48
e81c1aeadae246c58f8ba4348e6a9e6b,49,29,20,Europe,21,350.44
e81d0398eb774346b7b5a48db5a73c0b,358,316,42,Africa,19,2724.44
e81eafa8942345019de343022384e737,158,106,52,Asia,24,1406.27
e82014ee111d4d64845ced3a8b80f9fb,47,18,29,Europe,15,212.62
e8208d4fcb8c4649b94a6129cbf34756,40,6,34,Asia,22,466.01
e820a487afb64a4598659bd551bc91c7,236,207,29,Oceania,18,1904.26
e82270dfbace4bc5b723a77080787489,98,60,38,Africa,19,572.29
e8247a8f9f6a4c748d1993302889ee1d,251,195,56,Europe,23,1359.69
e824b2ddb15042bca8ed6735e228b50f,262,219,43,Asia,19,1685.68
e82574c375324f3bbcad8caa35fcbf3c,60,9,51,Africa,23,124.95
e827871d359b47399110bc5114fea2e3,318,279,39,Europe,23,1497.43
e827cd12e8ee4c22b73e46cfe21ad611,210,158,52,Oceania,20,1134.71
e827ffc65dc34c56a1ed2df4c2b11e5c,144,124,20,Africa,22,1161.34
e8286deb32b74edd87fe02f0f7b2d563,196,173,23,Europe,20,1560.66
e829556dfa5248eabe4baf19a18b61b6,85,65,20,South America,17,429.91
e82b6f89ed3c408d936723373ebab5a1,97,51,46,Africa,19,367.77
e82c690c4aff4a8db0b0666de19532df,270,249,21,North America,14,2257.17
e82fc0f89da24d19ad92cc2121bfe866,84,52,32,Europe,22,617.34
e830b8f1b57f4188be8b03f0a0eb0d39,259,225,34,North America,17,1562.12
e83399459cdc4ac0a1e259541724e889,110,64,46,Africa,24,588.75
e8348cb429f2438e90e01d14a372addc,363,345,18,Africa,17,1853.75
e83896e401904b79aed775efa4c9ffca,220,175,45,Africa,21,1449
e8392422030f483d99e2389cf03fedcf,109,65,44,South America,20,305.58
e83927b2f6c34d22918bd04b78a0a1be,176,123,53,North America,17,880.39
e83a388459014950a7abba3cf7a66c72,48,35,13,South America,13,436.32
e83b02a091094989b22c3adb3c557634,111,88,23,South America,21,1114.27
e83c41e75e6e43e9a938c54f3ba423ba,92,71,21,Africa,12,493.7
e83dd4abe41146f7a85c27a729bd4841,162,120,42,South America,23,1008.78
e84055a609f048c6b415aeeb30ea863a,161,136,25,Europe,19,1390.59
e842c0e873b1406bb1e304737370d835,87,41,46,Europe,14,400.2
e843cef71e554d3f880b2cf4cd049409,151,120,31,Oceania,20,1185.99
e844158414574f5e86619f0639bc130e,120,86,34,Europe,17,573.04
e844a20768f348f6a5c086f2cc1b416b,59,27,32,Asia,24,542
e84580e2f944481b9b1987dd4f337a4a,344,315,29,Africa,23,2330.34
e84684db6aa349868216170e8b5b1c7d,364,327,37,Oceania,19,2143.14
e8470cdc1feb476a9ac81c55403b3983,356,307,49,Asia,20,1607.43
e8478753f9f649c184a5c4d7510162df,69,29,40,South America,21,587.33
e848f799b8b947bf908df6bc3c9db97d,189,164,25,Europe,21,1478.17
e84a957796174df5ace76f675fe2a834,365,319,46,Oceania,20,2047.64
e84b366a575841c9b6d781f6dae93452,244,196,48,Europe,26,1337.39
e84caef43bed4527a49c4d5911af1371,211,187,24,North America,19,2183.6
e84d1dd1215a4a228a458fb4d33bfd70,84,57,27,Oceania,16,698.12
e84d5cb055a74503b96ea39b83fbca7f,125,95,30,Europe,18,956.21
e84fc59734ab4dbcbf759d3b0b577edc,219,184,35,Africa,21,1628.45
e85080ab83d64d839fb9c114cc59f07d,65,23,42,Europe,22,529.56
e857955743714cdd8a42abf5b8d37a10,148,117,31,Africa,21,1719.46
e857cacec5f04f95bb00897d8fbf5d83,222,192,30,North America,22,1593.55
e85b8fe337564547801c97e24fe1578e,365,336,29,Africa,18,2472.53
e8600d000f684191aff038bf1de6e167,176,149,27,Asia,24,1336.9
e8604885b91841c0aa1813a9ac51135f,359,317,42,Asia,15,2124.05
e862666c443042b181771334f0be232a,75,53,22,South America,16,712.15
e866e563d69c40b280e3a19db270ec70,104,83,21,Europe,18,571.52
e866ec64e05641b9922944e142f8ae31,138,111,27,Oceania,14,1719.5
e8688187774c4bfc9b34d6794f5f928e,59,7,52,North America,17,305.97
e868840a45144e84862d16e3ca3442bd,364,325,39,Africa,23,2579.72
e8692a17f65e44db942aeb5128e72070,144,106,38,North America,18,799.25
e8693675011e4e26a5f09afffa1e1391,294,279,15,Africa,19,1821.19
e86962bc81004071a68c0c948a59b90b,217,186,31,North America,19,1674.87
e86b564cece341bcbd002cbf1b163c88,279,225,54,North America,25,1437.26
e86cf175c1cc43c2a56864f3c858e4f4,358,321,37,South America,21,2771.89
e86e3f9a09bc47fdbf2eb78bf4ca5c6e,190,158,32,Oceania,20,1473.07
e871c9b21453459091120e2cfa41ff05,141,104,37,Africa,19,1224.05
e87497eeae8047a4941b5c00627a7340,365,352,13,Asia,21,2026.86
e87646d72eca426aa1f8383ea81f0bbd,255,222,33,Europe,18,1555.14
e876ce201a594f3595509d4b72d430c7,138,99,39,North America,22,733.13
e87709333cda4b0d868c2db798b2e7da,173,125,48,North America,22,1021.38
e87acba4d78b41e6ba1ed240abc171cc,80,53,27,Asia,16,558.3
e87c179fae474ffb9b86ede854a98930,114,86,28,Europe,20,866.2
e87cb3d18ca14b63b62f33cc5f2badcc,133,117,16,South America,19,1016.46
e87ef0849927491ba6ef4251423c302e,253,227,26,Africa,21,2771.48
e87f3a600a124f3d921c47ec51b1d7fe,364,343,21,Africa,20,2946.41
e87f7003e0d442f0b98e30bea9b54f99,189,153,36,Oceania,22,1743.48
e8859918cd26493f8014979ad431ad68,85,36,49,North America,26,264.52
e888aa09ba544869829989163269c4d9,215,176,39,South America,22,1692.21
e88cfacd11c84104acb205ae70b99382,295,241,54,North America,19,846.54
e88d6214841741daaeabf916fec428b3,199,162,37,Europe,21,1947.12
e88ec07c7f5446ccaa0e31442dc59a33,350,315,35,South America,23,2131.5
e89046b0bc954323b239adb905befeec,192,158,34,Oceania,16,1032.55
e8937647324146329f6c3e16d2da90ee,268,231,37,Oceania,18,1529.95
e897042d320843079a7e1d74002ede30,127,98,29,Oceania,13,1348.73
e89775424b75482b92a18ad21a972df5,198,150,48,Africa,20,1002.55
e89840f993d748f1ab1d7fa0c8986a08,210,189,21,Asia,15,1416.93
e8996adfed31465cb1fcef5b61ebd87f,365,357,8,Asia,25,2458.34
e89a30f39f1e41b08698d50cd00c562a,176,133,43,Europe,18,995.09
e89b095909a64ba6a77b408230ee1dbe,58,31,27,Africa,19,514.04
e89b218f153b49e5b3976a0ea951fe30,357,308,49,Asia,25,2190.92
e89b5b321fe9447e96658f42887346a0,159,125,34,Oceania,24,1274.3
e89b73a74da645b688e0794472ae0def,237,195,42,Europe,18,1478.71
e89c8505277e466ebee419667dba8ba0,318,281,37,South America,19,2148.93
e89cd3a294c546babe589e5b49fd84cc,247,192,55,North America,15,967.29
e89cdd6877b44ae1b3ff401cd2905251,167,153,14,Africa,21,953.73
e89da24aadd44739a8137c93eecf11c5,347,296,51,Europe,20,2066.98
e8a0c7e34b4a4388944108ed18dac899,146,116,30,Asia,18,1173.94
e8a2cb06f5f0410caf6abdf51290d4bf,91,50,41,South America,19,568.01
e8a2d3de88e74b6385e0bb3a791171c2,72,40,32,Asia,21,886.8
e8a46463a9b045d69bd3d078e20d9681,179,156,23,Europe,21,1364.83
e8a499d0f274430693a3430ef5743a76,321,283,38,Africa,25,2615.6
e8a7d44ddc3649f588b7c3af0c2655e2,284,239,45,Africa,20,990.05
e8a8573a77a44bebb4f2a6ffc5ea4f7c,163,142,21,Europe,14,1040.71
e8ac29574ce44d1b984e2283eee29727,255,201,54,North America,18,1588.99
e8ad10ea6fe14432916a0c0a9be08ad0,160,131,29,Oceania,19,1627.39
e8af1d299f9149b48cda6b00c9679301,44,5,39,South America,21,343.82
e8b2a8e0530c4e7ea3dbdb4e1040208b,360,312,48,North America,25,1880.77
e8b38c32a3354ac1bbf72c2c8b0b3ed8,207,182,25,South America,21,1357.76
e8b5db67083e4035add35a3dfda43db6,159,97,62,Europe,19,653.88
e8b61a6f661e4dc381c1f9e4d306a41d,326,276,50,South America,19,2929.15
e8b9df9faa9b4d3fbef53df2420b90c5,212,179,33,Europe,24,1569.39
e8ba3f0a2ecf4bf884a45c0b8db2de9f,347,297,50,South America,23,1850.73
e8bc08396b944f3f87be34d995e5435c,206,158,48,North America,21,614.58
e8c19032c3664cb98fd9d3ed1808c723,126,71,55,South America,19,547.46
e8c19e028c7c4089917edf0d029abd83,23,5,18,Oceania,18,85.86
e8c1eab0c4564ad7ade532c965aa0270,365,363,2,Oceania,19,2041.92
e8c3e065ee1f4596a7c3831ead98f217,353,333,20,Asia,14,3551.14
e8c3f3426ec243ddb2292dc7b22c1899,182,147,35,Asia,17,1772.03
e8c48bfbb843454f86555985d561f977,229,195,34,South America,23,1671.42
e8c56dc2ed494589abbfb4d34f577ba4,178,135,43,Africa,26,742.76
e8c62fea6018486abd35d87185e68c07,343,295,48,Oceania,17,1480.22
e8c78f3110d04ec1a8dc026ff2d0cff8,204,179,25,North America,17,2011.76
e8c93aa906ef4086a0e40ac0641e6743,145,92,53,Oceania,21,503.55
e8ca2639de69457da2c603229b4ec66e,355,320,35,Europe,26,2897.34
e8ca8048af5b476899d21f1d25c6b71e,77,48,29,North America,17,585.33
e8cdc3b87f484f0ea4a4d0606530b2d8,44,21,23,Asia,22,215.24
e8cece0d7b7c4d5eac4de4a5aa505294,301,277,24,Europe,21,2243.2
e8cee268cfd34ae6b33b74cc1667f6c9,256,226,30,South America,24,1490.31
e8cf11cdee954da88b5a2aff9e864daf,254,223,31,Europe,24,2011.52
e8d0941286f24277820d425c6f93b246,159,116,43,Europe,15,1089.58
e8d19d6b1b764221a8b1ce2066cf7213,229,180,49,South America,16,1462.55
e8d1f6cd29a54be78f99498f02b7a53d,30,11,19,Africa,15,93.92
e8d44b3393914a4dbec7be8a9f2d85f6,123,110,13,Europe,26,1170.44
e8d6f4336c154010822df2153669a9bc,365,333,32,Oceania,23,2330.34
e8da52f15dfd457ea93e66f53aa3dca7,172,119,53,North America,16,992.97
e8da9a16a5ec46c880ebbd311fb1af26,224,170,54,Asia,18,1099.58
e8e09eadb00f46bfa6cd6879b72107bf,111,65,46,Asia,21,871.13
e8e250f4b5d241c6a72ac0f759b3d55d,197,168,29,Europe,19,951.43
e8e4d666b8214689a0d903029f63d62d,205,167,38,Europe,27,1413.54
e8e6dcd59e8a49a9b745e72cb5c625b1,336,312,24,South America,23,2818.91
e8e788c30f7940ff8d92cdfb66b444de,183,150,33,Oceania,19,1222.92
e8e7a62978664e10b83574e5b9d3a651,222,170,52,Oceania,22,1132.04
e8e8657ef3ba463f962a7d916df39626,352,307,45,Europe,25,2109.14
e8e8e0c472984e9d977841c32a564bfa,365,336,29,South America,21,1415.85
e8ea30b20bd8445691c51c606a844f3d,271,243,28,South America,21,1601.29
e8ea5edb6c4e44f18fb37c3e0d21749f,156,104,52,Europe,20,963.05
e8ea635305ca4d69bcb40c4932c55397,316,267,49,Oceania,19,1623.13
e8ea9bb105c34fd887425d03d6d50e5e,57,26,31,Oceania,22,458.86
e8ec2bf482f44aecac823e1e6b3fa5ee,164,118,46,Africa,20,828.13
e8ed686247a440edb59eef8e1fcbea0e,115,74,41,Africa,16,574.37
e8ee654667c147449ef80cef6fde2b1d,342,295,47,North America,20,1888.27
e8ef4ded57b44b6d92f815147ad3a7e3,167,121,46,South America,17,950.97
e8f058f1db6746399c190738ac84f6d3,103,75,28,North America,19,882.48
e8f0d9ea8dc74aeeac91198dd18585fb,106,74,32,Africa,19,524.29
e8f11bbbb5c64478b372c7e3850cf00d,283,230,53,Europe,18,1764.24
e8f21a4c8126491795f419cefbc25d5a,309,259,50,Oceania,20,2096.7
e8f5357dfdf04d92a61eee627d1e6c17,51,16,35,South America,22,124.43
e8f60dc2228d4b83ac4c5e26cbb0c71d,179,142,37,Oceania,13,1631.24
e8f89a1e930542dc9951fd6205094ba9,342,313,29,Africa,22,2178.48
e8f9ab82acab49b7bee572588e5b2a07,129,99,30,North America,20,954.5
e8f9fee9e8a144d8a3ac49854c9de01e,244,213,31,Oceania,29,1700.94
e8faa6e93bbf439995cd8b7a145c436e,325,268,57,Asia,23,1625.38
e8fae63a2aa049a583067b072b588d29,192,136,56,Asia,20,1026.5
e8fbb5a9998742168670f7253a801a86,209,169,40,Oceania,18,1119.21
e8fbee2dc15542a9b5868ce7e1a4d2f1,76,49,27,Africa,18,377.65
e8ffaa0d24b54dfeb8d167fc359347fa,319,275,44,North America,23,1768.73
e9014f03e85648e6b32a515e6b72b3fb,150,101,49,Asia,18,1337.01
e9040608bdcc4bf084b8ba508640cecf,365,347,18,Africa,24,2085.39
e904787172b54b0facbab292fae55cd3,335,317,18,South America,16,2209.59
e904eeb3b4694576848b9ce70b2df5f7,248,222,26,South America,22,2033.21
e905ba43851044a7923e5020f948cb11,365,351,14,Europe,22,2011.37
e907ed420268400a95bd165a17807a61,317,278,39,Asia,19,2587.01
e908cf5415a74a86a021f7dead2b0d10,208,160,48,Asia,21,1428.82
e90bf2eb5689439789dcbb68ebd93b5b,155,115,40,Africa,21,782.86
e90d378deef441caa9487021a9a116fc,182,139,43,North America,19,989.9
e90fff1aca7740748d1500bd1071ba11,274,240,34,South America,16,2048.96
e911c52dfe624a1a80e685635092c141,47,16,31,North America,19,126.63
e912368edce346d5a1bbc2ef2caa68f3,363,360,3,Oceania,18,2530.38
e9128b32ebc943808849f48f6e8d9aee,104,55,49,Africa,24,963.44
e912e09c0d0349cf93a0ac5c40d06d3f,261,232,29,Oceania,20,1904.64
e91316eb5b29416bb79fe8a976bcf911,61,9,52,North America,20,301.45
e913603caf1a4804af3c4a6a428e63c2,353,319,34,South America,22,2269.75
e91435aabb1b4f248aac32ca3d45e8ed,139,119,20,Africa,20,1120.69
e917cd6fc4d74f24be36ca92b7ed6a25,136,119,17,Africa,15,727.01
e9184e58741c47a9983ccd56b524f736,365,359,6,Asia,22,3921.04
e9190c9f89be429e8004c93794000df5,167,151,16,Europe,24,1415.33
e921c2a090364976bf5ab2ddf0287818,326,296,30,South America,14,2336.92
e921e3b9e42b47fab363cd89177de264,273,232,41,Africa,23,1998.7
e92203bfbd2f45ccb938c642887bfaeb,202,175,27,Oceania,20,1549.19
e922b520352f4ab5a6b749a1c7c39250,173,143,30,Europe,23,1104.08
e922d2f59cdb40a1abfca525cf838c63,364,346,18,North America,20,2689.87
e922e8dc2d7b41e882ab8664e6f673df,181,141,40,North America,20,1553.86
e923317cd92e4d0a96604e7eadfb14b3,365,333,32,Oceania,23,2446.09
e927b18b7cb641b0b11ff41514652e0c,361,318,43,Europe,20,2410.68
e928123044bb47759bc68686437baef2,363,353,10,South America,23,2075.57
e928ede4679242df96afbdc5b6ae023e,180,132,48,Europe,21,854.84
e929f6bbd8984054ac1800092bdf363a,96,53,43,Africa,22,736.13
e92a0c85e39841cbb8b6234c6ecbfd35,342,300,42,Africa,17,2010.95
e92aebf550004c8dbaec7809a789a0f3,296,270,26,Asia,21,2219.22
e92c4f855bd4444381afb4dca237e0da,112,94,18,North America,22,703.63
e9309d343a1c4aa6b8be2973e23848ba,136,82,54,Africa,19,792.39
e930aadd655a4faf9d0bc19ce5de056a,128,107,21,Oceania,19,719.84
e930b69155c5478db69258fb55dfcb1a,233,210,23,Oceania,24,2163.11
e931fd1b140e457fb93a3217bf0b8fe9,229,193,36,Asia,21,624.48
e932d1ba1b9a4d6e99f99f9cb34e86e7,195,154,41,Africa,19,1375
e934267b4a454ded9089de3bbf2e08fa,273,243,30,North America,19,1656.02
e937399bc5d847158c6045fb2782f3e9,153,107,46,South America,21,944.33
e93957729aa94439b420bd3dd747b8a0,365,344,21,Oceania,21,1701.05
e93cfd7b9b06499abd1f669f5fe6a370,365,330,35,South America,18,1492.6
e93ded0e399f424084774b258f7b3811,159,119,40,Africa,16,1470.19
e93f62e1dbce45ed89a1e0763186f1a5,142,82,60,Asia,23,1141.3
e943656c9f794064aa64779ee206a79b,337,307,30,South America,20,2359.11
e943bc3244e142b598491c1ee6c8bbc7,265,232,33,Asia,18,1558.37
e94975bbe7d542e4a6f3b0650bba97ae,88,52,36,South America,16,508.72
e94be90e425841aea12de1dae181f3c1,330,277,53,Africa,24,1789.97
e94c3f8bf80a4700a6523effac05709a,168,119,49,Africa,17,848.24
e94d64d3043d4506918d8f61b64d844c,142,122,20,South America,22,941.45
e94ee92284a54236a44039f4c9097113,281,244,37,Africa,15,1939.04
e9536a96afe74480bbe8426b709ecd53,72,43,29,Asia,19,859.64
e95759d680b54791a83eafa550f3ee1a,357,326,31,Europe,18,2836.39
e95900579b2b47b9b5600a8d63cbdae6,365,340,25,Asia,19,2059.58
e959fbb4642e4f198e45c8f09b344fc1,157,126,31,Europe,17,1757.93
e95a309e5d254513a6e13b50297d0788,365,361,4,South America,19,2777.17
e95ab993272343388484da84788978d0,364,327,37,Asia,21,1642.19
e95cb0c55f754bf0adebb75ba07fe879,167,116,51,Oceania,22,608.37
e95de271a02d408b8bdab909df9434b3,79,35,44,South America,19,779.04
e95e81c15ff544afa7dfa74075e219c4,76,55,21,Africa,23,757.32
e95fecfcf731499e9eab6661f70eca2f,283,238,45,Asia,20,1725.08
e960a396fad94a3394323b91784d1562,80,47,33,Oceania,15,657.18
e962461b01274bb19348964d255444f0,112,75,37,South America,19,851.51
e9624b5123de4aefb0fe0cb190cebb48,365,359,6,Europe,19,1706.92
e9624ecfaea74cb3b0c0c1e512a5b866,248,198,50,Oceania,21,1772.27
e9667b388c3c40a2a5615dd816e83e2e,92,57,35,Oceania,24,913.63
e968107cc0ec42a4996aee5e19a84551,121,70,51,Africa,14,661.12
e9691bd263674432946c842920ae0b07,138,87,51,Asia,19,745.98
e96ade8e35084b37a92717c1bcb461d8,129,106,23,South America,21,744.05
e96b79416bd54b279749ad5c2c3a6124,304,259,45,North America,18,2651.87
e96d3e3cd3624493a918ea1a1624201f,293,249,44,Europe,16,1610.2
e96f1403366e498db9d6050feb06cc4e,110,82,28,North America,17,906.34
e96f615c3e784e56b29464364e01f2ba,100,82,18,Africa,19,664.42
e97043c1c18f46c69f7f02c24a42c6ec,133,92,41,South America,22,813.91
e971099fe3e8464591addb6fb3ba07f0,247,217,30,Europe,20,1277.63
e976df9ee39d451387aa567711ec1598,77,42,35,Europe,17,597.2
e978664bbfdf4e4b9e31f5ae409fe0ce,312,269,43,Africa,17,2022.58
e97a930133d0445ba33a3a39a3dda8c7,95,49,46,Asia,12,391.78
e97aa99c478a440d94eb1d4028326e35,58,39,19,Oceania,24,572.3
e97ae197a98644c6babf2b06a914a52c,225,199,26,Africa,22,1793.21
e97b2bdd43bf4d69a50351f2b6814ebd,128,90,38,Africa,27,268.67
e97ec80e2e0f4a3aa2224b1c9fb8c5b5,135,73,62,Asia,26,738.11
e97ef1e919b14c3a82223f9790c9401c,85,41,44,North America,21,540.41
e98002716202484a859ac61ec968fa9a,93,61,32,Africa,20,632.87
e9801bd3ce0d4b9f8886d171cafffda5,309,288,21,North America,23,2645.04
e981756b175145819a0afb575af799ea,79,46,33,Europe,17,645.69
e981c8ff00074e5a9e40042ea977c774,275,240,35,Oceania,22,2197.27
e9829601ff274860957da0c4630036b2,307,275,32,South America,26,1965.75
e9844fc46f014563a9c2dd69897a7f16,111,84,27,Africa,24,960.17
e9852ac248674c83af6e389630239d65,346,300,46,Europe,21,1562.58
e98553f363a94e9eaf5a2b211b4ef323,357,325,32,Oceania,16,2644.68
e988f4cc396645b58a4984040add0c37,364,321,43,Europe,18,2427.32
e98b3f55625f4fe881f693d35c8d5ee7,122,100,22,Asia,21,923.17
e98b5f71af6e48989e7aa6421dc2f2e7,365,363,2,Europe,19,2209.53
e98c55239b6648088f19a589e4e52065,225,204,21,Europe,21,2140.17
e98e85a35da749edba0a87a565f8edd6,284,235,49,Asia,20,1244.95
e98f04d7f707455a9674b24b74dfc740,198,177,21,Africa,17,1947.66
e98f3b5adbcf47369c319234cdba9406,260,216,44,Oceania,17,2371.08
e991128406a34a9fbe1dbe107fa92802,364,356,8,South America,22,2130.93
e99193ec9c964d089a8bcc1c63884375,246,204,42,South America,19,1657.4
e992e68f822d4f99b5d8526ae430f6bc,108,58,50,Europe,22,182.5
e99364b789fb4f6194b4c07bc957a147,73,40,33,Asia,21,595.66
e994990a2e9043c888c8bcfdcc39c1d7,364,341,23,Europe,17,2562.47
e995c65283c94308b0125e6695c6f72d,88,63,25,Africa,17,1270.44
e998b375efd940019218dcb1f13c8e23,230,187,43,Europe,14,1402.09
e999630e0e134625915a4c407064337e,254,221,33,Europe,18,2498.21
e99dbe4a9aac4b36916f25c4b6e71c3a,365,326,39,North America,23,2357.08
e99f0ed09aa2473c88e25699884ef706,99,42,57,Oceania,19,512.42
e99f4d7f8d9a4e28b7d2685acaf2d823,363,352,11,North America,18,3917.8
e9a0b13c09f943e6ba3b341b8f10eadf,163,125,38,Oceania,21,1152.79
e9a2003f6a4a417d838342eb2acb316a,63,39,24,Asia,24,356.48
e9a27095061e4a23a4f184c1181382c5,334,291,43,Asia,24,1751.43
e9a5ce179f664792a0d581538faec803,365,343,22,Oceania,17,1771.23
e9a84324c8854a2298b7dd3eb40476d5,116,95,21,Europe,19,692.13
e9a985b459284dc9afdf3c985e760928,236,195,41,North America,18,1991.93
e9a9a12bf0dc4c9ebc66bfa4c890d40c,283,245,38,Asia,19,2172.47
e9ac023af6504402a6e6c3d1681c1807,363,362,1,North America,20,1580.54
e9ac83e6da644b6ca70b1f4b1a43077e,363,337,26,South America,23,2480.01
e9ad33a0e3ce48e1a6e6f8e63e77178b,365,338,27,Europe,19,2482.06
e9b022507e48484e85dd2a9ef2b621d4,365,351,14,South America,21,2265.71
e9b281e2d5c94351942c02b8dc754906,65,26,39,Asia,17,160.13
e9b32e982be648fc942ca4481a69d202,232,195,37,Oceania,23,1240.06
e9b60a011b2a4996bf9cfb763f8579de,109,74,35,Europe,15,605.96
e9b6de2b2c074c5cbf0f34933b35f67d,89,68,21,Africa,24,839.09
e9b7932b70034bd3ac6867dbe08aaedf,69,46,23,Asia,21,760.84
e9bb12e2f94642e8a18f52ab8383daea,160,127,33,Europe,11,1112.49
e9bb7c85562c4190afbdeb9bdd59bcfd,365,316,49,Oceania,18,1719.04
e9bb7fa8c5154b31a2021343e3d4f035,365,345,20,South America,19,2311.94
e9bc7a52f6a44611af21565f7132bc4f,354,328,26,South America,18,2600.53
e9bd66536781437a802dc8b47fccf462,104,73,31,Europe,15,708.45
e9bdb7dd8dbd4d178c226a8e0cda929c,305,273,32,South America,26,1986.05
e9be39483729496eb20a548e002396a5,262,205,57,Europe,19,1347.49
e9c13a0edc6c44a49107bb7484995cb1,74,49,25,North America,25,676.43
e9c2558748e6474b87a8a5742b543324,271,226,45,Africa,24,1291.89
e9c3f0d6e68e4ff29408b6f01f955799,97,57,40,Oceania,25,622.86
e9c560c2db2a4b89b20b12f7ed581040,150,113,37,South America,20,1285.27
e9c759dd37bd410fb42564fa30dafda7,135,88,47,Africa,24,1062.51
e9c84c71bdf2491ea6d89574017b877c,179,152,27,Oceania,17,1605.38
e9cb06843ad94d05a5da75dc96ea7d68,365,364,1,South America,21,2084.22
e9cb2a0f742c48aebac3f3af6cb3b625,71,38,33,Asia,25,491.8
e9cba19301fa4488a09716e9b319fe5b,259,235,24,North America,21,2459.98
e9d0232447e146a48670e18ee1cad527,118,71,47,Oceania,16,637.95
e9d3c201bbf241d6a02c6b77786a278b,331,305,26,North America,24,2768.55
e9d4f41133a54bd7aa897eb902c0662e,110,76,34,Africa,20,629.57
e9d553abbe324d5b8f41cacf958619a6,254,219,35,Oceania,20,1532.16
e9d9dd0b48fe4508a83f468d4a25d70e,160,124,36,South America,21,995.45
e9de9ef66408460b8a18d31e6ced1ab3,267,220,47,Asia,25,1545.85
e9df8da5073c4509936ebf79e58cba62,138,123,15,Asia,21,988.71
e9df966e39fa4f348c01268754dc239b,365,351,14,Oceania,17,2902.49
e9dfb9cda6b64cd49d61a654c406943e,365,356,9,Africa,18,2837.91
e9dff27edb354397aebd81503f1e6971,71,43,28,Asia,22,297.35
e9e1b5ae90564c32a54dce4faa40d90d,292,261,31,Africa,18,2738.26
e9e3174087ea45198155daa5532c2162,199,162,37,Africa,21,1955.41
e9e38eb2644040548422a0b9cea8047f,149,117,32,Oceania,28,1111.38
e9e53ec9dae544a6a3987e83031da0a5,135,97,38,Africa,18,1023.53
e9e541c3b4d24d73b1f3ab4c75efb08f,314,284,30,North America,25,2226.3
e9e5fb9c12a14bf19453a87b3b68a5ef,365,344,21,South America,22,2504.57
e9e660e71ba34c779e4f1704cda8225b,147,102,45,Oceania,24,1312.7
e9e81ad9f9304a2287b0a28ff587c303,66,19,47,North America,13,204.11
e9e85063c41249a4a55bcabb56728b1a,365,335,30,North America,20,1965.21
e9ecced34ddf4281a89dd527c05d3884,112,81,31,Oceania,22,1298.73
e9ecd3c369be4db5bdc43f4847b7bd4d,363,356,7,Asia,19,2218.14
e9ed3726d14d4947b5e616933f65539f,337,312,25,Asia,17,2540.06
e9ed5cba2e304631be1ef23e7d220423,191,171,20,Oceania,20,1116.76
e9efafd03bf64393981b8c582dc6759f,355,316,39,North America,15,2470.76
e9f0fe60c7a24775ab721817c67fc999,221,177,44,Africa,19,909.56
e9f1ddb996dc44b1ad99eef95cbfec2d,365,342,23,Europe,16,2931.08
e9f2826cf2554d4283f3d4e6f5eb6a9b,342,300,42,Oceania,12,2084.38
e9f2e1ebd7b74d6ba985bc2a08e3b112,256,214,42,Africa,20,1428.2
e9f419ee907145448940c9d5c87258ef,134,100,34,South America,15,1076.73
e9f4e0af3cd740f184d6d7deb2515d55,287,250,37,Africa,21,2337.48
e9f6d71f9183440d9b2b8c585e80cec6,68,17,51,Africa,22,301.83
e9f70c320b5044ef8b0edcb439781e63,136,96,40,Africa,22,1020.19
e9f83099c00e4192a91eb0cf244ebcbc,306,278,28,North America,25,1602.69
e9fbc47090f64f1e88644fa848c85e0d,169,116,53,North America,17,523.89
e9fbfd9d0b4d4a6a84f4a97b513a6d99,360,350,10,Asia,21,1504.64
e9fc791b27274c428bea2e21304fa3f0,332,302,30,South America,18,2579.32
e9ffb13b853a48cc9f175a8f960b85f6,255,216,39,Europe,18,1284.48
ea0009696d1a412699026e4889cee5de,345,299,46,North America,19,2087.81
ea0036d3eef2425ea6a0936a0ab50c6a,264,236,28,Asia,18,2674.75
ea030426bb784726944ce5eb54908f68,169,122,47,Africa,18,790.62
ea030871f9b847af96fa2aa51aaa32a8,359,336,23,South America,13,3313.37
ea041dd6dadc4da1a0a8f59e6254bab0,78,22,56,North America,22,121.84
ea0579a3b1484762939e430771564d9b,277,242,35,Oceania,20,2050.28
ea094f569b6549a9898027be0f5b5756,360,334,26,Asia,20,2611.48
ea0ba0b5caa4416eae4cb863b52d7df5,214,195,19,South America,16,1975.51
ea0c7864bc354a858a4ed9af2ad1a086,195,183,12,Europe,24,1294.35
ea0e249d1ed946baab593b061e4c1295,261,234,27,Europe,23,2376.65
ea0e81e635d84c5eb939b40de2357901,80,46,34,Asia,19,829.51
ea0e9172a96b4442b33a5ce6a7c32cb0,319,281,38,Africa,23,1896.43
ea0f93df979f43ea957273514ae800fe,132,78,54,Oceania,24,582.22
ea12249ddfdb4cf4a9ea62300d4f721e,218,201,17,North America,18,1658.48
ea14435319de40d68bfc0c34a1f1f486,365,359,6,South America,16,2338.14
ea167268485447a185be3074b4e52a9c,333,293,40,Europe,23,1503.17
ea17c807ce4342e7a9a10cd0862ec12c,71,52,19,Asia,24,592.98
ea1b1f6c776b4f129890b493815f60d6,132,89,43,Africa,21,524.6
ea1b4769c9d143acacb46de352659576,260,216,44,South America,19,1785.7
ea1e66495cf14627864f7b633b1053bb,318,302,16,Oceania,19,3389.74
ea1e907265e740c38839e0af033abb88,225,184,41,Africa,15,1417.61
ea203950050242789f0018355364dcd2,138,103,35,South America,21,831.59
ea210a8057124820ae600c36f0cce73d,182,155,27,North America,14,1008.92
ea215cb2131049299a8a6ec5184d5abc,200,156,44,North America,22,324.21
ea21e18c735f487bb8c20321d1c624d9,188,144,44,Europe,23,800.84
ea23963a77994f8081cf478bcf3e8e38,182,141,41,Oceania,21,945.8
ea2420cc6ccb4be1aa967a8f21b1a310,297,270,27,Africa,17,1990.22
ea25b74f1e504565bfa54c69faf4bb50,232,183,49,North America,23,1249.61
ea25d3016d42449e908aae6034d59d8c,308,273,35,Oceania,21,2420.43
ea26f552566a408ba830fc9412b1cbc7,100,57,43,Oceania,23,823.28
ea2760db44cc4f41864b9d53593132b4,181,136,45,Oceania,18,884.86
ea285f1522e94ab78263ce3bde92a52a,208,175,33,Asia,24,1388.95
ea287ce1e0fa44db8e11e1c8ff19020f,80,29,51,Asia,20,333.27
ea2ec85107494e59a0b839cf41d214ce,312,287,25,Oceania,19,1646.64
ea308190d47e41ceae328dc464a0c21e,286,258,28,Asia,18,1665.61
ea314339171e4e08bda17538f1ecce90,136,89,47,North America,22,216.5
ea31e619e27d44df8c8586303f3fff99,328,301,27,Asia,16,2335.88
ea3323c4d28744508af5ec1e02655f74,318,292,26,Oceania,23,2227.86
ea3544949a8e4b5db89859a66f4bce2e,108,80,28,North America,14,1040.7
ea35498318a8448db26fab9cbe5b2621,354,306,48,Africa,23,1638.75
ea396f645a7a427bb323e9d7bbcd64f9,357,349,8,South America,16,1979.03
ea3988118785490ca72251394c5b2ba8,141,116,25,Asia,19,1432.6
ea399aba757b45eeb4c663e52ccfea6b,355,314,41,Africa,23,2522.55
ea39c011861142d09144746f64560017,98,50,48,South America,15,503.34
ea3c5dbb72f74604a2b29ddc24e3cb69,213,176,37,North America,17,1665.35
ea3c6fffc3fe46f98300aea327d4fcbf,244,206,38,North America,17,1155.35
ea3c835888de438a9c8ad77d2553c3a4,363,304,59,Europe,20,1550.86
ea4158ace7a24e0aa9089ae0cfa03480,65,6,59,Oceania,17,260.74
ea443bdfa5d0407abb01fe1f1db15dab,107,67,40,Asia,17,721.13
ea4543ecf8fc470fbe73b41ca590e5e0,362,340,22,Oceania,14,1721.92
ea4687959d2541d19c49b54e6e76a603,240,209,31,Africa,20,2483.93
ea4758b5c7234ff5bf9be457be16994e,275,233,42,Europe,17,1983.54
ea48fcb4a36a428cbf1f3c3d819886db,346,313,33,Africa,23,2475.18
ea495889e5674d69968e4d0900c8fedd,149,130,19,Asia,24,1068.47
ea4c34e9f52141228fd397042450fe9c,214,169,45,Asia,21,1255.34
ea4c3fb8963e4257b391211ad23dd1f3,288,240,48,Asia,24,1855.04
ea4e30821e00490daca6c59cd2b29d9c,363,307,56,Europe,23,2052.78
ea50bc8d718c47578264acaf682e9b5a,63,7,56,Asia,20,308.09
ea5140e0157841ec95488e92aeb7f808,184,124,60,Africa,21,720.78
ea57002f958540748383e2ac7f1164a1,249,224,25,Europe,23,1738.66
ea5763ca8750472e95ea3b72fcba8ef6,205,150,55,Africa,20,1116.71
ea5bc1cca945453fb36c9c89944de67b,167,130,37,Europe,23,768.83
ea5e91ff486249dd8255172efac13023,137,111,26,South America,17,1138.71
ea62c0a533054ee4bc87e6c2fce73d5e,37,10,27,North America,20,311.92
ea63fe8e87f64eefb016583e16db860b,183,149,34,Asia,25,1316.33
ea644f189bb049fe88dee2a8b81a3650,59,10,49,Africa,24,266.02
ea6561bdc6064346a82e2cfb051aec31,306,267,39,Europe,15,2193.29
ea6763fbed4e45739c3cc810ae0e51c5,34,4,30,Oceania,17,177.11
ea684c2af99e476682d56c5091d5c1f9,291,251,40,Europe,18,2057.52
ea68bb9202ab4de5a3f18ff61883df13,53,13,40,Oceania,20,482.11
ea69586d12d647ba8f1d7df465c3364c,363,348,15,North America,15,2851.85
ea6ad166524a467ba0f2aa071fa21890,289,237,52,Asia,21,1552.2
ea6fd72edfba49878b274f575532c467,344,309,35,Oceania,24,1992.82
ea70603c48084cfb8b6ff960baa4803a,219,164,55,South America,15,1308.76
ea709c773cff4190b4ac9947647132c9,231,175,56,Asia,23,989.31
ea713d6ec3bb4eb0ac1456ffe563e343,309,287,22,Oceania,21,2501.62
ea7143f7c15444d49926817b5459441d,283,262,21,Europe,25,2512.05
ea7401101ccf474f87a8f34a9864df18,149,123,26,North America,20,866.2
ea75543b7b544c89bc4fa6f86c70d022,213,162,51,Asia,22,1133.05
ea7654783b8f44a48832100e76a57ce5,77,50,27,Asia,25,578.26
ea76b4328a0b477684c3f8c56408b85a,84,46,38,Africa,20,479.46
ea7717fbfa734b7484d646507e0f5a1e,130,89,41,South America,18,432.07
ea7756cc1a94467ab4210a7564b4a3d2,199,183,16,Oceania,22,1418.86
ea77a9222c674c34a7d05f686f918b01,364,359,5,North America,21,2439.42
ea78c7f8b8b4498cafc93c3c806f1d7c,362,306,56,Europe,21,1875.27
ea79159130ae45f0b38d742f227fd80e,363,309,54,North America,17,1818.66
ea7afa6696ae47248f23caba5064cba1,356,301,55,South America,22,1519.99
ea7bf03f835c49939189f189d08a04a8,239,193,46,Europe,18,791.22
ea7d3c0fb0e24a3b961c5723d988adf0,88,41,47,Europe,22,256.14
ea7e4669ca604e998e8ebd06e89f0ac3,132,90,42,Europe,19,899.88
ea81b52a900544b28a55bea2e1d42989,110,56,54,North America,24,483.68
ea81fa35397e4156aa683255a4693f32,217,170,47,Europe,21,1078.35
ea83b55248f84774816bcccf73ffbb49,136,104,32,North America,23,980.59
ea83d27fde464dcead9c730a23f1ab6b,336,311,25,South America,18,2706.01
ea84e4d0be6043d6ae777080c992796d,121,74,47,North America,20,840.42
ea84f757b747482fabb0e83a61996099,300,270,30,Oceania,11,1745.41
ea85d02d5c0e41f9a6c0314e28fe7bad,110,64,46,Europe,22,247.59
ea8669bb7d014211a83815fb16c3092f,50,23,27,Asia,21,385.04
ea89447de0ce459d8a98b57d9f3aef98,249,196,53,South America,23,1100.03
ea89a85e9667410a9eec4725a3a21900,64,11,53,North America,24,317.21
ea89a918614a42ec90bc39d43d56daa2,364,321,43,Asia,21,1976.92
ea8a520b21d94ba5815f5e1ec7334d25,364,359,5,South America,21,2863.61
ea8c1bb921274cb2909c86138047b5c6,321,301,20,Africa,17,2388.34
ea8dc478d8214d5196fa629bb8b218df,214,191,23,Africa,24,1385.94
ea91c8028da6403988e73c140001ce11,254,212,42,Asia,20,1632.27
ea92566d957b4a34aa5f4d81fa0958f4,127,87,40,Europe,16,892.54
ea92f430a6e64193bceff6f2d46cd8fb,321,283,38,Europe,22,2136.57
ea93fd401bf6444ba663219b14f9cf86,363,319,44,Asia,20,1679.87
ea97b88afcd34aaebfa6ffc16a7ccdfa,37,5,32,Africa,24,363.53
ea983474edbd445e9f27650bee8fa47d,204,180,24,North America,24,1443.56
ea9a4852fb1e45bd9b7f395fff13bb9d,152,95,57,Oceania,18,697.07
ea9d3c4f155f441c871f6afad0b87272,40,3,37,Europe,21,359.15
ea9e69aec2fd49138adaa2d9ff920476,285,257,28,North America,26,2199.66
ea9fdf28255f485c9bdb23bf9bf567f1,364,341,23,South America,20,1689.88
eaa0603682404d72b9cfeb2a58125fe8,58,5,53,Europe,23,337.16
eaa133b3ad804b6f8b771e3f939b6a36,38,14,24,North America,18,195.2
eaa135595db34e648a24a3af643a1b31,365,338,27,Asia,19,2793.14
eaa1dff2a2954a368f02faa5a1a235a5,52,1,51,Africa,24,219.4
eaa27b72cf284d988cf3af5671a62d45,115,84,31,Europe,26,775.53
eaa8bc34e2a74035b970e7826b4b8f02,155,129,26,North America,23,1224.95
eaac87281e224e4a8d90b1a7a92c6548,202,164,38,North America,23,1198.17
eaaf456ead9a41ccb28891a31f599b02,68,49,19,North America,18,617
eaaf538adb864d3597fbd7e7c34e3f37,365,345,20,South America,19,1552.93
eab0bb5c3f30416b974fb053ecd7b4a3,341,319,22,Oceania,17,2577.18
eab152943a5e411bbe82299905f399f1,90,56,34,Oceania,19,731.3
eab25b71c54340d282039ca5943841fe,88,61,27,Oceania,18,516.02
eab52ca221cd4530a504b3ad12a95c8b,256,221,35,South America,22,1496.36
eab96fe5c602403090f4e0b2b9872478,241,202,39,Europe,20,1593.56
eabb6a2520044163b1c808c610c5634d,76,46,30,North America,20,210.32
eabfab9539c6463f89b80baa1d435117,197,156,41,Asia,16,1323.1
eac40c5d43ba4c119a336d6b0a660b1f,99,58,41,North America,23,462.36
eac4c4eafc4a4799ab70023604c3825b,121,81,40,Europe,17,735.48
eac5087ac1e64d5e9b821d6b99195568,365,342,23,Asia,24,2043.89
eac72def835e4423be51fac2c3b34310,106,54,52,South America,22,226.87
eac7734f05704a4e8ffd5df536c55232,196,145,51,Europe,17,667.26
eac789cec0d2405e8b237ae571ee1f99,57,24,33,Europe,21,565.96
eac7ef8ee90b460095509e66f650afbd,166,116,50,Asia,18,523.42
eac835afcfa941418212bfe6950bef69,83,67,16,South America,21,705.16
eac9aee189cd4efc84211cb38b2cb1fe,294,259,35,South America,18,1908.7
eacbfb911cfe4631ba91b01e35cb6010,365,334,31,South America,23,2323.51
eacc6e35da15448bb54df58dfe26d256,364,355,9,North America,20,2623.79
eacf33b42e494c99aae96eb7c0d77ac3,253,224,29,Oceania,19,2072.12
ead31ad5297b4c4e8b797db754e2fb86,266,239,27,Asia,14,2443.61
ead3d79c9b5949a4aef603d21a005d36,331,308,23,Asia,20,3310.04
ead40e67c32b4472af94ea540ba86e2b,169,112,57,Europe,23,1166.89
ead6d57a1c9f44b28ea2f15b846fda69,169,141,28,Asia,21,1400.34
ead8531e22f3413ba3bf46ac4fc2ac2f,119,88,31,Europe,23,887.8
ead8ad3f4b714c8faf63c454f0e2e2a0,79,41,38,Oceania,17,356.8
ead97eed0c764b939458e57ada086d88,365,352,13,Oceania,23,2167.98
ead982db627548b1b3a7ff2496d16591,117,80,37,Asia,21,810.42
eae0f5e058344527b7c0164cdedfdc6f,124,90,34,South America,22,883.09
eae4cd846b6b4793ae8ce46ea226a426,248,200,48,Africa,23,1978.45
eae71cc3b4ad42f1803e06172ea2732e,89,40,49,North America,16,410.16
eae7b54bf5d64a078f10028862938231,229,208,21,South America,20,1863.2
eae881e9df764f2680f62fa0c5812a64,112,85,27,South America,23,834.41
eaeac6bb547c497990aff791f225cf9f,201,167,34,Africa,26,1277.38
eaeae43db2b5428486c5274cc54eabc2,365,313,52,Africa,19,2087.24
eaed200330924ce0b6f82e2f848640d4,243,204,39,North America,16,1454.14
eaf49ea688744918964c9c4147d08d8c,238,208,30,South America,27,1976.89
eaf56b051f4f457fb1d73caded5db12e,266,218,48,Asia,20,1277.67
eaf70b315b854cf4993f17d7a4582d2d,171,155,16,South America,19,1321.9
eafa51c143d844d8bc36834a651afc2d,264,214,50,Oceania,23,1379.59
eafbed04cf314ada9fc92243f43b5bf9,42,22,20,South America,25,574.37
eafc04971f034fb08afe475168dbae58,187,139,48,Europe,19,1061.25
eafc82dd9eea4bc5948556547eb21611,73,46,27,Asia,17,566.72
eafcc84c071c4cf8bcd1a99b1d3bfe64,158,111,47,South America,21,345.34
eaff57860ea142da84e59915c38b3804,131,83,48,Europe,18,446.36
eaffb373fcd44e0aa47b3e0054c4a7fc,365,355,10,North America,21,2951.01
eafff327abb04a27b77edaaeffdaaa97,344,301,43,North America,18,2611.02
eb00a94c65f1446cbce15655b62fcfc2,259,232,27,South America,18,1736.91
eb0318636a5b425fb82102d5f01573f5,157,131,26,Asia,21,1125.89
eb03ac56538e4e7195597c825d37bc33,229,206,23,Asia,17,1740.08
eb0562ac10ce4615afe7b48caada6a0a,365,349,16,South America,25,3296.72
eb0630d888854402a0529a05fbe97aa1,336,310,26,North America,15,2856.92
eb06f9c2f27a47308e310dff5e6ed5b4,242,191,51,South America,23,1608.08
eb0824387d964ec18d514765702d2ca6,365,320,45,Africa,25,1965.5
eb090bf54f3d4ac9b7c5591390b07f2d,313,271,42,North America,18,2201.4
eb0b8f49b80e4077ba32646cb6587190,262,204,58,South America,23,1190.29
eb0d51acecff4667a5b658e5d88092f7,202,160,42,Oceania,21,1437.9
eb0f0bcae0b240738f8450f03807d8f9,127,99,28,South America,16,981.02
eb129904e8414f0b900828f6c69ddcff,128,94,34,Oceania,16,589.9
eb13e14c7dab4951b253bd09338098af,251,201,50,South America,24,1092.81
eb15b57fd64645abaf4359c94c886d09,115,85,30,Africa,24,860.61
eb1a0affab5744fe971ec459a12955eb,258,204,54,South America,23,1190.73
eb1ac358d2ff469d9338be1ebeede4f9,92,44,48,North America,18,730.01
eb1b1ea29e244157a3d38020569a3f20,114,59,55,South America,19,373.94
eb1b2805a642441da49570b2c11b0196,111,86,25,Europe,20,1080.06
eb1d2231f5104ff3b0f10e4454b62ecf,140,94,46,Asia,15,1215.21
eb1d3c309236454b82ed7610e545b40e,146,121,25,Africa,21,1012.93
eb1f017ef264480cbdd03a76fcea9fd2,104,73,31,Africa,15,440.83
eb216871ad82471cb49cdafb9dfda1f1,211,181,30,Africa,21,1286.56
eb224c95c8304ac8923458bd2c531ce7,266,212,54,Asia,16,1488.51
eb232f56530e4d9e8b1e74583393e2fb,79,47,32,Asia,27,731.15
eb250a7b417442d6b330763d57c565e7,365,330,35,South America,14,1218.26
eb25213d3eb142aeb2dfe1ddf1f893c6,204,166,38,Asia,18,1528.84
eb2635a1bc5543bf96c6dc34abfbe01c,74,23,51,Europe,17,199.79
eb2746831dff43c8a6e2a4317b6209de,365,324,41,Asia,13,1426.61
eb275f3b92c54e2296599f1e6e4bf9cf,36,4,32,Europe,24,349.81
eb27729c6a9747aa90fbfce945a3a22e,59,38,21,Africa,15,523.32
eb2999a26bbe433182f288f559e32303,210,188,22,South America,20,1197.88
eb2a81fda6804207a5ae2f26feb658d5,43,1,42,Oceania,20,157.87
eb2b5933362b4bf98410a42848074f13,93,46,47,Europe,21,559.26
eb2c6fc26b394e5d900b237d380de26d,314,258,56,North America,21,1357.88
eb2d7fc5ba1b4a3588ce2f6e5cf50456,336,312,24,South America,16,2135.32
eb2f6c4072c44255bd7c8228e56b3d3c,183,139,44,South America,26,918.45
eb304468ff08460a94b068b19f9ee341,169,113,56,South America,14,631.26
eb30e989365d4755b4198584c9bb027f,186,161,25,South America,21,1411.7
eb32273fc67142e0b2b5c3cffc2d791f,267,230,37,Oceania,24,1670.18
eb324b6e31504379a63d1d490d0d865d,344,299,45,Asia,17,1768.59
eb35ba8ec33e4cea83e99a55415af53a,302,253,49,North America,17,1208.53
eb373cb05b0f4c79bc411d6edbc2000f,311,260,51,Africa,19,1875.17
eb37a78046b64abc93f9fcd59c9a009d,254,227,27,Europe,21,1845.91
eb3a34aba77f4040b9fdd28461d57db3,112,63,49,Asia,23,799.4
eb3db23235ff4a4896a8deed47738944,95,37,58,North America,20,406.36
eb3eef87aff54f4e9176d046a83d293c,363,333,30,South America,17,2088.9
eb3f8a7363ba4f7888ac2184cc847dd4,232,198,34,Oceania,21,2406.26
eb4290c3aa334d7b8229359cb5328916,309,273,36,Asia,22,1960.55
eb4732b54fbd48cfb16c06916126bc4d,209,184,25,Oceania,16,1819.26
eb47e0b0c2e745859ba81d7fa03d4db9,161,108,53,Africa,22,926.01
eb47f336f7c744a99544ac9ed1452825,344,313,31,Oceania,18,2181.48
eb49ee659bc34cbaaffaa8257a76bca7,264,211,53,North America,23,1069.32
eb4d2b824bf049b1916d6e66de2f4d46,286,265,21,Europe,16,2545.23
eb50972bf3804a95b7c8c24d52251e6d,147,96,51,Asia,19,883.55
eb50a1021f124fc69b5640cd68a21bc1,318,288,30,Asia,20,2327.94
eb52ec5305b24ebfb12a91edc9eb5072,179,136,43,Africa,19,1246.31
eb54f5dcea3c49ddaee4c87c8162d211,352,330,22,South America,19,2128.48
eb5536647fd84bd5acf7261eab857487,318,283,35,Africa,17,2602.74
eb55d03ac01d4d76b61a650363f6a321,235,217,18,Europe,17,1946.98
eb566793744b4805807012d114984d69,329,278,51,Africa,23,1490.46
eb5900ed9f4f4b34ab15abe4817d5a28,172,146,26,Asia,17,2010.82
eb59b891956c4f06880705fa59f98746,342,318,24,North America,24,2656.45
eb5bd82685c94696a1ceccfee1fcee29,266,237,29,Asia,21,2271.4
eb600c0a87ba442cbc199c9c14b08c83,364,329,35,North America,26,3223.44
eb601f773bd94c1bb9c9336eb11564f7,116,73,43,Oceania,17,568.18
eb60fd3944b74f87b584ddfd0492c419,365,361,4,South America,18,2693.28
eb61b0ed73414b318c02e5919a9382d9,323,285,38,Asia,21,2069.84
eb64a33688474c1b8e555fcbbd68a2eb,362,333,29,Asia,17,3352.01
eb64a5e3e3344f80b3f4f18dd40429fc,127,97,30,Asia,18,944.59
eb667b454b4943869316da54e6c94e77,203,146,57,Asia,16,905.85
eb67eb11d1144f75a40332726d0cfeaf,188,175,13,South America,20,1503
eb6c9563a34046ff86ccff1785741b57,133,84,49,South America,18,762.21
eb6cabad68bc4a3dbb921f462a5c008e,132,82,50,North America,21,797.45
eb6fcce7c18547d6aeef9189ccf52115,286,258,28,Asia,20,1696.27
eb72b1f7131744b5afde6398f96deb6f,82,42,40,Africa,19,277.35
eb743f7f7bdb4145bc6bc9cd15cbb734,365,364,1,North America,20,2059.44
eb74f1dd6cc74c4d9c78dbece490145a,274,237,37,Africa,22,977.65
eb779bb4127f4ebca1fa142cf8e4c85b,182,127,55,Oceania,22,802.49
eb78ec0b3ee2459e95a3747288bc5857,42,2,40,South America,14,177.34
eb7a15930e724a7894e283dd1c3841e1,292,248,44,Europe,19,2488.35
eb7a9b8df92f4f7a93d841d0413a1867,272,225,47,Oceania,17,1355.97
eb7ab80b3cbd45238caeb56a0c6dcabe,164,139,25,Oceania,17,866.04
eb7b0a53f874438da29d2ae3d2fa7b1b,364,320,44,Africa,20,1963.68
eb7ba17c84da4a499c920bd1023b2dbb,65,28,37,Africa,22,455.44
eb7c111fab8f468b88bc7a2b364494e4,201,156,45,South America,18,1072.69
eb7c422fd3b24a41b59d111710544e95,322,275,47,North America,17,2029.79
eb7ca5143079454a92e705c3dec49e20,188,161,27,Europe,25,1891.56
eb7e24b54cbc430eaa8d4b717aa4c6a3,364,345,19,Oceania,17,1490.68
eb7ea1b60092455f82c99207f07daf47,63,42,21,South America,20,364.52
eb80797ab10e45c88eb8d9d0d8ecd509,172,120,52,Europe,16,902.8
eb8144a4f6de4872beb4c599bec420d5,362,345,17,Oceania,18,1366.85
eb81840a5ed44cf3b7c292707fc80dc4,341,286,55,Africa,18,1521.25
eb81f7e7d5204835b38f83942db2d5be,137,88,49,Oceania,18,589.52
eb828b3aca0047a1865e38d3b6c0c154,256,217,39,Africa,22,1919.59
eb82ff425b434e21a8e3832a51bdaec1,261,219,42,Europe,18,1138.55
eb8428464f8a4b9193c8901b19990024,365,329,36,South America,26,1400.44
eb8475df0dfd4b9980868d6b5b33c9e8,265,229,36,North America,22,1777.3
eb85696ed37448b9822a62642dc4c12f,364,357,7,North America,18,1472.73
eb8626952f60431da6ec51a55d374c46,329,312,17,South America,21,2507.69
eb87b9ad180f466baf61e611a4ccefca,155,107,48,Asia,24,785.76
eb890bb812f84e62b64abd5b944f9aef,39,7,32,Africa,17,388.8
eb89c5e99a7c4546a38c7b53f980e7f7,312,272,40,Europe,23,1407.03
eb8bc3c732ee4accbcc1f0fa97d76b56,319,293,26,Africa,14,1912.63
eb8bfaa3ffef488ba494ba258b18a718,236,207,29,North America,15,2204.39
eb8c16ba007d4f8289084d243cea6434,256,205,51,South America,20,1126.73
eb8e9c40dc2046fd887d7af50149389f,149,99,50,Europe,16,1342
eb8f93766d2e4199bcf18febdf559949,137,88,49,Asia,22,938.04
eb91977318de47ce9f3bcf9725696311,195,155,40,Asia,21,1249.75
eb94266b74284d59b7969a6d6e772560,146,117,29,Europe,24,1325.72
eb9566c6bf8c49068fe634e28d1b1136,214,162,52,North America,13,1346.31
eb97b6798e234981913f5c2788588c91,143,111,32,North America,20,1219.12
eb97e4c2bd1a4b3e9a9d996a6ce4f861,316,284,32,Europe,24,2035.33
eb97ea1a11cd4142abf6d4138f38b9cd,237,212,25,Africa,23,1336.7
eb980059ae6144908289b1e2aed7b0d6,363,326,37,Asia,18,2162.62
eb98e603986845428dd8004769bb6e7f,265,230,35,Africa,28,1996.23
eb991aa35886448797094e9415315ce1,320,299,21,North America,15,2677.93
eb9d6e095f0f4a0aba97c779689f3744,127,83,44,South America,21,757.21
eb9ee83488ba4b85b6ea97379abec56f,318,297,21,Oceania,21,2300.42
eb9efbf6ae284ce5a29a2f94137e6c00,359,327,32,South America,21,2003.5
eba59d1cbb494bad9d09b56e92e7f4b8,317,286,31,North America,19,2086.71
eba686ca6b844a3784ac303f01a8da1f,68,31,37,South America,19,425.6
eba82cc4aab04245b6b4f0a67a25cd4e,336,291,45,Europe,19,1254.49
eba8d06a28af44b89852340f72abfc8d,361,320,41,Asia,22,1928.06
eba8e554f4ed456ea7f088017869c503,189,133,56,Asia,21,660.94
eba9c74bbe3f46b5a9b95c345c5f79bc,66,10,56,South America,22,344.66
ebab1e2042ae4b9fa12ea4b43a8e0a9d,225,175,50,Africa,22,1167.11
ebadb92d0f914384892dd1eb20b28eb7,356,304,52,North America,23,1908.58
ebb0efedec45489b9bfcdd0c94eb7b15,348,327,21,Asia,20,2635.33
ebb40fc62911430f95a94273601d3332,197,142,55,South America,21,1203.13
ebb410d2b5494f038dbcac5e17da668e,223,186,37,Oceania,20,1352.5
ebb782e31bc94d90aa7113aaaaa56ff5,79,48,31,North America,18,569.57
ebb9ed84008c4bdf9b124069e2172ec7,365,351,14,Asia,18,3107.73
ebbb16e11ae24aadb03ac3cb181e3ce5,238,220,18,Africa,17,1836.28
ebc0588326684bf0bb0bdf97b8f1387e,284,253,31,North America,21,1812.61
ebc0df577edc4764b14639a18a9f95bf,317,280,37,Africa,22,2876.15
ebc43c8cfbfc4b1e8709901364bac0e8,130,74,56,South America,20,568.21
ebc55ecaa501415883c388525cd35f64,58,24,34,Asia,20,162.72
ebc5c183c59447d7b09de5f638202dbd,364,345,19,Oceania,20,2608.14
ebc665fe23b54c77ace5e40276caa336,364,332,32,Africa,20,1513.5
ebc911aceabd48e7864a0248f6f3ae4b,245,222,23,North America,15,1697.07
ebc98ccbe88940d9a3f28c0ebfa59931,149,129,20,South America,26,1075.81
ebcb1a63856f4eceb62dabe057e9ecc8,147,110,37,Europe,22,1451.79
ebcbf03f16f648a0aaedfc40b8086272,329,284,45,North America,21,1786.6
ebcc35abd8704507b9da53940c2b3dc1,169,135,34,Oceania,18,1170.39
ebcc686140c34bd987d62f52aa4f827b,76,30,46,South America,20,553.72
ebccb01a20e4472480f61d9e49e03a71,214,198,16,Europe,22,1588.77
ebcea1b385584132b482ca994aca6c08,105,58,47,Oceania,20,474.75
ebceb1c2c9cb43828d3b0214bce05e1c,272,217,55,Africa,19,1428.85
ebd8e5868ccb403fae432862892c948d,268,228,40,South America,21,1402.72
ebd93644df1d4ab49a49f40be32b7976,110,86,24,South America,20,891.72
ebd965dc96a34289a6ec9dc9a3d9f34d,351,316,35,Europe,21,3280.86
ebda0885161641c2b201d80deeaa1855,364,322,42,Europe,20,1951.08
ebddb1ee00c548a19eb7131cb4cc411b,223,177,46,Africa,15,753.9
ebde09dc896247cc939fee103a9bc53b,332,306,26,Oceania,21,2650.56
ebdfc8438a7d4b5990915394f0d08f97,279,259,20,Oceania,26,2273.25
ebe3ff6aa5954c7aba09755cda1d18f9,82,55,27,Europe,26,699.23
ebe58247a867433b933765095b989ebb,178,135,43,South America,20,385.56
ebe8091d14bf420a8725a5ad2c1452cb,117,93,24,Oceania,21,882.28
ebe80ddc01e74d318bfc3c8ed1018429,259,200,59,Oceania,22,1556.85
ebe9deb6916d4e3e839e13e2befab6cc,361,331,30,Europe,22,2508.25
ebebc1fefc8247fcaab96ebc292d7ae3,273,225,48,Africa,22,1341.31
ebeca471de2040a4aea42ebdf3fcae9e,308,256,52,North America,22,1785.03
ebf079730e7545f29825bd508cd2e413,361,312,49,South America,20,1670
ebf09b5ccec6422ebba07e49ec27f372,99,56,43,South America,21,766.29
ebf1febc8b0b42ab8b65ae66dea36295,143,89,54,Europe,22,606.97
ebf24530b5134c2fab78da58507b2e22,337,282,55,Europe,22,1659.82
ebf4b34a94074db09f414633b22f0413,74,31,43,Asia,21,597.95
ebf5ee24b1c746eb8aadef3041a92b41,356,302,54,Africa,15,2181.29
ebf8f18ebc77421eb708dd6cef775abd,365,355,10,Europe,21,1778.24
ebf8fcf61d4a43d0849c1bad264502ed,266,234,32,South America,16,1802.75
ebf90cdd03124cc0a4c91b3d41e78a1a,232,184,48,South America,21,1413.78
ebf92efcf1734391abe291e4b099619a,130,93,37,South America,23,934.53
ebfb668749ff496998ffdd8dac46d936,365,347,18,North America,17,2257.3
ebfe745f18d24ea6bbd84a1f1736cc5c,348,292,56,Europe,23,1788.12
ebffaeb627504aea836f6b890f55f117,337,304,33,Europe,21,1980.02
ec02628cb03b4e83a6e0d49d5460e423,170,138,32,Oceania,26,1599.61
ec054516ce634acdaae4ca689174813d,37,7,30,Europe,22,343.38
ec05f417cd88435a8b667a7bde882691,365,357,8,Asia,21,2755.36
ec06654cb7474bad88054c873a7abf5d,170,153,17,Africa,17,1419.58
ec07dfcddb99490ea25fb2a2fbc88f12,225,185,40,North America,21,1322.8
ec0978a887884ff792e8f1344d4a87a8,137,93,44,Oceania,21,836.08
ec0cdb4e8d9b4e7f83007b6b984221a0,348,302,46,Oceania,26,2058.7
ec0dba84a12745f0835ab3eb944b7be4,113,68,45,North America,16,647.12
ec0dbfaf069746efafe24ff160dd5a61,317,275,42,Asia,21,1681.11
ec0ea0f405c841d29807662b7fdf369b,231,176,55,Asia,18,1151.93
ec10c36d86144e6ca80d26ef029d2ea7,129,83,46,North America,16,1000.28
ec11fdbee0a349a2badd2e2c3c62b1cb,343,305,38,North America,21,2598.45
ec12103c521c4ff5a30aca00cfcb61c5,363,338,25,North America,18,1617.84
ec14efca41cf4647af2537fca4c4189b,47,12,35,Asia,21,387.29
ec152fd7d6e24467b919f62a23ba74a0,282,223,59,Oceania,27,1787.79
ec1589d6752d4261ac5538e66ee6bac6,364,347,17,South America,23,2470.27
ec1616d214d74fffbdd58bcee6ceb2a3,329,279,50,North America,17,2028.88
ec161fbe9ebf401a8a9c67992f8de503,225,188,37,Oceania,18,1438.9
ec171bcda1ce4f0ea60a17afdd75ba36,353,319,34,South America,27,1780.04
ec18199555ff4bdfa20263ae085a4b75,365,365,0,South America,22,2068.7
ec18477da18f43348209ebc0f0e21689,207,174,33,South America,17,1690.89
ec1883aba3944a0099c372ea2f9686e7,188,133,55,North America,22,323.68
ec18f339a8934b5486fc65aa2a2e6e02,326,300,26,Oceania,21,2535.26
ec193fe127be40bb9cbd5abd0408d50a,309,293,16,North America,18,2678.87
ec1b6b586fe640ab8094d25ad5cc6306,103,80,23,Oceania,17,587.74
ec2005a41a3e45f0987514524822465d,171,135,36,North America,17,954.04
ec2007b0791d4a89b2d87db5c3257a93,310,280,30,Europe,21,2537.65
ec200ebca0ec49049b7723e472120199,44,2,42,South America,23,447.73
ec213f113590491fa3337b7e1a85ce11,305,257,48,North America,16,1081.24
ec214183211e43aead9c13165083a55e,24,6,18,Europe,18,134.51
ec21d1eca981473a86234ed510c94045,103,71,32,Africa,18,631.82
ec241097b26f486ca0c0b03a1d587ab7,190,161,29,Asia,17,1761.23
ec2519027e8e4afd8665162f0b05ab78,92,40,52,Europe,13,830.45
ec26a432e9124adbab487f0db1759505,216,191,25,Africa,25,1659.48
ec2af2cd145f4021861ed29a80cf67f4,316,286,30,South America,21,2147.25
ec2ba5c58c254b36bfabf39a89452d29,211,181,30,Europe,24,1757.99
ec2c9728be4d4ea196904f3773e9c927,191,140,51,Europe,24,860.99
ec2cd9e8454541bfaf7fd48228549e6b,74,39,35,Asia,19,710.32
ec2e054fc1a749c78062ea4c6ee0fb7a,53,23,30,Oceania,25,178.91
ec2e0f6aef4644819a104a7bdda7cebf,212,169,43,South America,22,1124.72
ec2e49e934dc4f30a7f40873b98267e4,364,347,17,Europe,20,1516.14
ec30dfacbf2d4f6ead4766c4e4ca0869,94,70,24,Asia,23,577.45
ec313db7e97144feb94f1716a0a9c1d2,89,46,43,North America,23,248.85
ec31b0803f1b476b8bbffe5de0b1c45d,361,335,26,Africa,22,2512.08
ec327c72fe464593931a2d7c0e4bc08c,365,362,3,Oceania,23,1734.39
ec337f85690e4d4f9298d2ef70ecad50,297,259,38,Asia,18,1277.44
ec33ff1f49c5487e897d87b03b216817,47,11,36,Oceania,20,290
ec37757ad2174cf9baf2c727e667858c,365,363,2,Europe,18,2305.75
ec3c1cfbec9e4085a065e4fc968dc1b6,215,162,53,North America,17,857.18
ec3d55b178214b20be7f916389a7e7ec,64,30,34,Oceania,16,623.17
ec3f85fad52947c6a9303ce4bd06512c,314,294,20,North America,18,2514.5
ec42388d10c24ee48ed73005e83d663a,108,65,43,Oceania,16,358.21
ec426646c3754036adb61d6900cb58e2,340,310,30,Europe,22,3076.54
ec481930f96443b78bf1495c33690a2e,364,346,18,South America,22,1719.76
ec49ee1fd4af40c1b7f7f2c153efa9e9,286,259,27,Asia,20,1884.58
ec4b9ef92aa344f0826b75f8d8182067,209,170,39,North America,19,1429.41
ec4c3eb9ff81419aa9fc983a249b6b8c,185,167,18,Europe,25,1432.12
ec4cb6d2ef7a45eeb71fdfd1cbd9363f,60,13,47,South America,21,173.15
ec514fecd0f04bcdb5cf24de7ae82d13,365,342,23,Africa,22,1848.4
ec52b61cec974901813f2070ab02332e,67,25,42,Asia,17,391.53
ec53b31d36f04422af981a3ee0d13f23,270,225,45,North America,22,2255.98
ec560f96f253447b9c542e42798aaf81,145,104,41,Asia,18,1276.93
ec590ad47be448f29fc41c234b6b2577,150,110,40,South America,21,868.52
ec5c1f7ba88045c2902f57265c35c38a,233,183,50,North America,18,1507.9
ec5c28a58a2a4fa599052ae2542219bd,333,301,32,Africa,17,2791.27
ec5e567074884f2b825acf816155dfd4,151,131,20,Europe,19,1633.48
ec5edf405fc84db1b8a305f0c16669b1,245,209,36,Africa,20,1241.51
ec658d450f584515a78210e7c0d51865,75,21,54,Europe,21,457.11
ec6ccccd3d2b4244a5e64264d3635fa4,293,252,41,Oceania,23,1983.28
ec6e3f90e7404174ae8fe17d3c515803,78,40,38,South America,20,659.47
ec7127cd95974dedb9de2e03ab7a9f51,177,129,48,Europe,20,942.12
ec750f9bd227414589ab83b97ef0f4e3,218,171,47,Africa,18,1074.61
ec764602003843a08d75744cd191b470,177,153,24,Asia,16,737.84
ec771c6916984f90984aa48f2b367a03,248,233,15,Asia,16,1514.38
ec783c61427d42abb3382e3a72aeeeec,334,298,36,North America,15,3125.26
ec7cebb5524944a78e3786d4046e60e2,178,136,42,North America,19,1106.87
ec849e95e6224d8aab12307cbd5ce45b,206,172,34,Africa,15,1410.63
ec857556c26c4b2e8ee7333bea0c8369,277,242,35,Africa,14,1778.36
ec86ada178704d6b8d39913115881efc,306,279,27,Oceania,23,2047.53
ec885127fde748978a7cd6331d257e9a,250,227,23,Africa,20,1528.48
ec8966d4723d43b2b16af57ba5644b7c,324,275,49,Oceania,20,2247.02
ec8bab21f96b441a9fe0c7b7ed980382,254,235,19,Africa,17,1898.21
ec8cb131aba94068a8d0e8cc5281e93d,137,97,40,Europe,23,1180.11
ec8d988f471a402983d9685cd07d4111,91,40,51,Europe,21,337.66
ec8db993a6d44169b4273b27c0661b81,58,30,28,Europe,22,299.77
ec8f038f77044e19b701eb3c756450a5,93,52,41,Africa,24,762.57
ec8f9f1ddfd8493da1ca20d7bbda717d,129,84,45,Europe,22,493.78
ec9138b15228493183b68d0408310c13,364,347,17,Europe,17,1879.22
ec9149e6ba684343b33dda89b258d3eb,363,350,13,Asia,18,1703.32
ec93a27e62d04a83ae4c64eef5e927ad,47,22,25,North America,20,252.04
ec944b5f5cb54a7f8231d646d7d47ba0,365,363,2,Asia,21,2359.97
ec96f88116fe4b0eb07017bde182aa78,303,277,26,Africa,17,2351.87
ec972f27661d4ce4b35b416fd125a4bb,202,151,51,Asia,17,1235.27
ec976e5d423948a68000805567d708dd,143,99,44,South America,21,567.72
ec9844c995c64d9abb61c3d7cadeea95,87,40,47,Asia,20,374.4
ec9875836d624782b1920f2aae9ec713,204,165,39,South America,17,1022.44
ec99f996fd734d88953a0ee9d2e38196,244,218,26,Asia,23,1537.42
ec9c2579d6ed470cb73a89d7ba4e3a7b,139,100,39,Europe,23,936.8
eca030efe14e48f6afd29542c2afd21f,364,341,23,Asia,19,2923.32
eca04306760446b5872427560c25a6ed,240,189,51,Asia,19,1645.99
eca04627fceb476f8e170dbafd1cccc4,146,94,52,Oceania,21,475.57
eca2f73d6c66420bbf578a4d036a71e2,50,9,41,Asia,19,265.1
eca416c3496c43be8219d4007f5b7070,277,227,50,Africa,18,1080.78
eca49aeeee0141c8b0fb44d86031afef,211,152,59,Europe,19,605.02
eca8dbde7e37469d99206e0642bd4605,232,190,42,North America,24,1059.15
eca8f79912144183b22e18b70e46e099,358,324,34,North America,14,2398.37
eca921084a384a6da2027aacc5c372e2,157,122,35,South America,19,1135.81
eca9d3cf3ef7407591a98c48e93d07ba,363,337,26,Oceania,20,1622.05
ecab411d0b894956980ed8fc31d563ed,186,137,49,South America,16,809.05
ecaba3a3d44e4a4b8ad64deeb1bd7fcc,136,118,18,South America,20,1562.05
ecac3d09a11a4ef9bc07a465933d0ecf,138,92,46,South America,23,499.33
ecae15100643421d8ca9e2761bd6a130,159,131,28,Oceania,16,895.7
ecb1419ba55c4311871c3d33c65a097b,350,311,39,Asia,23,1876.05
ecb18ea2efce489b8326507e9fb99a88,165,113,52,Asia,20,1011.85
ecb24ab1247e41719706c8bfcb1d396d,264,248,16,South America,21,2047.45
ecb5d355031c4a7bb45b5dd516727f22,205,171,34,Oceania,23,1280.11
ecbb9875f112453d99b36bfd7b92e835,218,196,22,North America,21,1758.93
ecbbb6a23cfb4efcb45324e2d30dcd38,364,325,39,Europe,23,1876.62
ecbbcc821dcc4033816d2004130aaf9c,365,349,16,North America,21,2482.6
ecbd615a914e439796be95e7f88518d7,347,316,31,South America,19,2596.85
ecbe563017a148f4ac1b8b8f429852b0,363,345,18,North America,15,2091.41
ecbf7b084fac4b92a1b624a9b540a361,123,93,30,Africa,18,881.77
ecbfa5e7740f4bf9baa458d66fe17afb,225,196,29,Asia,20,1284.65
ecc26ac95265416680c530e526286f26,181,139,42,Asia,20,983.03
ecc3fa41237d48d28b377f99b0944cb9,129,102,27,South America,19,1288.57
ecc5aea9f1334811a45e7694c3ca0832,39,18,21,Asia,26,366.44
ecc60392456146289583a11b7a5b1420,151,116,35,Oceania,20,790.16
ecc73f409c084f02aa75d36fb0976e78,223,197,26,South America,20,1997.44
ecc812314988414fa63009f5b05cb167,178,125,53,Europe,17,804.67
ecc92666e8a64368a8d2e4418941e0f7,221,178,43,Africa,20,1314.61
ecc93ec6208e4963a9492b4b5711750b,169,136,33,Europe,25,1068.37
ecc9cbdc088c4cd483c00eb33038b07b,189,169,20,Africa,25,1823.46
eccd987fc655431bbcf1586742273b0e,365,361,4,Oceania,21,2945.78
eccdc7de215843298db01684f6acf526,303,265,38,South America,18,1813.39
ecce457d0c8248e8b2aa8212f4a2642d,273,252,21,Asia,22,1696.95
eccee0ea39cd472faea9fb10371ebccd,113,72,41,South America,21,443.25
eccfaeb21c54447ba413dffe605061d3,183,131,52,Oceania,23,894.96
ecd02d03bf3445d3a6eb8207653e463c,125,96,29,Europe,21,952.56
ecd092e3183645b0b47f7b67807b2323,215,186,29,South America,18,1777.8
ecd10a5a57974261a0cd4137c229b56b,82,33,49,Oceania,18,388
ecd1123f5dd04c11820029dc1239f762,86,57,29,Oceania,20,1063.25
ecd324592c0d4b35a376ebdbba458845,363,311,52,Africa,12,1305.57
ecd36fd7b36b4be397337b482d731fd0,343,318,25,Europe,18,2807.13
ecd4021f8fd6460dae15372724a4bb84,73,21,52,Europe,21,312.71
ecd4fc625ae7471d8d5dc4f1feef2052,348,301,47,Europe,20,1723.66
ecd5de584ac9495e828acd0607ae0939,315,281,34,Oceania,22,1631.88
ecd60bc8d2664c0cbff0edf3fef120c6,177,123,54,Africa,17,657.76
ecda896e6dfc46e0a4084c9c8d1dddd8,99,51,48,North America,16,360.99
ecdb5ca8538d49868939512eb2bd5dd3,297,261,36,Africa,19,2189.31
ecdbb70bc11d4418a399145fe05894be,315,277,38,North America,16,1806.67
ecdc5cfb467b47d5a17f05c31be6a991,155,118,37,North America,20,683.91
ecdc99bb7acc48bbb9fb0badca692601,324,288,36,Europe,25,1915.81
ecde3ab121944248bf3281943308aee0,186,157,29,Oceania,20,1530.25
ecdf8ac5c72a4fe5a20d6da9274e8cce,317,267,50,Africa,16,1429.61
ece4baea772d4fc0a3976848234fe389,285,236,49,North America,23,1456.23
ece9cd528cab4dfca9f1d90025c1059f,169,143,26,Europe,26,1262.23
ecead3126e5a46f399b4a2ed2fb6c899,70,14,56,Africa,24,271.04
ecee58c5d1ff4eee9221053151effa05,167,122,45,Oceania,17,1128.26
ecefcfbe9dbc471fa3b335f3319171b7,224,194,30,North America,22,1385.75
ecf3a448818d4545802f82a38abe6ce1,365,360,5,Africa,22,2781.76
ecf48e866ba841c790856e103756bb5a,212,163,49,Europe,15,897.29
ecf70bd60158435999b4de08aca7bcfb,361,326,35,Europe,20,2267.48
ecfa09ceab194677ab8cad40cb277fc6,110,78,32,Europe,23,886.55
ecfa2c0b863b4c2192b0cd458584a6a3,73,46,27,Europe,28,550.25
ecfb59b713a143f4bd2c28cd02ce79b2,54,15,39,North America,16,405.94
ecfc56e6035945259e71278480f50b90,316,285,31,South America,22,1932.64
ecfe62a0691c471892f8a7b0be00112b,199,160,39,Africa,20,2324.71
ecfe71b780aa4e42baa70810f07fa559,193,141,52,Europe,26,920.2
ecfe8581c8e54ff0996843b98219f882,304,273,31,Asia,24,1963.04
ecff1e6b19d34165872faabd4a709d55,285,239,46,Africa,17,1381.11
ed0004ff14bd4859990ca0e811af60b7,93,42,51,South America,21,623.19
ed0066499b504f3a8ac1868926716277,97,65,32,South America,20,850.11
ed01e32699d944b69b478daedfcd3517,61,35,26,North America,18,314.65
ed0397200b2a49ae8e9cb4747dfece96,327,278,49,Europe,20,1743.91
ed0418d6c9ff48e4a3d7dbd5648e8e20,99,50,49,North America,24,497.98
ed0441d32db5467991354a4bbc0018d3,94,45,49,Oceania,18,156.04
ed04a8c3d61146888d1474ad833f4f46,108,70,38,South America,19,574.13
ed04c3e40b7e4e0098c7a6965517c911,58,37,21,Oceania,26,331.96
ed05b7417010484e902fe516e162f4aa,332,294,38,Asia,26,2332.53
ed05c6714ad24e70b3bbd1862a4acac2,179,129,50,Africa,23,773.53
ed07ae9b86c84162b923f1217844b745,283,243,40,South America,15,1677.96
ed091e97d99f47979ead2e052102057a,181,148,33,Asia,19,1592.75
ed09fb8e497141e8a142a65a061d7e61,363,325,38,Africa,18,1460.96
ed0aa3c545fe4d3baeb2f7145aaf8893,298,273,25,North America,15,1905.31
ed0cf485a21d428ba91166a10ddcf158,331,290,41,Europe,24,1594.12
ed1297135c684f21b475dc93f3e8b2a0,132,106,26,Europe,21,728.39
ed130e0d7f404296a3655633c6356989,58,11,47,South America,21,269.48
ed15a11965ef4c7eafd42ebee58039c7,70,27,43,North America,18,188.02
ed1609b3264b4b4cb7b88d9af266e6af,232,197,35,North America,22,1370.01
ed1618905b414eb195a806c075590d48,269,248,21,Africa,19,1968.68
ed1a98ecbdbb4632963e4586682c9207,365,333,32,Europe,18,2090.88
ed1ab6a8522d4275bb7444e1d247d229,206,179,27,Africa,17,1631.82
ed1c6c6d8c574aeeaa3d0b7ad898b334,293,247,46,Asia,20,2290.64
ed1ebcb3dce5439385c1d8c655843fb5,289,258,31,North America,18,2533.27
ed1fa4a5fcee409f9cdd20b231bc4135,302,259,43,North America,17,2507.6
ed24e674dd444ab3a7f6d218f5260ea9,181,136,45,Asia,18,1677.06
ed26956f52b84ee0ab636dc3e08487f1,334,308,26,Asia,21,2947.06
ed27d23c16664c0aa3ad551e187d4652,162,127,35,North America,24,1174.32
ed281a52cf3e4b528a1380d122abecd4,139,97,42,Europe,19,743.21
ed2970f6668a496a9eca8df004ed84dd,313,257,56,Africa,20,1376.86
ed2bc6870a824a5991b67a268d05d402,118,86,32,Asia,17,628.3
ed2e4ad833774ffd8dde85a3db5adc83,99,61,38,Oceania,20,493.53
ed3049f0210e49afb55f097e9249442e,363,337,26,Asia,23,2011.95
ed31aa10623e492bad509b8a864dc6c6,302,262,40,South America,17,1972.32
ed3631c9f5c84a0b96a192169bac4c06,42,19,23,North America,26,169.79
ed387b9f1b454a5697f6fa6ead8bdbdc,312,278,34,Europe,15,2071.93
ed3a143e5925418ebb27f22a4213a6e2,233,200,33,Europe,17,1855.95
ed3c0115c6704ae6ad85e330f67a0628,248,216,32,Asia,23,1419.75
ed3cbc17e7714275b55018fdf71358d8,230,203,27,Africa,19,1686.78
ed3e39ecf2c54f79a0f323262ef45f54,199,168,31,North America,22,1580.04
ed3f33ee8bb54c16ab5cf75d1c9705f0,365,343,22,Oceania,19,2576.43
ed3feaa9ac374594b49f37606a027e9b,66,10,56,Europe,23,319.58
ed40476804b741ccbd3dd1917e1da1a9,104,70,34,Europe,18,569.59
ed40b907854547aebd99c65618944000,97,61,36,South America,22,634.07
ed4238a7450146e0b330df0b9fbca3f3,205,184,21,Africa,22,1586.29
ed43e7b372d840b08403814d0e836339,253,232,21,Asia,23,2077.36
ed445321cfa2462d9b8b25c07610ee79,242,199,43,Asia,16,1402.54
ed44e361afb6401e91af7dde53b92cbd,299,254,45,Oceania,22,1290.17
ed45fa901ae7426a9acc9b4c4fec1a5e,121,81,40,Africa,23,987.51
ed48de0a716849989181912455db119b,194,151,43,North America,22,1047.67
ed49aa28d6e4474dbc571f50e66d4b25,117,89,28,South America,20,1114.62
ed4ae18af3814111b50ccf5e57c1dd58,358,316,42,Oceania,21,2042.64
ed4c1023a41d4f2f80cb41edf41f62f2,69,13,56,Europe,22,397.64
ed4df05f13a5407cba049fef8a0735ab,282,230,52,Oceania,18,1558.86
ed4eb628b03448f093b860e74902776b,337,286,51,North America,17,1591.48
ed53f49066be4f838804990fd590d2bc,126,92,34,Asia,14,1354.95
ed557742c7354503b1b53d31b3c264cc,365,337,28,Europe,23,1743.62
ed561cb2aebe4dd8af72ebb37116feae,284,241,43,Asia,19,2175.44
ed57f9db85004e3fa20ab0fdc307307e,264,223,41,North America,16,1956.47
ed59d3d32852456480522ef9971ef6ba,237,178,59,South America,20,977.25
ed5a21645a904f078b1a6d20a258fa62,80,39,41,North America,25,771.9
ed5a649c9b014c6d884a8c7fd389d9d1,171,134,37,Europe,24,1357.83
ed5af262ba4e48c8ad8c665f103f8175,72,33,39,Europe,15,293.75
ed5bd5f7b7ab4bdebd18f90e1e6b3188,108,74,34,Asia,20,1079.21
ed5bdc4d756c4fa3b4d76191638fce49,289,269,20,Europe,25,2090.39
ed5be57740904b1682b9db882f2a7178,272,227,45,Europe,24,1714.47
ed60820297a94f819a478eca6dd31f28,177,151,26,Asia,21,1257.26
ed60c6fc6bed444ca7518bb401ec5c19,364,345,19,North America,20,2478.73
ed612d9159dc417cb706306ee7396822,323,278,45,Europe,20,1405.49
ed613fcaa3d4422bbc91b098c1338ec7,278,228,50,Oceania,12,1437.1
ed6200cd5fb14e73a05e486945392754,354,335,19,Europe,21,2372.05
ed638da56b084fe98cf9443ce24613b1,125,95,30,North America,23,536.33
ed651335e13f45fb939b8548bf3db467,282,239,43,Europe,17,957.14
ed68b13e92e34a749a092231165105af,49,29,20,Africa,18,344.2
ed68b1fa55674825938debe32381b0bf,70,11,59,Africa,19,390.33
ed6a6901b00a4d3397649bf479b7fee3,217,185,32,Africa,15,1678.28
ed6ce2eda8464b5c8e3490f49907c603,361,342,19,Asia,20,1449.26
ed6cf1afa4ca44ff9cc3320ace2aa15d,109,78,31,Oceania,20,769.07
ed6d82ba79214a1db274a2f28827e28d,365,336,29,Europe,18,2237.52
ed6f1b33dbd5478f8f9a529a3673a8c8,50,20,30,Europe,18,231.71
ed7062fe75ae467da935eae182e1a08c,299,250,49,North America,24,1813.45
ed720422411241cd805af7a41578e7e9,315,278,37,South America,24,2188.37
ed72ae76d8f548dcb9be13f272b315c8,168,145,23,North America,21,911.95
ed7536ba11f540a0ba5ad2a468958d2c,210,174,36,Oceania,22,1214.55
ed76922e3673447695e9ee14e57c1df2,345,313,32,Europe,20,2736.95
ed7744278a174221b6a8492c68cd9ade,365,334,31,Europe,20,2383.25
ed77928afaf248fbb108a75e4d74d264,189,150,39,South America,19,1428.19
ed7db3f587874f68a24d0c3de3a3772e,56,31,25,Oceania,19,283.42
ed7e977e55ee46f3aea97da39b3b02bb,81,50,31,South America,20,657.82
ed7ec7166b0846d6bd8550037559f96d,64,22,42,North America,13,251.46
ed8068c9efee42ec909dc1ac00a64c60,159,131,28,Oceania,17,885.17
ed819fd9b97f4aab82b248d5b90c600b,305,259,46,Oceania,23,1609.31
ed81e2f611d64ee7a7f868625d098229,59,7,52,South America,21,135.85
ed82543503cb4ed68c5fd5b3fbd328e7,334,320,14,Africa,17,3361.86
ed8309e1a2364acf82769f5df62de654,364,339,25,North America,20,2680.32
ed83718de3db4d648a18210007398cb7,182,138,44,Africa,23,722.73
ed84d7511ffd485b8c7b5d91077f3c1a,198,154,44,Africa,19,957.59
ed868b228c5c4c1e868ac3d9c6817e1b,225,179,46,North America,18,921.82
ed88e040e4fe48378c8c3586ddcab7bf,140,98,42,South America,23,888.68
ed8926c0e72d4fdcaa8e662e671bbd31,42,5,37,North America,24,169.95
ed898c3504c04f6192e79250b7fae1e6,168,136,32,Asia,21,2006.82
ed89c204c80c415abdf38ebd9818d3c5,253,223,30,Europe,20,1862.62
ed8aa4312d444ceb94893b8143eaccf0,278,253,25,North America,21,2656.16
ed8af7fa7cc8403bb9c99e3c4234a199,126,86,40,Africa,20,1156.4
ed8b09a827244da78b28ee3de852fb3e,65,9,56,South America,20,302.68
ed8c243ea89f4451adc7baf9ef1a132d,112,51,61,Asia,26,544.56
ed8e57c85d644a638b6a19b25596ad8d,72,54,18,Asia,20,551.02
ed8e9496a34b466d9de1f036928e4adb,291,246,45,Asia,27,1035.22
ed8f6665507b406e890958a50ccc0b69,265,244,21,North America,21,1861.56
ed90e046ae1e43f696a0cd66c11766ee,128,74,54,Africa,21,843.43
ed91e5316eab4c6ea91b3c659b4cc8d1,365,365,0,Oceania,24,1416.81
ed980d3d0b824de898b4582de3af1ed9,265,220,45,North America,19,1762.6
ed9c33b2a0294b30a55ca7966ff649c3,312,275,37,Europe,21,2231.62
ed9d53ca421247e399ec79b9e75f2ddf,164,131,33,North America,22,1234.87
ed9de7b2da4c4516be552564e660ad8c,319,284,35,Oceania,16,1961.82
eda0659fbcd84503bf2f02affd0c5163,162,110,52,Asia,21,804.55
eda129de4c2c487290b4699d4589e42c,190,151,39,Europe,16,1737.25
eda1f9f209974b75af4b55d548895ece,280,258,22,North America,15,1936.08
eda568735b184edcb83c22f078616b36,185,151,34,Oceania,19,1519.73
eda7beff061f44fcb45e1c5550588ff4,274,243,31,Africa,18,1773.53
eda94ab9b21a4efe86f5884d550836ed,281,234,47,South America,18,1227.18
eda9e618e4484e0897f60f437398b527,292,258,34,Asia,22,1769.52
edaa2deeb2d24429b5e01c29cfb71ae0,307,258,49,Oceania,21,1666.78
edae433a2d674af1a71fb3993f9123d7,284,242,42,North America,23,2066
edafb6974b4747458eec724abe2747ad,225,199,26,Asia,19,1105.61
edb009fabc774c14b0c4a0195cfa1628,338,294,44,North America,22,1679.71
edb1634109054aaba169b94d4d9e3cab,234,178,56,South America,23,880.35
edb1bdd907bf48c1baa263a42da0c1ce,130,101,29,Oceania,19,980.55
edb2250b256b4f149c92940fcbb19976,293,260,33,North America,14,2158.78
edb31c2d2c184e71a559fc0342b5493e,226,173,53,Europe,24,1190.69
edb6410af90a4db981c697dc8799032c,365,360,5,North America,17,2240.98
edbbd34b63d34653a35d9494ec99aa0c,155,100,55,South America,20,850.28
edbca510454c4c61aa6c2fa0259efabe,72,31,41,Africa,20,559.66
edbdeadfe54542199a85748ef792f2e1,120,71,49,Oceania,19,576.67
edbf430f1f094442bbc9f558b0341625,111,63,48,South America,23,790.33
edbf67a265354816b4b57c0f139fa2f0,281,239,42,Africa,22,1650.48
edc05fd00a23485aa85d31722fb6616c,365,363,2,Africa,26,1427.92
edc41e8837c64dac95e14c37898bd17b,112,72,40,Africa,21,990.52
edc59045d973472f8fecc5eab99efc59,358,307,51,Europe,20,2260.84
edc8ee5c55c5471f88094bd6fe811eea,362,362,0,Asia,21,2416.59
edd0c6c63c2f4d158198a757400befea,340,313,27,Oceania,23,2782.34
edd31bf2309742f5be4e8d04c8019fad,28,5,23,Oceania,21,84.99
edd32f9eda284aad8c2f62996c730814,89,49,40,South America,22,602.71
edd3a7932fff4fbf949ab3cf4db81bb3,69,41,28,South America,21,297.43
edd468d0d4874f26b966776ea52d7fcd,266,228,38,Africa,21,1523.34
edd5484ad9224f33840ae618516faf82,68,34,34,Oceania,22,259.13
edd55693e0344d9ea276f4c072081fd9,260,231,29,South America,22,2084.89
edd5730a3a97460993d0e9b83d263cb6,278,240,38,North America,20,1553.49
edd6452e03024ca29e3d99017087e5c8,77,25,52,Asia,16,445.54
edd9886be3f74e1b9eb1c31c746ac998,261,212,49,Asia,19,1487.53
eddbe8d33cda491695a0c1321965737d,32,9,23,Africa,17,279.96
ede6512212bc4ea98f83742d69e4e06e,327,290,37,South America,20,2896.32
ede95d54e1364214bdee6a9b077f3afa,119,69,50,North America,18,881.14
edec21212b08461bbfdc204251d59086,354,305,49,South America,20,1057.52
edec663d08514e398ab6c617bb4faa9a,142,88,54,Africa,21,767.56
edec70d53e0647008f02f0d66af152a4,112,88,24,South America,20,892.69
edeca3fc8be34a8faba00aa8e22241ff,328,273,55,Europe,25,937.76
ededa33629c0453ab0ebae0af0df568c,158,133,25,Europe,20,1166.52
edee3091a1824c588ecd06cae6991978,204,160,44,Europe,24,801.8
edeecbf8e3bc4d4a81e436e580e64395,92,46,46,Asia,14,274.16
edf325b9e0d14e50bed8a79d446cf6a7,296,247,49,Europe,27,1679.83
edf73c6b7125410d884057cc7a0d89ab,299,250,49,Asia,16,1345.74
edf88e3b10ca4a3d99846624b9fd5efa,192,140,52,Asia,22,833.72
edfdeaa4d22046898202ab52102bcfa0,287,239,48,Europe,18,1718.1
ee00eb41fe0d4081821ca6b7d343a81d,360,359,1,Africa,24,2980.52
ee02748a219d44d8ade3c551accf8eee,159,109,50,Europe,19,483.25
ee04cacb42194094a6bdd03d2ab621e0,45,11,34,North America,19,415.83
ee054c10c2ee41739efbdfe8d1a656bb,85,36,49,Africa,23,373.88
ee0566cb182843f392d6acd175c8e6bd,145,123,22,Africa,20,1349.73
ee05a3c5653e47dc8172e6212be163d4,159,131,28,Oceania,20,1279.04
ee0666ceb2614353933044eb700e4e7b,138,94,44,Oceania,18,505.5
ee07466800dc4eb29200d9574cb2f5ef,135,83,52,South America,18,669.96
ee080d55d3784b3497b131750ac49c2c,112,69,43,Oceania,17,812.42
ee0b6d5bf91c46d79dbd23c3df651448,240,201,39,Africa,20,1523.3
ee0c9cbcf8b64272a8529f84369db7e0,313,290,23,Oceania,12,2198.49
ee0d6dc4309e471fa91e71bb3f59f0c1,64,16,48,Oceania,26,345.55
ee0e5d57a3354a6fa42f3495f32295c4,68,16,52,Oceania,23,532.81
ee0f3459f0ff45b3b7e9622a6fb82b31,309,257,52,Asia,21,1860.25
ee115faf584b4156ae53f3255b1aa22d,186,139,47,Oceania,21,875.39
ee11714a105e48a3a30935f7089112c6,219,194,25,North America,20,2009.64
ee124de2dea543789c92bd97d1122cd7,277,236,41,Oceania,18,2591.93
ee1548f403c74644b61e8d07efff723c,83,65,18,North America,17,581.53
ee16221924fc467b8c6e8079e44231f3,330,280,50,Oceania,17,1656.65
ee1719d117cf4e129a212959bc5b7b3e,63,26,37,South America,22,439.07
ee1aad47ab3549d2918f66360e18f3d8,57,19,38,Oceania,21,643.8
ee1ab84eb86f4aa9afb2ef5ea50573b4,178,146,32,North America,19,1429.89
ee1e262a081f411e985536f5748173cf,340,295,45,Europe,21,2121.67
ee1efd90ad1c4eafa976dc3166bcf8ad,297,280,17,North America,17,2215.33
ee1f9d7b9bc942b380cbc7141f8da451,231,188,43,South America,24,1895.21
ee1fa514a02040d694d44b0a194b3c95,41,19,22,Asia,22,282.58
ee20d289d84c45568356dbe41ae719e6,48,21,27,Africa,26,347.97
ee215791073342eab7f8b0106d90566e,242,191,51,South America,22,971.58
ee217a5ebbc741b4ab48b0d49094bc10,363,342,21,South America,20,3349.64
ee22962037364f51a170dc3247816461,151,124,27,Europe,21,1314.46
ee22c89b1f174763b9c0fc7bc7869131,240,182,58,North America,24,1893.73
ee243d8078e949a4b4ebdd71df9ab42d,364,343,21,Africa,15,2720.39
ee2adb3d863e44998f091c746a757b38,169,137,32,South America,18,796.5
ee2bfc2b53834845ae26951329ee7f5b,365,332,33,Asia,22,2870.59
ee2c861db93e4045b744b127f31b514a,98,52,46,South America,19,536.87
ee2cce36327047dbb83567d1bf610229,84,47,37,Africa,21,908.11
ee2d462a5f584ba2b166145955ad2748,118,87,31,Europe,19,1113.22
ee30456afbba4dedb188cf9a8e4d15eb,301,247,54,North America,20,1165.19
ee32eeff1a0e484abe08d1c1ef398063,359,321,38,Africa,21,1673.9
ee3443697b974b37ad0cc0793b8a93d6,328,285,43,Europe,23,1749.87
ee34f143e62d44faa5541f11d8817e2d,302,271,31,South America,25,2455.49
ee368560a1e2411cb4b0330879593392,359,323,36,North America,15,2727.53
ee37abf44176435aa6d7a1c23d0fef0a,364,337,27,Asia,21,1439.78
ee38b1c26b484c65b7ecc91183bc2fce,288,246,42,South America,21,1475.38
ee397f7297434ba187f0f8b31ec44331,357,319,38,South America,19,2130.41
ee39d88a118440be9e9155ffaaff9dc6,332,290,42,South America,19,2116.71
ee3c86fdee7148fd9267a831af993889,65,46,19,Asia,16,181.67
ee3d624b764e4f348c58e0f7cdcc1029,221,185,36,Asia,21,1894.82
ee3d7d4148fd4f39afa935ce104a1c6f,365,346,19,South America,25,2537.84
ee3e010c5e3f4fcf84c48b64a13db3e5,220,193,27,Asia,20,1784.07
ee3f1caab4424c9cb50f4022b32e6fdd,239,216,23,Africa,23,1508.28
ee3f2e0ce63e4387882ed69a90186b13,247,219,28,Oceania,20,1355.76
ee3fb0864bf54d7c94aee91414e8e7ac,337,327,10,Asia,16,2177.28
ee40d832103443918a5b4582986cf5ad,180,146,34,North America,22,1316.47
ee412177b63d4d1f87162eeec37f1667,85,29,56,South America,20,281.18
ee443b25296e4112969c0c1780a6d947,282,224,58,South America,14,818.19
ee4442ea1f74429db7fe60594ba4b726,79,45,34,Europe,24,630.05
ee44457811654bafbba79c8ad3095d34,214,173,41,Europe,18,1385.49
ee44a5db00294a44a626dfd7468cf7c3,203,164,39,Africa,23,1070.44
ee45b1fd825d4e0e92ac3548ddf9b454,241,195,46,Oceania,20,1041.44
ee482eaaa51d45529270fbad99ba47a1,364,341,23,Oceania,13,1704.58
ee4a140054684a4b8bcb8a5f3f4be2ba,149,117,32,Asia,21,1241.17
ee4a5aef97854ff1af7e6241742918a2,161,138,23,Asia,20,1151.72
ee4adceecbd343178bb3b6dcd9be173b,316,289,27,Africa,16,2877.32
ee4b1d25a62f4129acbdf93228baab25,362,359,3,North America,19,2628.45
ee4bffec69e94ceea34ef30a73a13678,229,176,53,South America,22,1137.98
ee4d95c286d848dfbd124423aaea0ea0,225,192,33,Asia,20,1859.51
ee4e3f322989408dbb24da9bea08694f,123,92,31,Africa,19,620.85
ee4f3f97a949453cb013dc23a7a7bbf6,111,84,27,Africa,24,1012.81
ee503ccd23ca43bc865cfa8cbb181bd8,280,226,54,Europe,14,1679.1
ee50bd9847f540029996d71cf5d56714,172,159,13,North America,18,2449.49
ee527bc3b9114f0a8ee937a6f90f8974,135,101,34,Europe,22,693.65
ee54ac5e168b4aaaa9b23f12e6cf97cd,319,261,58,Oceania,22,1367.78
ee54f3a29b3a4eb58759217cbcda86a6,364,360,4,South America,22,1703.8
ee556b09b34f4e1496ea9993805ca4e6,128,84,44,Africa,17,1088.96
ee579d81284d462986ab73d461ed7885,180,146,34,Oceania,15,684.77
ee589eca22a94d779ead5e1761ceeca7,228,173,55,Africa,17,1076.11
ee5a6121983a4438bf49831047e403c4,141,92,49,Asia,21,444.35
ee5ad94fff8141ba980f2591cb6ad35d,197,150,47,Europe,16,1071.22
ee5b83d481d1488e8e681924f7e5b6e1,365,359,6,Oceania,20,2917.24
ee5ca4069e824c049903dcb23893cae5,69,33,36,South America,20,424.81
ee5ca9d82206494eb7751a49d39b18de,336,290,46,South America,21,1408.82
ee5d07f862fd466b889e90527b6c635f,294,262,32,Asia,20,2246.4
ee60a050bfed4095bede7997ed6aa47b,364,323,41,Oceania,27,1399.5
ee60e610f25743d5b00fe7c19a625699,234,182,52,South America,20,1260.38
ee6445f3175f4f0599edd45071110431,77,17,60,Asia,22,214.93
ee66893eb6c14ec486b843182f3e70e3,365,319,46,Asia,21,1448.5
ee66de6a8f164fcb8520c2cccc2a0d29,365,363,2,Asia,24,2367.32
ee6814654deb404f810ac9876f0aa460,41,16,25,South America,24,164.8
ee6c2b359cad4bc39cd1884b324f5186,340,300,40,Africa,20,2754.89
ee6c32ed45b6452daae1bae22d3f9f6d,209,157,52,North America,15,1228.22
ee6e240c80254488b9604a48bdc62151,87,46,41,South America,19,490.82
ee6ef30e008547f9a90c4ebf01a3ee6c,105,81,24,North America,20,1143.88
ee6f4ebae4584789a37f9847c0f29a60,318,297,21,Africa,17,2137.53
ee706140b6b14a3e8eec5648ef07a7e5,41,4,37,Asia,16,435.81
ee71b57df58c4020a350468a24a797f7,23,3,20,South America,20,70.6
ee788c52c2ca4a2fb6ae913856f219ad,281,245,36,Asia,18,1681.71
ee78d0d9257043788d2ecbc00e076aa2,121,97,24,Oceania,23,1038.18
ee78d8cf380749979ae36539451eaa97,182,146,36,Asia,16,947.2
ee7ca1da6b504ed383ed73930be1c401,227,200,27,South America,19,1874.09
ee7d2eddeb0b4152a74aa0bad7f95b26,278,223,55,Oceania,18,1562.21
ee7e57f9872545ad993093f34492ddf9,248,216,32,Asia,22,2404.96
ee7f7b5fdaa6404085c74e76cc037534,362,361,1,South America,19,1103.61
ee83b8a2554647599d852f0d08d29f41,208,167,41,Africa,21,1362.3
ee83d4538bfa4ac78a26dead55bdb1f6,360,318,42,Asia,18,2807.45
ee8490c7bc164c7d87f84fdc5777fee3,353,313,40,Africa,21,1631.72
ee85d79bdaab4e17b8f0edafbcc82f60,33,5,28,Oceania,22,143.33
ee876279c11143d5978d6c4de492a7c6,92,60,32,South America,21,961.76
ee87a1f2db3541508eeca173c8418439,181,144,37,North America,24,1232.29
ee8917f2230648008bd69c2a8b89b344,119,78,41,South America,14,530.97
ee8a183ea24a491b97593860338d6fda,178,136,42,Oceania,22,1028.74
ee953d27cbc1453eb031dbc0291de48f,149,101,48,Asia,21,383.37
ee9745819c1e46b68137475fa3f22656,41,7,34,Asia,24,400.13
ee9926858a85427abfae9c6594404993,66,29,37,Asia,14,457.15
ee994dd7c18544a6b3e16034458bb4dd,365,310,55,Europe,20,1769.13
ee996cab24f44c0da4df29c5062b5ff2,270,233,37,Africa,26,1739.44
ee999b3a1135428881e68d2372991075,186,129,57,Oceania,16,1243.45
ee9a0ce178e14711b259d5a7c8016f75,102,53,49,South America,16,726.23
ee9a3dbeb694431eb27f551a2976d047,290,239,51,Oceania,19,1320.37
ee9a3fc7b0424d5baaee194dcf25c134,111,61,50,North America,22,662.38
ee9ad6131f924ef1a058275d7b3abb29,329,300,29,Oceania,24,2118.77
ee9b5367703541238a44a2c41e865654,364,349,15,Africa,23,3167.47
ee9d7e4387c4416fb627cfa881a8e7cc,364,343,21,Asia,24,2687.69
ee9d9c80f8e04b6bb20bef7f3f84210e,284,261,23,Europe,20,1788.38
ee9efa82acab4d82ab5955a7cdabcfc0,112,59,53,Africa,19,547.96
eea113bbfc1b4801aa79f813253ed5ab,364,323,41,Asia,16,2102.24
eea1eb1b0fcf40f6a889345063874f40,303,277,26,Asia,21,2823.8
eea42d06f46a48559e17526709083d49,56,31,25,North America,20,694.95
eea69176e9334d27949594f4799a4d0c,86,41,45,Africa,22,661.32
eea6f6f0799743ca807262b4228ca296,80,38,42,Europe,22,813.72
eea872be14e540b1ab23300de571fbe4,82,45,37,Asia,20,504.97
eea9ab64c4dc407b9a91a9074b7e85f5,98,80,18,Europe,21,544.28
eeab7a8f56574dbf99b2184f0d486967,220,184,36,Asia,17,2005.05
eead66cde5ed417aa09ebfd2af5b2d29,178,128,50,North America,22,883.63
eeae3965b1dc420b85a270c4bc0c7252,246,206,40,Oceania,20,1291.37
eeb187eaa4d240b286896985075fd42c,283,257,26,South America,26,2771.28
eeb5824371ae4886a98cb04b04533d49,107,86,21,Africa,14,611.51
eeb747c4fe454f8f98894570dbf685f5,363,310,53,Oceania,22,1594.56
eeb8efa8da02430a8e5ec21db73a73d8,83,53,30,Asia,24,506.78
eeb93953321f4b3f8de30a89a1a62656,50,7,43,Asia,19,674.01
eeb9db3212e84e639afbd36cf39aee88,301,274,27,Europe,21,2256.3
eeba3782e86f43fbad16c16d8fa024f3,296,259,37,Oceania,22,933.93
eeba3fc7caf246e48b741f69ff621aad,44,7,37,South America,21,317.68
eec19df7afae49d39d50e7af77dc9f07,298,252,46,North America,20,2070.27
eec3d1ccdf98435c8eccac49cc686b75,286,259,27,Africa,21,2615.04
eec3e2c6694d4500aa295df82b99b649,219,176,43,South America,16,1175.52
eec41801083a4017b2ad14aa28da6061,273,227,46,Africa,20,1703.03
eec447c33f6a4641923b14da3f54b92e,187,152,35,Oceania,16,1250.79
eec4fba605ff47d4baedeefe93ce8d16,335,304,31,Oceania,18,2265.53
eec5015c01b84307b57ff0a95a8c835d,315,257,58,Europe,22,1587.77
eec742045ee5462e963e9c86b8952523,288,238,50,North America,20,1282.91
eecd88e184a14003a2813da4ee1f8b82,107,57,50,North America,17,747.99
eeceb3d13c17414ba0679db8a9939ab2,363,331,32,Asia,18,2074.64
eed176e5e1e24ed5830887e81f00b328,219,166,53,North America,20,854.23
eed6638c05f3464ba600cc4900ec1e2a,142,92,50,South America,17,741.12
eed7556d60e640a39e060ee901f7f38c,356,318,38,Oceania,17,2475.97
eed82926a54b4d78b1a365fc58dcafbb,97,49,48,North America,20,972.29
eedc6ad9deab4821a749b99d0b1ad653,320,296,24,Asia,19,1590.69
eedcbc1c75a140f18190af458b8a172d,226,191,35,Oceania,22,1692.04
eedea2bd95e545ac8b29528a991a4b70,346,299,47,Oceania,21,1619.33
eedfb266b6f44488aa3695664daf78e9,96,57,39,Oceania,21,826.4
eee044cd383a4479861a276efc90810b,362,327,35,South America,24,2084.81
eee103fb728f43c090a296e924853f9b,335,299,36,Oceania,16,2372.21
eee2d67071d743379b58c7ab07beafdf,259,231,28,Asia,24,2409.48
eee3593bdb70429e89852f367246c02f,320,260,60,South America,15,1895.8
eee628b4552b4d22b4142d21521f80ae,50,6,44,Oceania,19,179.57
eee8358629d349d7b7ab382bdc809291,364,321,43,Europe,19,1227.69
eee83d403c3e4df7bd8beee2ab72e6f8,131,108,23,North America,25,814.6
eeea0131c4c841289b597f6b1c83addc,304,259,45,Oceania,25,1381.78
eeea01d4166643c29768f473bcaea15d,115,70,45,Africa,19,582.87
eeebabe53d3f4ac8b39ecf7bdd460941,50,29,21,North America,23,132.97
eeec041c12974376ad01be71b34e0371,334,280,54,Oceania,24,1335.63
eeec611e89744d9682f13e3707937a24,365,364,1,Oceania,24,2857.49
eeedbfb2a889421e8d5349b0676a0577,180,150,30,Europe,24,1379.15
eeee1383ea37479caca37713f34c5294,210,161,49,Oceania,17,1278.33
eef823fa577b4496899facc934b216d1,143,115,28,South America,18,1266.56
eefa30b4fa9c495985be3be15ded10ff,136,104,32,North America,24,1173.35
eefc7ee229ca47929642e1a1ed725303,197,169,28,Europe,20,1675.12
eefc8fbff1674b81866f8e36d5336203,249,229,20,North America,21,1884.01
eefc9cda7a0f481ebaef369b1e9393e4,316,290,26,Africa,16,2199.16
eefe6ef685ef438f89ba180655f9cd67,146,119,27,South America,18,1016.7
eefea2e2a64744aa8bcf44dacf6e0964,365,345,20,Oceania,16,1432.96
eefeda4b8cf54a20b0ab355b7983d264,214,189,25,Oceania,17,1282.85
ef000ec182e747edb6af6e548bcfc55d,76,38,38,North America,25,807.37
ef047c126ba241f396f49831007af4b4,181,140,41,Europe,21,937.34
ef06162fa7224e61b0a27c64ea10e043,240,204,36,North America,19,1045.44
ef06529e497942e8907e50812e693a09,327,281,46,Europe,22,2300.81
ef09b20974b347dc8c5854edc3d0f577,251,235,16,South America,15,1847.45
ef0cb3eafee24b4aa942437041bf54e5,257,215,42,Africa,17,1730.8
ef0d2eaa225e40f08c90fe0fa54ad721,97,49,48,Africa,20,546.55
ef0e3428d50d44eab81e124796ce0366,261,244,17,North America,18,1588.88
ef0e49477c664970b008f5e4055ee65e,279,231,48,Europe,19,1547.58
ef10570d60124257826c8d5b250ad34d,363,363,0,Africa,18,2225.32
ef1078a660004002aa04d89f4528be72,212,172,40,Africa,14,1367.67
ef107afb87e04d2c8b349bdef47948f0,99,64,35,Europe,26,464.05
ef1134e5587b4986aafc65ea726e4f8c,125,76,49,Oceania,14,759.51
ef12665a52f54085942f3f13685396c7,249,198,51,South America,17,1043.76
ef1502ce74df41f39c6c6e3e4f271075,364,337,27,North America,21,2419.31
ef16deecc21b4282abca657725d77b85,298,234,64,North America,19,1416.08
ef1a8d7f8c2b4a44b58e1aa6ec1800ce,177,147,30,Europe,18,835.99
ef1afbe4aca44f1b9d1a54408a1a47af,365,357,8,Asia,25,2578.88
ef1b32dc6b584c22a642405e2fad4c61,249,224,25,Oceania,20,1610.04
ef1b611748f94cb6a9e7bec024ca55ef,177,124,53,Oceania,23,1330.4
ef1b875aa88440cc91c74d61e82a1ab2,151,120,31,Europe,17,834.67
ef1e620bdee94d5da92129ccf2418a38,214,180,34,South America,21,1445.68
ef1eaa7b7873419cbc1f9a24441b1203,46,22,24,Oceania,19,205.16
ef20364bceed4bad85330d29d0178ba4,212,171,41,Oceania,16,1079.97
ef2077cc80944c819e9caac912011e5e,66,22,44,Africa,22,338.2
ef2187cb7a5f4ae4be7f991205ad5f15,98,57,41,Europe,17,369.69
ef22e662bb144ed699f7f860f096d3d8,155,131,24,Africa,14,919.22
ef250a3adfca454c862afe2486fd8620,170,147,23,Asia,16,1677.38
ef28c1a0533b4157a31270ca5b753f3b,316,277,39,South America,24,1840.79
ef299a69dce347ae8019b225cd9b4859,362,314,48,North America,19,2530.06
ef2acde0eb7f4509a9bf6ddcf430ace3,178,132,46,Asia,20,958.98
ef2d0555d5a94b3ba8d6222ff1e88b11,317,264,53,Europe,17,1910.11
ef2d14a08a0045ffb4aa777801a43051,164,112,52,Africa,17,1069
ef2e884efee449d7a05c2d84a658f625,226,173,53,Oceania,26,1361.98
ef2f1ddde8464cdf95a4af4d397f79f8,349,328,21,Asia,22,2819.47
ef2fcad8c879486cb5b467c6ed3eebe8,267,230,37,Europe,21,1912.88
ef30459cc35a46a88c0ef8bdeaf9bcf2,280,243,37,Europe,17,1198.19
ef321fc59949404886afd9f0937051de,365,344,21,Europe,21,1942.34
ef326bf9f83341009e7f96a679894992,309,264,45,Europe,23,1380.23
ef38586a448c4cf0aada28a0c8898ea0,269,226,43,North America,17,1431.9
ef3917d231a24684a790e93648d698d5,143,110,33,Oceania,22,1265.35
ef39bf81586c44849f5871580a4409a3,146,99,47,Europe,25,813.9
ef3d28bbb215418aa0703b750aa328bd,302,257,45,Europe,19,2364.22
ef3e4ec1dc3249a3bb06149d1e06cd8d,187,140,47,Europe,18,1303.92
ef3ec78187fd47729a66eca51d80443e,94,37,57,Asia,18,641.13
ef3f032ac4ae48e1be557118e03691dc,215,168,47,Europe,20,915.37
ef443d2b97b845459fa4413b6c6a31ab,355,328,27,Europe,22,2931.4
ef44c7cc50da4fa5a98e913942878963,129,90,39,North America,22,842.65
ef44fe31c1544d71b80eb294d409397d,274,247,27,Europe,15,1934.43
ef45d6210367499f914f99a21bba955f,339,301,38,South America,19,2146.95
ef46719fb47842028278acc6553ec06f,53,26,27,South America,21,400.59
ef47ae9ed21042c187a231a26acd6866,178,128,50,Europe,16,657.65
ef47cbc944ab435b8bed33874c19ed86,247,200,47,South America,23,741.78
ef4b8d5b205147528ef7b92d1be69ba3,66,31,35,Africa,16,496.74
ef4f884d859849b1883fdd34b782fe58,243,220,23,North America,20,2154.22
ef522268c7214f78a0e087a0a6af9c2a,340,325,15,Europe,17,3187.46
ef537c83503048508f012c7e6e0b956f,132,110,22,Asia,25,606.25
ef53da8eb2644060b1cc89f6ade0869e,172,119,53,Africa,23,1078.27
ef58f568f8b441a18de1a163e3c094b2,180,133,47,Europe,21,815.88
ef59433acaf44db7a1776847fdb8587f,252,226,26,Europe,18,2245.38
ef5a980497924e7dbe3747b2f47dd9dc,365,322,43,South America,17,1667.35
ef5bcbe48e8c4fd1b7ea27a0a4f67b01,98,54,44,North America,13,505.67
ef5c1b66979348daadc296a1d0b0620a,233,203,30,Europe,24,1921.48
ef5c556800a34220a1dff6d4739f7753,169,139,30,Europe,23,1113.78
ef5c838872f4460db0ef3c339a4d0f0d,347,298,49,Asia,23,1617.39
ef608b0c963648d4965ca7de59e024ad,68,17,51,South America,20,317.32
ef60e074d41746dd92cecec8f885feca,90,40,50,Africa,26,310.61
ef6432ee1141476f89dd6c08129a1776,311,263,48,South America,24,1647.08
ef6450de39c64074ac7f259360fc7077,49,28,21,North America,19,3.89
ef64b0a7a3cc451a8478d279eb6c7c62,137,88,49,Africa,19,728.76
ef66358d202c4e35b2de93f796ff1cff,274,245,29,Africa,19,1699.13
ef66c5640b084895860783a942f7ce59,271,221,50,Europe,26,872.33
ef69d4d7b85e4f9bbd11e2ea5e41428e,314,272,42,South America,18,1530.45
ef6ad21e01de450f89d148ec1f60aaa0,339,288,51,South America,14,682.92
ef6bcfe9673b4c9fa56090229b389230,205,174,31,North America,27,1835.36
ef6bf9905f4f46cea328dace4c414601,226,195,31,South America,23,1854.66
ef6c8f12fcd742f0b9e5688f2f9248ab,303,276,27,Oceania,19,2263.47
ef6d894130d042639e6c5746792d04b8,251,220,31,North America,23,2102.46
ef707541ff1049028c5cbc45b9dda37b,159,107,52,Oceania,20,484.32
ef70de4f3c614bb39bf036d3b461ed1d,109,66,43,Oceania,20,699.48
ef71bf88de7c439886bab100fa275891,317,298,19,Oceania,16,2499.65
ef74579a922943f7abc24b4bcf3d5686,242,215,27,North America,15,2359.48
ef7641d5d869480b97fe29d9beb00c74,321,270,51,South America,20,1413.86
ef78f8bf50ed4f02b0ad5374546f69b8,237,195,42,Africa,16,1842.28
ef7b93ea94d24584a3c165e3cd33415a,256,212,44,Europe,28,1386.86
ef7f67e054f94acfa13b7190f18f1a20,246,216,30,Oceania,19,1490
ef7f6e62b3ec438b946086ce18d2b1fa,248,197,51,Oceania,21,1744.42
ef804f3adf064ee38a6c1c78194bb6c0,40,3,37,Asia,23,144.94
ef80df83461e4748a9c8eed710a086f0,46,5,41,Europe,17,300.96
ef848088afdf4b4aafebc1fb94da007c,173,129,44,Europe,17,930.68
ef8482a978064980a0d556f38c9d5515,223,190,33,South America,22,1316.59
ef84b07155cc4d3baadc02112e6d9eef,171,133,38,Europe,16,822.11
ef8850cf89e64e178da51d8972696f8e,365,333,32,Africa,26,1685.57
ef88cfc9726f43c1956d894e368b2315,257,236,21,Africa,24,1620.83
ef8a9f28998946f4bc34d5c25f1718ba,235,201,34,Asia,18,2010.14
ef8b784a4eaf4d8f92113659afa29fc3,121,71,50,North America,28,614.63
ef8ca434ff314b059b7dfafda0839690,280,232,48,Asia,19,1223.93
ef8dbbae82af44dc8532a34a2b0351fe,164,137,27,North America,22,485.89
ef8dc04248924f7aa3adbbeeb04a6ca6,348,293,55,Africa,25,1166.02
ef8ea16a676a40398153ed9f1442c0b2,71,26,45,Europe,21,295.46
ef911c3d15cc4cbca035b45963bf6910,172,145,27,Africa,25,1096.24
ef91c04b1d584fe5a8a0a6094f3ad74f,123,89,34,Oceania,14,716.04
ef93432e9a254851b8fed10e0d4e9b8f,223,186,37,North America,16,1797.77
ef947c06e3d04c8096d7a274b48ca87c,351,306,45,Africa,19,1351.77
ef95b4eae2fb4c39a34570bd6172142e,294,256,38,Asia,17,2364.51
ef98a1435bdf4ebcb84bfa063e699218,166,122,44,Asia,20,1194.21
ef995db5f39a4cd982233f05a0d07f9b,227,190,37,South America,18,1300.82
ef9ae128054f4ef39cdc9e4153b93683,201,170,31,Oceania,23,1041.07
ef9b642a92ca49d3a55c794a10427ff1,91,50,41,Europe,18,125.14
ef9cd2edeac041008aa4af13aa2e92ba,314,273,41,Asia,21,1934.75
ef9d6fb220784e5e9040de1838e72a5a,365,353,12,North America,21,1604.05
ef9dbec1c7704e318587bdef32fb2520,164,120,44,Europe,20,1010.34
ef9e466302284ecd84b423b339e23996,365,364,1,Oceania,23,3282.01
efa29ca9e9104a96bdecf3c180ff67ce,72,48,24,Asia,22,864.51
efa2bd658e004044949d9be1321eff42,365,324,41,Asia,20,1887.52
efa6902c2de44f8f97550672d1215e6b,278,221,57,North America,18,1526.55
efa8e970695f4bc48a32031a780776c4,98,66,32,South America,18,623.76
efa9780fc1984f119fd5a309bb340a92,116,90,26,Asia,14,954.74
efabeb9e070f4701bf4799461cfeef20,50,34,16,North America,23,272.86
efae3e20807f48f3b11330975121691a,318,302,16,Europe,16,2810.9
efae8d398c72406b92d3ba93f287a2aa,29,3,26,Europe,22,144.93
efaf1fd75b2f49dfbffc8efa2489cddc,362,337,25,Asia,24,1928.46
efb1967da3bb44518b1b4ec3fde46b0e,50,35,15,Asia,15,386.95
efb1d33c6bc5435b919c8088da867448,276,226,50,Asia,20,1349.12
efb1d70f308c451cb97644fc93f484ed,290,247,43,Oceania,22,1875.89
efb2b55732de40409a1ecbb6688ec233,194,175,19,North America,19,1626.12
efb32b25eb5248a7a1391bd8033d53d5,261,209,52,Europe,18,1445.51
efb4962b553f4a6197081b01f3fc95e0,293,235,58,South America,18,1405.83
efb4c454350840e0ae1eb182bdf6c5ac,250,198,52,North America,22,1472.12
efb778e272f744ca90a6c6147f17b0e1,148,113,35,Europe,24,1023.6
efb978c313eb4e4889c9319eafd8017e,364,318,46,South America,23,2010.51
efb983fb43864427a3823b662b31fcd3,82,45,37,South America,20,493.14
efb99e46f9fb4e1cb30ca3b0b98c5ec9,150,118,32,South America,21,1411.5
efbb5f6eff5e44fe9544a2bb5aef0a62,364,364,0,North America,14,3044.15
efbc44de87764295bd077f080bc13894,101,70,31,Asia,26,1079.36
efbf63d00c99426a9b1f8787f40a248c,199,150,49,Europe,14,1165.34
efc0217b7fea46dab9f1fe54017d8f35,49,30,19,North America,19,295.83
efc4bbb01dbd4d1ca9993d13fa2f39e4,365,358,7,Asia,19,2394.2
efc5e701f2594faeae73f76b4c001591,280,239,41,South America,23,1633.49
efc60ea904cb4727a3c31d9f07c97ce8,303,254,49,Oceania,22,2144.08
efc71543da984577af7ffddbd7b1753b,157,107,50,South America,17,558.2
efc95ff80c7a4513b5bb5bca7b9aa5f2,58,20,38,South America,22,263.78
efc9b73c898b482badd6b40e156b29ca,182,167,15,Africa,26,1042.31
efc9fdb2e94c4b53834f04043c24625e,271,244,27,Africa,16,2011.3
efcc62fcdeab4977aab7cfd8889c524f,365,344,21,North America,20,2885.11
efd0fb94b6194700bc5ce9e41be9eb34,332,305,27,Oceania,26,2018.71
efd45ba0e0464cfd8f7684b61972356f,343,294,49,North America,16,1705.11
efd52700c6e84b54872cdabe937ff357,170,133,37,Africa,22,702.78
efd5d022fdb24842a083b7f345f55942,74,38,36,South America,23,667.68
efd73bc424ed4afcb7b1a8688ccfb56b,205,152,53,Africa,19,1110.97
efd88fe5f0c949f1855b1d6a5b8869ef,332,282,50,Europe,20,1981.32
efda108e7a9647fab1a2bf8d9714d9c2,359,340,19,Asia,19,3521.75
efde8ec855f74dc59e9ce3f215313fa0,362,337,25,Oceania,14,2373.97
efe04352d8d84aae9af0286adb97372f,72,40,32,South America,25,491.01
efe152048f164944a99bea20c34cfbf0,66,23,43,Europe,16,379.26
efe35b0b1dc84f71b5bfa4343d01e3e2,264,212,52,Oceania,18,1427.23
efe3631118604cffb5201bab3a466e78,289,240,49,South America,25,1241.72
efe3cac6005c4d17a33d5a0d8da8489b,225,204,21,Oceania,20,1454.31
efe77162ca0848c889a162d49edec648,330,299,31,South America,22,1625.03
efef1447386645e593937017c6a83a00,365,326,39,Oceania,24,1496.21
eff0e4059610423cb8f85e1ad728d5bd,138,88,50,Africa,22,600.42
eff38f269f4745138dcf04c5827d3d89,365,333,32,South America,18,2542.89
eff395a3a3aa47e590c41e6321fb0124,210,170,40,Africa,21,1520.71
eff42cb02d30421c9ee347053a3f25ca,221,192,29,South America,17,1440.2
eff61d208a614e788d3be43388847b95,231,183,48,Asia,15,1970.29
eff71904018c4e5fb5544b7ec0f5eb87,217,186,31,Asia,18,1641.23
eff93ddcd4e840d5a93d94b48c66aa8c,333,306,27,South America,18,2408.49
eff972934d604ad0b6a0c7e6ca8719a1,78,35,43,North America,26,634.31
efff071603ca4783ac8389be9a6e1974,66,34,32,South America,22,534.41
efff1a48491e4359ba9d54af9422c668,314,284,30,North America,17,1564.73
f000401caa514e2da145ea40c0d8ba61,247,198,49,South America,23,1831.64
f0009d7a464b4ceeaee616f3e0afdfb8,365,357,8,Europe,19,1845.37
f000fd57e75140cfbba2978f1413f4b5,365,332,33,Oceania,20,1910.37
f002e542026f44179ccdd1278f9ba774,177,148,29,Oceania,20,1532.3
f0035b03c525444883ef9ff025ab7b80,202,191,11,Oceania,18,1141.08
f00448829a624415bd84a09892c83afa,173,124,49,Oceania,23,1075.91
f00594c985f242fb8d6b02941953aadd,311,254,57,Asia,17,1678.91
f0067c1ce909491d8fe567c70e8eee8c,220,184,36,North America,22,1210.64
f0073a1336ea47b0a864756a1d88879c,190,149,41,Asia,17,1247.48
f007c4985c4747e58327967f3b086029,176,128,48,South America,23,835.03
f00ad0c12242405cad46474ca038b4e1,161,117,44,South America,19,768.7
f00dd22c4e3a46c0a15e11f4414a7105,135,110,25,North America,17,1133.98
f010385329c24e33bcbaadf9090a1c76,359,341,18,South America,17,2175.31
f0108c01dbd74fdcb2fa3bbd4a10ab75,118,61,57,Europe,25,603.68
f016002b8c1e47ba95271dda9568668e,313,281,32,Oceania,19,2517.78
f01853f82fe74ff9af5006334dacd9c2,106,70,36,Asia,23,852.48
f018cb3eacbc4560aaa5782deebcbf67,50,14,36,Asia,18,339.82
f019237ac0564a98a2ff739681dc1f4f,136,94,42,North America,22,617.36
f01e3c7f42f547b68ff0ac4f91a72c09,364,353,11,North America,17,2698.37
f0201b308e0e4b3b881dd7b3b014ab48,219,177,42,Asia,17,878.56
f021b1a30fdf4602acac6cc2e8c714a5,156,129,27,South America,22,1093.26
f02586fbe0664d95b666fde9598b09aa,365,349,16,Asia,16,2813
f0265f53bfc749dc9931edc7245c7713,260,212,48,South America,21,1106.12
f0266ea434b248a0a4403626006e3cea,171,145,26,South America,21,1316.41
f026d4d8378846868d4e63595b21dbef,305,257,48,South America,17,1779.87
f026de4bb3a3414087874ca5034b598c,174,131,43,Asia,20,837.61
f0276a2eebff41d0a0905ee11b86a826,258,216,42,Oceania,20,1613.09
f02777981284455cbd0429f727560905,141,96,45,Asia,25,497.91
f027a268b15f4937a1b9aa3ffc4e2604,236,212,24,North America,19,1872.05
f02886fa28084be1bdb72c2ce9d57b50,170,121,49,Asia,24,513.07
f0289397d0ce4dd2997aa685a0abe823,172,140,32,Asia,22,1412.76
f02bb44ed4754b76876e9ccdcbf30de9,122,83,39,Oceania,15,383.11
f02fe7b5da8640e68140d4d1b5a7eeb3,346,306,40,Europe,17,2158.83
f03420537e524f99a1431abed6b62c94,250,198,52,South America,20,1150.02
f0347dc4cfcc4b5498af241cb9605ba9,277,252,25,Asia,20,2140.84
f035068b6e3046eaa03df7826e07e136,124,81,43,South America,22,936.17
f0367f8591174174b6d11d14390a9188,312,279,33,Africa,23,2618.81
f0368eb3ae714de5927b7ddde60bfd1c,170,123,47,Africa,24,839.19
f0369457c6c54853bf4eacbf80f5f1f2,55,3,52,South America,20,413.78
f0378a1835894d35b7f45e9763803a17,172,120,52,South America,16,1373
f037f61d3a364b92b65163a0b5d95a42,218,205,13,North America,17,2183.36
f039a73d139c4f64a37ea97c0ca92dd7,365,352,13,North America,24,1872.01
f039f64931fc43de8b9dcc91fda394a2,322,294,28,North America,15,2363.33
f03b5f4ed88f42db8bf2fc783f331c6d,317,267,50,South America,22,1449.46
f03bca336d414049a3b63423656876c3,365,348,17,Oceania,20,2219.98
f03c6c6934e5461c9059d9e2c2545f64,349,305,44,Africa,20,3104.19
f03d690f00424326a294be975430308a,199,156,43,Asia,23,944.07
f03ec5ebbf6b49708c1e223cec6d7033,139,102,37,Asia,18,1675.51
f03f4e915c564b4c9e683f59b14a418b,157,124,33,Oceania,26,1578.33
f03fbe9490fc485e9acafab9fed8cd56,363,349,14,Oceania,19,2418.55
f040abe998db49f7a1dad0fa48e4ee00,71,49,22,Asia,25,845.68
f041a9b5a3f34a988be02899a490f81e,195,170,25,North America,24,1433.3
f044dfdc87ca40699849868c7b8080dd,100,48,52,Europe,20,840.76
f045893bca8a4ae1a07f93bb0859d5c6,365,355,10,Oceania,22,2083.71
f0459026c3c64d3c8cb5fb79e04ab92e,365,342,23,North America,24,1558.97
f046d646ccef476892d92867c7ef7da3,212,176,36,Africa,20,1916.73
f04a1ee343474c2494465fd55d74947a,79,54,25,Asia,22,455.88
f04ac3aec0604bbc923e5cc2ddc9409f,355,322,33,Asia,20,2519.84
f04aea217953481b8f11e9249559fbc7,364,347,17,Africa,14,2282.01
f04c870580134435b029d28a6f8c5c45,200,173,27,Europe,19,1546.41
f04e430244cf432293b3196e47949775,361,338,23,North America,16,3120.36
f04f9d0b49fc4035b29f9a0d5478c0ed,213,191,22,Africa,21,1794.99
f0503a8775ef494b8ffb1d2006f8b6e7,221,182,39,South America,15,1598.68
f051e5b353cd44288cb0235a840211f7,343,310,33,Asia,20,2529.57
f054e79cd4f14450b9a54bad676cfa27,233,209,24,North America,17,1143.47
f05615aab05043f1a02fd989254078d7,119,81,38,Oceania,19,786.98
f057ed50d4aa4dc598f1ee97eaeac0e4,303,267,36,Asia,18,1945.76
f0582f1cbeb94edc87efa1d5b62fde84,345,285,60,Europe,21,882.72
f0586738d97142c2b5bbe744d3b02853,41,20,21,Oceania,18,409.37
f059605a401849ad8bb7852331ecc4fd,155,134,21,South America,21,1293.46
f05b93a8ad1d42429edc4504106a6362,226,182,44,Oceania,17,1177.74
f05cd33f61ea405fa6dc1dcd60d599b0,264,215,49,Asia,22,1779.82
f0603061c2ab4963bee9d8344f66db93,82,57,25,Asia,21,824.61
f060dd5e4afe419d8a5b5dbd75148967,152,132,20,Africa,16,1660.87
f06178807ddf4b3fbc71d48d7e1fab34,72,18,54,Asia,23,154.58
f061d20990bd47f9b407a030b8903adc,133,109,24,Oceania,20,806.24
f0630dd9b96b41d0b850464f4bc65f56,209,174,35,South America,27,1145.27
f0632bfc2874435e80f7b9718473083b,50,7,43,Africa,18,261.58
f063cbddd1154fcdba342715a3e36382,28,3,25,South America,23,253.29
f0642b10f8b4467883f6d6a15f889dae,363,336,27,North America,20,2159.93
f066d6cf950c412b86d4b1aa89d26b5a,286,235,51,South America,23,930.47
f06b7752c2744003bedb57e64e7d92ab,273,245,28,North America,21,1798.42
f06fca5667ce426190ba01f669f62fb8,108,69,39,South America,21,407.41
f070dca06ee64379a57c45b244fee91a,249,201,48,Oceania,19,1081.93
f07243faf74741bc956dc2e33abcf9b4,248,219,29,Asia,24,1805.78
f072b21c400742299dc6b557b2be2a2d,323,288,35,South America,21,2294.14
f072d2a17892413893c7d9819e347393,159,107,52,Europe,22,611.84
f074c6a0479e474fb6229ea993cd93a9,365,332,33,North America,21,2021.46
f07714c460b14c3fb81e15c0f009a5a5,277,245,32,Africa,21,1813.09
f07747e80e084da498109ad85b25bfc0,203,162,41,Asia,24,1511.69
f07b5ce0732c48749990130ad4c029ef,210,182,28,Oceania,22,1747.44
f07cf66142804f4a9cddd5fd35edbd7e,86,41,45,Asia,24,249.85
f07d63329a5644c1b224dfdb47416f2a,354,313,41,North America,16,2366.97
f07d8572892749ed8c07bd6529772bc5,363,362,1,Europe,23,2766.5
f0836dc7bba54a56a332aadfcba7c81a,365,330,35,South America,18,2420.87
f085e45d1f9a438d94e90212cb649a93,356,300,56,South America,24,1855.02
f08734fd9bda44bd9213f832a8f2e16f,228,204,24,Asia,20,1331.01
f0878f7b261545fca94868efe1df8ea1,279,239,40,South America,23,1022.06
f0878feb76494cd8be7c05e88c04aa05,316,288,28,North America,17,2130.31
f0885b0f4d4c40c79814d53eb2f0c55a,253,228,25,North America,21,2481.31
f088c1e4a27740009ca09aaab1946835,305,278,27,North America,20,2630.38
f08b5d0806e74e8fa974b5b7eb5357f2,291,255,36,Oceania,20,2050.35
f08e28e80e7c427b98f942961d606962,288,257,31,Oceania,14,1180.32
f08e6ed108fd4fb8b76ac84da127082f,154,132,22,Europe,25,1175.26
f08f0ccc89ea4addb1a1ee892c85fed1,316,276,40,South America,25,2421.42
f090a60f04b544749fef86829c50c39f,364,336,28,Asia,23,2803.07
f091793f0b7e48cda3b6fac6a960a8b7,135,96,39,North America,20,843.14
f098b4b29a49464ca6420ab1efc5de41,58,4,54,Asia,20,125.74
f09a909dd2044bba9035accc562b5240,211,172,39,Africa,16,1324.64
f09b5d8d6e9a4b12a527637e604d8016,191,170,21,South America,20,1478.68
f09bc08126074efc840e9ac34f155a5d,364,364,0,North America,23,2141.05
f09cd0f0b9214ae6b5f17307c1191b1d,346,312,34,Oceania,18,2189.05
f09e80eec1094444973306b5a2ed2345,356,294,62,Africa,24,2062.98
f0a3364be54449e89b48c15e1b830113,182,130,52,Europe,21,734.12
f0a34f0e225a49aa8d0bc331f298d404,267,238,29,Europe,22,1949.02
f0a9b17ad04a431b8721249bf9519f98,166,147,19,Oceania,25,1601.51
f0ae86b131434e6b87606297bd77fee1,150,111,39,Oceania,24,755.74
f0afb0cbf3fa48f6ace2f3558264b84a,186,163,23,Oceania,23,1264.4
f0b0918b2f3f428ea88ba158c6e8486b,160,130,30,Oceania,21,1342.9
f0b5996d8b5a4b9f841f61f84a890251,128,99,29,South America,20,787.14
f0b8647c12c14d15b2e4468bb3be027e,86,61,25,North America,17,860.36
f0b9f140bf5846118839f22191037893,163,145,18,North America,21,1237.66
f0ba0291c38c4ead8597fea727eb5834,146,98,48,Europe,20,706.23
f0bd1529218f4c2ba0088a47c4cecce7,319,296,23,Oceania,17,2828.15
f0be6aafa04a4ac2a65753b7399396e1,93,63,30,Asia,16,676.49
f0bf402acac24deba2dc53b07c34075b,343,313,30,South America,26,2100.41
f0c002a3b34a48a8a3436bbfe055f21e,278,218,60,Africa,13,1690.87
f0c3c568643543f986f7c57e1466a35d,162,146,16,Europe,18,1691.19
f0c7573d5e81410abc75c4e4d2e0475e,27,7,20,Europe,20,116.82
f0c789dca5bd4393949bedcdbbc4c95c,365,354,11,Asia,24,2155.09
f0c80b062d0c4606a0b62fec0b1eb1a6,340,288,52,South America,24,2100.86
f0ca7801a93041fda5cbd32f1020d404,329,277,52,North America,20,1919.44
f0cb59a38b624e05a276cdb389d99f60,151,107,44,Asia,19,1055.07
f0cb928eb21d466aa7484ab3a8db7402,86,44,42,Asia,20,225.76
f0cd8a54055147dd9e305e0ba4ea42a8,125,83,42,North America,20,1002.13
f0ce4682f2a84998b58b6b7688817265,298,250,48,North America,24,1240.41
f0ce8b585529423c9d003fcdfc4a5f78,217,185,32,South America,17,1892.03
f0d042b98e704fbda07a04f06c2bba4f,178,148,30,Asia,17,994.18
f0d3589d6028409bb349b6b3e83330e6,346,308,38,North America,19,2351.35
f0d54d9c14e040eea23a58d84a5e67a2,120,71,49,Europe,18,556.24
f0d5a1df4bbe4773824109dbca4478cc,220,178,42,North America,23,1609.88
f0d6a7a90b2946c28318127664922610,139,81,58,Asia,19,795.15
f0d7bbe83fd040548e1f8f0d63b12f05,267,238,29,Oceania,21,1805.12
f0d7c85e971c407c907bc4acb45dd9ae,188,132,56,Asia,22,925.22
f0dc193f5aef477cb50b2eeb89e1eb2d,164,120,44,Africa,21,1577.62
f0dc6279d4254c649235e983ac209d47,364,320,44,Europe,21,1590.09
f0dd39fd6bbd41b7bcada6754ca617e0,286,256,30,South America,17,1837.19
f0ddcbe6ca834e05856079798e16dfdb,365,338,27,Africa,18,1985.11
f0e0eb9e23e040079609e06834218936,115,92,23,South America,21,630.49
f0e499560347433595df0c9c76acee9c,136,95,41,Africa,17,613.81
f0e54728b6e24228b0e19fb4b2431575,60,28,32,Europe,23,367.45
f0e556ddda424d46865152ca9584abb5,85,49,36,Africa,18,333.8
f0e57c355dc34bb4a8c1cac598750316,269,221,48,Europe,20,1511.03
f0e598a25e50484cb95fb2f8bbb39d4f,264,219,45,South America,25,2014.72
f0e5a26ac1f24052b74e289f49d6c9c9,158,99,59,Asia,22,779.78
f0e72c7315aa401f83dc9fa4f0e6b6ae,269,239,30,South America,19,1617.17
f0e9265f039b44d5b0c3d3fefd2e3612,224,180,44,Oceania,21,1519.18
f0eaa34a81a2414fad222344fe0137ef,90,71,19,Africa,20,768.54
f0ecd911aab64d22a923e029fe9702e8,184,163,21,Africa,22,1033.58
f0ee30f967bf4f58bdeadfdd6afcb73f,126,104,22,Oceania,23,969.24
f0ee381e83e543149bd78c30d0c7bdb1,182,154,28,Oceania,17,1419.49
f0ef74371ad544f596c82a4cb0903a75,172,147,25,Asia,25,1781.66
f0f24bce39244751ac55f68a55e5548c,208,173,35,Asia,16,989.16
f0f42206c97a44938eaf637ee744bd10,271,217,54,Europe,21,1281.75
f0f5d830f35443218931b46e7ce8d8f5,250,206,44,North America,17,1216
f0f78364b12e411ca02e5dec652b503b,148,120,28,North America,18,2007.13
f0f7bd364a4b4970b4627a4e27d57230,64,25,39,South America,21,412.51
f0f8520682304b81a96900a53ca6ed9b,257,220,37,Oceania,19,1153.54
f0fb396cdcea4902b4c7748e61ddc9f9,345,297,48,South America,20,1592.01
f0fd25bd91f5441ebf85a608a6176856,315,276,39,South America,23,2521.65
f0fdedcfc678411095c40aec13a24f81,289,241,48,Europe,17,1202.69
f0fe552622ef49ffadfeb80a7b622cad,204,175,29,South America,19,1359.36
f0fefe2b83e74b7ab1e9f0656b9fb284,351,297,54,Africa,22,1842.81
f0fffdb6a98f4891aaf8cb5945af4bab,114,86,28,Europe,23,817.97
f1010bac546c4777a6c1487d1c4de55a,288,257,31,Africa,21,1642.12
f102f99398df44f5a44c9fe00e33a752,365,328,37,Oceania,25,1876.41
f10694ad030c48008b43fb59bae99147,298,264,34,South America,16,2669.16
f10832b02ee44c98bcb6ba91379d84b3,357,309,48,South America,14,1223.35
f10b5f4e75df4e06a09d3d4ed93cdfdd,184,129,55,Asia,22,901.02
f10bc9c959fc44bc80f36d261bad9a27,365,349,16,Asia,16,1067.85
f10dff0ae52843128ff998f3ce34d9b6,313,257,56,Oceania,21,1244.07
f111b8e24ad14f58863c2b0c09c151b3,59,17,42,Oceania,18,315.26
f116176ff7574636a4a4ebaa2040ca2a,39,2,37,Asia,15,255.42
f118a4ffe8b141fb8ff2cde59d591642,34,16,18,Africa,17,245.57
f119f65ab369453687cf5edb3bf68082,87,50,37,Africa,23,267.53
f11a662ba8ba40bb806470c55afcc21f,76,54,22,Asia,26,920.32
f11bca44c57849288f3da8e6da7ad9dc,323,289,34,Asia,16,2098.79
f11e6198d48e49228d07649f84dd79ba,305,259,46,Europe,16,1672.48
f1204f81ead14b5fbe5fcfeeccad3674,344,320,24,South America,18,2773.25
f123c63ee9cd4bf4bc52d33dfde324de,274,250,24,Asia,16,2015.53
f126db7f7286461eab213537439e94c3,85,42,43,South America,16,697.15
f1292160232847518b8b52af055d3782,276,254,22,Asia,19,2659.64
f129c50e8f654b7b9f3d5faa3ff8a424,324,284,40,Asia,17,1951.04
f12fac6449434c9fa8ab6e22b6ca2c16,96,48,48,North America,20,614.18
f13066e818cc412faf328ac72d421276,251,197,54,North America,24,1544.57
f1353beb43d5482da0eb1cd247f6ad98,228,185,43,Europe,24,1041.54
f136763655514bdb810e5371e8c51695,135,85,50,Africa,20,464.59
f137775ac73e453cbb53c26580751aca,116,67,49,North America,22,391.87
f138c9f879e24c85aa9d7a86712565f6,332,308,24,Asia,21,2889.05
f13920fab3304c9499abd6b28ba17253,137,114,23,Europe,16,984.13
f13956b72d7b4ab3bf98e97944c76220,124,96,28,South America,17,1013.48
f13b2321b94544a3b0c5c8b9fa696430,356,355,1,Asia,21,1983.65
f13d120c45ce4d0ea23dc0099e4a01e5,51,24,27,Asia,21,233.8
f13d20a65f5844a2a4503f4fe802f77b,320,275,45,Oceania,21,2114.74
f13eec128c734586b0458ea8285f5e8a,58,21,37,Oceania,25,192.18
f13fc8ac45d146228a645408d47117c8,365,361,4,Africa,17,2211.5
f140d50239334c70a1c9e50f8fa59ea7,242,221,21,North America,18,1998.93
f1412f7c4ec94a2b9f40a755cbbf8ffc,129,103,26,South America,23,763.75
f1448130ce0a46b1bb6b2aa5dbd972f6,363,336,27,South America,21,1626.91
f1462a4d703643548893892c94faf4c3,248,230,18,Africa,21,1862.67
f146d652dd1d4dc38418973e6d8bab02,146,97,49,Asia,19,948.95
f146d76957584dd8bcacf9c747cf7fa4,200,179,21,Europe,19,1545.44
f1470ff53eb6427a8c3b53ec60293fda,95,55,40,Oceania,16,412.94
f14bc02510f64497bed4cc7557676f5e,355,319,36,North America,20,2199.44
f14d8df04070411ebff436f2baedac61,276,228,48,South America,22,1541.23
f14e6fb84aa143e49df1bdc88696e421,364,326,38,South America,21,2186.44
f14e82e6116c4416908a6989812172cf,86,28,58,North America,23,623.9
f150a96a1f764fcf8403953c47854d02,214,179,35,Oceania,19,1424.77
f150feb048b24853a908e3063b003d1f,207,161,46,Africa,18,905.8
f151c34992bb40acad708883e8673a00,263,206,57,Asia,15,925.78
f15524e03bc14148b012ab419fea89d1,288,268,20,Europe,20,2089.04
f1566f9e96a247abbf18c53d8a1463b0,142,94,48,Asia,19,325.08
f156c6a29e1741f7a8e2ffc3bbd1f751,257,209,48,Oceania,22,1965.01
f15789f3c8784cfe9baca69a34adb95f,365,362,3,North America,22,1570.94
f15a38c4f43e40fb89f60aa818be48d2,198,170,28,South America,13,1095.7
f15a39f55e424f39b6c5386194777bc2,198,158,40,Africa,22,1117.46
f15a654224b64f8ab9bf7a5034f61cfb,269,244,25,South America,22,1430.98
f15aa51e83004b05966d051faa72260a,217,167,50,South America,20,1419.35
f15c08d4c1234073acd60345c861e349,309,264,45,Africa,20,2585.17
f15c1310d8294072a9e28d3825b8aa0c,199,150,49,North America,22,1023.72
f15c33a9136c4af3ae05237cb58fbeb4,182,145,37,Africa,17,1515.96
f15c4c2737a84bae943ca8d6f4e0fd3b,355,323,32,South America,29,2644.52
f15ec233d38c4abfaeae982ad4dd3fb2,91,65,26,Oceania,16,661.42
f161000828f84149b28171e90c6bc231,365,356,9,South America,17,2361.02
f1625c14537946fa81183716e968ab92,38,2,36,Europe,19,524.69
f162bb234d4a4a49a7c13b721bd0a294,149,129,20,Africa,17,874.58
f163f3f4724346c2a4b24bfbbe3bd56a,98,69,29,Oceania,18,474.53
f165c0c173f6497587cbef8dac8f1c1a,160,124,36,South America,25,1144.39
f167f1221efb48f79485a822189cb627,305,255,50,South America,23,1523.15
f16879d451ea4bc9bf9fa058e5b013ca,324,278,46,Oceania,20,2436.54
f168eecf37c24d32aad3e2900c6dd42e,365,333,32,Africa,18,2030.81
f169c2417fcd46809d7bda7289bc6dee,363,333,30,Africa,21,2572.42
f169fed4c1ad42a89b57582324c09fe0,349,289,60,North America,20,1267.87
f16bcba3ffa3474ab7c2c82d7ab90673,92,71,21,Oceania,19,654.1
f16d1d055d2f444daf4fd0d38aa0ecf8,271,231,40,Europe,16,1780.99
f17082b8001f44bf8a3abb40a6ed64a2,149,98,51,North America,22,458.54
f1715bd8de4a4340ac73a4a4dd51aec1,208,160,48,Asia,27,694.23
f1728dc62c594b76b694770cdcd3c983,173,148,25,Africa,18,1224.37
f173eabf048940278c17cf0118dc032e,364,349,15,South America,21,2626.94
f17656b47e0c405aaf1c3faf20265f53,115,64,51,North America,18,447.15
f176930c54364360b27a104d44061dce,365,358,7,North America,24,2656.01
f176f7fe7f094052b226c0fadf091934,57,12,45,Oceania,22,326.18
f1786223525b4230ad5dbb12f970b9ba,310,261,49,Asia,26,1765.24
f17c1bb502a1482cbdd49cb5a2d74704,125,68,57,Oceania,18,636.72
f17d97fbb5694a979a19297e418937dd,125,91,34,Africa,17,506.73
f17e583fd5c24400bfad8c3a8a61f5e0,363,310,53,South America,17,2218.38
f17f978c3a814c0ebd07ba502de78b7d,165,136,29,Oceania,21,1107.04
f1827953bfd040f49715dd119a8c851e,248,227,21,North America,22,2363.05
f183f3202d1b41ffb77ecbfaf78afa51,238,211,27,South America,20,2095.85
f1865aaf093d43738564e31ece43aee3,352,315,37,Oceania,20,2838.36
f189e11f2bcf4f4492d87d2b7172044f,279,257,22,North America,28,2148.62
f18ac04f7df2476e813627568ad0831f,90,70,20,Africa,19,1172.37
f18b47e8ae7541f7ae6b2946bb55c5d3,36,13,23,North America,18,301.71
f18b7fdc3e9c4709a71ec4a4d7bc9943,365,330,35,Oceania,23,1914.37
f18c2fbabae84168a26eafa5c4e50515,159,123,36,Asia,24,900.54
f18cd5184a7741179cb1a793b4309c55,306,243,63,Oceania,16,1543.19
f18d54d1dfb7454f91db36b67685606b,102,78,24,Africa,24,463.58
f18f87c09af843c69dc03fab2c59005d,205,176,29,Europe,14,1473.61
f19012375698441fa12c7b7d76966204,199,174,25,South America,16,1784.1
f1918461a3624c51a196d740f6323bbe,122,88,34,Oceania,25,843.78
f193f746fd4e409e960af5a34cd875b5,347,299,48,Europe,20,1822.81
f1958f6ce7bb448998fd308588a44195,52,27,25,Africa,19,398.11
f19670ea732f4ee588fc8648aaade983,58,3,55,North America,17,329.63
f1967cd85d894e8ca74c0f6ce3278f82,291,273,18,Asia,18,1714.53
f19b69e91fb942e699157d3822f8eba3,247,218,29,Africa,22,1739.15
f19bae45ea9944448f386e82fe2cb38a,214,174,40,Europe,22,1126.25
f19c80abdc13489cbce9e59427f8e1d2,211,178,33,South America,15,1113.1
f19e1d3f5e4b4333854e56b574427a06,355,310,45,Europe,23,1590.73
f1a1db9bcce64b0f9a0c7f7107537f54,115,70,45,Oceania,28,606.24
f1a47d652e0242b8aa5a762b3138b407,147,116,31,Oceania,13,857.73
f1a9cfa6b7af47ba86c0bee55b344728,256,208,48,South America,20,1297.74
f1aa0853464042149aa73f6e91fe25db,114,56,58,Asia,16,160.23
f1abccdc0ff845b1a95c38ddd3789abd,204,173,31,Asia,24,1525.07
f1ac0469ad0a479e80ddc5e96f566e45,58,10,48,Europe,14,91.59
f1ad50b04d9f49d295f14c84f81984d7,57,11,46,North America,22,396
f1ad7bf79db04666887d5378acc0d68f,363,349,14,North America,16,2402.43
f1afccb2f8484f46bab1934927884172,181,144,37,Asia,23,1374.92
f1b210f9dcf34e7b831859cdd3b9292b,46,17,29,South America,20,369.57
f1b2427749c8447b8e7d2401f1cc6671,276,249,27,South America,18,2651.1
f1b3071aeac04e9e837c29326ed14c6e,207,185,22,North America,16,1761.24
f1b3d65d7ea048f1afe70dc2ecce22c3,184,155,29,Oceania,19,1613.92
f1b5496ac6354a60bcc371dfa681335a,195,156,39,Asia,21,979.52
f1b65557a62b4007aad4fb52c3cae9e4,328,272,56,Africa,23,2084.87
f1b68b04e9c54010b054315cf4d2c203,313,293,20,South America,19,1902.39
f1b8051a39c642a2957afa07d9bdf3d5,278,256,22,North America,20,2273.67
f1b862e5a7544a12959d322636e02513,332,284,48,Asia,28,1056.56
f1b8f87e4c3c4eb489175a31a1762727,240,189,51,Europe,22,1057.65
f1ba466a4f234d08b471851e0bee6f70,173,135,38,North America,20,1074.8
f1ba8a729bf14a04945c5c45ca426c18,241,215,26,South America,20,2167.77
f1bcb3111e8e48fc99d6f72978689137,365,363,2,Africa,21,2357.27
f1bec7dba4404aa3b0387e6d72d7e601,176,138,38,Asia,17,547.73
f1c09593a11b425bb4e7a169db5dcf4e,75,46,29,Asia,17,596.81
f1c30aa27d2a4bea847e55de42821f88,340,313,27,Europe,20,2266.26
f1c4e2c88c9046a8ab1473e75938547d,173,121,52,North America,19,794.42
f1c754e06aa047ca81c07202228b760f,217,161,56,North America,20,1348.47
f1ccc4c28566480ba4d1052e1291fec3,69,24,45,Asia,20,96.02
f1ce10924a3e493b80d58f888f9e06a0,265,218,47,Asia,17,1300.13
f1cef640fd664079948791ae023d7333,124,99,25,Europe,15,644.26
f1cf035ed44042818fddb4b18188264d,364,363,1,South America,15,2089.96
f1cf0ef6470246309ebd1f245ccf865a,270,226,44,North America,19,1714.25
f1cfcceefbdf439287ab1392a1f763c6,80,45,35,Oceania,25,459.97
f1d20fe12c0f426f979e7b0d61cffcd6,120,68,52,North America,20,513.52
f1d21e9e6f7840a09f5558ded1c7d9e4,365,345,20,Europe,21,2000.85
f1d230033cdf4ecb98f24807baf99664,326,297,29,Africa,14,2129.79
f1d61311b79b42659a523483fcc5f178,250,211,39,Europe,24,1802.23
f1d7ccb72e3c4b4d8ad29b9fd5125668,365,353,12,Oceania,23,2822.89
f1d92e9c20b74ca2a0438d00dabde452,40,15,25,Asia,19,146.52
f1da573fcdda45b79f362fe82862d529,56,18,38,Oceania,20,446.29
f1daf69e7a7446e4a167cc83e3935149,248,205,43,Africa,23,2173.67
f1dd736f2b464af2927583f312a37ed9,205,178,27,Asia,14,1925.85
f1df0be02e73467dbbb8f6790f78ca52,344,321,23,Oceania,18,3246.61
f1df1487f3ce4932818ad73419394d67,220,194,26,Europe,27,1437.15
f1e195560da249169b9ce738b586833e,210,169,41,South America,19,1292.12
f1e7505a7cb144faa924d6184907e1ba,256,230,26,Oceania,21,2372.81
f1e9078bc058497ba2f093cb71fa800a,82,36,46,Europe,21,74.06
f1ea3119662041568bdbbcea5a6965cd,227,174,53,Oceania,23,1158.79
f1eb832cea4b49bdaf1d1fad9fb6698b,227,171,56,North America,16,1060.54
f1ed51fba1aa4dd4838063243e922022,261,223,38,North America,23,1839.94
f1edc312c5264634b4de03c7d035c7ef,197,152,45,Oceania,21,832.12
f1ef008fb4ff4bdfa4a0dc3d8bb4c181,246,204,42,Europe,26,1420.52
f1f20c3c16ec4f67979ef2eb9e6ffc47,263,226,37,Oceania,20,1912.44
f1f233475fc54c759f0596d7116a93b8,365,338,27,Africa,21,2622.75
f1f38f03e2a54150957062d63b488ff1,346,318,28,South America,25,3219.23
f1f3ca0386cd477b9d4327229f97216a,362,310,52,North America,18,1386.76
f1f3d4270fa343769f45292e51ed595d,242,191,51,Europe,23,1442.95
f1f414cbb9a3435fb9d6bb4c287241d7,363,330,33,Oceania,22,2029.28
f1f58b03602a45d5b6c1b3461b9a9d57,200,150,50,Oceania,18,1216.98
f1f631db37a140dca6984dec249f13c0,220,182,38,Europe,21,1133.47
f1f6f721f2f04cc0a9a7fd3f1d12e44c,207,169,38,Asia,17,1606.83
f1f94a9798144fe6ba7e06c401b9d110,80,53,27,North America,18,435.29
f1fa7afcec994ee094c71d7dab3c5087,192,150,42,Europe,19,1571.53
f1fcaf687ace430ab12acc6c73d58fd5,109,67,42,Africa,25,608.15
f1fcfbdc45464b28be58a66469900aaf,189,166,23,Asia,21,1951.39
f1fed7020a45457d86c39e7c40f439dd,217,188,29,North America,20,1184.14
f1ff15b0ed1f4badabba4bd1c7271064,328,306,22,Africa,18,2212.87
f201438d186a4409b6f0cf10ee4a3f34,49,11,38,South America,25,268.35
f2030ff84c134d58bf9303c99ea8ba9a,87,26,61,Asia,22,273.86
f2067622e4164b4e9aa563fff9c338cc,88,35,53,Oceania,18,215.86
f207631afe0c45a997d823083664747b,51,9,42,Oceania,21,52.93
f209a5ed8e004198b243e4fb4f5d32c7,178,157,21,Asia,17,1897.76
f20aa37ef7604e94abd30b8d819363c5,193,171,22,Oceania,24,2382.94
f20e35ab2b964045a9806b286e883583,208,185,23,Oceania,18,1599.3
f20f5745f14a44b3ad0c4513dfabbba6,250,227,23,Oceania,21,2178.07
f20fd81a57be4eaf989056b745c3e0e4,87,57,30,Oceania,16,853.46
f210da6597c74fb89096272dd02641ad,116,80,36,Europe,18,959.7
f215f8bc90ab4558a26f999452dac7f3,354,303,51,South America,20,1730.47
f216a55bd03142759dfcf2b5a3691cb5,226,193,33,South America,23,2258.89
f2170d071cce4e73b5e81ff666952412,275,244,31,Africa,19,2117.18
f21935e49b564e96a7f10eca9746a599,233,184,49,Africa,17,1322.45
f2197e462e0846a392fbfa3ff6203b30,273,234,39,Europe,21,1782.8
f21b8717fa6840bd8c50a15e3f470ad2,159,108,51,Europe,17,1067.7
f2212ecda8bd4c438d429535f0160cf2,365,324,41,Oceania,18,1750.67
f2215f36f6484e09a25be621da5dae80,266,232,34,South America,17,2069.02
f224896b64ce4afa97483e926ccd6515,277,228,49,Oceania,19,1530.88
f2257c90a47748bd84a834b3be019339,343,319,24,Africa,20,2680.57
f2264dddaace4b54b04f3a49e1f2464b,346,302,44,South America,21,1949.06
f22710eed6eb44fe807fc2490d9f229e,354,334,20,Asia,20,3151.84
f2274a929070459f901362c47f105556,176,151,25,Asia,18,1689.98
f22849e9fee8481b80b181635ca58dc4,253,234,19,Oceania,24,2280.85
f229ca212cb448468f9242f6dc30f08c,281,248,33,South America,22,2199.68
f22d166f711241f8895e929ad30ef87b,51,14,37,Europe,20,418.03
f22d73db9612490a91d33db5b1bbfa71,122,69,53,Asia,21,580.26
f22fc62007854e02a465c0a46bb136e1,91,60,31,Oceania,19,976.3
f23028183aea4314977953d2c894b442,260,233,27,Africa,24,1424.19
f2313a267635478a9fa9f618382deb98,360,330,30,North America,22,1823.96
f231c590be8f46fcb8713d7d4029984f,118,90,28,Oceania,18,856.08
f232df819c9a4bf5bffb55c801a31bf6,304,285,19,Oceania,27,2106.57
f23469b4f9d042b2a7196ed4b40af2bf,131,105,26,South America,19,1006.94
f2396953e1244277bb418fde2692bc28,210,168,42,North America,18,1049.15
f23a73995f614991bc8856fb8a8c30e7,123,80,43,South America,19,1070.02
f23adecf321941a4a968fe69149ba19f,288,245,43,Africa,21,1121.89
f23ffb276c4a4f8cae76d981ebc11b58,324,282,42,Africa,23,2279.03
f240ed1a5adc4f28be0df9fb78ba8a19,364,356,8,Asia,19,2862.58
f242f13c087145f28703056fbc912b13,315,271,44,Europe,18,1544.19
f2492360e5ba4429a3ac9f16bfd7b478,85,48,37,Europe,25,670.31
f24c5f9047b943e6b0dcefd69a05cac5,265,230,35,North America,19,1828.67
f24c94a4d3ab44baafc0714f8d21a468,243,214,29,Asia,16,1806.78
f24cbb2d56a74366907a29fa03a17ded,338,304,34,South America,23,2176.99
f24d139588f041c2ad44352a45842615,26,6,20,Asia,25,47.72
f24d9c6aaf3a4fb79a451b901d1c3921,86,50,36,Oceania,16,437.7
f250e8b0554f424bbe6184ca3a0f5ab4,78,55,23,Asia,19,809.05
f2515ea00d914ac49fc5d2bf670f2686,313,289,24,Europe,23,2205.13
f252108e885c4529ac0c73af30346c21,362,328,34,Africa,18,2173.75
f2580027ee1f4b0bb0c26d7434fafead,281,240,41,North America,21,1842.57
f25ba480be544c38a80ef64436dca4f0,195,170,25,Europe,20,1338.61
f25e74d74c5e43cdaf616737396e167d,187,175,12,Asia,23,1580.09
f25f4ca2bd3f4e438e96dc690d0af46e,351,295,56,Oceania,18,1920.55
f2621a10554e4c52b1942cbb70d08f64,73,24,49,Oceania,24,520.9
f262a7c724ee458cada3601a9febec01,206,189,17,Europe,20,1370.05
f26525b249cb491d8531bd3d0b30cc6a,140,91,49,North America,18,635.2
f2692b645fb64789a4edb9518d147f05,360,330,30,Europe,22,2381.1
f269dd089aec4660b5f388eb38cddf50,116,76,40,North America,19,765.84
f26ce0023f84463baa9f3a983771854f,206,165,41,Oceania,23,1827.43
f26d8ca26f954890bc98923b59b51459,108,70,38,Oceania,21,462.17
f2705b9a69c942b5a475fbb7d8ec396d,295,241,54,North America,16,1446.54
f270b598f02e44d186881468197652c2,284,259,25,South America,22,2141.74
f270b7661a9748388c173f1155ce1c06,165,124,41,Oceania,17,886.67
f271522d7b8c4c71a833962bf5fe634b,46,26,20,North America,21,335.26
f271b903755148d6a718e0ba56fcea92,55,13,42,North America,22,620.75
f273e0860e0c41fc9508533dfa4aa578,189,126,63,Africa,17,883.44
f2742b2e17dd43d3b0c39759f7d8edab,348,302,46,Europe,20,1662.34
f2756d0151f540159e2b1d5103024e66,233,183,50,North America,16,1027.31
f2759f20c1554505bfa8c54ac5491abc,315,261,54,South America,24,1380.75
f275cda6d7754481b325c7500d612754,307,259,48,Africa,22,1843.58
f2786cc2e5c747fba8cbbf67638b92cb,365,358,7,South America,22,1460.9
f27ecabd91194d3685504e3572bf8265,118,83,35,Europe,18,882.64
f2800a0c53904472b2ffa2f0551b5d59,365,359,6,South America,27,2470.52
f2814d2b1fa34e5f987a9dccab9f1f9f,164,126,38,Oceania,20,933.88
f281cd4eddd941e0815dea2cee4d82a9,98,71,27,Asia,19,453.04
f2828c4839ae467dbcad335278ba3c68,327,279,48,Oceania,24,1628.79
f283072b12f8457d9273432c71505f5e,271,225,46,Africa,20,1097.37
f2836205f5fb48bb822fd6388f4db0b4,295,248,47,Europe,19,1806.47
f2840fbb2b72441db92d0425ef91a6f8,113,58,55,Africa,20,604.92
f284f2fea5124d6096a3373aeb33d413,21,2,19,Oceania,20,23.77
f2851f69b441453dbc9fe2cc0cc22f33,91,46,45,Europe,17,294.27
f2853021f4f4491fb424136dbf27a1b4,88,43,45,Oceania,20,294.33
f2864b56b270498fb87e202dd473c0dd,98,70,28,North America,23,840.23
f288bc9be0f44828ab1fc4c29d97b6f7,75,45,30,Europe,22,361.37
f28a80c7c4a64f2bb0f725a77cb7c33f,190,134,56,Asia,19,1350.28
f28c33757024465faed2766f668f3bd7,160,131,29,North America,24,1155.33
f28c4e4d0a4947bb9192942ef8b08777,46,26,20,Africa,19,288.01
f28c898d1e05482a81857fc2e1766dad,70,41,29,South America,20,776.42
f28cb1a014e14631943e2bef83dc6605,120,104,16,South America,25,1022.21
f28d8177d97f49ffa9404a591e02cf81,93,49,44,South America,18,162.24
f29232ceb66e4f688eb56f1a87032057,205,156,49,Africa,17,1363.62
f2943e41832f4fc0878e1fabf823cb36,66,26,40,South America,28,318.22
f295c7a72a6b42919cf51ebba58a6546,175,122,53,Asia,16,997.19
f29663d6344b45c2aa6ada77a15b3575,268,217,51,Africa,18,1727.48
f2973c4139914afcaa08c69c6be72be0,336,302,34,Europe,17,2374.22
f2987df7fa2f4246b5733f2da28741aa,313,264,49,Asia,23,1075.28
f29885d825b6432fb9eedc937c3373a3,364,355,9,Oceania,16,2514.24
f2990e4948a74d509fe46759afffe845,176,157,19,Asia,19,1206.52
f29c6e7c01254d2fb8a1762ff67ca313,58,25,33,Asia,22,227.23
f29d6b0a848f4cbfbfbc6a59113c802d,363,339,24,Oceania,19,2017.44
f29edddb4d774157bd8ba32a6b9f4d92,178,150,28,Europe,15,1344.36
f2a02ece0213439d83635493903c0e77,288,250,38,Africa,24,2803.08
f2a0a10470a842f59ddc5b29abb85de3,133,97,36,Africa,18,1059.03
f2a31f63f4314f72b120bf6a3f62f73b,250,216,34,South America,19,1589.5
f2a56f5aaa74449a9672f3bcb548ecf6,364,362,2,North America,22,3297.28
f2a6182b7d9f48b09b28ee1024b4d5b9,365,345,20,Asia,14,1752.88
f2a62943dbd349a580cf9bd41f41c49c,155,106,49,North America,22,751.93
f2a66d163d9c4fd587d60493b7e4f265,364,335,29,North America,17,2765.55
f2a7647a2368421ea5c753ee0e291606,95,67,28,North America,19,791.08
f2a81c450e204c458653ea1fe275bae4,74,29,45,Europe,22,650.99
f2ab1ac3e8444f8896c7fabfa4a755f5,217,182,35,Africa,18,1456.25
f2ac0fea4d9644bb9b49193e22127c2d,265,209,56,Asia,24,1567.48
f2ac5229b86a4694b3b73c83b4dbc8d0,45,5,40,South America,21,116.25
f2acc8a0a9e94f449a751a346f851304,275,253,22,Oceania,21,2321.23
f2b0228065ad4bbe8ab5d5600a23a4d9,44,19,25,Africa,24,139.2
f2b0908202ca4ff7b0957a67a7952b87,218,169,49,Asia,17,1169.09
f2b1ce804335453aa4686adb90d94323,140,88,52,Europe,25,559.98
f2b784ea663d47bb8eb30cf3972447de,318,281,37,Africa,15,1800.89
f2b8d5a4346f45479531d891dfe9f74e,363,332,31,Africa,16,1754.79
f2bc6396cab442cb87dbc2b92582e5b9,274,235,39,Oceania,23,1204.38
f2bc752402164488a34a31cb64c9f412,40,24,16,South America,24,227.24
f2bc8ca332f44890bd24d519bb2c9942,31,15,16,Africa,21,271.66
f2bce9e8d8574dd489144236058fe32f,134,79,55,Africa,19,462.42
f2bd11d63079454cb21e51845fa4e329,57,39,18,South America,20,731.23
f2be2c679baf4cbfa36b820e30c53657,326,305,21,Africa,21,2010.7
f2be9424bb4247c4b4639cfc4b98844a,172,117,55,Asia,22,1152.3
f2c2466f5f7f40188f3321fd03d16f0f,112,70,42,Oceania,17,464.83
f2c2dc6065014954adf0d0c6f97e331d,344,304,40,Europe,13,1892.73
f2c2e875c14245ec8ffb5d9e9a261802,117,68,49,South America,21,413.54
f2c2ed1d94fc41a38bcab4d97b397c95,363,359,4,Europe,14,3660.04
f2c35500b3ad43ae9f57638b1d87fd95,62,28,34,Europe,19,618.08
f2c44690e202491fb419488c59d707c3,251,232,19,North America,20,1319.41
f2ca3ec97c8449fb8d99e6e60812a20f,92,60,32,Africa,20,955.71
f2cc00c28e084694ab975c47cb83afeb,308,278,30,South America,17,1832.49
f2cc11657e37471eab5498c1877a1103,199,157,42,Europe,16,1660.26
f2cc70f458e94c669091cb1e8616d134,365,360,5,Africa,20,1462.51
f2cca7b4647740a6a6d2dc0e6f3cd30a,103,64,39,Asia,20,598.53
f2ccd1c1102e43caa051f471bad7bf8f,365,349,16,Asia,20,2018.17
f2ce54222221462bbcb506a16ad6caf7,171,148,23,Europe,15,1089.87
f2cf110d30964fb0a4fe0ac45c219d21,127,70,57,North America,19,519.83
f2d579e095974c1d812416ae43239e6e,341,301,40,Oceania,22,1865.39
f2d8c267bd45436ebb2e7f52c9b7d064,335,311,24,South America,23,2137.11
f2d8d20e549244d68ea270fe59b051ba,87,46,41,South America,22,678.02
f2d9b9274d2f4967834e09f46dc97a90,175,124,51,Oceania,19,677.27
f2da178a632d48e289eb76f7f0b3a275,124,97,27,Africa,18,785.84
f2da65d7edb24ac1aa2681ad02a4d370,121,88,33,Africa,20,646.94
f2da87ca3d9b4159b2c7ea568fb07a3c,199,168,31,North America,18,1374.35
f2dc9e413ed3412cb773ef4c0feea006,343,299,44,Oceania,19,1848.79
f2dcc082b2974bb3803668653c6b55b2,203,164,39,Asia,19,1108.52
f2df7cb78acd4ba39ae1777a311eaed0,344,323,21,North America,20,2778.37
f2dfb84a81964d8bbe6cebf707def450,301,272,29,Europe,18,2004.61
f2e08f5b9f6a41629bfbbbc5256a4531,254,222,32,South America,22,1370.74
f2e122bcb8eb4c77a0fcf42bc5366cd9,364,318,46,Africa,12,2737.06
f2e1686de1fd43a1bb02afd45d8172eb,123,76,47,North America,17,778.57
f2e3d472ceab43b4858c5ed82ffe50dd,307,257,50,Europe,22,1286.48
f2e549c06198407eb82dce14801c227b,327,279,48,Europe,18,1691.77
f2e54e82d653417dbfe0e3b239e6a935,264,217,47,Europe,21,1841.42
f2e7b45e71564cbebb25e9e63a4dbe5d,287,244,43,Oceania,21,1387.32
f2e822ebbe0043a5ba89934c8119356a,316,259,57,Europe,20,1658.36
f2ea2cd5d43d4e9aac09211ca41f457f,174,153,21,Oceania,25,1709.68
f2ec6505c08f45f3a6ee5762525c57f1,148,124,24,North America,18,776.8
f2ec84447efd4032ba4cd0860fec32b5,315,277,38,Asia,15,2796.18
f2ed39ddeb1d47c2836375ce97bda64a,157,120,37,Europe,29,1446.71
f2ee80276d5c44c1aa9989bdbe632c26,97,66,31,Africa,14,868.64
f2f65adca69348299c756c616c2e2eeb,74,34,40,Europe,22,461.44
f2f72d2498ab4843bd28db999ea2f539,207,168,39,Oceania,25,1587.87
f2f80202da2741a2b337af07e4c707ba,362,306,56,Asia,19,1923.77
f2f901661fd44463b9f772eb4b8b1eda,297,253,44,North America,21,1311.87
f2fa5bee3ae74a668f2007b9c4138388,183,151,32,North America,24,1404.39
f2fb6ee18cfa427093d83aebcacab5e8,355,321,34,Oceania,17,2682.02
f2fef5ef833647d6b42ee9cedf29207b,70,45,25,South America,16,369.12
f2ff997781e540bb85c35136689053d9,51,11,40,North America,22,234.69
f30202cf2c7946739d8766d25973645d,49,26,23,Europe,18,911.63
f304b89559c348768fb008c7bcd2fd45,229,184,45,Oceania,21,877.44
f305e5531a4a405ebc59cd5c53243f6f,99,73,26,Europe,16,1045.03
f306d776e772455b9dca07f9097c3869,228,212,16,Oceania,20,1769.19
f3099fe44abd4370add0ac1eb794972c,125,80,45,Oceania,20,563.76
f30aef154a5f408cbe1e2d33994178a7,102,78,24,Asia,16,728.34
f30c0e77e60945bf999a6201396ba2fa,154,123,31,Europe,23,1062.22
f30cd045274142ebabdecdbf12daac90,364,308,56,Africa,21,1670.17
f30fb763e3694163a2dd81690a1fdd3f,152,115,37,Asia,15,736.61
f313c8a38b844bc19aa4fdd2f1ad1574,298,270,28,Oceania,19,2003.03
f3145057720a42d98f38afe13a8f69e2,226,195,31,Africa,17,2255.55
f316034ce0224e6694b461203829efa7,333,303,30,Asia,20,2862.36
f316ee76a4704beb81e639fc7669bc54,70,29,41,Asia,18,384.62
f3179513d5654021a7345ae92c5352b4,128,79,49,North America,20,209.61
f31bd93ce8134950a4c64431f1e50bb9,354,323,31,Asia,22,2731.86
f31cf68f1b4d41dd927e84ce5c805007,122,90,32,South America,17,417.49
f31d0fdb57304937b598d6e30e20e987,70,37,33,Europe,22,590.6
f31d7688e6ac4455ba09d24da22d48ae,89,62,27,Europe,20,829.52
f31f0cf546094ff4872758dacb7fdf85,160,123,37,Africa,16,1146.29
f31f29b20b1c41d8a96edc15b45de888,362,322,40,Africa,20,1781.67
f3211901c4d4489ca445c80899ee66dd,146,97,49,South America,19,790.31
f323193953b2462cb570fd185aabd390,365,365,0,Oceania,24,2591.51
f3239fe2cdb14fa6a91831e3cb576b4a,165,132,33,North America,23,1180.98
f323af00a3c249e19d1a9cd6f4e27523,248,218,30,Asia,27,1996.94
f325713916084f6bb993b48eb1d95c9a,116,82,34,Africa,16,1014.98
f32757d7dcb24596ad0b78a3d4e609ea,292,260,32,Europe,16,1942.84
f32854560f1a4058a3c1019c2fe140ca,174,148,26,North America,18,1347.15
f3286747bc31487c91ea415b44e31819,139,88,51,Asia,24,464.64
f3296b8ddab544fc9fa73c293143c8ec,193,157,36,Africa,22,1850.9
f32c86562c8348f994c28e14744d9dcd,364,364,0,North America,19,2294.91
f32f822093d0482cb610ab9f061cc4ef,315,279,36,Oceania,22,2427.64
f32fe8fce241408790c4a76122ec7308,300,238,62,North America,21,1989
f3303c3e566747b1b977733a7789e795,127,78,49,Oceania,23,356.1
f331640834f64f76aaf524e94319d3b8,83,56,27,North America,19,327.91
f3329f36ac7e459da57360b9aabd9a49,363,333,30,Europe,22,3098.06
f338b5f4b57148cd9a2c22f1150db4fc,352,293,59,South America,20,1965.07
f33a3707cef0462191a4d0d72b051403,78,46,32,Asia,24,938.33
f33a86ee7188403e94af84b6799b54c4,135,111,24,Africa,21,537.58
f33db51c7a664b81b2563c23a7dbe6a5,329,291,38,North America,19,1520.36
f33e5360ca1140f087ea984b5161cb0b,236,199,37,Africa,20,1826.63
f33ec1dacd614dccabbfa7b652e834cd,312,263,49,North America,21,1526.63
f33ff4abf0644bc09cd4d9326ff0f67e,364,323,41,Europe,20,1919.27
f33ffdc880264180af3399b49cc62df1,343,296,47,Europe,23,1408.78
f340f74271b4438d8c9771a39c0ce213,365,347,18,South America,20,3228.08
f3410f85ee424c618c803380baa37622,142,102,40,Asia,26,813.36
f343a58577824d488388578fc1d8941a,111,68,43,South America,20,519.19
f3441e8c4cd7447ca3e066b667ab37d2,208,177,31,North America,27,1149.23
f3445a5bb3c943ac90f66c0a3dbaf1c0,261,241,20,South America,21,2720.4
f34496b2b7e94474aa3d5c38bb438cd5,348,293,55,North America,20,1739.89
f345ce862dec4b61b9b33098b013eeb4,289,237,52,Asia,18,1396.88
f34868d72f1d46a0939f4103170e90c9,91,33,58,Oceania,21,581.7
f349eed7cdbf4a4f90cc192a5ff62ace,128,78,50,North America,19,569.45
f34d13e8abd347ac8a257efa4dcc06fa,341,299,42,Africa,24,1806.54
f34e08a09114418492502e7a2f58ab7a,238,184,54,Asia,20,992.34
f34e1025d07f45f8ba3223eaed126110,361,325,36,South America,23,1195.53
f35086988c0f4cfb9d96a90caebc9b82,312,265,47,Asia,21,1006.76
f351a26351e444d2917bc855eb377e56,326,282,44,Asia,19,1822.7
f351cf2121304b78aed180edb0e9e8ab,284,230,54,Oceania,22,1620.52
f352a3114e204cb99edf308a043a1ea4,325,301,24,Europe,20,2193.91
f352e5d788dc4b7aaa206d4a28f09956,153,120,33,Oceania,18,892.66
f353bc3d848840ab8bf6c10633414fb5,279,243,36,Africa,17,1786.03
f354f475deb648c0bcde60d0490fbf4c,90,56,34,Europe,17,383.59
f359d49ebb444fff98b66a37566a9b77,230,186,44,Asia,17,1427.08
f35b2208ff5b4a03926eb51572e79b20,266,211,55,Asia,20,1317.97
f35ba28a0c4e45f795c4d925751be446,346,315,31,Oceania,19,2132.45
f35c2e9423c54f108194bda7afa7e49e,294,248,46,South America,22,1459.37
f35f877c46264d20a72daf72fe300844,365,319,46,Asia,21,2149.76
f360b6e5acc5499da79eb66e412159bd,306,281,25,North America,25,2416.99
f3629a21e6494d5c8d913e06ea09d1b0,363,309,54,Africa,21,2229.49
f367d35561384b8d9e91121abedaef73,278,254,24,North America,18,2079.78
f368192c684f4668abae4926d8319729,65,22,43,Africa,17,421.97
f36b449dc99d428b9dc51532822b2403,165,136,29,Asia,27,1178.72
f36c428e283c4ababd154014299044fe,329,302,27,North America,20,2575.24
f36c875fca75496480691ce090882f45,359,330,29,Africa,16,2931.46
f36e405e003348e289d5527e972c3405,241,209,32,Oceania,19,1358.07
f36f3ba2b4ad410eb8277c80b7dfd115,178,134,44,North America,21,863.95
f36f3df792464f83b769d62b440a773e,325,289,36,South America,26,2053.47
f37007d5c8394e7bb9fc0353c9647e5d,262,222,40,South America,24,1738.9
f37026cbd8a443829bdc8b42929ff683,28,2,26,Oceania,18,278.05
f372f0c844f545998f08a9f1a51c8393,332,290,42,South America,16,2817.65
f373bed975024cc38ba60aa0b99d1ee9,328,276,52,Asia,19,1111.64
f373e8bbc152443497227936504c9f14,340,292,48,Oceania,22,2502.5
f374e578c050452d98c4aff3c89c9954,299,275,24,South America,20,1415.79
f3763c3eeb984d1485bd8dd56bf9a4dd,315,282,33,Asia,20,2335.84
f37806c918784762abad88525f3f7c40,115,68,47,Oceania,15,484.71
f37831e077ff41b6b91300890ef7f2ed,49,14,35,South America,18,353.23
f3789de6dcaf49e48c74445d386ca7e3,365,363,2,Oceania,15,2015.47
f37d48aeebdd4a378a9660ec1527ff3f,50,9,41,North America,20,256.98
f37d689ae4004112b3431de3539f8d21,313,286,27,Asia,21,2775.71
f37e79241c7546bb92b3eacc9cbd63cb,337,295,42,North America,22,2792.86
f37f6fd42ef245f1ba31d01e2995632c,157,111,46,Oceania,27,760.97
f37f734e12e34e8b94f1512e56ba81fd,355,332,23,Europe,26,2285.15
f37ff190cd2e4152b555f4d1f17f1f37,276,225,51,Oceania,18,1754.95
f383dcbed8b1413d8766bae812c68a2a,216,180,36,Oceania,24,1592.34
f3841707048243968eae649e9bfeb5d5,188,153,35,Oceania,17,883.02
f38646ffb4314097936292ea2680b2f4,329,298,31,Europe,21,2093.5
f38653ad7c6f40608f12b6147b387159,64,37,27,Asia,20,287.04
f386d60998b44721b8c146040a11320c,258,206,52,Africa,19,1110.11
f387095c0e334e72983a03ca3a582506,299,279,20,Asia,16,2301.67
f388169d653d40fbaeb03a66118c709d,328,306,22,Oceania,21,2009.99
f389e20eddbb4b6c8b8e8bd2d2b1c327,248,196,52,Asia,21,1063.59
f38a3c0ec4594bee8d8b7f47fac66487,288,251,37,Oceania,21,2256.69
f38a45dad1a4411b8f0d83f3e4866a57,235,204,31,Asia,21,3050.29
f38b7a67c9654faaa89ab28c167d22eb,184,157,27,Asia,22,1182.76
f38c33b309e644a49c180e80437921f3,106,63,43,Asia,23,598.96
f38db2e2333e40ab95545bddc48e48cd,42,6,36,North America,21,580.43
f38dd1905c6c4d65ba9d70085d98d3e3,174,137,37,South America,18,1140.3
f38e7fd0fc074e23aec8eb3a46d52467,50,18,32,Oceania,20,628.16
f38fa854f2754238b4dafdc4db9100b7,365,327,38,Africa,22,2164.16
f390e9d20d8b48f6afc03998493d169d,92,36,56,Oceania,22,589.31
f39108fc5fc7468fadb2b0cd1e0a3bd4,324,273,51,Oceania,17,1707.97
f39437e9c0f54db1a933f008452477c4,365,318,47,South America,24,1998.12
f3946b8b606a49bcb483b7e7074f6ba2,334,279,55,Oceania,16,1799.12
f394c39500004a84b29fd54c0198c684,129,88,41,Asia,23,758.95
f39804e2539d45c89c294b6e18c068ba,67,14,53,South America,21,178.34
f39afe35c4694d999549ae4b14036d23,46,5,41,North America,20,403.91
f39b137b18a84f4595c46461e8321820,121,97,24,Asia,21,1056.56
f39bbd353c684daa93c84810312c6eca,48,19,29,South America,19,414.18
f39ca7e30def48808e7e8ada7385ebac,222,199,23,South America,20,1434.29
f3a0a09041e74a24916dd573548b6c38,77,50,27,Asia,19,494.74
f3a26197a9cd4adc88550b081de8b87e,157,131,26,North America,16,1040.05
f3a686b3e798401e8923eb61e9cb3374,341,291,50,Europe,17,2286.17
f3a7cb1c5bf348d8b693d82221f5a67a,354,310,44,South America,19,2702.85
f3a8b8d521f8400f9f92e7f5d3c37f67,184,142,42,Africa,18,1285.35
f3a8ec0013d947de97f6d4885a5b0cdf,364,327,37,Africa,21,1888.02
f3a985fb73fd44d48a21cc9d0b60777a,207,155,52,South America,18,797.96
f3a9db6bc196420495f3df589a58d935,288,247,41,Oceania,17,2303.92
f3aa15616c584fc79a0741c9c55312bd,152,123,29,Africa,23,1112.29
f3ad062bf320424eb43629b5db46ec84,333,294,39,North America,20,2212.2
f3ae63fb05864b7c987c94e7d05bab1a,212,187,25,Asia,19,1648.92
f3b0db8f53d341d1a1f773ba0f01f7a4,245,198,47,North America,16,2129.44
f3b432e7a084427eba870e2fdcd1169a,275,218,57,Oceania,20,955.37
f3b4fae78b9140e0a9a1cd125348f366,134,83,51,Africa,23,594.52
f3b532a74a354cca90bb45411c2bacd8,62,15,47,Africa,21,225.64
f3b9a7b10cbf44f69d381601bd955082,148,100,48,Europe,15,722.3
f3ba93c92f32424d8da6ea174cc7b61a,360,332,28,North America,21,2856.17
f3bf4ffd7e2b4615a1e0fe801e8a97cb,181,136,45,Asia,22,1526.88
f3c053c3dd2a4172839e689c09705a48,128,74,54,North America,20,366.96
f3c3018aec684fdfac3a74270ee40e3b,320,284,36,North America,19,1742.4
f3c3b8df0185402aace3f47bffde2781,365,323,42,South America,15,2370.76
f3c5db3cd2cd4705a90d7727e86f479f,283,258,25,South America,21,1957.63
f3ca2da50be44e979926a06fb65997b1,133,94,39,Africa,15,780.72
f3cac5253c9d44a2804d6deaf770a06d,355,301,54,North America,16,1940.26
f3cc0f1a891d4edabbbaecd1e482f015,340,317,23,Oceania,23,2306.39
f3d0bc9319e04b79b7e6ca5b9dc969f5,365,354,11,Europe,18,2097.84
f3d1a520066042278805ac73547b64cf,179,153,26,North America,20,1622.18
f3d1e67b778940d99c4ff3e0604a60b7,185,129,56,North America,23,964.53
f3d77a3a756b4338a5f20ee02c9f6784,247,216,31,North America,17,2003.4
f3d7a62f11da4dfa8436e162eed03c40,250,217,33,Asia,16,1373.9
f3d80a9e245a4a779e34cdb2ecee350b,345,323,22,Africa,19,2150.14
f3d91591cc6c46bba491c0d64f67db8e,261,229,32,Europe,19,1752.22
f3def701839248b3913771cf60c0e189,290,250,40,Europe,16,1390.84
f3e432e591e149d3a9d355109dd32fcf,365,351,14,Europe,24,2703.4
f3e4a5046cde4dc781723faf23a411cf,342,291,51,Europe,25,2235.18
f3e5050cc8fd4ae4800a4f50fb28389c,53,24,29,Oceania,19,523.81
f3e75b87ed0249868fed18cd2de4df5b,205,157,48,Africa,24,1752.65
f3e8110613cc4cb8b8df00dff5035843,252,220,32,Asia,19,1756.13
f3eb51a8ae3f4110910c6a4b4d74ac83,142,115,27,Europe,20,830.67
f3ed07c8fa914d2281e1e0911a455598,243,208,35,Asia,21,1733.32
f3ee35d6ede5426eb846381f18dc52fa,309,294,15,South America,19,1890.58
f3fbfb4181c2484885f7b49b26f70c78,59,25,34,Oceania,21,510.07
f3fc836c8a0e476cbcd45b6484dd7133,21,2,19,Europe,23,85.6
f3fca5d1eb5b41e6aa93b3f0a569f5e3,189,155,34,Asia,22,1417.5
f3fd61d81d3247e883f26f99c4c4a860,176,137,39,North America,23,726.63
f3fe988a200c48218a5461ad614af623,249,192,57,Oceania,16,1588.08
f40168b3fbfe4e8d87db489207259b29,30,7,23,North America,21,318.79
f40208e7e4844595bbc02b5424bdd774,259,247,12,Asia,21,1835.16
f4045af4790841b5a49120f41ccecd51,115,78,37,Africa,24,843.75
f404a9912f974822900a971c551e4f38,84,45,39,North America,21,536.89
f40548cfc2834068968360feb9583aa0,351,302,49,Asia,20,1878.59
f4054f34e61e432b883502db0701c4b3,337,318,19,Asia,20,3591.79
f405784113604416a891a59a7144f2e6,313,259,54,South America,20,1320.23
f4059c42eb034185aadee2b1a220a84e,227,174,53,Europe,19,1252.1
f4070aef27274a05a2b9ce620d613056,278,235,43,Oceania,21,1892.86
f40a634c8df742cc90631763217a3e73,162,130,32,Africa,20,766.45
f40ea8957f704008803d72973e748b1a,199,155,44,Asia,19,891.36
f40ffb8248d44076a598d56e0d9ae18b,169,138,31,Africa,23,1605.02
f41099f9f37046f2a4ab7cf3c702da51,365,338,27,Europe,20,2936.84
f4163dad26ec4ac2a77b27d8044b0297,151,117,34,Oceania,21,1689.99
f416d3d993274b53ba11af8efd5c84f8,250,214,36,North America,22,1850.73
f41b17e0033e477db9893288c9887b96,356,321,35,Africa,20,2934.16
f41e397060ed4a1d83d0393e6a06f5fc,174,131,43,North America,24,807.87
f41e770fe6c84ddf9e9c37f2d56b7a25,315,289,26,Asia,22,2141.4
f41f0ea4b0ab4e29a1cf5831453ce814,234,216,18,North America,17,1939.24
f41fc90988d5431faa2df974e4f647ff,268,244,24,North America,17,1410.43
f422305a4e63461b97f36e01b031c407,133,80,53,Europe,18,842.99
f424800519684f439c0b8a8545f6a09b,97,73,24,Africa,28,925.36
f425fc1efaa8406ca587e3edab73f05e,37,20,17,Africa,19,369.57
f42680748c9c47bebb452d5896c6aff3,94,39,55,South America,15,512.09
f428cd25decd4aa4a1fa8f1f3a391d8a,365,349,16,Africa,19,2146.51
f4293477cc214f0580be225eb23f001d,144,112,32,Africa,20,1270.73
f42a096ccada4a1cb6ba4a9c429604ae,364,347,17,Oceania,14,2981.03
f4305ed8204349b29213df47d2a3259e,208,189,19,North America,21,1356.38
f430ff4b4a1e444ba3ce0615664db2d9,326,296,30,Oceania,17,2202.35
f43620e3e50e406eb20de2cba2df8b31,98,78,20,Europe,20,702.18
f4374298190b4e4c97b7945b364c60fb,137,88,49,South America,20,853.89
f437448f423a42d7a94c61e56266097a,155,103,52,North America,22,760.83
f438a4a1c12f44d3bee4b8eff8fdf2b1,148,107,41,South America,18,1369.48
f4393b6c2faa4d25ba80e825d2c8f1fe,109,82,27,Europe,21,679.13
f43b5d437c0443a5a05be7c5814b18af,365,355,10,North America,21,3257.19
f43b6443e97a4197a9d06e64815ada46,292,246,46,Oceania,19,1362.65
f43c4c3ce2de4641a26e226acea2fefa,141,104,37,Europe,18,625.64
f43c513591d04ed0856a8d64a7d17f12,55,12,43,Oceania,15,527.82
f43c5db4d403420187770c9b5f644349,350,306,44,Europe,24,2202.01
f43fd50b24034cdab8f4081941046065,63,38,25,North America,24,605.42
f441c256d2044fa7ae9748a9ddf7ba35,92,48,44,North America,20,497.07
f442756be9094601a6833f2fd304b5e7,251,197,54,Oceania,18,1475.23
f442eb3d15aa4832abff759360527017,279,243,36,Oceania,22,1541.53
f44463181c2d44b986287de7aa9cb3b7,311,265,46,North America,15,2328.1
f445772a54924e74bcadd3f8b88254b8,261,208,53,South America,15,1095.4
f447751ee9fe4d3d81fc9780089ea53f,300,261,39,Europe,17,1990.39
f449867b6ecb478b8871a8cae0135238,131,104,27,Africa,22,948.92
f449c6d06b9f4e168f80fa3399507182,253,234,19,Africa,22,1244.64
f44c0d37f97c4860a5d8739ef647633d,365,355,10,North America,24,2716.19
f44c4ef2770c4a128b1f4f07d00048b6,365,343,22,North America,25,2689.15
f44e7cf1ccc24ebc98e047fec96e98c9,360,324,36,North America,19,2850.41
f4503863889446748146ee90fa2fb3da,365,336,29,Asia,23,3224.25
f451494b161145b08134bf8cbc084f42,285,248,37,South America,22,2210.09
f4539f4f898f4be483e4429da628f0b1,103,54,49,Africa,21,891.3
f457f7a49dc64b309cbe4e78963a5773,166,128,38,Oceania,20,424.24
f4585095e8e24ef9bbc5cc2c8728dd13,318,277,41,Oceania,23,2317.51
f45add532ceb46869e4aca73d617aaea,365,336,29,Asia,16,1742.12
f45c28897aa347e0981a540b96bdd2a2,276,230,46,Oceania,20,1662.92
f462007c31fe430083b75486e9199e7c,339,305,34,Asia,21,2129.96
f4633b440a9a4d46837083f0395d3ab5,361,337,24,North America,18,2139.82
f46583d63c394799815a10dfd60acc05,365,351,14,Africa,24,1345.45
f465965728c74292931d72441cd37e60,141,112,29,Africa,18,933.41
f469bcc21cf14e219c97b19d993368d9,210,157,53,South America,19,619.94
f46bcdd1454146c1bdd160ca15365c01,56,2,54,South America,22,434.31
f46c736a511f4805af608731811bb621,350,318,32,South America,17,3013.28
f4702ccb718f434fb625eb8414cbc14f,263,225,38,North America,18,1968.39
f470ed019efd47a5a041c46d1cd70147,64,7,57,Europe,23,197.11
f4712806b2664b81bfa00192978c3d00,141,110,31,Europe,17,1063.14
f471a21665a64884a4c7a7e737d4cd36,143,106,37,Europe,16,1251.23
f4727c8a89d147f3bfb9f4e3d1740395,163,145,18,Oceania,20,973.12
f4734f48deca4474a4eea01e679ea881,101,80,21,Asia,18,982.08
f47433fee8484fc888eb9a6b6048cf2f,151,100,51,North America,21,1238.18
f474be03ef8b4a8a8acd2957e0dc10f5,199,149,50,Europe,17,952.58
f47525e918474a79a51c466f9f30e477,337,292,45,Africa,22,1713.42
f476ffdc36e549939b3f3b0168c30d04,112,86,26,North America,21,854.96
f47700d1435f4ccda0701e257b7ac117,365,335,30,Oceania,25,1426.34
f4772b74119d4b1d8d006ac7f415a560,126,74,52,North America,21,631.92
f47758ff651442f6a9e9a9475a4fa354,260,222,38,Oceania,19,1871.78
f47889e633124a8898d217431e17483d,154,98,56,Africa,17,883.29
f478b5fd2d934138a9ac4c2b998d31fb,194,155,39,South America,22,1180.37
f47a90a6f34e444c998aa21e2bf3db8d,111,55,56,Africa,17,658.17
f47d7893d2fa43baad8ff8db355b04d9,130,102,28,Asia,17,906.25
f47e5d6ecd174ef78c45dbb00fef8eaf,279,231,48,Europe,15,1563.91
f47fc82206ac4352a8bf512a0bbb2f67,81,56,25,North America,22,776.89
f481ee7b20114e419c299f9f675f2f39,105,48,57,Africa,13,236.76
f482d9bf7f314268ac74c0a0176465ae,249,190,59,Europe,20,1176.12
f48624ebfbb14ddca49be2a60d72884c,166,128,38,Europe,23,1256.89
f48945ee0b764c06a1eb18ee6fe6c435,165,133,32,North America,21,1255.86
f4899e48de694a0e85fd78ef6def605e,306,268,38,South America,20,2162.89
f48a8b49f03f4c8fb3ff25e82b1254c1,102,60,42,Oceania,19,1228.27
f48ab0b3a2964242b73bb7b06b9a1511,99,48,51,North America,14,617.25
f48aed4d76424e5b94809b6b2a6dd8c7,51,6,45,North America,16,332.05
f48b603a4a6b4eb990d4754570e34534,233,180,53,Europe,19,1249.96
f48c2f36fbb74d87a0446ba6a13a0ba0,79,29,50,Asia,21,755.51
f493487497c342a9886334210a85e304,271,233,38,Europe,24,1937.8
f4938452f36a446788c6256786174eb3,114,63,51,South America,15,477.59
f49731acaa5d4a15a64cf37a944ad763,280,244,36,North America,16,1162.33
f49741f8cddb407cb35fc13f178b1291,365,327,38,Africa,21,1378.23
f49946c4e55644288f4c7c207b851a6e,365,346,19,Asia,20,2409.56
f499b72f85aa499f915a531f6e4605ff,213,178,35,Oceania,18,1878.59
f49afb8193f74fe38f9d68625af152b5,270,234,36,South America,21,1978.04
f49b2b0af7484738b3e9a51cbf003729,100,56,44,Asia,22,424.47
f49ccd2fed974f338b24d36d8ba1f301,364,348,16,North America,20,2060.25
f49d16633154465e84099aa93d8dff67,242,215,27,Asia,18,1848.94
f4a042618dd647b7a6011783163d7ac5,269,231,38,Africa,23,1893.12
f4a1ee96507b428e8d3d0963baa911d9,318,298,20,Oceania,20,2618.06
f4a396162cb0424fb4c8a0a356f5785c,133,84,49,South America,17,665.55
f4a4d7ce4737471dabe9ae1df8f5b69c,258,226,32,Europe,24,2472.28
f4a9957762834220b5c89c85ef705869,184,144,40,Europe,19,915.88
f4aa241664a047caa88b62c70f24310d,103,49,54,South America,17,320.84
f4ab423898ca4bcfb4d010d561ef684b,105,87,18,South America,18,755.05
f4adbc9eedbf485fb07497816e15e79a,27,14,13,Europe,21,506.83
f4ae3e96432a4119a9066696ca429a55,312,274,38,Asia,27,1660.83
f4ae3fe9bb2643b4ab44963ac42fd7be,272,245,27,North America,27,1627.78
f4ae7aebdc0445afbeaa23dc2d5da4b6,144,86,58,Europe,25,841.92
f4aec6f6ea8048c4b53342cbbbe87fd9,365,343,22,Europe,19,1594.62
f4af71e9abf34fa5884f0ea669f0a08d,281,231,50,Europe,20,1512.81
f4af99f69d9e449f85a83aa7ef1c0fb4,195,154,41,Africa,20,1066.09
f4b0c03014ad4a31a9611cd3efa52614,269,234,35,North America,16,1491.91
f4b0c5b38f9e4ca2bf00869afbee227a,86,61,25,Oceania,17,393.54
f4b1d6bd585347aaaba0d0bb2b4806a9,319,289,30,North America,26,1738.13
f4b3e46f37194d7e98a344ae800cc9a8,137,108,29,Africa,20,1240.5
f4b4c3cd148f4b9abc766cf638ad6096,193,161,32,Oceania,18,1355.85
f4b6ed8ab815491bb71326cadc2e8e8e,260,234,26,South America,21,1810.33
f4b8411220364ca292521fd4c8187e1d,188,170,18,Oceania,23,1554.37
f4bdf78f64ed4eb383fe3278f0cf9151,77,54,23,Africa,21,575.86
f4be217b3f0d4339b4c7fcdccd544f81,84,57,27,Africa,23,618.5
f4bee91f660e4a10ae4f929d018f4320,209,168,41,Asia,24,727.92
f4beeb174ce24aa785227f30a1e0604d,168,120,48,North America,22,1293.98
f4c08bccb4d840af8e7372140172ae09,261,204,57,Asia,16,1489.71
f4c21890d8834ae4a46b8e44078db56e,57,39,18,North America,16,484.31
f4c898965a474c30a14f42d523a14d81,87,69,18,North America,24,867.97
f4cb0952c0ee41b0b5c10785f4c3c2f3,64,30,34,Asia,11,512.2
f4cc044912cc4c7e970a7b18dea9b12d,275,227,48,Oceania,21,1194.93
f4d4a1deebc44fc2baeca89e52e998d6,173,152,21,Europe,16,1088.23
f4d7866fc58c4a77885a62ade51d0429,116,72,44,North America,16,859.71
f4d9896de67544a3977278d1ab53e2ad,365,339,26,Africa,21,1154.27
f4d98d942a674913b7cac3f3751b500b,309,278,31,North America,24,2216.13
f4dac5b2c95d4588a6422b75b6b2e67f,196,156,40,Asia,23,1579.3
f4db2668575748c2831f1df8a6ac0852,270,239,31,North America,23,2055
f4dda2bb3a524f5bbe9f0219d588e3a1,359,329,30,Oceania,15,2591.2
f4de2abe14654bd3a94c3cc7266b4fad,364,360,4,Asia,24,3206.31
f4df49d4bef4461e94e8aca9bb16907c,356,321,35,South America,19,2134.28
f4e1edbafa01432b9d9362550f983969,118,77,41,Europe,21,739.96
f4e2d2c5afb54e6cbe80d42522849e28,218,196,22,Oceania,25,1182.68
f4e3585a2a1643d0b96866655bc3ce01,205,182,23,North America,17,1545.58
f4e65d2f4e65420489a0d15f8c65d1b7,364,350,14,Africa,22,2101.09
f4e797b2c7a340c4a59089188919a2be,94,45,49,Africa,17,693.71
f4e9b8cd934d43158e3ef30c68d95140,113,60,53,Oceania,22,777.78
f4eac80ef58341ae973065131e930552,292,272,20,Africa,20,1740.88
f4ec36d5e429418590a0c119cc32d569,363,346,17,Oceania,17,2738.16
f4ee3f8592b94d879431873ce245eaad,200,148,52,South America,16,792.06
f4ef7878a6074cef89205da9c4adef34,365,363,2,Oceania,21,2627.91
f4f0c3b052574d78b8b97bc9de85182c,316,281,35,Africa,19,1552.56
f4f18fad6aa244d8b39aa0719e95829e,239,203,36,Asia,23,2060.72
f4f19823570e4349828137dd4df66bae,43,17,26,Asia,17,351.18
f4f1be6a482a405e88f2f7fd0dd7aeb9,169,132,37,Oceania,17,1716.7
f4f29148e0f54a078c52393b22336dba,365,351,14,South America,26,1729.41
f4f3e6a0075548e8a4c754a9deb58452,147,95,52,Oceania,17,461.71
f4f578385ce64fbf97d9eb379ecf29d2,109,56,53,Oceania,26,396.53
f4f592c0c6904c59a658da347d76bac6,87,65,22,Oceania,22,820.14
f4f620e093454bcab2d90b7f30c5dfe0,277,244,33,South America,17,1906.06
f4f72bfc97c14058902ac7e7fb2d833e,365,348,17,Europe,21,3307.52
f4f98e2837664a3e94a5d0dcc2e1468c,101,74,27,Asia,25,808.1
f4fb1a0e084f4e3f9217931fdee68d89,156,109,47,South America,20,831.31
f4ff0828756548e8908da4b85a1ea2c1,216,172,44,Oceania,26,1416.74
f4ff591715bb4660a226c92e07367bf4,81,44,37,Oceania,22,573.33
f4ffbcfbd5404246ab3f47e6ecd52806,300,268,32,Asia,21,1634.1
f500e67084d7456b94cb23441ba4ea5a,129,83,46,Oceania,18,448.01
f502d9e0db124a50a00fd1be0955b569,321,279,42,South America,19,2539.57
f503b382a7bc4a0b89ec281f57cd6569,132,94,38,South America,27,880.39
f5056e6a21c847f59cac4d606a80d8ef,62,35,27,North America,19,441.11
f508416efd8b4ce29416fcc48f8ff90b,365,365,0,North America,18,3212.35
f50ac967efe14b078108515d993a795c,207,177,30,Europe,21,1615.94
f50ba4baee4e4466856cf35bbae0dfe6,365,362,3,South America,17,1536
f50cb89bda1f49eaac5b9ab15aba4568,119,77,42,Oceania,19,543.01
f50e69ab78f343bd98f1b32277abfa84,364,316,48,Africa,16,2550.25
f50fe16131f54a61ac9a2152d0ce4bd4,33,8,25,Oceania,21,30.5
f511556eb6fb464d93e512f6ceb0bfb2,87,30,57,Asia,23,396.78
f511c2c0cd204351b5d5a31901239bec,284,248,36,Africa,19,2172.84
f51394e702d54e9b947c5a991e6b099a,74,19,55,Europe,20,811.69
f5167518a9aa44c78b3e95b5407a0eaa,189,166,23,Oceania,16,1279.87
f516cee14a0b41939685329cac16960c,270,234,36,North America,22,1542.31
f5172fab765f4043bf16ba38475f3650,278,235,43,Europe,23,1277.32
f517eb05fce84cad88af638a3d12f708,348,326,22,Asia,21,2216.24
f51c26f58cc94f778db63367a1cd439d,96,73,23,Africa,15,777
f51c34d97f624412b6cb360bceb8fc59,199,175,24,Oceania,20,1624.13
f51f89e3a5344a898eba92997e8be028,321,283,38,Asia,23,1898.55
f5209b11d7714625adbf652fc458e99b,245,223,22,Asia,23,1971.28
f520aed0ea524dce8f9c14cf54434947,266,234,32,Europe,21,1805.18
f5233e697fcd405fa419aa4c15702234,344,316,28,Europe,20,3051.74
f523629bbd0c4e98962b5e7e25f6e3be,200,163,37,South America,24,2059.79
f5264b3e7bee42b4a31bbbc1b4576c85,61,10,51,North America,18,322.89
f5274245464e4999a5161fae71c0eff5,149,92,57,South America,23,702.79
f5291cb115a546b3b91130877e4c750d,194,150,44,Oceania,18,771.19
f52922fd6f124148acf838eee6ba898c,322,281,41,Europe,21,2326.03
f529650f3a904e84acba98c36956c44f,322,289,33,South America,20,1591.58
f5299263cfb540229fd2927f28fdad2e,181,138,43,Asia,16,1092.46
f52aeedd99fb4ff6aec4520cc91eea45,200,145,55,North America,23,884.71
f52d1e826e57487e8ec5faca2e3743d1,218,192,26,Oceania,24,1663.25
f52f8900daf9464891dae267c0ea1d0f,364,353,11,Africa,20,2593.53
f52fb50db600424d96927621439249a3,293,252,41,South America,19,1303.48
f53005c1b2f943bb9d5c711f3b51a3a3,223,188,35,Oceania,24,1787.81
f533d7a1f3684bc4976ef8435fce1c29,365,340,25,Europe,19,1733.72
f534a85c918a4590819d45929bd4d503,161,116,45,Africa,18,722.38
f5378460f1cd48cebdb6cb886b08abd0,222,197,25,Europe,17,1826.49
f53c3645ad2043e58f1fa1237722eef5,147,103,44,Africa,22,710.31
f53cb17ffb9b4b27a3595deffa0cea08,135,113,22,Oceania,18,1093.22
f53fe3cfd1c1452cb577705c29ae4112,178,156,22,South America,18,1436.72
f542b4df57ad49f2a7dbef0bb932c0f2,110,81,29,Europe,19,1059.17
f5484afdb49c420a8aee5393fa538407,329,290,39,Oceania,19,2036.58
f54b24c3d1fc4c79bb65329570c16999,220,190,30,South America,19,1438.93
f54c0738e9a64e9880ca05f5f9035201,56,16,40,North America,25,210.42
f54f45161cc94e7baa81469f8c3ef35f,356,338,18,North America,21,2409.24
f558c881592a4a66b19b049e56ccc1d5,299,267,32,Oceania,22,2163.13
f559a4677d244a6dbca8679f91d0b206,207,152,55,Africa,21,956.82
f55c7319162340559213b16bb3416a26,216,179,37,Asia,21,1625.63
f55d98868d174b45ae88b4e610af140a,104,81,23,Africa,19,364.89
f55e1e24c2dc4945a705f6e01e2307a7,257,198,59,Asia,23,1071.41
f55e973d5e8e4b9d845dceebb75a5c1f,233,174,59,Oceania,23,1608.62
f55f789126d3494f87d19a6a4f0fef07,215,204,11,Oceania,23,1304.28
f55f90a71d09417fa11131d2b9d19713,103,51,52,Oceania,16,678.8
f5605a1f440e48eabb84b09174f71da1,299,254,45,Africa,18,1575.45
f5630cf915414f71add14e940ed0a9bc,284,254,30,South America,18,2387.17
f56338d836644b999c1c385a99e7ebf8,335,279,56,Oceania,18,1436.81
f5641031109942088c69a2ede44389a3,153,129,24,Oceania,19,648.75
f564da52712f4bd6bf7a91c4388a4d9a,274,226,48,Asia,22,1374.57
f568fa860d2b49e18573258ee0688d90,196,145,51,Asia,24,467.91
f569b46ff3ba444e8734f425385c34c9,362,331,31,North America,20,2780.16
f56ae92a4332442f9cdb56d7dba08b5e,161,126,35,Asia,21,863.88
f56bf0ca5fb74ffd9ffda5a05883c9e5,108,70,38,Asia,23,635.79
f56c4665c84e49dfb0abfb78e0be65cb,232,204,28,North America,19,1725.77
f56e821b6a02470992ff951d6be9f724,331,279,52,South America,19,1703.07
f56eacfc30dd48419c60cf099eef66f2,266,230,36,Oceania,19,1578.64
f56ebb06a5964af6a911f40687d2a90b,365,341,24,South America,19,1622.12
f5709bf64f4e4cc0936f832fecbb335b,352,326,26,North America,20,2973.25
f571214ffb994b359e4c86774c2c3ced,127,102,25,Asia,20,1238.97
f57392a99c4f4759ac51c7e487cb7395,298,259,39,Oceania,23,2132.06
f576f0dcc7964a12b951f8c0252da023,87,32,55,Europe,19,328.68
f578433875d2447d9f371160bac44e4c,168,139,29,South America,19,1070.98
f5798ce2115a4d96920a55d9c8e4e0e9,120,84,36,Asia,20,760.87
f57aa77986534ee684883e26de3c0b9f,363,352,11,Europe,16,2455.84
f57ad98c1d694b64a86bfecd8f86d741,80,27,53,South America,15,668.75
f57b9ce403064bf48d6d78168df0e726,340,293,47,Europe,19,1408.97
f57da77a25824bf6904051ae5b436626,365,329,36,South America,24,2231.59
f57e66b7af9a4bd1a123ba40c8b212a5,79,47,32,Africa,19,280.24
f5800ab7312f47e889a1fa23d83d4855,78,49,29,Oceania,17,606.8
f58304ee0d074706857c65a8775bc8e9,298,273,25,Oceania,20,1993.9
f585078cbd9c4422bcae1ee01c555079,342,315,27,Africa,25,2604.51
f586cfd5a8ff4c1aa5e34f814c3c9145,282,241,41,Oceania,19,1666.33
f58a406f72404bffa59d0f4545a95d49,135,97,38,South America,23,434.74
f58ab7f7683640f983f0095524d35b2d,347,290,57,Africa,21,1674.27
f58ab8c7288142faa972eb3c042cf53e,91,48,43,Oceania,20,618.32
f58ad7eece2d40a2b6be6efbc7203ee1,99,64,35,Africa,28,541.1
f58adb309e664a1aab489d5c524a1556,31,1,30,Europe,20,309.04
f58bf9b19ddc428e9be1151e444492c7,337,288,49,South America,18,1554.91
f58cdd7fd51d4eb183c972b0ebf150e8,111,86,25,Oceania,22,805.58
f58d7ad2f4a74be683b54e34e7bcac6f,329,298,31,North America,20,1955.81
f58e1fac335e416a99e3ee312b98d2e6,179,126,53,South America,19,1101.55
f59074d9718243bfa1b094cf5754974b,265,220,45,Europe,16,1544.1
f592411c87c6421da6d2e9e57c8c50e1,256,227,29,Africa,23,2030.6
f5955dcefa4c471aacf8fe952674ff6b,300,249,51,Oceania,26,1307.7
f5961a94c67d435f9146a98f39a85572,296,251,45,Africa,21,1398.64
f59888aaca8442929cf5151e6c7f86fb,128,75,53,North America,16,887.99
f59b335f0b8b4f4eb622a61e557c54d1,107,51,56,Asia,25,321.36
f59c496805d644d8a037a7e082a935c7,261,229,32,Africa,20,1709.43
f59c500882d149a0aa183c6cba08ec9c,338,296,42,Europe,14,2157.53
f59d686c406c417d874f2a4a3264df30,335,284,51,Europe,23,1887.21
f59df31de5e24893a54cd4ec91f3ecef,291,254,37,North America,21,1444.5
f59e9667d26c48d6aef7ba5987b8dbe9,181,145,36,South America,14,981.44
f59eb3e3e32e42a0806ddbabf6460607,323,291,32,Africa,20,1070.41
f59f4aba021f4c4185a0f9dba3dd780d,70,19,51,North America,18,360.78
f5a04a92c5b94c43a0b72ff93a8b82a1,302,271,31,North America,18,2533.69
f5a1125425c249689de21eb2ff7a9b0a,95,58,37,North America,22,923.86
f5a4133a5d8a473cbd8ca649122e61fa,316,291,25,Asia,18,1717.71
f5a79e29fcd14667a185b50786f46e69,223,178,45,Europe,23,816.37
f5a8c42964d4410e95112487e0c433bd,247,214,33,Europe,17,1663.46
f5a9324fc483481bb137c2c628b4d58a,193,166,27,Oceania,16,1760.74
f5ab93495a614967b869ecf143062af7,132,102,30,South America,19,895.67
f5b144fe59604afbae069d1d5a71a142,325,295,30,North America,18,2306.07
f5b33d21c2fc48d792990a32ccefe75b,235,217,18,Africa,16,2197.82
f5b4538f231f45c2a17d7298762f0790,220,189,31,North America,24,1485.27
f5b60659ef7d4d049d018d78af1a69e6,349,298,51,South America,22,2084.25
f5b6b39ca3be47349a986268ae178449,285,246,39,Africa,24,2117.4
f5b993bc4e7c422babf70e5458c95d93,256,230,26,Oceania,25,1461.71
f5ba5852f32a4c4c90fbcd4a8dcee9f8,362,362,0,Asia,26,1800.82
f5bb473ec0fe499db83d1c1be027483f,365,354,11,Oceania,21,2954.49
f5bc73181fac4ae29367752cd2d688ff,247,219,28,Oceania,20,2265.05
f5bd67ea0a5c4d199ff954aa5b1dd30c,325,298,27,North America,18,1813.95
f5c0dd68014b4ca2850a4f90764b92c9,360,322,38,South America,23,2864.78
f5c1bd4b935a4a61a757f9ccacca2ef3,118,97,21,Asia,19,773.95
f5c433f6376a422387d8012e928eb3d9,365,337,28,South America,26,2424.29
f5c47b1456c6452a893192d0b0d2cb25,350,319,31,South America,17,2129.09
f5c5437395034d2294d82998f69431e4,231,205,26,Asia,18,1623.79
f5c644464f294ceba6006c83f9af79a0,299,274,25,Oceania,18,1928.3
f5c79db16a8d4171b8b0969adaebfa2c,76,41,35,Europe,17,529.11
f5c8344d672b4d2f9236553386b5966e,214,195,19,Africa,18,1343.8
f5c8d12fe9e54f9498ed3a313aa5e313,200,149,51,South America,19,1242.5
f5c8def11cfa41a7998edac318163f53,336,282,54,Oceania,24,1289.55
f5c8e99f43ee40c4aa36d5d75313fdab,364,334,30,Asia,19,2528.79
f5ca35babd40451392a1416b87c16be8,241,221,20,Africa,23,1372.65
f5ca7cb514e2438a8d761e30f0a79259,210,166,44,South America,19,1111.14
f5cf71920f474caea1624f0849dbb9cb,94,41,53,Oceania,20,680.64
f5d6db461a714d42b6811716278efaf1,353,307,46,South America,22,2127.99
f5d7fdd867214e1f90586124b35d0d2e,170,130,40,South America,17,983.31
f5dad91e848f498c96d25e4f0a9b715b,216,197,19,Oceania,19,1939.62
f5db38b470084c089c04cf422dc54967,183,132,51,Asia,19,668.27
f5dd8600965b4e08bc453efc04a4deb7,365,364,1,South America,18,2496.12
f5e18ab45031459eb5727455fe00e4cc,53,3,50,South America,20,505.75
f5e21e17cfe142e89795b5806dfe24e3,169,130,39,South America,19,1555.66
f5e276333cd4443d93d043e72460830c,288,261,27,Oceania,17,2412.68
f5e349e08aed4a0c904826d65288f995,159,128,31,South America,20,1367.68
f5e3508e625940c486942a05d1806154,305,260,45,South America,19,1474.28
f5e5a04ffed847a79746a03cb724bdee,40,16,24,Asia,20,140.44
f5e65a64b4f4441fb9ee4545128683f2,299,248,51,Asia,18,1149.15
f5e777c181b54ca19f27294bd4f064e2,281,256,25,North America,19,2292.38
f5e8674822104f71ac9806c7bb9d77c6,228,198,30,Oceania,14,1456.27
f5eb3eec801a4e6a990c971bece58299,364,357,7,Europe,23,2187.68
f5f1463c481c4c898d428d590428ca40,328,284,44,Oceania,25,1341.55
f5f62b1ce6d04f0790b287d77dca2c2a,254,208,46,Oceania,19,1309.15
f5f67044c1e54b1ba9578ed1d819a2a5,363,363,0,Oceania,17,1974.21
f5f88def4a9941588422a4548384e83b,187,142,45,Asia,23,852.22
f5f949dd9e0341e1af7edd1e716622b8,208,150,58,Africa,18,1216.94
f5fcf7c48fd9409f906586fec9323c39,254,199,55,Africa,21,1219.04
f600d536be744723b2f1a161a0e6d4a8,129,80,49,Oceania,19,785.98
f60155cace0745bfa80a371188474bee,364,354,10,North America,21,2574.25
f607b1a62cc84efb9a0a8b5cdfe09a1e,270,244,26,Asia,17,1646.67
f60832523b8044168e4cf47ade2bf643,179,151,28,Asia,20,1163.72
f6083e3757d94fc6969e4bf5699b4f37,365,336,29,South America,20,2841.92
f60999996e074828bf008628622f411c,190,139,51,Africa,19,1403.35
f6099fc2487b4edc9021a90ac5529443,209,161,48,South America,19,929.52
f60c6b51ba7d49098faddfa9edad1111,76,54,22,North America,23,475.89
f60c78a45b6a4d778a914e5b6856baa6,358,322,36,Europe,19,2407.76
f60ca8ffd5d044f4a51afef4ed1157bf,200,170,30,North America,16,1130.98
f60e5f67f86744a3841eca4dd3c36893,88,53,35,Africa,16,1211.64
f6104588e36440298e6cb60609e6357e,80,29,51,North America,21,528.92
f61486b961924434a466b71496cd4739,344,311,33,Asia,19,2746.73
f6150411bf0744709f4f73321248b586,47,16,31,Oceania,25,414.84
f615b86f42ce4517b5b57ea2b2bceb59,149,124,25,Asia,25,1058.86
f619fe1fd61e44aeb45814344303ac49,349,326,23,Asia,19,2608.47
f61bebe0250443f99990b59c878738c8,218,197,21,Africa,20,1583.29
f61dde26faf34fff9acd8e99435addcc,306,273,33,Oceania,19,2856.46
f61fd8b49ae241d58b23e35475d58200,249,200,49,North America,17,1748.54
f6234763f30a4f5ca7edd583ee704545,364,349,15,Oceania,24,1642.97
f624e102ed824c43a4360ef33afe81b2,365,360,5,Africa,18,2655.32
f62517faee424c29bfa359231368aa9e,303,277,26,Africa,19,2412.86
f626838111404f4bb2284817b89147e5,281,247,34,North America,19,2168.39
f6292ccc40e4465ea7b693cb74fbb460,95,67,28,Asia,19,515.28
f6295bdf2ca741c497b6e389767509c5,238,217,21,Oceania,23,2138.55
f62a1d950df64912a0fa82c8ace9b22d,268,241,27,North America,19,2321.27
f62b931553b2432dacf22d4464abc930,120,69,51,Africa,21,657.02
f62cae6b803542ffbedcba85b2ec2d4c,365,328,37,Africa,19,1043.7
f62e8e856bf74bdeb212910bcef99815,358,332,26,South America,19,2232.67
f62f78a5eb34498f9ca1c00cacbba6bd,365,350,15,Africa,18,2282.41
f630f87e82274b97b77d1b9cbdd09c81,61,7,54,Asia,16,262.4
f631eaa4e1754c3594b2bfe1c08f8ee1,72,37,35,South America,25,610.94
f6320d78ade14bbf8adeada18e435922,260,223,37,Africa,24,1335.64
f634060fb78847868e55300e437265c4,365,352,13,South America,21,2319.89
f636ff1c78a84a26853b342fd00beab3,101,50,51,Oceania,21,468.65
f6373f8acf3e4f6dacc63b4a3e98bb7f,270,227,43,Africa,26,2088.72
f639938feb4041bd856241a01e701858,51,25,26,Oceania,21,155.81
f63b86f6a87641358f141021d443f23a,356,323,33,Europe,17,2199.99
f63d228a1af649e7b4b1b7a39750affd,141,103,38,Asia,18,1129.33
f63e8d7d16584d37954d2bb64aa6742e,105,71,34,Oceania,19,989.29
f63f8134afac46d7a2ed16f64347e16f,361,304,57,North America,19,1683.95
f641fcba8a1e43c5b4c91d5d6a58df8d,170,114,56,Asia,20,877.7
f6423a3c81794f8ebc4da8e463a97150,220,178,42,Africa,23,1314.73
f64575f1eace4d2991eea2313069ebb3,317,292,25,Asia,18,2618.92
f645a1a61006401391ae7e23c7ee19b9,225,174,51,Europe,16,1337.06
f6478ab8d7fd4e7ab105e71efe61f303,137,88,49,Asia,19,297.84
f64b36515a21463bacd6234d77bca2d8,123,97,26,South America,23,988.07
f64b7337ce4042d580ff3289d138d47b,258,220,38,North America,23,2053
f64ddcbf35e34d69a783a626c6ab76a9,108,55,53,Africa,20,497.47
f64f23555ef54194b286fbf09acf4f17,244,196,48,North America,18,1101.06
f64fc03f463146679fd5f50b53ee4ea8,357,325,32,Asia,22,2777.37
f6502c73473a4c67ac59c030031a59cb,144,115,29,Europe,14,1390.43
f65137827f364b0d885cfff2daa59ec5,232,181,51,South America,20,710.7
f651b9b0e8bb44fd9aa203661b295aad,330,288,42,North America,22,2497.26
f653137ab8b04f25b956171adc6125cd,211,181,30,Oceania,22,1373.45
f6532c1d7239458f992c920d8baa38e4,310,298,12,Europe,21,2030.96
f65412b6345d4feeabc5a43ddac43d53,334,293,41,Oceania,20,1564.2
f6561f32aaf448fd95b0c0dfca37eaaf,333,307,26,North America,18,2991.19
f65813a7da7942269125e6f6fa60d079,249,224,25,Europe,22,1732.02
f65b13dea7a4461f9601583104d5b33d,365,339,26,Oceania,22,2331.44
f65b9f43d7564ff495b336243b3db400,352,311,41,Asia,21,1758.53
f65cf9eae0944997a43739faf7046cf9,349,329,20,South America,29,1987.27
f65fb70132354f46b9eefcc0b203eaac,253,211,42,North America,19,1232.21
f660229945f74cac9ab8f68b378e156b,79,58,21,Oceania,18,847.47
f6625594c93d4bccb5639a96fb9eeaeb,303,281,22,Africa,18,1750.17
f66448231b224f0d8f5749819ab4423a,245,199,46,Africa,24,1233.4
f66e440d4a774c928e7ddc5ad82d17fd,151,94,57,Africa,22,920.3
f675be01587c4fd3911cf37741e68334,63,33,30,Europe,21,350.4
f677881be4b24af98ab18c03314787a3,100,78,22,Asia,21,484.81
f678a28177da4e77a5439cbf246c10e4,277,250,27,Oceania,20,2271.28
f67b8bd2d0804882ad3f5495e5726ad4,112,63,49,Europe,22,544.87
f67cb384d9054241840f777cd8e7a90e,364,347,17,Asia,15,1649.87
f67df63b464943d9aac5272f5cd6a0d0,338,288,50,North America,23,1758.9
f68174bc61d44572bc75a90dc374567e,211,162,49,Europe,21,881.99
f68418b41d884ac49c54c31f0744993a,64,22,42,Europe,22,544.1
f686d4890d2144fc8d030d2eb2411c49,288,249,39,North America,18,2954.15
f6883efb62124ac89c31e4df8ade3f00,217,169,48,Oceania,18,1131.03
f68975c3e07645f4b0fa344dbdfc4eae,268,244,24,South America,20,2063.67
f689d153c5594d12b3dca77000ec2e69,360,356,4,South America,23,2170.16
f68a0f407cdc4b7d9c1c68b01d677345,46,9,37,North America,19,325.51
f68a416bca8148acbb81345b8a7f546e,365,338,27,South America,20,2496.63
f68c158da1e646a9bad6f0e196578375,336,306,30,North America,14,2295.14
f68c53c4afc547ebbd7f1a1bec7ea46f,362,355,7,North America,20,1854.49
f68e220d9734437cac8f68feeb623224,358,354,4,Asia,18,1319.82
f69251e8a8424428b0cbfeacca81fdb1,228,206,22,South America,16,1919.88
f6939d99199c411c9bd7d2ddc4245268,364,359,5,South America,23,3620.74
f6969d54506a4a47ac47b40046bbbac6,362,338,24,South America,22,2841.01
f69837ad3ec34986b89a81227f0e7878,259,203,56,Europe,22,1297.45
f69a4dc862534b2da4c8fcc02ad407b0,285,259,26,Europe,17,2314.65
f69cab8c44b04590a20c57e6d53357f1,123,92,31,Oceania,19,701.77
f69ce5ab354c42c8b4f8f3ac7d3c2aa7,312,279,33,Europe,19,1967.08
f6a234257a2843faafbdf29a28283411,135,83,52,Oceania,19,457.08
f6a4f422b59444a79cd4fbc1b5044872,98,47,51,Europe,23,948.5
f6a5ced58f9b4eb7a439cbe133507cac,238,198,40,Europe,14,1982.83
f6a616fea7b145959860db1331c2726c,349,332,17,South America,23,2481.63
f6a718ebb02d40bdbe5ea6f0fd21811f,187,134,53,Africa,23,698.7
f6aac82b2286436a86e6d745c8eb68a4,364,336,28,Africa,25,2412.81
f6abaacc874447aba2b8a19c09393118,232,207,25,Oceania,20,1247.09
f6abd23143e94abe988a6e31b14a11db,312,268,44,North America,23,1684.28
f6af59b333f745ba81930118716139cb,221,171,50,South America,19,967.86
f6b06745ae314f3995b7b25e51e47332,195,168,27,Africa,22,1134.47
f6b0d4ed0ab74763b391ee2d5b5b0431,196,179,17,North America,18,1752.03
f6b1fdb30943490fb3eba94e87511a4a,276,254,22,Europe,16,2944.67
f6b4739d31b84dc0a819271b0dbfb0e9,328,280,48,Europe,16,1333.07
f6b51bdbade64514a690dedaebc37d43,153,137,16,North America,17,963.55
f6b82ea0682a4de2a974777563d4ec23,364,352,12,South America,21,2401.82
f6b84a2cd249415c8c574b788c6ccc33,151,115,36,North America,22,588.24
f6b9fdca044742df9cf262ff36d56c11,358,344,14,Oceania,23,3433.62
f6ba1e786b2c47f999f3c405afd708eb,82,42,40,Oceania,16,387.65
f6ba8a25c40149beb004ae46b2c376a7,335,292,43,Europe,20,2537.92
f6bb07ebe2fa44b08f5f8c7de34558f3,303,286,17,North America,17,2231.6
f6bc69f1d4234a5f9a25706bf5ac44c6,213,189,24,South America,24,1436.01
f6bca8e0e5aa4d3ea3497592e6a62d96,64,45,19,Asia,23,358.02
f6bd3b7905a648d5887fbd3428c473ec,168,120,48,Asia,18,418.34
f6bdde98019a419d8eb062d2c2fd98cc,188,169,19,North America,19,1612.79
f6be2142500e40c5b4d363485c711030,304,283,21,North America,21,1996.17
f6be681775c4489cb7c3d3e1de0ed87d,300,277,23,Africa,23,2211.67
f6c2a32d768c4cf0a63201671ed58529,61,20,41,South America,20,419.56
f6c2f276b0174491b637ec8214f48974,309,272,37,Africa,20,2112.56
f6c4a06facfd4184bef500864bd4e685,99,43,56,Africa,20,534.11
f6c678c700ec43f9b345f00022549ab2,322,281,41,Europe,24,1854.1
f6c68c5e394a4d5bb377a1e6f5e19e7a,161,132,29,Asia,23,1191.11
f6c6c8f0a5b249ae9e5492a869df981c,365,329,36,Africa,21,2212.96
f6c857a792994ee89c2839d474e7c9d3,364,322,42,North America,18,1656.39
f6c89467f33d401491b573033f4649b2,147,117,30,Oceania,21,1265.74
f6c92b9dceec4b31b0b26f68dbdbc305,341,277,64,Asia,17,1830.87
f6cf09936629469ca7ff7482af8c7e8a,245,195,50,Africa,25,1085.44
f6cf0ccbdb6d4fa8b1c344f70515b281,310,277,33,South America,19,1581.37
f6d0dc7358fb44f4a49e2d0739be29cd,56,25,31,Africa,21,465.42
f6d27e893ade4973b9e26a971d0b11d9,196,173,23,Oceania,20,1626.23
f6d6078d5dd3455c8e8ca4cf24286bfc,173,148,25,North America,15,1095.52
f6d6ab25786f472b81ad08222178e91e,208,161,47,Europe,23,899.25
f6d6c662dbc443f4b019f4f4e8e51bc2,320,273,47,North America,25,1171.89
f6d80e30d5094f3db6ad73dd476b7d0e,94,53,41,Oceania,16,638.79
f6dbbee011ee473e877087667feaf961,142,91,51,Asia,14,942.56
f6dc9861e7474522ae9d8c03cd6b9caf,364,336,28,South America,18,2238.25
f6dcf722880a413ea9bb18882a2a9277,363,347,16,Asia,19,2669.07
f6ddf3f0bf7845a6a8d43bbfc054a8a0,246,214,32,North America,19,1564.54
f6e2a1b7a0c546408fd9c7b307deee61,340,289,51,South America,23,1374.65
f6e31ebcd0e54b019511e89db0d453a7,93,63,30,South America,19,537.95
f6e3dc6708364486bc1cf1782af0df01,332,292,40,North America,15,2165.39
f6e3f4baa458491bac5477a42f41b97c,365,353,12,South America,17,1802.58
f6e58b1a41ae4f5aacc89bd23bc4ac17,100,52,48,Asia,16,498.98
f6e6996801414d88a35be33bbcf83a29,87,65,22,Africa,23,736.99
f6e7c0ed43b747878079e71758e432b5,291,234,57,Europe,18,1963.53
f6e85921c07d43749448210c9fb205a5,149,122,27,Africa,19,1012.81
f6ea584c5b20481a9526b4070693e749,273,238,35,North America,19,1439.68
f6eadb2b208b47ff8366dfdad64f66e2,34,16,18,Asia,20,96.17
f6eb366741d446f8b1e0d43a91f30e4f,77,52,25,South America,19,431.47
f6eb44829c2940208e5326c20976a5f9,61,36,25,Europe,26,353.51
f6ec51cfa7e149a78c3f3c4a946b07fb,97,61,36,South America,20,777.89
f6ed1563991e40a4b9e657af69d61615,365,338,27,Asia,22,1601.49
f6ef314402eb4a0faf20b87823819cf1,137,107,30,Europe,17,1365.7
f6f07711f958424aaf83b7e1f5dd773e,342,316,26,Asia,16,2789.47
f6f220c1f024445fb9bd08d0835a5116,110,67,43,Europe,22,418.32
f6f244bf3f8f4e1b89c6c1932f33a3d3,62,14,48,Oceania,21,278.97
f6f316df11864e3b8b04df4a97afb8aa,88,58,30,Africa,18,556.72
f6f3ec5811a940549a35d9fbb53e1085,131,97,34,Africa,14,1106.36
f6f53f3bcc764b239ea5925027e9c307,114,76,38,Europe,23,746.29
f6f7659bccb54f33b2d3b5c007460209,183,132,51,Oceania,16,855.76
f6fb3a5184c9455aa37de8ba10ec6bd5,176,132,44,Africa,16,1484.96
f6fd6061d0cc4909a73b79a8c7763cea,271,222,49,North America,25,1385.09
f6ff021e2c614572853da337bf4fc6ae,365,323,42,South America,17,2040.29
f7002a7de9164b0a86343dbaec3ec35a,110,54,56,Asia,21,559.51
f70322e0b90043f7a4000c9feafe4ff2,69,17,52,North America,21,274
f7061fd005a04dbfafcf0602c891d048,54,27,27,North America,13,602.95
f706357e12b349d5b2c7f7f64b5bb340,146,123,23,Europe,24,1161.17
f70a766662b841b2866519cbcd047733,310,289,21,North America,19,2023.63
f70b614c5f97409586d025912270b688,206,166,40,Oceania,18,1101.82
f70e437c07bc4dc796256e2d7e5c6aaf,268,244,24,Africa,20,1903.55
f70f880a5d624d5bbf30185ab82e0dd7,341,317,24,South America,26,2731.78
f71172b886fe4035bd173287b1a18bc1,208,185,23,Africa,27,1776.97
f713104e427f4a17b645b5f174b34f7e,198,161,37,Asia,16,1228.11
f7136af862314b4c850854142fcf3b7d,247,212,35,Oceania,17,1902.9
f71392f048964f6086d354af87b361da,120,71,49,North America,20,679.65
f715eb0f71ac4fa0bbe35c9a59f00bb6,365,347,18,North America,29,2403.16
f71c6e0295a9441fa0e38fc200a2de6e,52,33,19,Asia,21,571.49
f71e810cb2e244a18348694de11240ac,306,282,24,North America,18,2166.43
f71eafa3ed454ac3b93ae645a6f314ba,345,319,26,Asia,17,2463.93
f721b5586ecd463e8dd94e0ed6e8d2de,72,29,43,Asia,14,154.48
f7222c497d1d413baf9c93ffbc711db1,276,241,35,Africa,18,1662.99
f722abc33c774568bfdfbdc9085b79eb,276,242,34,South America,19,2035.36
f722ce37f6264bb0854fd55a7ab3ee37,50,15,35,Africa,18,375.95
f726776111704acfb11583b546df284d,33,18,15,Asia,19,151.39
f72686f515b34459bd86d454b4da1777,133,83,50,Europe,15,340.81
f7289810e65145128b11f2b17fd530ae,200,152,48,Africa,17,1128.48
f72941425b4f4e9a9c0a2dc49ced5fc8,116,95,21,North America,18,773.8
f72c7bed78a24fb6ba771c55a716e46e,156,128,28,Asia,19,1067.99
f72cdfb0dbe943c0966b14a4e9050125,99,58,41,Asia,14,498.07
f72d8b7cdd384d63804be1fedba9462f,218,198,20,Asia,27,2166.75
f72ebbc087de4fbda71ab9a638478a2b,222,174,48,Oceania,17,1187.22
f72f980dfaee458c8eb8422e3529116e,249,206,43,South America,19,1364.37
f7312ec2048341db96568de03cb02cdd,283,247,36,North America,15,2077.44
f73308f450b0472da553de8bd4261d82,364,358,6,Africa,15,2156.31
f733622a78214840ab11b498e8887e49,301,243,58,Africa,20,1216.11
f73546017bf445f4a865133ccbb894aa,343,312,31,South America,22,2530.23
f73549e928aa4eca8b5f814209215705,171,136,35,Africa,18,1289.32
f735d957e43a40109b1101310317a2a7,291,242,49,South America,20,2278.22
f736e268bde3467480b879acaf805980,194,158,36,Africa,24,1310.71
f7388cd3e5bd43e785626812b253ba13,365,349,16,South America,23,2851.82
f7396f7612504f5389fbf8976372e57b,365,363,2,North America,20,3270.75
f73aaa93917143999c227cdae7f83f63,197,161,36,Asia,25,1365.71
f73c626c9a024984a1111e36758f8db8,246,219,27,South America,19,1760.16
f73cc4a5bb7143a289fa567c3863d9d9,195,172,23,South America,16,1655.04
f73cdab5dca74a4883bc8e209403eb9f,159,119,40,North America,17,795.87
f73daec1dd0540858eb7ca5456c7934f,347,324,23,Oceania,24,2480.33
f73dcf4a80e14c0ea1ca33430d326363,83,35,48,Asia,20,495.13
f73dfc7aa8c945319df7d97014cfac74,192,148,44,South America,20,914.68
f73e55b5fc8e431c9ef112cbd8159546,109,67,42,Europe,20,508.65
f74348e4ca9c443a8d2765e0a360c1dc,121,92,29,South America,15,700.25
f746e851f627451282748839527c930a,96,49,47,Africa,16,559.43
f747c9f579c243059c80a4ce2ea5f18a,157,107,50,South America,23,798.65
f74b8cafe0c14ce885126d35a55f2e20,307,279,28,Europe,12,1997.6
f7549ed3265c45a3835be6fceb951444,365,335,30,Africa,21,1657.57
f7554215caf84094bd5c258d209543c2,355,303,52,South America,24,3324.94
f757461b1cac4296be1d275fe8c19582,365,364,1,Africa,22,2063.54
f75aa97147ec42a0ac785c565d677a34,258,231,27,North America,23,1533.34
f75af66c11074801bf2adfa4f1451ce1,26,3,23,Europe,19,411.97
f75bdfb878404a1c8ba3dd2c650eca7d,230,209,21,Africa,16,1574.68
f75cbcc97e2a4cbfb43d27007b921017,79,29,50,Europe,19,115.18
f75ce63ba641415d894d0e93e925ca0a,334,281,53,Europe,20,1946.02
f75fbd74600c4e8fbd93283c9af19bf6,105,86,19,Oceania,20,960.58
f7605fe68aeb49c6bff987238fd06f38,266,243,23,Oceania,23,2432.53
f766d907e7b7449394c8baca9dd37c86,365,352,13,Asia,15,2538.06
f7690eebcd844b52899eca8b7b889eaa,316,277,39,Africa,24,2224.89
f769e033c5a24aa5b3f6559c4283f349,313,280,33,North America,17,1903.58
f76be31d5e81483faa6ffadc9a216a7c,29,1,28,South America,24,289.9
f76e9be208f34eb4a1c5b97fb8a3c7ed,299,276,23,Oceania,16,2032.09
f76eab71e7de4683bb331ed1ad6994ae,316,272,44,Oceania,20,1338.43
f76eedbc414d4b4ebce7f917f246bf75,365,333,32,Europe,18,1725.44
f76f54d46fc64240bdcad3ddaf93ce0b,322,277,45,Africa,21,1992.12
f7713dfde80942658cdea04e94d1280b,365,353,12,North America,21,2507.33
f771b222530d46cd98530535c9a9d59f,81,50,31,Africa,21,783.46
f771e9767954436d8fe562a1dfb6b99c,70,34,36,Africa,15,439.07
f774885f2d5f431490a10a42de6624da,360,315,45,Africa,22,2121.42
f776661eca1e42f3a7adeac3b1c9792d,260,230,30,Europe,16,1908.13
f77697a2e131454f8124d54ecb883cb1,48,23,25,North America,18,326.94
f7782f49edd649e4915befddd63031aa,131,108,23,Europe,28,1406.68
f778404068c6482f8127a80ced875dbe,168,138,30,Asia,23,1461.43
f77bc67a9d7b4eb5bc6442c1ee843bda,87,35,52,Oceania,23,492.87
f77c05d3e3414baba1d412ecb7becb04,60,27,33,South America,18,446.31
f77dcf9812d0471393f37a35462e8d57,132,107,25,Oceania,19,971.9
f77ebeffd96a46e5977160735edfe14c,327,273,54,Oceania,17,1575.22
f77eeea8286b4fafb6d06e3d217ab0b3,165,132,33,Europe,20,729.52
f7808fa71965400b920dc97c56e270a1,152,101,51,Asia,19,717.99
f781c44a445547e9a0cf72143b898f91,317,291,26,Oceania,20,2654.31
f7830876c22940ae9edd8e03ebd17250,180,152,28,Asia,20,1701.22
f78552ff25c84d7284a3059c5326ff22,351,314,37,Oceania,22,3483.33
f78664a5affd4b1595a10126d90f7544,334,305,29,Europe,16,2085.8
f789bd3030b14a21950878312b649a1d,211,186,25,South America,18,1892.82
f78b143f73a74e4f853ba45c57ae0316,217,192,25,Africa,19,1563.9
f78f50f7dee74610bf4a89b4f71bcb7d,327,274,53,South America,19,1361
f78fa304124149d3b3b4b615050e35c4,284,255,29,Asia,21,2640.44
f790530fc1d54b378ac8c1975e25c286,365,349,16,Oceania,17,1780.41
f7908ab19f7841feaf7e440205dc9379,156,125,31,South America,17,739.09
f791085efc1c4bb0a96eabee1ff796c4,280,241,39,North America,24,2395.83
f7940990dd704d7097d8d5b0c53c2aed,209,174,35,North America,20,1818.45
f7943b8ddcf34d1ebe20455b6ced8418,312,275,37,North America,22,2248.42
f794acc1be42442293cd9a7c3dd821e9,278,260,18,Africa,19,2202.05
f7962dd8eb3141389dc75c798e7c33bc,140,91,49,South America,19,461.11
f7970a813e7048a8a3f0d658a94dc10c,365,321,44,Asia,22,1648.11
f7981c6118624adb8166150334f688c1,360,326,34,North America,20,2491.38
f79a07b993c84e34b33b5f850894803a,48,13,35,North America,16,125.47
f79b61af6a674d76908767264f0902c8,364,337,27,South America,23,2143.12
f79c1b25491b4488b73f75ed0cbf21c8,104,69,35,North America,22,896.41
f79c65dfeb324ec2a09e3bdc047ad62f,246,194,52,Oceania,20,945.46
f7a1c3231e3f43179d0cb7851842fe50,298,246,52,Africa,20,1754.49
f7a2257811934a95bd87fad2a58904cf,146,97,49,Africa,21,712.72
f7a2f3fdb5a948c6ad6aa75ff3a255de,164,129,35,Africa,22,1009.12
f7a36dd70eae4b4ba060c6b2749e5a12,365,337,28,Asia,21,2023.92
f7a978e3ef374401a4bfa0b8048323ef,242,193,49,Oceania,21,988.25
f7abafab1bf44f708182edbff933edaa,258,198,60,South America,19,1483.51
f7ac633554b74d1486b341b1a74176a2,286,254,32,North America,23,1756.74
f7adb725f32947d4849451390543021a,102,52,50,Oceania,23,518.37
f7aef71307434caeb05b22d78588f7a8,363,345,18,Oceania,17,2663.22
f7b52511577a47c29d5e819e74c6b235,159,121,38,North America,20,608.72
f7b578dab4834569bb76054337b96be5,171,118,53,Oceania,18,1045.35
f7b5ab26abaf4fcbb34335b8d6ed171b,297,259,38,Oceania,26,2059.6
f7b8040567b945d6a6bcefdc54c2a8e7,160,129,31,South America,28,872.86
f7b8d67afe174b17b759697764579ed1,206,176,30,Africa,17,2029.39
f7ba050e2b884bc6b3642d15f6140069,362,327,35,Oceania,19,2521.25
f7ba4bd5eff741f888c2a5258b545de7,88,47,41,Oceania,17,502.61
f7bb435a01404ac6b67aee89ef68d324,68,41,27,South America,18,267.19
f7bdf235f26049c19edc74ac974db863,123,79,44,Asia,20,578.1
f7bee0117dbd4adfbc4277b0532af23b,202,167,35,Europe,17,870.35
f7bfd0644ee64704b842f761e60cff7f,107,65,42,Asia,19,825.98
f7c14ac655ae49efba9386ca7dce779c,193,158,35,Asia,20,1534.12
f7c20b31ae6e4bf7bf5dd2555fa5a7fd,168,121,47,Africa,16,571.77
f7c9a0c04bfa4dda8e8a3c9b3f63ecbd,69,39,30,Oceania,19,704.37
f7c9b034751145df9dc83474f603bb03,192,168,24,Oceania,24,1377.46
f7c9eeb0caea483ea141096fdf68e220,364,332,32,North America,20,1536.3
f7cc35eea8f64ef4bab788600a3a7532,217,177,40,Africa,23,1057.8
f7cca04c42bf48b194d2375c25ca07c4,152,137,15,Asia,20,1408.48
f7cd256b846b41c0a9d921925ff3d9c2,180,151,29,South America,22,1237.12
f7d1666ef5374a62a7ee2d17b78762be,334,307,27,Asia,23,3205.89
f7d2eb1493ce40f1929efb3f7de900f2,62,20,42,Africa,14,303.23
f7d38ef0dc334dbf812d7d17bec04641,345,321,24,North America,19,2064.02
f7d8b1f163554b9ea8d86ec24aff30cf,365,344,21,Africa,22,2605.41
f7d933053c884fd7999827f35f8d0eb6,288,264,24,Europe,18,2069.26
f7dfee95debd47f3abf12ea79c9916d1,263,215,48,Europe,19,978.21
f7e0911510494ed484cfddbfbaf08e4e,153,120,33,South America,23,1283.42
f7e10df05e4d4a17932384b5944c4fcd,309,286,23,North America,21,2939.91
f7e18beed983467da339701d9d3f99c3,332,292,40,Asia,19,2008.93
f7e9efe92c374d66b012d58c6091b847,253,224,29,North America,22,1790.79
f7ec02e4df3f407182971054fabfe274,175,148,27,Africa,20,1310.37
f7ec904e2b5148caa2a192e9ad38af91,59,29,30,South America,20,527.94
f7ecb00b516545e98a28b79f5feada48,320,259,61,Africa,20,1820.41
f7ed8aa63d474d6da26b4d10d53f6b42,75,54,21,Africa,17,634.13
f7ee0d5168994a45a2d9ee72c2735fe2,154,112,42,Europe,20,677.73
f7ef87b8c33a4b7582c1d4edc72fe1a7,347,319,28,Europe,18,2408.7
f7efadbd991540749ff3908e317caf74,81,54,27,Africa,18,490.18
f7f11b4851b348c7950429a6efe3c9f9,354,304,50,Europe,25,2048.78
f7f1af4616ec4dbc8fed819e7af7c7f2,317,268,49,North America,17,1195.38
f7f1d2a386554e7b85edcbfb408d5698,59,5,54,Oceania,19,255.95
f7f2477e2003485ca6d6f0fcbf424d57,355,301,54,Africa,23,1986.08
f7f9511a17654499b9a31c9759d5d016,117,80,37,Oceania,16,594.95
f7f971f52d06421b86a6ac1553d1d2a2,362,349,13,Africa,19,1661.7
f7f9da14347a47568c11d9cdda758749,335,318,17,Africa,26,1911.17
f7fbf0b8bbfa46e2a5e7d83b51d161ec,144,113,31,Africa,18,1087.89
f7fcb8eb08a847488fb62ad78a2fc3ee,169,130,39,Africa,25,1651.08
f7fd4d5ff46e430f930a8308d294153f,144,115,29,Asia,16,1284.85
f7ff982f3e814a53aa8e334fa292d3e4,70,17,53,Asia,20,431.6
f800d3bf8bcd4bd08ff83ec4e365337c,167,143,24,Europe,24,1145.67
f8018388f59040518d90133cef6d5fe5,365,352,13,South America,24,2832.32
f80187aa5e1544ac9a0495084a262802,59,12,47,Europe,19,182.23
f802205b85144dea857630401e7984c2,359,318,41,Asia,18,1619.49
f8039d5110a94b8eb7a547ab16a1ef9c,43,9,34,Oceania,16,114.51
f80901ca1f594ba5a15424d3828ba5e7,39,18,21,Oceania,20,157.63
f809bc6ed1414f7b858520fcc111762a,365,340,25,Europe,20,1979.06
f80a50ca9997449d8c3507e272dd1fde,267,220,47,North America,18,1641.19
f80ba460e1c84df5871eb8d85985bef5,122,77,45,North America,18,698.73
f80ca573844144dd928be0c96a47aaa0,169,146,23,Asia,19,1342.09
f80dbe9ece8d4988bf8a5dda709737ad,236,203,33,North America,18,1495.56
f80eb376e0e24eff9d29f5163889cea7,200,161,39,North America,16,1524.52
f80ee6cc816c4ce0ad793029646dfb00,347,289,58,Asia,15,1324.22
f80f763cedd84c6691e59c2d7e858871,351,331,20,South America,20,3395.96
f811751e191e4d089ace328256c871f7,219,199,20,Africa,21,1645.12
f81186348dad426da96b7c5dc86921e4,192,163,29,Oceania,17,1706.89
f811cd74b6a9487586502ac92b99cf13,247,219,28,North America,23,1611.74
f81280c5c8ca4bce9e783fcd743fcc49,168,120,48,Oceania,18,650.52
f813cea98c104a848c70338dcca55d3e,127,86,41,North America,21,821.35
f8149c07a6db4fe0a456cd35efbcd0ae,134,108,26,Asia,22,637.28
f8183b637a174defa04635cc545ea5c7,114,87,27,North America,20,722.2
f818d8cb22a64c22b9351352aaad1671,260,225,35,South America,22,1647.74
f8195d7c31184e4a958fa1f47bf0e6a5,100,50,50,Asia,23,742.92
f819dde1e55945c59c9d916bf6b374a9,121,79,42,Asia,26,913.32
f81a27744a04459d84c6e123da09fed3,170,136,34,Oceania,19,1211.31
f81a34cbaf154e18ae7e1fa00154a5df,271,239,32,Asia,19,1657.02
f81ba1bbcd5443cc98739300befffd65,179,154,25,North America,21,986.03
f81bb7f03cf0477381760b24155df1df,353,315,38,Africa,16,1999.47
f81cefa8d24c44f6badf7ed2caaad8d2,275,229,46,Asia,16,1564.65
f81d711adc054d4da85b799fb468d7dd,282,243,39,North America,20,1867.88
f820c147a7934a9aa649f8722d475a93,224,183,41,Europe,23,1207.98
f821f414fd0f4b89ba4d24af538ba73f,361,352,9,North America,18,2916.76
f8246377a1a44b4abb9508a4b0efd641,364,316,48,South America,18,1156.83
f82490fa208a4fff983bbf4896e3d94f,365,342,23,Africa,19,2625.07
f82677720b3c446eaf1e07f1d2e08d51,47,22,25,South America,24,461.98
f826993192604720925f9d9ddecb8788,95,64,31,South America,15,446.22
f8277942204642f89e127057a73209d4,172,147,25,North America,20,1054.03
f828111f9abc48a98cfb3e604476304f,77,61,16,Oceania,18,802.15
f82858da580d4922aa8793dfa6ddafcb,235,200,35,Oceania,17,1895.1
f8291a9263f6473b9403a5b59b9d69c5,262,232,30,Africa,18,1821.59
f829bf2045f6489297acfe85110ed7fd,362,349,13,Asia,22,2604.55
f82a4fec25634408810157170f65224a,365,365,0,Africa,22,2055.18
f82adf66e4e842ffb8e57a6842cc0249,257,218,39,Asia,16,2031.16
f82ce83255e547789dde5cd4a19295ee,361,310,51,Asia,18,1707.3
f8309e3509e440faa95dc121ac752447,300,253,47,South America,19,1833.3
f832936232ab4c66bdb41a8a9f5da06d,339,311,28,Oceania,19,2827.8
f832d6f2fc1e42d0a5856ccfafff38ef,321,292,29,South America,17,2082.92
f8335a6120d74fa6875daec5095ac41f,88,49,39,Asia,21,537.52
f834da53fba44d2c8042ca687c0196aa,69,43,26,Oceania,17,301.82
f834f98da7794159aded62f7660de7c4,59,17,42,Africa,19,623.6
f835612f3b70435db73ac78d7a4c009f,54,18,36,Europe,11,497.72
f8389c9c42c74cbebff7afaa9a6254d0,57,34,23,Europe,25,443.99
f838cd0390564c7d9852913f349d939c,239,201,38,South America,21,1902.91
f83a052ddc9f42ac908d6f0d9b01dfb0,347,314,33,Africa,21,1640.69
f83fd9aaa0064add9b4645d6a5acd703,98,69,29,Europe,23,487.33
f840103efaea4787a951d2c74a701177,360,347,13,Oceania,18,2771.24
f84158df84b0485887d0658b611ff89f,146,122,24,Oceania,25,1101.03
f844266acca3469db192cbcfc6e7e3d6,138,103,35,Asia,22,562.6
f84689ed662f45d7811590b540c11e84,307,253,54,Europe,18,1946.07
f847059ce3d14f23aa53d45413b0a0d4,239,215,24,Asia,21,2253.67
f84827c0085c41c29c85b0c09f143783,183,146,37,Asia,17,1713.51
f8487091a7e74d19a400ccdb0459af7a,130,88,42,Oceania,21,817.91
f848f12da79442ba964383473c610aac,50,3,47,North America,20,332.47
f8497a070db04ef7bfa5d7140109ac0a,208,154,54,Africa,21,815.65
f84b9f981c514a34bf2d9d716893bb61,327,279,48,Europe,21,2090.06
f84f9d9f1e294aeb93bdb1c3a67016ca,70,50,20,Europe,18,661.94
f850445a7f6d477f906e5168e267704b,148,116,32,Africa,19,732.11
f8507faa843c43c7a52c10b8e9dffa21,365,327,38,Oceania,20,2442.45
f850e442cef14e48b98b318c56c452d7,77,26,51,Oceania,22,537.34
f851322b031b4ba5811be3c444b25fc2,121,70,51,Africa,24,327.32
f854157263a24b5f8e64ed6e366f1fc8,65,31,34,Asia,19,504.42
f8542f9f3050418fae3dcafe111fdf5a,56,1,55,Oceania,16,97.89
f857c403f07148319610f964a436ed84,309,249,60,Europe,20,1010.04
f85813ab35d042b9ac9060b67c98f8e8,331,273,58,South America,19,1490.87
f85bf0cc8f184fd2a729829526ec8e6a,365,314,51,Africa,19,2120.01
f85c3e9fcd1548eea5747aa4b9380992,239,201,38,Africa,22,884.91
f85e1bb760a840b08060f6a7dfe3acd5,281,249,32,Asia,21,2035.78
f85e697a1d644929bb5e880788fb98ab,132,94,38,Asia,17,997.61
f865c7a46767495588c8849192c8bcff,144,101,43,Africa,19,837.28
f866590bac7b42adb1d5a1498cab593b,324,273,51,Asia,20,1660.06
f867d5927dea43a7a6ea1005e2a65bc9,192,142,50,Europe,17,1092.42
f867f6bf36b24a15bc4097ed032d8286,239,218,21,North America,18,2089
f868106a05c649c09c26a9abe2afb795,75,23,52,Oceania,17,573.36
f8692407573a4b5e8fcdab58235a8d7d,300,271,29,South America,23,2157
f8692b6cfc46467f8bc4a19f7446441a,157,109,48,Oceania,20,728.42
f8698b8bc7fd409bba523ecc4160b84f,360,331,29,Africa,17,2759.93
f869d070d9bf43d38b2573b9eec4187f,207,184,23,Asia,21,1695.24
f86eaf58766040899012a2d0883f8b8b,225,194,31,Asia,20,2092.65
f86ed46dcad34eb4b7855f5a01953403,201,169,32,Asia,19,2341.59
f86f94fc48234a5ba482c591c760e205,232,197,35,North America,19,1470.61
f86fea0e49b24afd9ea36f1ce12a1324,55,27,28,South America,18,274.44
f8758148cc394471bc3ff86ba8951caa,159,133,26,Africa,21,877.4
f8773d71856d4a25a3a834536474c696,169,124,45,Africa,19,1435.6
f8797a9b5a1f4b8fadeb3cf5c006c42e,70,17,53,Africa,17,231.74
f87a6c061dba4466b1f364e26cfa2c1d,79,38,41,Africa,20,455.57
f87a95372e6b4bcaa91e338dea912687,365,359,6,North America,16,1445.28
f880000013824c8c99ab2f26be36a438,97,41,56,Europe,17,631.58
f8801d20d7f6466b9bcd78acbb964b63,106,49,57,North America,20,242.3
f881d963df8b464f85715a76c6263902,47,25,22,Europe,20,363.96
f8850b093aba4750a6c1a27f9ae41b0c,246,217,29,Europe,19,1700.61
f8859556dba2470b853073de63f396ee,365,333,32,South America,20,1626.76
f885b42024b04170af095d89d5c4a1e0,341,306,35,Asia,26,2331.99
f8862df9c12b49528c9b4fbdb00d7576,147,124,23,North America,19,964.07
f8879a1b77a8426c96179f3809355389,99,48,51,Africa,20,468.6
f88c2d56ead24877b2ddcc4dd24bd2fa,360,338,22,Europe,16,2592.95
f890a4cac2a0485bb20b5690c0cd4ccf,218,186,32,North America,19,1489.18
f894d20e7a574b75a587350f6b0601d6,97,69,28,Oceania,24,752.3
f895bff7178f4406b95b4418e88ae2b5,31,3,28,North America,17,169.06
f897234767b046f6b1374f050e943fc1,346,313,33,Africa,23,1997.5
f89983001a3246748d02737759790fad,100,60,40,South America,16,1150.34
f899c8d508364a3ab73145b5cfa68d44,290,278,12,Europe,24,1842.69
f89b2941cce546cea49f6fb155bf59df,155,116,39,South America,19,693.27
f89b30f1fa82435b82329c8d728e48ab,306,272,34,South America,22,3016.82
f89c591d4b4a44829b39b9607baa8b22,141,88,53,South America,27,648.16
f89c802695b74546b4f3257f74aab7b4,278,245,33,Oceania,18,1669.63
f89d53c318e4490ca007f2e411666642,335,309,26,South America,24,2707.09
f89e1abb75214ab6be7b3e67b7fa04ed,252,225,27,Oceania,20,1564.22
f89ebe7be6fb467f87c9caf1406f80c2,181,123,58,Asia,21,593.13
f89fa3a417e141e8b1528f7a9e3c6977,79,22,57,North America,21,352.22
f89fb3da3e4e43a0b169d44a09b0fda3,363,338,25,North America,17,1764.36
f8a02f2461124c37b32fc79b00fc51f4,193,157,36,Europe,21,1278.69
f8a3b6663ca3409cb0b0c066cd81d34b,208,168,40,South America,19,1146.17
f8a683acb3934bfbbbb9eed3d9d61ffc,139,97,42,Oceania,23,1189.86
f8a6d3378f7041d99c7db999e1eeb2d9,172,151,21,North America,22,2169.89
f8a6ec2729e0482490b85fc9fd677b48,175,135,40,North America,18,1175.6
f8a9f0e4b4314e02b10fa0e63df8cdfe,291,247,44,Europe,21,1353.77
f8aa1b5268b6417e870566f9d06ed789,221,180,41,North America,19,1706.37
f8aa1f2443184af6b86bd4f71ee2983a,169,129,40,North America,23,879.71
f8ab240c25814ca8baa8f2148499a28e,274,245,29,Africa,19,1804.62
f8ab90217a6a419fb33df9031839b93e,67,18,49,Africa,20,257.03
f8ac09317e8d4d7db9e64b6bb8c81d10,22,3,19,Asia,20,116.46
f8ac276a3e444d47aac89cb94e287a2a,363,353,10,Asia,20,2930.68
f8af463d6fb949e4884c0f7593945883,333,305,28,North America,16,2792.93
f8b8dd5caaa04be4a4236ae7ae0029d2,49,1,48,Oceania,20,127.5
f8bad9e6dd9b4455a8d805760e231b29,67,35,32,Asia,23,301.24
f8bb4b15bdb54ec2bac3e32e8b3faf43,91,51,40,South America,16,581.01
f8bc0b6e39c744ae9aa8d0454d18f3fd,230,176,54,Europe,20,1355.66
f8bc65fe1cb14402b6de88331da446cb,261,229,32,North America,17,1726.2
f8be54be96aa433680a930812b5d9f62,195,166,29,North America,21,1752.02
f8be884139ed4b08bd3ef084cc138110,195,152,43,North America,16,1304.65
f8beb6b1674041cca6bbdb0250cf4f6f,92,64,28,Oceania,20,539.51
f8c09df1818843218daa709bc49c4fd7,174,122,52,Africa,18,812.16
f8c56acf98634603beae8139aad520f9,315,261,54,Africa,15,2096.02
f8c759812bf0413cab4e729dc099a227,308,264,44,Africa,20,1695.26
f8c85a417330467d89650c683443341e,365,361,4,Europe,17,2434.99
f8c9fc9398234f43ae214057e3250b15,342,313,29,Europe,17,2242.24
f8ca796fb78747c2859c542cce2d5eee,272,225,47,North America,22,958.12
f8cddb89380c4f98b457463bac18a61f,71,34,37,Asia,24,740.47
f8d505ab40734519b10f763d5e1b2667,301,258,43,South America,20,1675.16
f8d548eaded94179bb17a7f9f908d9d1,154,102,52,Africa,21,766.2
f8d65de6d7f546dd9917b2a420c03dd1,358,333,25,Africa,17,2218.02
f8d9ab1d79864db3868fd200ed3f0eac,223,188,35,Africa,24,1654.06
f8da93e6711344ec9db1bcad3d68d9ed,159,104,55,South America,16,712.56
f8db26d52dbe44e8a4c0a9ce3ebf6964,361,325,36,Asia,20,2108.06
f8dcaceb71744cf1ad8c7d47737b98b5,346,320,26,Europe,20,2338.9
f8dd970c3b094b84a995ba8ffcd9ef76,231,186,45,Asia,21,728.9
f8e2994987824798b2a3336fab4911e5,352,295,57,Asia,19,1871.75
f8e2d7ea3dd844fd8a102635512786ad,352,323,29,Oceania,18,2303.64
f8e3f80412ef4f7fbd10d73ee6d121b1,150,99,51,Europe,19,1065.12
f8e4804780af4210b663d49583ee2a5d,365,343,22,Asia,15,1928.39
f8e714b72bc7472d870e951878b8be1e,48,3,45,North America,25,170.67
f8ea14a4d5ff45c9b4964334017d741b,365,312,53,North America,16,1473.79
f8ea8a8be17b4516a472ad8adaf2fc24,70,20,50,Asia,27,177.14
f8ecf00c0e4946adaff078e3359a8e48,365,355,10,South America,19,2716.23
f8f14ce5eb8148d0b07a6e9fe559b3b3,76,21,55,Europe,19,289.45
f8f753580eff426f92da647c5f388b2a,132,85,47,North America,18,390.16
f8f79be46d5b417882474028fc43c022,121,105,16,Africa,17,727.79
f8f7c257fc844a1d899cdfbe2b92ad7f,263,245,18,Europe,28,1749.52
f8f8247c47bc4c48b00ddf2e924ae96d,121,91,30,North America,20,1007.91
f8fb9046c7d84d74909438009dc91d80,353,319,34,South America,19,2308.11
f8fc605c00b443f196048f863f37c94f,334,283,51,Europe,18,1339.66
f8fce11a37d944d98eabaab1e82dcfad,347,321,26,Oceania,19,2709.43
f9012c349e794f2eb9fbbf4f8bc51161,294,270,24,Asia,20,2749.71
f90369daaab7482baa20e6a2f614ee05,57,14,43,Europe,19,317.33
f908988411b54f369e06ee7fcb53427d,365,342,23,Asia,14,3063.56
f90a524668074001b6a58bf00ef5f3a9,144,95,49,North America,23,592.17
f90ba8e90acb4290b0b6531b23b1082d,49,20,29,South America,20,459.04
f90c899941654fcba8fde32f2e6111b5,343,297,46,North America,24,1781.78
f90ee32e9eb44bef85c66129a4acbfb5,319,288,31,North America,22,1758.06
f90f9b05ee2445a0a0bf6dc474f726d9,80,54,26,Oceania,24,679.52
f90fa94a2afe4bd1b045f53bd6e31b43,233,206,27,North America,21,1793.68
f91268a2f98d485eaf35d47f07c9e583,213,175,38,Oceania,22,1233.53
f912b949fde34e158525764073984e42,140,116,24,South America,19,1276.34
f912cdb56da246bc9477a8be1619e926,311,270,41,Asia,20,2390.07
f913a7ad5cca468d8c2f14d7f980172f,347,304,43,South America,20,1946.6
f914d7a86f6d41c28d47cfe29b6eae6a,41,4,37,South America,15,482.08
f9173ad0737c45c5a24f66fa8cd8509a,126,83,43,Oceania,22,803.45
f9191906b4154b9fbece0a94cf5c39d6,34,15,19,North America,23,272.68
f91a5ed94fc44785974f4f43ffc413f9,265,245,20,South America,20,2318.96
f91ab0265b5943ba92754f8a89f3bfee,89,45,44,Europe,22,891.33
f91b1acff6fe44c58b4f4c4d74b1948e,97,75,22,South America,19,787.22
f91bbbcb5a9d4b1abb3e2691f9ce140d,348,306,42,South America,20,1398.09
f91c014fc5004279ba470990beda4646,293,240,53,Africa,14,1336.8
f9205b2b96404d53816690aa2d8629b1,140,93,47,Oceania,23,1065.83
f921e8d5636a4b76bd0fa3c760fc9516,363,349,14,South America,15,2517.97
f923f54067de44a9a222b9d7a2902872,83,27,56,Europe,22,527.89
f9241738cacd483690acecf6691a94f3,364,330,34,North America,21,2433.9
f9243c21571e469292388fddfbe3e40c,357,305,52,Africa,16,2089.18
f925f7c44f57491db27ea26b0a2ee718,128,85,43,South America,24,764.02
f9266115e8fc4db09775cd845a818b9e,133,104,29,Europe,19,1060.89
f9268a8a961a4b7087595fadf927852e,116,66,50,North America,20,746.04
f929b06c059c433493a6e84922703376,300,249,51,Asia,24,1448.03
f92c47ee8ce14a2db17d96cf9b024df7,365,323,42,Europe,17,2003.24
f92c9c522a5c417e92e903683e9a3ec0,225,188,37,Oceania,25,1363.2
f92d416d86824819a828a553eab193a7,236,182,54,Africa,21,965.22
f9304fc0dbd44746a13928dbf7a73c2b,277,232,45,Oceania,23,1345.56
f9309394cc454fd9b01badd50745c03b,362,349,13,Oceania,24,2741.44
f931e93737824d3da2463f04e388cc46,326,304,22,Asia,17,2823.44
f93202f062a7440d85c78a8f5b9861f3,76,19,57,Europe,16,579.96
f932bcfd2b744287992557284fdd4feb,64,44,20,South America,15,483.61
f933df28318b4a1f8751879833bec57e,278,244,34,North America,21,2124.93
f9363704a0e94c438e92b4d46c2edb26,308,251,57,South America,20,1907.42
f938990d7f354aec89ff36164772521d,355,305,50,Oceania,18,2171.88
f93a680a9b3a44f8a4cfc50973206ba4,321,286,35,South America,19,2610.79
f93ca8b298af4f31a4443af4320bfc21,248,208,40,Europe,22,1334.49
f93d1921692c4d8fb073a939f26d1ac2,139,102,37,South America,20,1146.46
f93d57814bd74130b6ca2c51200c7340,283,243,40,Asia,18,1737.78
f93df6a44be046ef94c666522ccc8ec9,365,338,27,Europe,22,1518.22
f93ee63ec19346579d7ec77773046877,282,245,37,Oceania,17,2809.72
f93f04c026794a1f9286d10b62d24efc,69,30,39,North America,19,726.39
f9430465a9ff429cb83009e5196e2266,187,136,51,Africa,22,938.16
f945b746603f4f959ea5e501d224994c,113,88,25,Asia,22,712.1
f947098e2fa74c1b8840389fd8d14ac7,153,107,46,Oceania,23,1099.37
f948d4c454524db891d6c1cf32a09f17,222,188,34,North America,14,1547.24
f94921dae6e342ea8d23a39590515860,252,216,36,North America,21,1730.01
f94d498c9db8414f9ef88028c5a9b642,344,314,30,Oceania,20,2172.87
f94d4fc761e64d618a63dca6a7079793,146,103,43,Europe,20,1097.48
f94d9b7958d249dabb6c4290a94d4a94,135,108,27,Oceania,24,691.82
f95100eac33e4422b4901d5371d4076b,219,194,25,Africa,15,1913.54
f9545fd665e946478f6fa0b32dbe3b10,123,81,42,Asia,19,733.32
f95500c691924567b97a740734d01b73,365,338,27,North America,23,1837.32
f9553cfd928e4d7eb31e1a86bcf33e1f,114,76,38,Asia,26,900.21
f9558a1f13f54e9cbbc99ff200b348c5,218,191,27,Oceania,20,1684.97
f957d0ebe9914a5488fd9237cc0d9211,147,112,35,North America,20,1418.07
f959ddcfe9944c48815e7ad640b21009,365,360,5,South America,22,1848.56
f95dfb2ae01940ca8013def4e0e1b538,302,255,47,Africa,18,2182.08
f95e6357367846249c112c793069be3c,329,281,48,Asia,19,1769.29
f95f55d1a55c4bcba6cd1cbd5cc3c16d,124,75,49,North America,20,496.01
f9608f9ddeb14cb091abe84a531f37c9,273,233,40,South America,29,2058.42
f960f28dd7d240b885fef6241b48d00e,160,128,32,Asia,22,1009.62
f962e3c65cce4b71b3e54b7103107f67,64,21,43,South America,20,219.79
f96357c59f9f48f789bb8841f578e911,282,241,41,Oceania,19,1337.81
f96417f6be624cf398b991f43192bf71,188,152,36,North America,27,1221.32
f964418f6e954331a5d642c0da4d010e,294,257,37,Africa,21,2364.11
f9658a5782964909856771cc1b030eff,348,317,31,Europe,22,2468.27
f9677c98068744598972e24f86a7e71a,197,142,55,Asia,21,1019.76
f967e02895fd4eed94a7c3ee0a75a66a,135,105,30,Asia,20,961.45
f968ceea6dc74fcfbc5fe848126baaea,102,77,25,Africa,21,702.32
f9694e665c8d43989171bcf5c1f99bc0,32,11,21,Europe,21,223.59
f96a1b1bc2b04ee498ea497d0946564f,364,359,5,Oceania,12,1862.45
f96a983398c949269f8d9c4321d57f93,208,173,35,Oceania,16,1590.79
f96ba60f876447c69f7d1c268339bca5,289,241,48,North America,20,1535.15
f96c9983bb11440b96c1e479c202e5c4,231,191,40,Europe,23,1591.81
f96f3c2895594d17aac5fa70c7002c6e,130,88,42,Asia,18,755.83
f96f6fdf3adc4a65be5c5f6b97ed9a9a,71,54,17,Asia,18,838.64
f970aa4586b04416bdd4b2b4c27a78f6,302,266,36,Oceania,20,1635.3
f971af499b774ca79a4a1528656db1b8,115,59,56,North America,18,516.96
f974133ade9e408dba3dc6d868892112,101,47,54,South America,23,357.55
f9756cda5d354922aa345b4f9f909262,270,232,38,Oceania,22,1907.43
f975cee32bf94e5d8691b1f188655e33,266,236,30,Oceania,21,1651.65
f975d677aa1d43f68379ac7ea5e8c7e9,145,109,36,North America,21,947.1
f976c27e37d64e8b9c4da7930b5244df,128,89,39,Oceania,20,765.57
f977106aab88423e879999703f9db7e0,79,48,31,Europe,20,402.15
f97ca5e9eed3497d80fb70db998b984d,364,345,19,South America,17,2929.45
f97dc9b17bc4410cb47986aef3dcd13a,272,235,37,North America,17,2250.68
f97dce734349456e957f134ec09d1db6,109,69,40,Africa,24,1171.17
f97e9ed3131f47a2857c58286d364456,42,14,28,North America,20,171.12
f97ebac278cf4841843e08cd733495cf,211,170,41,South America,16,862.76
f97f2c26297442edbc5ab857a073cf51,333,311,22,Europe,18,2594.48
f97f387fbd4a405ba58b0e9b86e7a9ba,325,296,29,Oceania,21,2649.27
f97f608d9d44459bac529a56a05a72c3,305,285,20,Asia,20,2702.19
f97fa94d6a0a4a03ba147b95150481bc,77,44,33,Europe,21,494.77
f980e5db871d4bb49ae4068cbb57f574,84,48,36,Europe,18,310.53
f981bfd395b04c7f9d270f00172ba581,364,330,34,South America,22,2529.48
f983ef5650324aa58f8c0b7d4420feb7,256,222,34,Asia,16,1919.3
f98566a05e2b473189d69e0d01884da3,67,17,50,Oceania,22,467.69
f987175027504503bfc9028d13ca4439,363,361,2,Oceania,17,1725.15
f9871f22b81a4edea37c2b5a658cb9d3,328,299,29,Africa,21,2298.05
f9877cb8c56c470c804f7132046cff68,261,227,34,Europe,17,1802.97
f988bd338ba649c3858c77db1b5f4b46,97,74,23,Oceania,22,1152.27
f989125fe1624c2f9035df6d0b033be4,330,282,48,Europe,20,1510.2
f98b850dfc1f4c0eb4e00dc1ff5cb9e1,288,257,31,Europe,19,2323.35
f98c41b2085f4070b081a6b63c8dba9b,259,206,53,South America,20,1570.03
f98d24bbb96d4ee39219f47413831123,364,336,28,South America,19,1970.97
f98db5df5a5541cd83871d4dd3f2fd8a,226,204,22,Europe,24,1847.49
f98f8a57b1dc4c499f62991795c24c61,365,344,21,Europe,20,2254.3
f9908b208ceb4768b71345b5de368c90,226,178,48,Africa,20,653.57
f990fe314cf24b748829b8819c07b623,256,241,15,North America,21,1846.82
f991e3e5e99f4195b863d7827fac225b,159,110,49,North America,16,995.8
f9920373425d4fa7bcd8db45644a56dc,40,1,39,North America,22,368
f994bdca00da4a48a99d809787ea18e1,360,338,22,South America,27,1991.81
f994e2d9074f4704b27188e8ecb33097,364,343,21,Oceania,23,1676.68
f9974ab2a3584c1db929a9cbb35fca97,365,321,44,Europe,21,3065.28
f997a09e3e96442da8f3367b8df5b7c6,323,296,27,South America,16,2026.43
f998b033a6ad4190ab2144753a5bf869,272,232,40,Europe,11,1718.34
f99c7db919774f34b1b02823f8c9582f,289,248,41,North America,22,2135.5
f99ee7725df14a5db3a6aa5a300107cd,293,241,52,Africa,13,1895.21
f9a120afdecf4753aefb6a6f443f42ef,284,242,42,North America,23,2104.58
f9a1907fdeff4786a1cd31fc8dd1dbf0,335,290,45,Europe,17,2678.96
f9a21b0167e845ea866db9da236dbc1e,62,10,52,Europe,20,202.1
f9a4adc300764a0e8c5b6a41839d2b24,350,305,45,North America,15,2033.3
f9a4f534ffef4f1a9650fde1bb74a644,360,332,28,Asia,15,2798.15
f9a6fe4e38da44dfa006c14d309def3c,336,303,33,Africa,20,2556.29
f9a90ae70478407186fb6bd2ff9e9ea2,365,348,17,Europe,21,1587.52
f9aa112c4efe47e78ebeaad5244c1724,107,82,25,Africa,20,713.85
f9aa5c8c51af4b08af12b1ebe3ac4bee,337,287,50,South America,17,1209.36
f9ab98eb98bf4817a3b70bd9e32787cd,339,294,45,Europe,24,1635.88
f9ae5f665bcc4007acf5d0b1aeb316ae,326,275,51,Oceania,18,1711.84
f9b21f65cd5b4126a1aa6654a05d2de2,112,56,56,Europe,22,635.68
f9b30c092f8f41a39fa5e40391696e75,218,172,46,Europe,22,852.16
f9b62fe248164b249136cb0b2c8b014a,152,118,34,Europe,24,1190.16
f9b8bdc88b12475690d513b265c476f3,176,151,25,South America,23,1375.63
f9b8cc87a179421dad83b877328c016b,248,200,48,Oceania,23,1668.12
f9bb1f86116d4bd28184def5dc353ef4,215,182,33,Africa,24,965.6
f9bdec2ceb8144d89a563949784a8c1b,365,355,10,North America,16,2188.31
f9becdb154574f2f84d9c218f644e0f3,184,154,30,Europe,20,1341.41
f9c129b9c7514bfaab0a054ff758c728,119,91,28,South America,19,797.2
f9c65de0477c4e2c88b6bd3f09a8875b,249,209,40,South America,19,1773.17
f9c91d7fe01443fc8e229e0124675a0f,136,122,14,Oceania,17,1145.42
f9cdd177b7d7404b9094294a05bd3eb0,280,232,48,Oceania,17,1492.99
f9cfa5c10b3649a7a9374706a25271c0,259,228,31,South America,24,1533.03
f9d3077f31ce43bb85f2d0f26bd61672,212,172,40,Oceania,21,1789.38
f9d423fae94e4968955b8e409a627b5f,176,151,25,Africa,20,1507.5
f9d4cdb93fed4c61a8c4a904a9a1a33e,248,201,47,Europe,20,1646.28
f9d8d103fcc64d0baa168a911bb2bcbd,40,11,29,South America,24,604.16
f9da4be44db04589b38eca2596281a03,94,47,47,Europe,21,630.47
f9da4ec7f09642fdbf528a85ae65d420,365,323,42,Africa,22,2066.68
f9dbc709af1540448633611fa7002d82,364,354,10,Oceania,30,1344.95
f9dc01135e194703a4a343a16c6a56cd,138,117,21,Africa,19,1025.81
f9e12f2864a547a4acf56b9f9e9a8d92,168,150,18,Asia,19,1751.82
f9e206e889474815b5fc0f82330b440f,60,34,26,Africa,24,377.89
f9e34e8767954b348fbd594fc5368bb2,95,33,62,Europe,20,724.89
f9e5fab16e734e77a3bf5a95d3462840,166,139,27,Europe,22,896.47
f9e75571164b403f97bbea88fc8fde6b,61,34,27,South America,12,205.43
f9e78e04bee441d8af36dc5041a34651,293,261,32,South America,29,1850.95
f9e8aebd377b405bbc694c290888d122,199,154,45,South America,18,759.01
f9e9551a88e54dd784eeeec997ec3735,125,109,16,Europe,20,1107.75
f9ea09f0267c418ab8e0c63d69e9dfcb,50,23,27,Asia,19,405.74
f9ed72bddea44417bafe1bdfa42b105a,285,252,33,South America,23,1934.13
f9ed86d65ff04813bb19fbda1965bd20,75,56,19,Asia,18,1060.88
f9f322e367cf421cb4f5635ce3bdb794,290,240,50,South America,18,1547.28
f9f35e985ff74399b79a67d05116ef7a,356,337,19,Africa,24,2766.41
f9f3a26b48cc4fac8b7b2235a22aef73,172,129,43,Europe,21,1136.65
f9f40174d31e4a62864957df720137e5,365,331,34,Oceania,22,2237.99
f9f49a121d06414c90ea0881a457b094,303,280,23,Europe,21,1705.6
f9f8151d72ab40edb7cfeb71c9e0f820,347,297,50,Asia,18,1330.26
f9faf1357ade49aa98a53ec9fd99c698,86,46,40,Europe,21,180.82
f9fc70d61504434eb742045f8edbc791,134,98,36,South America,17,1320.99
f9fd80b56be345a0976e0903be569523,82,65,17,Asia,22,535.73
f9fe12e6cc6a43dd90a67b07a96a9ab7,118,96,22,Oceania,24,862.64
f9ff68488785403e89a39f97051c4210,140,102,38,Africa,18,867.47
fa00d3ea38904c91ae2c29b9224eb1ef,160,119,41,Oceania,22,491.67
fa02586e9c8948c8aaa29f006712a511,364,323,41,Oceania,20,2263.55
fa03cfb91b9648aba48a9ce38b7fc411,234,211,23,North America,19,1114.96
fa04f8c025944f71bd05eaa31c97103b,78,29,49,Africa,21,677.31
fa0a34bc625045cab77efb7a69b7947f,364,338,26,Asia,19,2331.25
fa0c3c2943524258a8030da02639fdf5,182,128,54,Europe,16,763.13
fa0d54cb4a8a42c58f901fcae0c01970,347,306,41,South America,23,1536.65
fa0d97273e504b3db7367c3d0a701a83,131,100,31,Oceania,18,1004.96
fa0e7a6e05ad448595e652e1a242a99c,321,288,33,South America,17,2039.62
fa0eb3324dac46578232c6f1538bb0e3,361,350,11,Asia,18,2735.19
fa121179f8b7484fafc89d61e407b869,227,189,38,North America,19,1154.64
fa13a98827f84179884af3bc1b66a412,64,34,30,Africa,23,154.91
fa152932d2e34b6793733a8c8add2220,99,48,51,Africa,17,688.31
fa190328f0ae4756b3fd0c2ab631a8dd,284,235,49,Europe,21,1613.37
fa1a1dda9f0e443ba7d7ac0781a0283a,318,261,57,Africa,24,1467.39
fa1d7aa6c85e41869c3631b5b7d7f4ee,89,55,34,Asia,22,645.97
fa1df70fb4c74869b3789a624f8725eb,124,91,33,North America,21,1031.73
fa1eb08e1f0745638559bc5bf9a7e4b1,364,328,36,South America,27,2405.48
fa1ef88a381d47958e9ec4a0ed3e8b98,76,27,49,South America,19,289.83
fa1f3c4d2c1445548e16d9081c249d65,120,74,46,North America,22,683.08
fa20e09ee77b46edae07a08621a99a75,91,50,41,Africa,16,693.36
fa235798de0945b1906160fc1a1a68a0,365,358,7,Europe,20,2294.28
fa23c8757d17497d8a8c7de4725425ff,362,343,19,South America,23,2013.95
fa271622a6a24409b2c2931e4fcfa850,365,364,1,Asia,15,2896.97
fa2787c9f27a41db97d482bf341fe99d,364,307,57,Asia,20,1858.75
fa27f5e01ee44535a37b19eed68ac4b5,364,363,1,South America,22,1865.97
fa293c75ab024ccaba3576f10bbb1141,217,182,35,South America,14,1720.51
fa2a078aba644f068cbebaef9915ecf3,139,101,38,North America,21,1000.65
fa2a83307d44466ba402518318f5d98f,250,214,36,Asia,25,1586.16
fa2ae0217b2149e3926895c8282c7da5,261,235,26,Europe,24,2157.33
fa2b3876a23f4c3e935bdb1d4209efbd,160,126,34,Asia,20,836.95
fa2b96fa29554389a0a6447377dc8544,51,34,17,Europe,20,289.21
fa2bdf6576234ef4812998b7d5386189,94,42,52,North America,24,298.66
fa2bf529d9bd4b7896f64334318c4000,309,274,35,Asia,19,2269.62
fa30710def7d4be1b1d22ef4a558e17e,94,65,29,Oceania,17,918.05
fa308abd71f84f54a8701e1c9c4cdf62,46,16,30,North America,18,241.39
fa30eae4a5624558b1f8c0e86b7ff1b1,180,150,30,North America,20,1282.36
fa316448e8284e23b03b8b738e79dd77,39,4,35,North America,21,127.25
fa317d099807421f9d3a765575c9e08a,144,115,29,Asia,18,769.48
fa325fee8cc1473a986ac4990f5c3f1c,146,107,39,North America,19,1228.09
fa34a88cc9ff4266b83561181d53c210,298,273,25,North America,23,3102.83
fa353042928f41f28734ce63646dd2c2,224,178,46,North America,25,1164.59
fa35fded7e1d44b1b078f6dc00dd32f8,76,41,35,Asia,20,428.93
fa36ad494cea4be59eef4a982f7974c2,335,298,37,Africa,23,2283.7
fa3963925e0f425a8104f98a550843d4,207,171,36,Europe,21,1484.73
fa3b7d811a0d4935a2ff13eaa2d682b7,357,309,48,North America,20,2034.34
fa3e865f2a2f44b3be0248f27147f787,271,234,37,Africa,22,1481.83
fa3f1bafccf44bf9813620f18a915683,268,237,31,Oceania,17,2055.34
fa3f230117f942b6b1d62af815c86986,79,56,23,South America,19,600.95
fa430b12d40544ca96bbab7b9521d3db,131,95,36,Oceania,22,752.59
fa437d164a764cf8a3f369697661f3a3,188,152,36,Europe,18,1430.17
fa4634a975974cbb99bd8f77919f20d1,82,46,36,Asia,11,844.91
fa465cedb9db428fbd8bdbb3623ca5ef,106,80,26,Africa,21,784.06
fa48b14a6e6846dba6c50208d10b19df,347,293,54,Africa,19,1171.35
fa49074c659b4e21b00ae2e15e2261b4,235,183,52,South America,20,1357.37
fa4983fcf73249f38b08f93845bddb05,360,322,38,Europe,21,2583.49
fa4bee70f72844618131aecfc87b0dd3,203,162,41,Africa,19,1477.07
fa4ce65504d74664863d523c23a739a4,104,64,40,Africa,22,777.01
fa4f381207004036950e015039f92ec5,96,54,42,Africa,22,357.88
fa4fecf1142643efaa341d79bb1d9458,216,175,41,South America,23,1411.23
fa5124458a074d31bd99378a7478c967,129,84,45,Asia,20,1233.31
fa52b493e8c14eb4bf32a831ac97571b,162,116,46,Africa,19,846.23
fa53e90972f140bd99c710b943899277,101,48,53,Europe,14,243.95
fa57e6199a324f8abd23b5df3281b2f3,156,142,14,Europe,20,923.29
fa57ea0834b242d989e72129148f978e,162,131,31,South America,20,1492.76
fa584d75a63648a4a452db1ccec9cce2,199,155,44,Asia,23,1362.78
fa59e77d2cf244b1b1b9a02b382d4208,240,218,22,Europe,21,1519.73
fa5c62235291469da3f418bcf31c5482,260,215,45,Asia,25,1705.89
fa5d3df798524862a0a10058a1c67112,255,231,24,Africa,23,2400.49
fa5d723d577d4ded9e7034a17ee88ab9,247,223,24,South America,21,1960.93
fa5e43a5e58b4ed8be7428b6c53d37ea,137,95,42,South America,22,544.49
fa5ff89009c2436f84fb7ae40090c8f5,260,204,56,South America,24,1637.49
fa63a1e981bf45c991a871b8ecfb0f33,273,250,23,Europe,22,1725.87
fa63c34b295c4b7d8ffbe453211a2e24,73,17,56,Europe,20,416.84
fa65f3a4e3334d6794b2c4a3d43c5d29,287,249,38,South America,22,2249.87
fa678545143b4e809d5a02d62605c319,295,267,28,South America,15,2228.26
fa67da2d78634118b94a3e66afb5063b,335,301,34,Oceania,25,3207.01
fa6909b1859a4dcb88198c8cdd04681e,69,35,34,Europe,18,646.76
fa6bb5d455d24758b656ebde4454839d,164,117,47,Africa,21,1001.43
fa6e4c7e642d4f34a2f2c8b3e4ac25ca,356,308,48,Africa,22,1746.41
fa6e872ac3fc4728a41c549b7de4cce7,244,204,40,Europe,23,1596.17
fa6f1d62082f40f69711afa72addb652,140,106,34,North America,19,1057.72
fa70c0f3dd7445c79ccc1f7585b9b2f8,294,256,38,Africa,17,1978.06
fa73a528aa5e4ee88edf7366d6b2699b,302,277,25,Africa,21,2300.84
fa7510cf8c7d44828e4de56a70b8cc71,365,356,9,Europe,23,2346.87
fa75e4636d094dedae4c399d064992c2,180,143,37,Oceania,20,1283.15
fa762d759a56414988d63243891bd3bf,362,325,37,Oceania,16,2449.28
fa771e13460845d09c8aa3ee840bb1d6,362,329,33,South America,26,2533.56
fa782fcc76e84326a81622f555061734,179,151,28,Asia,20,1099.63
fa78b4efe0db4eb383293bc5d7e1cb64,222,191,31,Europe,17,1971.18
fa79fcf4e4014b43acef2250b86edcca,353,319,34,Europe,24,1802.17
fa7ce42b29cb4853b5386552ef01887d,29,1,28,South America,25,290.97
fa7e0b6e5cf447e9b658250b0790ea50,152,111,41,Oceania,20,733.5
fa7fa1f816a04534a3ff4a4bb7d48ec3,364,345,19,South America,18,2695.73
fa8059cf7526416cac02e13668dc2524,51,20,31,Europe,24,82.09
fa8212c7d5a04b198d05504f37b999a9,307,283,24,North America,15,2063.83
fa8283d7ddde41b9a58cdd055c1ade54,183,138,45,Africa,21,795.44
fa83d9c7652b4050a88482395dba5e67,360,308,52,North America,26,1188.8
fa84c826e51a47fc9bcb4cf9bc38550d,173,120,53,Oceania,20,708.5
fa86a8c3fe5c4096934caed5009deb7b,181,156,25,Asia,17,1517.18
fa89d7bd959f4cf99206db8631f780ee,276,248,28,Oceania,21,1583.29
fa8a733ae3b744d7b4ed741b74e70f03,231,200,31,Europe,14,1720.36
fa8b5b071a194b25854c3e1cc886e181,130,100,30,Oceania,19,1127.81
fa8ceba151424a39940a3120bb351fa5,329,280,49,Oceania,20,1659.83
fa8e24895f18428c8a87a8d772ac2d31,364,339,25,Oceania,19,2929.54
fa9159ff834a4e3cb62e3e63898958ae,365,361,4,Oceania,13,2600.11
fa946c0b57264527a9bd7891ea8b91bb,123,76,47,Africa,22,1018.16
fa951335d69a497d8c6d08c67ab6db77,57,5,52,Oceania,19,203.28
fa95b13bba1d40bfb2fc3f015df54fc5,365,351,14,Africa,15,1694.45
fa95f37cf98e43779cd6ceb1e2013c68,264,226,38,Africa,20,2143.98
fa97705f7e5e4e0dac1946ee60b25120,196,153,43,Asia,20,1347.33
fa982fec8dd94934a487c68970a4c3e7,189,156,33,South America,24,1155.31
fa990301d9b5402fbcd02fe6f57b46fa,246,197,49,South America,20,1225.83
fa992fcb808247b6ba757a2d94afa831,135,85,50,Oceania,21,608.4
fa9a9e3f8c5940538390934efa5d8038,182,130,52,Africa,19,968.39
fa9bd807bc8f4e47ae1bbd8005ceb452,262,204,58,South America,23,1701.47
fa9cba765d2b45768b85c797995b96b0,223,191,32,Africa,20,1618.53
fa9cc62e63584a0a9333c2a882fe8151,88,52,36,Africa,19,846.18
faa054c49ee9477a9d3f7ca001bb3748,243,192,51,Asia,19,1153.03
faa1152b0ea043da873f95ce814398da,364,360,4,Asia,24,3139.86
faa3d6c44c4d45e4b0bbea3856784ebb,364,326,38,Africa,18,1269.02
faa46a3686a64c09b61a004051927b16,305,277,28,Africa,16,2432.11
faa4d772dc6a417fb6c238101152c95d,49,9,40,North America,20,497.67
faa4dcdfe6f84b32a726334765d17848,320,273,47,Europe,19,1475.91
faa66cd5de324103aafe678d229e6393,364,327,37,North America,21,2733.72
faa724c7b153459f866d71d6b7bd64aa,69,21,48,North America,22,360.2
faa7ea6226724526840c9b519e59d79a,338,308,30,Africa,22,2199.12
faa918da71ec430db513e19d0586da49,157,141,16,Europe,20,1517.54
faa9652d09a24f5fb45dee2e56279c48,158,110,48,Asia,23,932.96
faa985c619b84bc88b4c77da6d82fd78,226,174,52,South America,18,815.02
faab832b46d3442fa6a6e1310209d312,263,222,41,Oceania,26,1889.35
faac2a1a30a2451d8335d0f3a5c382ce,301,256,45,Asia,20,1532.77
faad04443c714051b2133688c67dd8a4,365,332,33,North America,18,1909.48
faadd41a9f064bdca557b17689ffb495,364,345,19,Asia,25,2766.24
fab14e35b66f4a3ba16ea44f05cc9bd6,84,55,29,Asia,18,243.32
fab22c62868e47e581ec1e924875c81d,257,201,56,South America,20,1110.56
fab389898a3d4ad98f31b124555b5a23,316,266,50,Africa,21,1635.74
fab4cc0254934d93bd38c213f2321af4,150,128,22,North America,17,1470.52
fab74214ca904e3e977d0e04c4c07598,131,110,21,Asia,23,964.82
fab750f06b3942c893e3ddbabba4b632,119,72,47,Africa,21,700.03
faba8bcd4a854edaad93e6fe34f9495a,71,17,54,Oceania,21,134.1
fabc2e6c875b417080290f0c037ed337,101,73,28,Asia,18,720.43
fabdae543fe24db886a7ae6c6be43bbd,55,14,41,Asia,22,382.87
fabe06f6bc694ef0ad92f00dc9538423,347,322,25,North America,19,2121.49
fac18ff720ce46eca665c3c772c76dc0,364,356,8,Europe,16,2536.5
fac1fe1c52f140b5a4212ebf92e6f49d,346,314,32,Africa,18,2399.3
fac288abf39c4bb99faae840cda21630,248,195,53,Africa,24,1235.62
fac49f4cf2154324b7f4b156cebd3b13,171,138,33,South America,26,1559.03
fac7a213f1e94701bea7e4fbaa3610ac,255,232,23,South America,20,2778.18
fac8a5b71cf44b21a8ae18734ad8c6f0,365,340,25,South America,21,2148.35
faca52aab8c944fe84ef15227bb3db57,285,239,46,North America,19,1260.32
facb29128c674d24ad36473c09fe0d7c,365,363,2,North America,16,1980.74
facc0b7ebe744ceb9c882c15515385c5,277,249,28,South America,19,2084.61
facca0879a674511b5b257d352c22905,87,49,38,North America,26,191.71
facd226c119f4c05a80802c1a4a468c9,138,105,33,North America,22,914.09
facde6322fd04bf58a27edf50ee01308,125,84,41,South America,17,612.59
fad07d7140b64a2d87709507d1f46d59,233,206,27,Europe,20,1490.14
fad100904ae74e76804f756aed84fed0,179,145,34,Asia,16,1498.64
fad223de8b1d4e8197b0020f9badd195,365,308,57,South America,24,1231.37
fad29992c5a245f4ac259d3a85de34cd,313,294,19,Asia,20,2423.68
fad48f6549654f3d84ec0df1c85f912f,94,62,32,Asia,24,714.23
fad5da86c1224c27a20601e5b830dd47,145,90,55,North America,18,863.75
fada90083f364bd9838ee4875809f050,264,229,35,Europe,15,1303.72
fadb4ebf3e7742e0a70064784bb0a4a5,55,23,32,North America,23,380.31
fadbb22ebd4c47989f6d2b40bd73dac5,358,298,60,Africa,16,1816.58
fae053318b634eb483718d5146ff7163,107,71,36,Africa,18,705.63
faec4f9188d74ca6b67879b89442e7c8,67,22,45,Asia,21,426.71
faedac2a7b804163978154bbc27b0069,256,208,48,South America,24,899.38
faeea758cbe24e44b285c9a603351b21,205,188,17,Asia,22,1333.78
faefb9caca404a099d3dffb07231e334,365,327,38,Oceania,14,2526.45
faf025a9034f468cb5b3d1a17c8af9e4,97,64,33,North America,18,863.57
faf0ddf600c54f4296d18c0f835eba6d,365,337,28,Asia,27,1817.45
faf1c91e96b84763b99f9480ca3d2766,362,356,6,Asia,19,3587.27
faf21c57d8c84e43bd565bbb44a7e396,130,100,30,Oceania,19,839.77
faf28449aa684a10a17963cf263d2ee3,84,55,29,Africa,24,1073.05
faf320e78e1e4300a20e6dcf9eb7555b,234,185,49,Europe,18,1590.47
faf49d430eda4c3099c8256089e79c66,94,39,55,North America,23,355.76
faf5388041534e1b8fec1ba8dabffb97,135,77,58,Oceania,17,670.23
faf5839026f745d9a30e7526b4e33e7c,307,294,13,Europe,22,2238.47
faf5efc5f59c4e13aa9dcad1d075a5bc,120,99,21,South America,19,883.81
faf8c00095d343ad9f2883952e3c68c5,226,190,36,Europe,11,1778.5
fafab8af75b240baa3ec131ac6d2f211,364,359,5,Oceania,17,2638.42
fafdbe21c2304e8da3ceaeeba4b7b99d,197,151,46,Europe,25,1601.77
faff197a86b545d2b3b2ea9a3bdf22ae,262,212,50,Europe,20,1622.38
fb00326a40b94cd2b37653d01e90fc77,141,89,52,South America,21,854.11
fb0160d3f06045749e9d3c45de18b1e6,123,80,43,Africa,17,431.94
fb03eb4710604a5bae7665703cd3d513,198,145,53,Oceania,22,899.26
fb094a4cfa6b4e25b9499b1675a54ce9,126,87,39,Oceania,16,1086.37
fb0beaf4f7034b2d8f7fb7e96c7119e4,222,180,42,Africa,21,1063.51
fb0c35f9d90049cd837173b30a62e0ac,297,261,36,Europe,22,2017.88
fb0e5e446d8244f68c6e02f1694a666f,77,62,15,Oceania,18,501.45
fb0f3686a7ac44cdb7ba39c9fb0c8386,256,221,35,South America,21,1985.51
fb11a510692e4591adaea693ae5b4526,71,31,40,Asia,14,626.84
fb11ddcac16d43a88dc4c4dbd7a33dc4,364,323,41,Oceania,18,1804.22
fb14f6dead684199899fd278da78e728,321,298,23,Asia,18,2051.57
fb18b94ed34d4846a5dc178fee58a7cf,363,327,36,South America,21,2843.24
fb1a1d51e81b4ae5a9a2e014f29f0393,108,63,45,South America,17,814.17
fb1d88703b124efdb4e201c673260837,118,80,38,Oceania,22,1054.58
fb1eebfd723f41f1b184563560492fb6,269,246,23,Africa,13,3117.94
fb1f55e2cf4d46219fa56a90f2cc4838,298,270,28,Europe,17,2914.07
fb24447dee4c4830892d7f4f0eafcad3,160,120,40,South America,20,754.43
fb251abae99c4344afcffb1e7ce67990,200,180,20,Oceania,18,1806.19
fb28f9a37b1c4ba8ad152d0ad9b25541,97,55,42,Europe,20,383.39
fb292b0193cb417e84baab2ce6a6c303,38,1,37,North America,19,240.07
fb2bcb11ca574f0eac55aaa82c0e76de,49,19,30,Asia,16,228.65
fb2c3f259da24c488afd4706b0baed69,180,163,17,North America,23,1372.25
fb2ec7c517cf42ffb8c081321aca46ca,338,301,37,Europe,20,2292.19
fb2ecc208e6747a0b07bc1b4acd14a85,61,12,49,North America,29,276.7
fb2f268519c64d9fa2b7b6ffd19be041,231,185,46,North America,19,1334.25
fb318ea9309b4058bbf4a65885d00aba,334,290,44,Asia,16,2002.01
fb3370c195b74d538131fe8d04d8afdf,109,84,25,Africa,20,1031.64
fb35265654c64150b39673b8fb406918,311,267,44,Oceania,18,1406.58
fb35275ef77040b4a863321e076e8eea,199,151,48,Asia,20,1353.7
fb362d99f5ff471abbf12d94e72714b2,66,42,24,North America,17,430.95
fb399b52172d4bf091210e6c6e73832e,365,347,18,South America,22,2378.25
fb3bcd89614e4dbfb113e85c2e9b954a,291,247,44,Europe,19,1102.79
fb3de527235a487cb89d645be2d21902,103,83,20,South America,22,914.61
fb3eff30338a43fc9e35412743afab0c,48,22,26,Asia,18,214.85
fb43829141b341ecbade76f709bb05ac,291,242,49,Asia,18,1650.32
fb44a3aab529414eb04a35a977481ec3,322,303,19,North America,24,2298.91
fb4709f0f2cf46a0b52f127a95f7cbca,214,171,43,South America,12,1781.51
fb4b35ca19d94a39a76943f99efe421c,156,108,48,North America,20,903.41
fb4f1f6496ad425c9fbbbe597d3f72fe,145,109,36,North America,27,1199.98
fb50c752f13c4c588ee2619d48280915,157,137,20,Europe,18,1297.22
fb52184e4b214e85bd79114f6d7e3e92,231,171,60,Europe,18,1034.7
fb52d010e3be405fa138e60359f59f5e,365,355,10,Asia,21,1779.22
fb536012bc684b728a7519b97ed6a67d,365,356,9,Oceania,22,2677.53
fb5528628cef4a459282fc831240da0d,283,258,25,Oceania,16,1855.99
fb5561dabed54c678f71f41219f53343,118,60,58,Europe,18,525.15
fb56dc88fe0c46a4b748a5f629ec26da,283,225,58,Africa,22,1118.54
fb57404189d54d5f88446d4a6db7389a,337,307,30,Asia,21,2453.17
fb576a12d02a4e78a7d3e9dc89cef45f,54,24,30,Oceania,22,327.49
fb58daf88c994f17bd1fe39c6e7f0fb8,346,306,40,North America,21,2454.96
fb59979cd3204f1ea07ce9cf07d4722e,211,176,35,North America,21,1734.22
fb5a507fad1b407e9db67e03fe64d00a,77,34,43,South America,24,331.18
fb5ff0ded72d45a4b404c323c374c4d5,149,127,22,Europe,23,879.71
fb6068e86b6f4298ae96adab5898ff36,65,39,26,North America,16,576.72
fb63215184934a9ebb1e5d7366b53d62,176,145,31,North America,22,968.57
fb644b6c78cf499a949551586f0bd455,298,260,38,Europe,21,1747.57
fb656aff394a435c97f53e8ced24cb47,207,170,37,North America,20,1241.41
fb66543ec70e4a898aca028bec08567c,283,244,39,Europe,15,1885.36
fb695aa1de0d4e258779b999b2f730b1,58,6,52,North America,18,97.36
fb6c1b4751534f02a79f34677506ae07,226,183,43,Asia,19,1872.6
fb6e277d12d74844a0e6058bdde704ee,339,317,22,North America,20,2905.41
fb6f1f5c5ae241cc9febeb75c61d23e9,94,38,56,Oceania,18,579.05
fb715db60d9b491f9f161d2596f78abb,129,99,30,Asia,18,1144.5
fb72eeb64a8a4c9dabe1c7938f05da64,338,298,40,South America,21,2417.89
fb78a428c97a4c7d9d9582dcdfb82334,166,117,49,Oceania,23,659.35
fb7a9b6885ef43eaa4cb7222424d123e,122,91,31,Oceania,19,580.83
fb7b1dd90e6f44b0875eaa361af55c67,248,224,24,Oceania,21,1821.49
fb7be615453740008a9f95724236f78e,51,2,49,North America,16,179.89
fb7c1befab9240ba834d9fd26ad7f4e8,304,261,43,North America,22,1269.22
fb7da17c8f694d71b9c6d282744b2912,240,191,49,Asia,18,1037.3
fb82c0e86e084efbbb517903d2358fea,147,98,49,Africa,22,1177.78
fb842aea88d24bbd96b6eca0df85d6de,67,52,15,Europe,18,335.13
fb849ceb591c447c8537ed31dd6a3651,135,115,20,Asia,22,750.65
fb85594e7f554dac861cbd001ceb2a74,182,150,32,Africa,18,1306.4
fb8617fb1dec4b9a95702f1d34028917,273,248,25,Africa,18,1748.36
fb87d36cb0e342d6b68ee7be63f9ccdf,318,275,43,Europe,13,2123.12
fb87d4d154bc4429aebbd3d64ec6679e,363,340,23,Asia,24,2248
fb88e2eeaf7644dabc9e24fbbe1a2f08,111,90,21,Oceania,16,794.22
fb8a8ea0777e45caa1b9a32c2436c22f,344,301,43,Africa,20,1423.9
fb8ad4f412324913afa4819224009860,138,87,51,South America,21,809.94
fb8cdc8b7d404cd4862bbbe385428998,110,59,51,South America,19,402.05
fb912656fa2946ab91063a418848232a,209,159,50,South America,22,933.46
fb9257f3e8f340b7b24e3cd8eedaff4e,53,5,48,Oceania,20,91.4
fb9620342aa841218318c23d2dd1176d,129,81,48,South America,17,532.23
fb964ce97e984b7ea62e57da5bd5190c,141,120,21,Europe,19,1337.67
fb9673d131194a73ae001687bba46b2b,69,19,50,Europe,14,414.19
fb988312aeaa465caa6b8b7c00fe840e,307,258,49,Asia,18,1089.27
fb989c1ace9943d9bbfd625bb0971dde,365,325,40,Europe,16,1234.76
fb99fb854db44bb8855557a2db63912e,133,77,56,North America,24,467.39
fb9a2e599d334cc994306480761493d3,183,129,54,North America,18,500.93
fb9b8eb3c8414b2d8fbf3978f01e5336,113,82,31,Europe,19,903.79
fb9c1481ed77405ba54fe4063ae00226,255,224,31,Europe,20,1433.24
fb9d0501eb3a4b2381bd75c0a9f0cf96,323,304,19,South America,22,2190.06
fb9df901b08d46c6817c1412905cf3c6,103,64,39,Europe,22,792.82
fb9ea14a1a2c425b8220538df31eb0c6,82,39,43,Asia,19,534.62
fb9ed3bedd70434a91c2002eb4136c4f,363,337,26,Europe,22,2658.93
fba074ca8afe4b4a8596dd830c8b4cb4,161,125,36,North America,22,1156.11
fba1421fdcbb41b2a01ec9577e5799fd,294,250,44,Europe,19,1709.88
fba4fbfd6e7f44a7a5b32cb1eb1f2894,38,13,25,Asia,21,343.42
fba6fbe6995f4a49aabf88fae9a49b81,282,258,24,Asia,19,1925.19
fba77c9630404f4c9b3e0c5aa9c4deba,77,41,36,Asia,20,253.98
fbabb16a3d6b4b84a912fa53cba4fbfb,171,139,32,Africa,20,1150.3
fbad28a5413d42c79867211672876abe,338,290,48,North America,21,1745.57
fbaed00572754d8fb387234f061aafcc,114,75,39,South America,26,611.36
fbaf050e3d9e4cb2bb11b2f857f7b3d5,178,143,35,Asia,21,1203.53
fbaf97a9582d44f8803871e4bba7446f,364,338,26,Europe,18,2515.77
fbafb106155746cb82f7ae124515ee2d,210,188,22,Africa,18,1644.77
fbb1f1a832c24a329ad28ecefa97acbe,300,249,51,Asia,19,1548.83
fbb4cd7df24d4c9fa3916fa27a733c36,133,87,46,Europe,19,584.89
fbb4e0ce36e64e22a0a6935a7c157e76,28,1,27,Africa,19,165.33
fbb5664cded44326be451b3aa2ffe14e,365,348,17,Africa,23,2617.76
fbb93c5b85104f919cbdd52584105a89,365,355,10,South America,19,2696.9
fbb9ae9d0bdc48ca8b62b06c39a33f49,185,143,42,South America,28,969.11
fbbaed8ad31349a096a2cb3d71869dad,72,55,17,Africa,21,911.29
fbbc4c562e6f49c59d86205ec5533faf,223,172,51,South America,19,730.09
fbbc7ab9716d45ad8ac702de8139c308,309,264,45,South America,15,1416.28
fbbcaff9e31a4aa69619e33de5fd0131,265,240,25,Oceania,20,1889.87
fbbcc4eb4380476c9d45973709f6b124,111,67,44,Oceania,22,580.07
fbbdb4c059094b468e07e83a827eb147,358,323,35,Asia,21,2380.88
fbbde6b9a0104c789e969a13cdb30b44,140,92,48,Africa,21,639.73
fbbfafd76f9f4f82a8c4d5291d810037,333,288,45,Europe,25,2331.26
fbc0cb3dd301435e94f45a3a6bcbe92e,363,340,23,Europe,21,2281.56
fbc0e5bc11d5427799dce5cc60a6068b,174,155,19,North America,18,1427.57
fbc255c446e64c93ac57f90d9e9ae3ab,324,293,31,North America,20,2849.95
fbc291161220482586a5fa7a4720de70,39,9,30,Africa,25,390.56
fbc329d007a74427bfb0738992351be4,78,49,29,North America,17,580.18
fbc3fbab29eb4c39893a355d182ae798,78,42,36,Oceania,22,709.98
fbc52b70ae594789985446693358fdc7,134,105,29,South America,17,878.55
fbca26320d844641be5344f40d5f9f83,325,295,30,Asia,17,2428.03
fbcaa3b6d13c4a36ad8608fb70b95e4c,327,293,34,Oceania,19,2226.26
fbcbe2ba036a41f7ac5df8ea53f8f5b4,271,250,21,South America,17,2480.31
fbcbf36b2d304c75b76fa1596ad9005c,224,190,34,Oceania,18,1106.84
fbcc6ea3c54049568e80369594a55c50,287,250,37,Asia,15,1418.45
fbcd80162023485b991669d5a5c5e713,152,134,18,Africa,19,1735.14
fbce6be0692840ada3ac09fbcf558c8c,361,328,33,South America,19,2002.49
fbcebbb255c143fa88849c1cc062885d,364,339,25,Asia,20,2365.28
fbd132e3f68247a684143f7e311c75fa,98,79,19,North America,17,369.25
fbd168955603426ab6b11b8f71f69a53,353,332,21,Europe,19,2816.87
fbd1acc9b5c44455b2fe9cd54a7ddd47,77,42,35,Africa,17,536.6
fbd1faf17c3843e9925895579a25fc71,90,47,43,Oceania,16,1104.17
fbd4267fac914a3c97d6b6934e74a866,284,234,50,South America,17,2041.15
fbd48861728140dd8c2b5487b985e969,194,156,38,South America,22,1817.07
fbd81515bd2947ae8d9ae734ee5f4977,55,6,49,Europe,27,320.39
fbd83e8abad146ce9eeaa1cab9944690,365,323,42,North America,18,1376.75
fbd9b7a4396e4356b583baf6670adb9e,218,180,38,Europe,21,922.7
fbdc3b26ef2f41f48dfc6fe19b89ea02,201,169,32,Africa,19,1536.58
fbdce1ad89614ea6af620587dd03a440,306,283,23,Africa,24,2251.96
fbde64a602cf4744a254321094291bd2,83,43,40,Oceania,20,570.09
fbdf0f69acf24e6b80364f1f20a1d89f,69,17,52,South America,25,316.3
fbe1291248c94d30a23b6bfe9badd14f,206,182,24,Africa,18,1512.83
fbe212bf663644e6a74365bd6671daae,255,234,21,Europe,24,1842.96
fbe2aa1b19734ef9a22d54fc6be54df4,77,46,31,South America,20,350.84
fbe2b348d2af4282b0b75e402ed4d9c3,323,304,19,Oceania,14,2194.55
fbe33747a1d441ec8ad2c5d18ee6d74b,136,92,44,Oceania,22,317.09
fbe36708850e4b8bbb700827fcdcc2c2,338,285,53,Asia,23,2194.95
fbe40993b8674ebfae724ffca2928f2f,303,272,31,North America,22,2622.36
fbe6ea5ea8454ac7ab3bcac1ec2850fe,144,109,35,Europe,15,804.27
fbe731492e6442feadb92ae218566f52,68,44,24,Oceania,21,382.3
fbea55e771d443ffa9922fd18e4ab753,97,47,50,Africa,24,434.25
fbeab365ae7b45879cd6dfd557531de8,54,6,48,Oceania,18,80.21
fbebe2d741eb4fd98f4b6739bdf19342,198,139,59,North America,22,1468.47
fbebf5e081d74f04a460d3e4638a1902,213,185,28,South America,15,1247.65
fbededbbdd364c49af561b6c082fb65e,172,116,56,Asia,23,1058.23
fbef57f3d0c240c49f2255476eae6538,249,197,52,Europe,21,1583.52
fbf00046337b4c30adf2c42605be0647,361,338,23,Oceania,18,2250.91
fbf3517cd6944ebd9834c684e53a8e6b,217,163,54,North America,19,1259.36
fbf41e0c72ab490ba49793a308fac9a1,233,180,53,South America,18,810.31
fbf494013a4044c7bf584f7b2a58aece,251,198,53,Africa,14,1049.19
fbf4a30c045445e0a322e2483c72f502,129,106,23,Asia,17,977.24
fbfc10a781274a3ea31bae9721696c59,193,167,26,Europe,25,1523.74
fbfd296a45fa4e989719167ceebc1ad0,54,31,23,Europe,21,607.14
fc0004065ead4c09bd28f4bf71bbf470,233,208,25,South America,17,1779.93
fc011f5053af4989a71029927aee316d,260,213,47,Asia,20,1318.21
fc01cf2854e246caa2048095b9af14f7,365,349,16,Oceania,20,2018.23
fc06805c5d114b91a476b5728610afd2,365,355,10,North America,25,3153.75
fc07476030a247a38c31fd46a3bf26db,250,227,23,South America,18,1579.11
fc088dfd07da46fb8f6878e00cd1c6d7,187,150,37,Africa,21,1215.69
fc08b20c6b9a4b0da9a04945f276e364,103,50,53,North America,16,570.82
fc08d0dcc39d46fb96fe45f781d08257,87,39,48,Asia,22,366.59
fc0ab81ec3d5464ea779f6f1291781b5,239,219,20,Oceania,17,1449.18
fc0b463017fb4b27b07664ad7ccacc7c,202,182,20,Oceania,20,1343.34
fc0b6a6b26cc4ae8b72bcf2277419a94,80,33,47,Asia,19,552.64
fc0c278dfe01499f820af86a0850db2f,244,209,35,Oceania,24,1631.15
fc0c76410b594f1ba3ae16fd2ef9aec0,146,108,38,Africa,22,1390.17
fc0ef16a8e084001a7c613a66f3bfdd9,172,143,29,Asia,18,1211.99
fc0fab8075d248e7acd88b8ed0398dd2,121,99,22,Africa,19,1025.2
fc11d51ae0e94da7887859128257c637,72,45,27,North America,16,362.06
fc131de390ed45dfa2a1980d3162ef4d,126,93,33,South America,21,1373.35
fc134ac23c0c4427a52c7e30948c1621,365,364,1,Oceania,19,2578.5
fc13accb358b451aadb10c2b293a78b3,110,68,42,Oceania,22,583.65
fc143f1cb479416c849ea47c76b535ff,107,74,33,South America,22,1082.87
fc144a8b64a643cbab45af854eed837e,231,206,25,North America,20,1638.56
fc15e9f4dd864d5d821ff88d930af3a4,341,289,52,North America,21,1434.43
fc18430c804c449ba14d09df602824fc,29,1,28,Europe,22,236.62
fc19debcf5dc41c28127efccf794378b,363,349,14,South America,21,2052.51
fc1a9584ce9240e69e75e5e35e63a41e,216,191,25,South America,18,1524.75
fc1bdde67b904046b1745267726e28e6,261,237,24,Oceania,18,1703.8
fc1c7d8ac65d465f8f2cd32e9896d38f,225,195,30,North America,22,1425.88
fc1cf2dbc0584c179c92d277b88aa3d8,363,346,17,Oceania,24,2142.84
fc1d39d8336e4bbfa6b8d52cb85717e2,321,301,20,Africa,24,1808.96
fc1dbcfcad094fb79b9f296cd856bd46,248,221,27,Asia,25,1642.66
fc1f197c11fa485793e531d44b172b0e,134,96,38,Africa,24,778.82
fc1f6e0a059b4e1ab7928e267628b649,291,241,50,Oceania,18,1362.89
fc20309c57df4ad797b92e1e8eb8ce5b,45,11,34,Europe,15,360.17
fc20aad1d27e413dbca140540d7669f6,49,24,25,South America,21,176.58
fc25311cdb19425282e0583f7c23c451,131,96,35,South America,22,570.03
fc25cd079b86480fa2f172c737122580,167,138,29,Europe,27,1650.39
fc2c8820fdf046acb4351164f2b510bf,319,288,31,Africa,25,1832.05
fc2d9bad722741cfb473d2d49862c145,193,154,39,North America,18,1454.16
fc2eb33fb2e9478ba8c2c5bbc29f45ba,131,84,47,South America,17,362.6
fc2fa741d8674da7b899d56b37064b5c,133,108,25,North America,19,631.69
fc326227a06c4782a5645bfc310d4074,84,33,51,Africa,22,572.08
fc33480bf3ee43c286e5329b799b561a,365,365,0,Africa,16,2212.74
fc371a89a7d143e8bb8477a2839c7dad,236,208,28,Asia,24,2079.74
fc3b1593920e4e218e4182eb893973a2,151,121,30,Europe,23,1226.52
fc3d69e3b86a4223b3f37d15af8ec172,272,250,22,Oceania,23,2020.75
fc3de0057a06484ab7c0f2af9ef83dfb,292,252,40,Europe,19,1666.92
fc3e09944cc0492ab13ac79313b41ca3,296,250,46,Asia,22,1533.14
fc401b2e40984924ba8a0cbbd438ffc1,343,319,24,Asia,18,2334.25
fc4036eb7a434f84bc45f8ff2aa90348,309,275,34,North America,18,1957.96
fc4083df2f37423faa909602df4a07db,362,325,37,Oceania,19,3296.71
fc4313365f2a4d17b5c01c5761a020f4,93,69,24,Europe,14,680.55
fc44e011af6e472db024fa680cdb1af5,51,26,25,Oceania,19,277.09
fc485ab876b3406cad034a78eb494e79,88,62,26,Africa,24,573.52
fc4895c047bb477ba18bb1685605a588,365,352,13,Oceania,25,2637.84
fc48eb34628649a1915fd9757ace55f6,200,149,51,Africa,17,1064.57
fc4c8895d40f4a11997a00fa083ec8c0,335,290,45,Oceania,23,1619.98
fc4c9af6eeae4e5f911192b2c134940f,353,304,49,Europe,26,1775
fc4dacde6d8e4f68a1cc8dcd281bbd8f,80,62,18,Europe,23,572.84
fc4e0427c0cf44348a27c8f98b6c8778,90,54,36,South America,23,721.98
fc4ef36132be4376a69ce21d6a381a1a,229,179,50,South America,20,1008.72
fc502819f4ef4ca28d178e72edaa2b96,88,34,54,Oceania,23,534.2
fc52f2328a1e495494c86101c536c82f,217,185,32,South America,20,1286.8
fc53122797874950ba206b4538004b03,57,29,28,Asia,18,720.12
fc536d48b6ff4375a0e8e8cacbc0de45,45,18,27,North America,19,471.5
fc56dcea168e4c9193e77dc28faaf4fa,365,361,4,Oceania,19,2428.38
fc59f5bc3b6b42e6879a3b293464f07e,59,15,44,South America,23,502.41
fc5bac5c3f754851af94c40b17a1c740,257,221,36,North America,19,1933.49
fc5c9bddbb754d29a949aa06e8778639,222,198,24,Oceania,24,1611.3
fc5d6626e98746f4b4d60186e0fe09dd,31,11,20,Asia,19,363.92
fc5f254af186471393f91e40579487dd,61,8,53,Africa,19,633.66
fc60b71b3fee4930aff7b22dcd9622f0,148,104,44,Africa,20,1039.57
fc6209b9942449829a9124f94be43c09,217,183,34,Oceania,20,1632.01
fc629d3b15914feb8abefdd445585e3a,140,107,33,North America,16,973.77
fc6814aa96fa4a32b447209c55b2ddbc,365,358,7,South America,23,2087.62
fc6c25cc7a1c4aaf99f352e66fbaa7b4,134,103,31,Europe,20,903.66
fc6c45126722454caeef8ef82dfb56bd,336,316,20,Oceania,19,3571.74
fc6cda9109c84cc4a75d0c09f81e8fe4,152,101,51,South America,17,677.05
fc6df359c1234ce1b932904dc0223b5d,261,207,54,Africa,22,1356.3
fc707afcba6a421f80ebd145d7d49632,170,152,18,Oceania,22,801.52
fc73fe5e815f42a0a92cd37ee87b1b48,189,131,58,Asia,18,942.71
fc7786ce4a2a41eab23c2bf044733948,219,166,53,Oceania,19,944.62
fc7a1874f2a3484c9da963767fa6b91f,292,258,34,Asia,21,1783.09
fc7afb6c54d9499e90ea0423e42c27e3,362,358,4,Africa,17,2559.52
fc7b3ec6f7ba4940bb0204bba4388029,104,80,24,South America,19,762.06
fc7bfe9d8fa8475f9e20b5d19808e104,206,161,45,Europe,21,1727.08
fc7e45aa67814424a218f9ee67c8ed91,316,260,56,South America,19,1702.53
fc7f2c36ef244f319a56152614541277,357,335,22,Oceania,15,2619.07
fc8072b972b64a289467176b7a3479bb,365,313,52,Oceania,23,1326.89
fc80b728181742bb8fcec37172dec591,246,207,39,Oceania,20,1438.86
fc8348ff32764f2e896f8e820f369a7b,152,102,50,South America,21,486.33
fc879aa515ad4deea712bc33ae0fabe4,308,290,18,Europe,24,2531.08
fc892264058c4597b219e42b5f13c145,46,15,31,South America,24,208.04
fc893bf0a0a048af89017272c33ac2b0,205,174,31,South America,18,1694.84
fc89d9a958564e40bf4f4d9f01724323,174,154,20,North America,17,1562.88
fc8aa01da5a24cff9e188c89cac16f13,295,241,54,Asia,18,1433.21
fc8baa09f3694e28aeae1e2a312579ef,122,85,37,Africa,17,493.66
fc8c118bceed4c72b1ed5800dba2e907,229,177,52,North America,25,1269.67
fc8d395bb45f44d7b3ea98e095def4b9,362,316,46,South America,20,1943.13
fc8e7572338142c08c7a6cdd43d5dfe8,127,87,40,North America,22,898.87
fc9085457120458ea69b873ef60ca3ab,332,305,27,Asia,22,1705.04
fc91af0f734a4881a94065705fd36c6d,280,235,45,Africa,13,2047.57
fc94bfddf49448b49310d510d35d9019,69,17,52,South America,22,455.17
fc94f7fda27147bf9ca52475c42e44cc,347,294,53,Europe,20,1790.22
fc982672754146689361a77326b797a7,44,19,25,Oceania,19,313.82
fc9832eddb4e448390b92fd8be9148fd,224,170,54,North America,22,1313.11
fc9ba8419a514df68435f7e981d8d683,262,222,40,Oceania,19,1124.53
fc9e1d6c08cd48be9900816f843b1469,345,310,35,South America,21,2781.23
fca0f10e42fd459fa8f8ba0ffec2b7eb,92,57,35,Africa,20,486.49
fca1729001c6409d914a386f2b61e703,365,346,19,Oceania,24,1905.72
fca1fb438b99440b912d6e07623b26cf,36,7,29,Africa,18,348.85
fca353d8033746179e9723060484ca25,119,80,39,South America,23,1173.61
fca3ed04a22e44048461d7ee15ebfa14,249,200,49,Oceania,21,1579.43
fca67d113997470daf122018f790f29c,88,36,52,Asia,25,818.7
fca6dc954c5f40ffad84fda72bf60041,341,306,35,South America,22,1924.51
fca9624fa42345a6976437e8675d6f23,217,195,22,Asia,19,1766.69
fcadf774d2f543d6a6e80bb535c8192a,123,76,47,South America,18,784.6
fcae18a4cafe43fe8eabb73de7458966,107,82,25,Oceania,21,877.45
fcaec298100d4309a81c3708e1b49243,60,14,46,Asia,21,242.43
fcb2d3e189a5423c974138547ef46edc,183,148,35,Oceania,20,1425.39
fcb82c6bcb9247d68b8c78bfc4fca542,100,65,35,Africa,24,258.76
fcb841ededf14a77b48f52ff8dd5664a,120,84,36,Africa,21,703.72
fcb983df5f4d43e6bb0815edcbe15e57,151,100,51,Europe,23,816.82
fcb9f813d1424c3182a2b1880163b2a5,142,94,48,Europe,23,517.84
fcba33704cfd447398469c5cf59be2e7,343,317,26,North America,21,2246.64
fcba8b662b2d49729ab4f33ec935210f,364,327,37,Oceania,17,2332.45
fcbad017145c4dda90179634e1bf9254,74,38,36,Oceania,21,666.62
fcbb4639cfa34e1fa10d14fea5677eef,349,302,47,Europe,22,1820.2
fcbb8c8cfec442139370b3d8251187fa,231,189,42,Africa,21,1325.06
fcbb9523ef0c449dabd24613b631b7ca,336,313,23,South America,21,2286.02
fcbbbb9c29ca4e1b8661886d88a058f5,311,275,36,Europe,18,1502.49
fcbdb6ebc2974eed9dc08ef3159eacdc,70,37,33,Africa,21,382.33
fcc0941487ac4588a07ae03c104c43ef,172,137,35,Oceania,18,1270.09
fcc110a3f7d843bb9aa3261d0fb46cc2,364,321,43,South America,21,2583.19
fcc17fa3997945ab8b33eb5f8abc0baf,112,64,48,South America,19,615.72
fcc567f43e654f4698d74a9b0c7d7caa,129,101,28,Europe,18,926.12
fcc5825154b24ed2ab61285c2f25c3a4,138,87,51,South America,14,935.59
fcc890faf5bf48a7aa3706cce3a93895,229,187,42,Africa,19,1994.92
fcc9fe5ebfc54a5f9b52ff18bf753cd9,348,291,57,North America,19,1827.9
fccd002f60174148952d36ea005fbced,58,35,23,Africa,18,203.23
fcd0f2fb106844b59964dbcfab06aa8b,240,185,55,Africa,21,1126.1
fcd148b59c7444f18d5b28f3d5b0d3f3,52,20,32,Africa,18,382.61
fcd16bf9f82644a9b145270518758081,267,241,26,Asia,19,1972.37
fcd1f59dd47b4ee4af212b9434d651e3,113,61,52,North America,22,521.34
fcd311b130eb4efc9824e2a009b87ffc,269,235,34,Europe,19,1795.51
fcd51970fcee48ee85a07857a95d6a6d,175,116,59,Europe,22,1143.82
fcd88bd9395b4ea8b4c8e4eeeb826ebd,156,115,41,Africa,20,1000.87
fcd955353a2a413e95b02edc332ef4bf,211,168,43,Asia,18,689.49
fcd96f70e22d4c6383a4a5ce03ed05ac,244,199,45,Europe,22,1018.74
fcda5955bbb84db288ee357a855c0d51,364,330,34,Africa,22,3067.19
fcde4de8e6b14c3a958a03745a7c5b6d,365,337,28,South America,21,2047.33
fce220c13d694b2999303f55e2548ea9,365,340,25,Africa,20,1930.82
fce2f8eacd904c77b61221e31ae5adda,213,174,39,North America,16,1344.99
fce4bd714a3b4c8c9277df88d9d7a68d,307,267,40,Africa,15,1795.65
fce4e2eb0a8d45db8f259ead08fa7375,111,59,52,Asia,15,536.13
fce5d5f46b474dcea3e319559d289602,268,219,49,North America,23,1869.45
fce78ead1886406ca0a70d0a3a9a4758,67,36,31,South America,27,429.22
fce8023072fe403da35e52f5bfcf84d4,262,214,48,North America,20,1303.14
fcea67218b7b4f33ac085d37dfae22fa,77,23,54,Europe,16,432.93
fcea9ae9d1a34d849777c27cf0c49b81,345,301,44,Asia,21,1869.63
fcebe0b70fe9455894b444703c63f445,91,55,36,North America,18,659.23
fcee51d9eed84b3bb51ece7da04d4da6,173,136,37,Oceania,21,1264.77
fcf31b4fab5848aaaf05d1858f06c123,365,362,3,South America,19,1913.26
fcf566ab87844f89bb1b69511a51a74e,144,120,24,Oceania,17,1099.44
fcf9849d780546e7a290f476092a7835,365,336,29,Asia,21,1928.25
fcfa2169acad42d3bbe7df7603051198,305,265,40,Europe,17,2150.12
fcfa38e57c744b16b6af7364157543f3,364,333,31,South America,20,2082.05
fcfa812172d14af0b620497e00a0148e,189,154,35,Africa,22,945.17
fd0331dcafb4420d8a62ee37fced8caa,305,274,31,South America,19,2407.39
fd06f992240a46c0a6f9a9b2f2363baa,201,166,35,North America,24,911.28
fd076d8509f94b13907f947e2693ad26,246,204,42,South America,19,1642.09
fd0963a2071d4d31826f1ca840d84581,66,48,18,North America,26,779.1
fd0ba72172384f659db18b9f9354d649,223,203,20,South America,26,1949.37
fd0eb1c2c9db4f079cd7c4952be2a314,115,65,50,Oceania,22,465.91
fd0ee2285d3a4766970c1512c994c074,199,148,51,North America,21,981.54
fd0f36027c48468896e6796218c7a1a1,117,69,48,Africa,16,855.54
fd12613085b94ff0a78f59dc1d95cefb,58,21,37,Oceania,27,389.71
fd134cddc8a24898b76b6a401c2d5974,173,152,21,Africa,18,1179.04
fd15e3130ff34d8981108f66156084ef,248,214,34,North America,18,1810.2
fd17ca31ee46416c8eee500731f9f214,152,102,50,Oceania,18,1176.77
fd1de514e93b4e1e8567e867433b0b82,349,307,42,Oceania,18,2751.27
fd1e5443f31e4e358bb649e78f30f775,360,308,52,North America,23,1414.5
fd20901025f444688acc9080dc4875fd,91,48,43,Oceania,19,779.97
fd20923413d14b64b84bca97558e6f9f,71,34,37,Africa,19,71.18
fd213861d8d5468c83b3957bd3201125,248,212,36,South America,18,2053.61
fd23591c84f8443c88eb0bc4570f0944,275,256,19,South America,18,2088.81
fd265871e9d544dea90a2c6a7883f722,143,110,33,Africa,20,1037.51
fd2877863f5d413987b04fc88e2411fb,199,168,31,Asia,23,1317.21
fd2eb0ec175f4f4e9dafafacf59912bb,365,316,49,Africa,21,2244.33
fd31e6bd10744ba2849c8c1ebbae0afd,258,213,45,Asia,14,1812.95
fd35901871a349c5857645b5b6ab863c,271,235,36,North America,15,918.38
fd39b62e009a44abbfcf63759507e885,80,40,40,South America,15,1105.58
fd3b2bf3323b473bbb51a408d8ed8a48,106,48,58,Europe,22,695.6
fd40bd2fa78a4bc194c818545f2d9d60,357,316,41,Asia,20,1011.28
fd43a8602afe4c23bfe092b1c1caac27,365,329,36,Asia,20,2717.83
fd46a742a9bb479e863e3c50c63a362a,45,20,25,Oceania,18,542.81
fd4a4afd201c4d16975895006bbbe4ec,234,188,46,Asia,17,1217.74
fd4c7197f1194b1792a691e39630f31c,201,171,30,North America,21,1342.7
fd4f71b2bcc847c2a8a56c7bb8292e15,192,168,24,Oceania,21,1367.59
fd4fbf0e71de45e0ae1b91c0e3881d92,175,157,18,Europe,20,1478.24
fd513695162c47938539919ebe5bc58e,364,361,3,Africa,20,2623.11
fd524eaa0d8b4deeb8f2499cd1bb18cd,272,229,43,South America,15,1736.49
fd527cbe70f94354ab1abf85817c9e5a,33,5,28,Asia,13,205.46
fd55297d75904160b07bce2e804c6d62,99,60,39,Oceania,19,703.44
fd575939bfc544188f8b84bd5bff1141,365,353,12,Asia,21,1562.67
fd57bf39e92c410995aeb56c649affe0,114,55,59,Asia,20,800.69
fd5967f860ce40bea14392d600b7dc77,263,212,51,North America,25,1112.83
fd59aba55dc0444f907ad9c956900d80,106,57,49,Oceania,26,526.14
fd5a937e12384594a8fc9d94ff6d5223,52,5,47,Asia,16,28.99
fd5e9eccbc4043d7aa53e592c04d3f06,358,311,47,North America,23,1884.5
fd5f882e8e3e42e983e6bc59ee30fcb2,290,241,49,North America,18,1033.14
fd5ff8c4ae1d48eea4acd17ba60c3bca,354,301,53,South America,18,2296.28
fd6416570c2a48ccbfb5ea0e65166a89,74,42,32,North America,20,258.41
fd677ec1875041fdb3eb0a7c21d595b5,218,196,22,Europe,24,1758.27
fd6aab7cdb6b4d0da7ac45e5d7e50252,327,278,49,Europe,21,2150.84
fd6b09b09914441aacf7a4d41a3c432a,168,138,30,North America,22,1637.75
fd6e354e32184a9d9d3a746a24cdb5fc,226,214,12,South America,20,1929.11
fd72f0b0c8f84df98812de0b1c5bb51d,154,133,21,South America,22,1126.58
fd75869ad102491da44f9d8f377c8c7b,177,115,62,Europe,25,1066.65
fd7e3814f3f34ffaa03ed9f0b11eb49f,365,345,20,Oceania,16,2625.6
fd80c649f46c4ed9a8226eb22f670d76,365,343,22,Africa,17,1967.59
fd81cfe091724397b04ffed538ac2332,350,317,33,Oceania,24,2628.97
fd81ebaa95f3452cbef2e7716216e17c,311,280,31,Europe,19,2596.84
fd82b6bc84db48a393af72cfdf4f7eb0,325,270,55,Oceania,18,2164.78
fd83781a425d4caf98488390756a8056,365,363,2,North America,28,3376.72
fd8591f79ea64738907283ea45f3cfa2,261,215,46,Asia,22,1536.81
fd85ac5f3ac64f3e88d17c0267e56212,303,261,42,Asia,17,632.78
fd8621fa6d4b4105b14ad94bf93b9ab7,321,275,46,Oceania,17,1913.7
fd86bee138b34413aab93ed63dff26a7,196,166,30,Europe,15,1669.73
fd8923460c3a47899adf7e26693145db,302,257,45,South America,15,2729.82
fd89aec507b24f56a17dac33d3df2645,365,337,28,South America,19,1555.04
fd8b67f96a8e4e64845a7dd5b64c5c8f,64,18,46,Oceania,22,588.75
fd8cf106c8e4421c937e219f1f77d1c5,167,125,42,Africa,22,866.65
fd8dbc230420472cb190c90285b8ea01,365,344,21,Asia,18,2098.17
fd8ddffb8cec4c2a8c174fcca1d5a0d1,186,156,30,Europe,17,1688.06
fd8eac5bed7b40ffa21daf4cd68a5f36,119,96,23,Africa,23,824.94
fd8f4823879042d2a096098b6cb21dcf,281,253,28,Africa,18,2101.19
fd90c9904a0142db914fc39f5d05fa50,177,151,26,Africa,20,1537.93
fd919fbfd0de4cabad042895e6d66dd5,306,260,46,South America,23,1605.88
fd9288e4ecdc4ef3bd0b832738ee797c,119,82,37,North America,21,760.26
fd93795ffb524050b11cf84f3401cb5c,365,336,29,South America,20,2465.78
fd956b57a7f04a16a0246b4834fd58e1,280,258,22,Europe,22,2555.17
fd956d63c1e54dba937962bc3aba9ff2,278,243,35,Europe,20,1259.46
fd96828444d749edae0e1355d1da6c76,251,203,48,Oceania,19,1570.62
fd995df16fd24a6bba1f2135894f3ab8,266,249,17,Africa,18,2036.77
fd9abdc090f843a695c5047912e1c501,364,318,46,Africa,20,1701.56
fd9b532c9cd7447d8aba15d5f6a19205,202,185,17,Asia,22,1251.65
fd9bd607e90940a38a83c2297036c617,179,142,37,South America,15,1102.57
fd9d139ff76e45dab41fefb748d68c4a,205,172,33,Asia,26,1133.02
fd9d7e65c0884e929acdb88d27f493a0,152,113,39,Africa,21,1037.34
fd9e219863f74a3fb075b871e920a9d6,360,316,44,South America,22,2011.85
fda02d0a8dc04e4a9340b7d3ca2bb4f1,110,83,27,Asia,18,905.19
fda096ad2e7e430d88b06f6318725849,267,238,29,Africa,17,1522.97
fda0d344f8b94f998082f2de85dbf595,72,35,37,South America,26,525.47
fda1d7d134ee49c38660eb35b500aec0,43,3,40,Africa,23,65.55
fda35068469f45a4b7804e20f2cb9e45,188,157,31,Asia,22,1390.07
fda5ec6f13a44b52ae1ead532d862791,364,339,25,North America,19,2845.91
fda6444b178f438886f784bc5b8bb53e,268,247,21,Europe,16,2484.73
fda693f6076b4196b0ef29f5bb0de987,318,269,49,Europe,21,1615.19
fda6e36f16b54ff39c8a4127a6e51d7b,362,333,29,Asia,21,1572.78
fda734189ee3401ea0df9f3d2299dad4,365,347,18,Europe,21,2805.14
fdaabd9989c648b7829a639e51c58d92,333,308,25,Asia,24,1855.93
fdaad085b8664f559c087bd438258ec6,165,131,34,Oceania,28,1100.54
fdae3431d9814b13aba74575ad1a2f45,316,297,19,South America,20,2558.44
fdaec32f2a41402cbf8b9206f10cbc4c,364,332,32,North America,21,2367.13
fdaef9ab2e4543d0ad1c5b10d9ce4972,351,312,39,Asia,22,2620.92
fdaffc82ce574bd9b31e93cda0528a96,133,92,41,Africa,20,648.53
fdaffe9312194770a4ceb327bca080df,341,296,45,Asia,23,1534.68
fdb0b133e58d4d98a5ef01b5eee35d02,342,319,23,Asia,23,2584.47
fdb21bd2b3784bb7acd1832e94baf2a5,139,113,26,North America,23,927.64
fdb3b221fa92401f98a09f2d416bbce3,166,134,32,South America,23,1110.98
fdb3c7a83b734211811130a03385ffbe,150,113,37,South America,17,1017.8
fdb4906eee4049b6a141387294ef4400,101,55,46,Europe,19,827.03
fdb4d5704a33480381cb8d94180173f6,365,345,20,North America,24,2472.34
fdb4eb335f774c74a5a8d0f9163e7f0c,359,339,20,South America,19,2516.69
fdb71214507048acb2774c637af88130,266,217,49,South America,19,1123.86
fdb7e959b35443d092d86cfbcbaad044,171,138,33,Oceania,19,1135.72
fdba286b3764437aa61bdaafdd81dee0,340,305,35,Europe,20,2765.33
fdba508125374e9c8a8f730053574940,354,309,45,South America,24,1491.65
fdba9cb865b44813967747484a342f20,297,259,38,Europe,19,2087.6
fdbb734e51db4519b002d4bd24688432,235,200,35,Europe,19,1622.48
fdbec7d8c94b4ebea646e85b6fe81ff2,365,341,24,Asia,21,2774.37
fdbf47ae0162481abc16048a8f18ec78,155,109,46,Europe,22,704
fdbfa4de42d74844b487cf42012e4d91,364,338,26,North America,24,2338.99
fdc02b09b26b400291ba21033c9fa446,274,244,30,Europe,26,2533.65
fdc046d743d645f9aa51c3f9ed5d9760,146,104,42,South America,19,763.63
fdc164c84ef145ef8c6a9a86b588dffd,285,247,38,Africa,17,1760.99
fdc23c415a5940089c19dbaabce4c6d0,175,139,36,North America,21,1389.15
fdc27beaf3a44d38b2cf7306ed230608,153,131,22,Oceania,18,1215.29
fdc31a377a7e4d188c27417f3e672a3d,104,84,20,Oceania,18,752.48
fdc450d0a048425a92ade7fc93320b11,74,48,26,Africa,18,630.74
fdc63e212dc24d0c8843d916442bafef,365,338,27,North America,19,2335.45
fdc7543a463740e1a19febb952dece60,346,306,40,Oceania,20,2632.06
fdc89e3ae3f044f891f700f86a17b503,139,100,39,North America,20,642.54
fdc8be814de447e69d448a209c7ffbba,139,115,24,Asia,21,952.7
fdc9b8f72b364c2b88f2e6f6878ead73,204,184,20,Oceania,18,1582.5
fdca9dca36284794bbded55a9ace742f,71,44,27,Europe,27,702.6
fdcae89993234a71923611b5d2bd356f,142,93,49,Asia,23,1053.3
fdcb7293ac384cef8d487649009208ae,365,328,37,North America,15,2981.92
fdcc765988ec47efa99551a150e99af0,223,174,49,South America,22,1162.4
fdced02d4c1942b29e5fb8973fe66a99,153,113,40,Europe,26,919.67
fdd052d7bb724acf8d929c3ef4216da3,311,283,28,South America,23,3106.25
fdd13c1853624d4a953d9ec115aaf905,154,129,25,South America,20,835.5
fdd26d0b6cba41fbba595ae98a52bfef,161,126,35,Africa,18,936.87
fdd4150ba3874f3eae6d1f82ac5bcc52,315,285,30,Africa,20,2767.13
fdd4746e032f4ce9a0a8e6f858b68331,185,129,56,Asia,20,842.96
fdd4b734da814c908287ad95bf44b54f,131,78,53,Africa,23,578.63
fdd7496dcbf4497a84ba5436b3e25a90,182,140,42,Oceania,22,1620.81
fdd86f4093e34714a8516fc867323019,179,157,22,Africa,25,1727.13
fdd972c5f792463ea714613cabe64f4a,38,7,31,South America,20,470.25
fdde3eea9deb4020b14ac474c91cfe7c,54,20,34,South America,19,359.25
fdde74652e51433fae46bef4d59f6244,167,148,19,Oceania,18,885.29
fde114702b004e62b7d1f4ef00214055,62,33,29,North America,21,662.41
fde29d6530864e908c75f74fec25ae5c,365,324,41,Asia,19,1525.7
fde4ab66589f4dfea30b337feb05ab76,178,155,23,South America,21,1375.34
fde7db7b7bc94661b43f82299bcd7cb0,363,340,23,Asia,21,2301.11
fdee8e2f00d84be88caa82c9eb5073b0,180,143,37,Oceania,11,844.77
fdefb6650038456e9cce4214f234e616,217,173,44,South America,17,1547.12
fdf141abb9e5414396ca66074089fa2e,195,145,50,Europe,19,811.18
fdf30162d1b24b09bbeb5f3f2c40bb93,265,237,28,North America,19,1585.13
fdf41f5590fe43baa2ae77afc30779a4,246,207,39,Africa,20,1863.34
fdf4d03274ce4c9a8b3146fff0f78bdb,73,48,25,Europe,19,187.51
fdf6dc037c97428e9bca798ddc92b001,299,254,45,Oceania,19,1579.05
fdf7513d32d8434eb26605e4acf725eb,164,134,30,Africa,22,1050.43
fdfb6da8266b493480132bca2ad70102,152,139,13,Africa,21,773.95
fdfef965ad8c4e7f8403c2d424260719,46,13,33,South America,19,426.47
fdfff4f2caf34a7a98a0046aec7ae3f0,105,58,47,Africa,29,569.87
fe0181c6c54a4bd69edc80a3c0ad68fd,70,28,42,Africa,25,397.08
fe01f29474794350837ad2e09d4392a8,249,211,38,Asia,20,1247.26
fe0210760d8d4b2a8d1c702f524fea5a,41,3,38,Africa,19,161.78
fe0322a7e594423bba9103377f93d926,210,165,45,Asia,16,1489.35
fe04d18b71ef4686a0c9716ca6ae979f,119,71,48,Oceania,18,495.75
fe088fe5614949e09fd278c36e88a4d3,228,180,48,Africa,15,965.19
fe0a4fc3762346149ab6ffcfd948d21d,360,337,23,Africa,23,2555.65
fe0b80b1ac044e4c999a35c04911f5c3,190,152,38,Europe,20,1679.99
fe0cfbb0e189481992f30eca2d926637,365,358,7,North America,23,3184.36
fe0e59a2e01a4ef2b1b18001943b0be5,223,183,40,Asia,20,1461.05
fe0e8332b6164753957e4e77cc84d338,343,291,52,Africa,16,2276.76
fe0fcadd33d7450197e37692b5c888f6,92,71,21,South America,26,551.62
fe1362dc7bce4f488590090515178513,198,157,41,Europe,19,1179.65
fe13779d1da0446abae0adb9819393a5,278,242,36,North America,16,1832.41
fe13d6ea89fe405f888f6d77ca1d16d2,163,106,57,North America,18,873.71
fe15166f9be746a58fdc6e8fe95d6f06,75,52,23,Africa,19,663.92
fe15b7c43db54c44bde72a18ddf45b23,148,100,48,South America,24,598.95
fe168d00c83f4abe99c232d446847cfc,364,332,32,Africa,27,2124.36
fe18006b8a0644909ad726e30cbfd772,178,156,22,Europe,23,1403.32
fe19da903f0240c6aaf331b43aacabf8,257,235,22,South America,20,1832.87
fe1a31cfadec4f3596606a8731b35e14,119,96,23,North America,22,852.85
fe1a92ce0b36400aa4813f0a0f909fcb,264,225,39,South America,15,2099.77
fe207d22d6c44b4abe46e880931fc0a8,365,343,22,Africa,19,2064.85
fe22eae398d94eef85884067bc47e05f,236,205,31,Europe,24,1430.81
fe23988614dc47fc837165756d2caa35,173,146,27,Africa,20,1104.13
fe245e784101422cbff4016b85f2f466,362,339,23,Asia,21,3088.69
fe2a90413ee440a28685fa7cac3bc923,359,310,49,Africa,22,1790.43
fe2e465d2aa846e0a99c62a8a392484a,365,343,22,Asia,23,1671.89
fe2e4b10ed234804b2e4f99dd9314261,231,183,48,Europe,18,1496.41
fe2fb2bcfba0493aaf0a7f0fd087c423,101,84,17,Africa,27,1007.78
fe30ef7c2b10413889b74e5dddf82ed3,32,12,20,South America,16,193.08
fe35698238204be9ace0fe5da6800675,45,6,39,Europe,20,431.31
fe3671929c5945e9b6424452bf65dea8,127,96,31,Africa,21,677.79
fe36e7b0f01b45c89da36324e7d66977,73,51,22,Oceania,14,304.11
fe3859ddaf664b2d841572a021b639d9,319,288,31,South America,20,2201.55
fe3ad9f1571a4e8e9f1877701d064a80,79,26,53,North America,15,196.12
fe439e5e932c4423b34a80574cb1075e,364,331,33,Europe,21,2350.93
fe43d857ef37417090cec59d627f2e5d,192,163,29,North America,21,1212.2
fe45201245c94375bc51e2aaa70ce961,324,308,16,Asia,19,2208.18
fe46ed830abf4036837e629f2aef087b,110,87,23,South America,18,517.15
fe474bba15ed4ea79654c7e7b7669f89,310,284,26,South America,20,2482.68
fe48336f87d94598a65d10199c45d50b,169,127,42,North America,17,1511.25
fe4a52161e2d4782933d5d0bf4a7336b,259,217,42,Oceania,20,2268.78
fe4aaee059fa45619fcf7648889be46c,282,257,25,Oceania,21,1548.85
fe4bd5319aa142ea99b349a379b622c2,49,28,21,Africa,22,341.56
fe4eadc8f30945f69741ee5751358a74,258,216,42,North America,22,1260.84
fe5532c1b6624052a21bc476fe7979b2,237,212,25,South America,21,1229.29
fe55b84b3d3c46048ae99b2252c34a85,114,67,47,South America,20,886.82
fe55e0cec30b4fc38bba44f6464c85d5,350,300,50,Europe,19,2501.7
fe570db67d9e45c5979d8edb3f717507,311,277,34,Oceania,20,1965.49
fe5818c64ba843848f55998d681ae65c,47,30,17,Africa,21,417.67
fe5900fedfca4f9093f80522956d151f,202,184,18,Africa,23,1596.93
fe59025c1ebb4c79a09524cbcb5543fc,106,51,55,Europe,22,851.6
fe593d7a7acd499eb854d84ba50197c6,201,148,53,Africa,20,1144.1
fe5a1d56a31d4d37b1f606d719d6efe9,179,145,34,North America,20,1275.49
fe5a21e6ba4f4794ab0e6f93705425d6,280,229,51,South America,19,1183.88
fe5ab153fe2a4e2bafab2f480f580bec,320,285,35,Asia,21,1374.97
fe5b86861d7048cdbf8bd6ed396caf58,96,59,37,Oceania,18,758.1
fe5bc39e53844c289dd2c1b36f42fb72,124,100,24,South America,23,1115.68
fe5bc538e6be471e8c7b64b8922003d3,304,262,42,Asia,17,1138.86
fe5d7c8d5e924a46a7c756d6bb2182c6,34,12,22,Asia,15,139.1
fe5f82ff37f0438e8ccd9d9e1832549c,315,258,57,Europe,18,1340.04
fe600f9296c74d2a9a47f24b1a5174b4,225,206,19,North America,21,1832.57
fe61d0d39e9e4a56b825ff0708b7a0bf,69,41,28,South America,20,836.48
fe65b14e6b304ee485f79f964a646e0a,131,80,51,Africa,20,509
fe66b842c3dd4449bfcc3cbe61023ac1,362,349,13,South America,20,1930.76
fe6721d0604442c2aaef2103faf8386b,291,258,33,North America,20,2391.32
fe673f84df6e4ea0a25a55e7c402b272,255,224,31,Asia,17,1840.72
fe67fd317d3946f78842051d54610838,155,120,35,Africa,27,890.96
fe6851deba10401d9afa53c6f0b8ed80,241,217,24,Europe,18,1457.67
fe685ef3d92d48049cee6a6293188776,159,132,27,Europe,16,1393.4
fe6a89be5dae4d09a95ae0cb3de3b650,364,333,31,Europe,18,1672.37
fe707ec7d37249f5a16d729ad56f37a5,199,174,25,Oceania,19,1610.28
fe71305ded9d4bd08c3b1dc9db8371da,254,201,53,North America,16,1582.78
fe74e642d0004cd68fb16d20297321ec,135,95,40,North America,20,549.82
fe780da07f4941d99a4f2e68ac11e0c8,200,185,15,South America,17,967.13
fe792843106d4e6191ec80307ce9d96b,208,179,29,South America,18,1164.17
fe79fd6b9be14fe799b2f2e1c3c3ab2e,176,132,44,North America,20,1169.29
fe7b9ae23f5142cabd1652f0b57e4200,96,75,21,Oceania,17,254.71
fe7d3971b247477aac7c36d7be8f02d7,271,222,49,Europe,18,1263.84
fe8077230bf945f08e24fbf3b0e5a236,123,107,16,North America,20,903.23
fe80cca63c8d4ac088faf9a07a186571,44,7,37,North America,22,258.56
fe81ae69180749d88f2e67b1c21bf361,365,342,23,Africa,20,3254.41
fe82646ade7d4c62939f079e1a0a1645,365,363,2,Africa,19,1803.02
fe837fc2b2ad491ebc30762f646f0faa,256,207,49,North America,18,2447.82
fe85dc7d89a04c759a6ff8579492e1a7,365,349,16,South America,21,2198.56
fe86b56ff368401f8b85a730fb760e98,275,239,36,Oceania,19,2020.32
fe86e71a571240aaa976849ac02575a9,345,309,36,North America,22,1971.4
fe8b6b0973e7441b8690c2df243b22f1,187,140,47,Africa,22,953.87
fe8cdb01403a475c94a383d088ae875f,258,218,40,North America,19,1367.27
fe8dd6401e39435faf9038e9a375fdd6,360,315,45,Asia,19,1702.76
fe8f279f37024ae9b70de0433871d2f8,53,15,38,South America,21,292.94
fe8f712bb3a942d59ab07dbeb8e90b08,151,109,42,Oceania,19,474.3
fe90983251aa4f7885dd6f49aa513a61,126,94,32,North America,26,640.35
fe90de88a5fc4ac0bedd10228f5f004e,221,199,22,North America,21,1661.95
fe91985a941d487a860708bf9b6c6a0d,259,199,60,Asia,20,1417.07
fe929d20adc44227b0700891c9417f8e,297,280,17,South America,22,2771.99
fe92e5b8214140cc910728adf70c5f43,301,261,40,Europe,20,2152.37
fe93887d10dd4b7d94285249748196d1,61,19,42,Africa,17,262.96
fe968b3147434c978254276522cc183c,162,124,38,Africa,18,821.58
fe96b7b1f956494db919f8bd1211686c,288,235,53,Africa,23,2045.27
fe96f912d22649edb652e3a2c56330fa,131,103,28,North America,21,1181.01
fe98c32362f84a4b828e7d7bbd5283e3,178,134,44,Oceania,20,1258.52
fe9bb57895c04f5e817e6f8c2552a6a0,89,54,35,Europe,21,784.7
fe9bc159f72b44569df1189e978995b8,273,237,36,Africa,17,1636.88
fe9bd6e4026a4c26a997ed2be9edb845,113,83,30,Europe,20,920.06
fe9d1d395df24a769316f16ebd9b4502,147,106,41,Africa,19,1337.11
fe9dd8441792490ea2e84faae502ba69,110,80,30,South America,18,665.89
fe9e2672e7eb421fb55e3adb11d6955e,229,189,40,Europe,18,1505.81
fea25600846944c0b60ca530c9bcf787,82,53,29,North America,20,625.99
fea290e6ac384d57a8e716846b01d4c8,230,184,46,Oceania,17,1324.44
fea44da897cb4ef386effbd8f883756b,56,3,53,Oceania,20,167.12
fea62468b5c54c9884eb6baac139ac97,131,88,43,North America,19,1143.72
fea62c2922db4c55b33d67c92916767d,323,267,56,Africa,22,2100.92
fea81f6b7c1e4f818497f97af7707c3f,330,293,37,North America,21,1815.68
fea9075cd85b44bda4a040317991c9e8,328,286,42,Africa,20,2504.2
feae4d5cb2c540a3b89da2898299f0b2,350,321,29,Asia,20,2141.28
feae7e9be04541208a1d743a209e4301,148,126,22,South America,18,1013.93
feb17b472c7146e8ac71adf08982a42d,294,264,30,Europe,14,2378.96
feb4596596604106aa77638f1d399f08,191,168,23,South America,20,1375.75
feb4c80ad44945b1916abe901095a501,75,24,51,North America,18,61.81
feb6f311cee7475bbfe9f95824e3331a,364,347,17,North America,22,2294.8
feb8c885ee144c738c65f71f0e498ce0,175,152,23,North America,17,1754.33
feb914eb073647fc8dcb7ca2d9c86aeb,329,281,48,Africa,24,1557.67
feba209214bc49f485ab0a8ecb72fa04,364,361,3,Asia,25,2878.32
febbb3e6fdd54f83aaf1d901ba600c16,103,76,27,Africa,17,723.74
febd8e0ed08e46ddb299fb6136962741,342,328,14,North America,25,2586.02
febe270d86ba4a69be6a8f773210b858,60,9,51,North America,17,49.96
fec16b9b0e314408a78edbe8e2021279,158,123,35,Asia,18,1164.8
fec4517fd3bd4b42ae99ee35606d6263,311,291,20,South America,26,1986.18
fec5564cff17419f8e93504b12bc2d4f,123,83,40,Oceania,20,625.08
fec692acfbd7470a963f1a70f100bd96,190,160,30,Asia,21,1027.54
fec740a54d13478e8dd23035492ae00f,146,107,39,Africa,21,726.74
fec82f230247493c852f77aac2102eb5,38,10,28,North America,19,279.84
feca06c372074b7db37d53bd8716c55c,211,191,20,South America,16,1346.73
fecad8e2d4d147bcb1da4920db5a679d,287,233,54,South America,15,1624.14
fecbbabe6ddb4d3d963a9df978398786,203,167,36,North America,19,1012.14
fecf269c060d44218f224e10a545d7cc,330,281,49,South America,24,1284.02
fecfc9cc1e8c4015b586216d4d5fec06,28,3,25,Asia,16,353.48
fed2b54dcc62442b86fe72c8c5f3ea9b,58,34,24,Oceania,19,543.03
fed2c0b4810c43be9a518bdac17bf664,24,4,20,Asia,23,425.05
fed33de62a5d47ebac0506a4a6f286e3,308,261,47,Europe,23,1395.54
fed410ddf93a48fb819d66dc92e3cec0,314,282,32,South America,22,2300.44
fed5f0076511449ea2f513bf47940275,94,38,56,Asia,21,307.81
fed984e55b524743808f1dc33308029a,129,91,38,South America,17,858.22
feda189e8c0145fcb1f647709fd793ae,341,301,40,Oceania,20,2120.75
fedc0f9368204e4aafaaf35369774169,117,74,43,South America,21,443.23
fedc18094a7843f6a20a2c3eaa002a02,136,110,26,Asia,23,1130.36
fee4daebf2ec4e4c8d523d6fe6899816,333,309,24,Asia,21,2700.19
fee574793a2b40d29f2b8534e154847c,365,353,12,South America,20,1927.88
fee5a123aa604013919c1e982cce2351,364,328,36,Africa,20,2936.82
fee5c2a6aea24c2d98a455269d0632ee,168,115,53,Oceania,25,902.66
fee5ebeadd644cc58816ec19c65e9e7b,303,278,25,Asia,17,2390.73
fee6c74eb7ae4ece93f3dc6c246fb022,364,337,27,Oceania,20,2121.55
fee813d48a28493dad5eaf5f95c9fae0,143,119,24,Asia,15,957.86
fee9ed6ff81a410987b8b62bd2232e5b,76,21,55,Europe,20,329.7
feeb761df94a41128638e1c3aca997ac,365,329,36,North America,17,1364.98
feed252b2db04c618be6230fa83a394d,354,311,43,Africa,18,1937.15
feee67fbb64a4ac990d0a22f44fe020d,190,133,57,Asia,18,949.07
fef02ea4412e4af295710b948f900b09,118,69,49,South America,22,364.69
fef06c4e18404549b62744e8aa82fda3,198,145,53,Asia,18,1117.02
fef4142bd3aa4331adf5b97b07063a7b,234,198,36,Europe,18,1591.33
fef54f7524be443586a2b39fdb9eaa7a,81,38,43,Oceania,25,298.08
fef558e132824bfb8c90a1332c7a653e,272,231,41,South America,21,1684.42
fef5636162c241a9bd31c732e3206906,335,315,20,South America,18,2148.86
fef6851a205041ce9c65a68d3044c457,365,354,11,Oceania,21,2578
fef71398275b43f5a34e83dd59db404e,365,336,29,North America,16,2448.7
fef9ad04f3d84d1c9d3fa9702c023b3f,164,131,33,Europe,16,963.78
fefd543329fd4b8ab5e988f008d9f243,257,219,38,South America,23,2060.89
fefd7c35bb7644db962c7d41e564c711,83,55,28,Oceania,22,511.75
ff02527148c2441c8f3ab871a737a446,63,45,18,Europe,17,276.72
ff02758ef29f4f5b84cc6737ea511d07,57,22,35,Europe,21,365.8
ff02aeb5873b4eaca2ab7daed81c66fe,293,261,32,North America,20,1437.69
ff038ad8619745cb9781b8397e95b609,103,59,44,Oceania,20,377.2
ff080e1137214b378ae79163b601217b,332,278,54,Africa,21,1654.32
ff085b9db4d24c08a7f42208d5bd68b6,334,285,49,Oceania,20,1563.86
ff0ab22437fd4edc9fa873564d93142b,123,79,44,Africa,21,686.92
ff0ab5c0ff4b4593a6eee3c5da407fab,90,69,21,North America,20,478.31
ff0b8ec04541467484f429f9dad385e8,82,29,53,Asia,22,634.32
ff0c891cdc0a4d9e88bf9e5c21d4f1a7,173,124,49,North America,19,1044.81
ff16dd1d43a440198b9fe3ec4a09ccfd,323,270,53,Africa,21,1482.01
ff17277217fb4d4690d51d558f7d6a55,364,324,40,North America,23,2601.43
ff1ccf3736b44b54adf8bc3bd0e9cebc,364,360,4,Oceania,15,1711.55
ff1ffed4640b4949951bf48c8daf77f4,238,200,38,North America,26,1722.41
ff212546426847c1ac09e2bf9417bb74,191,128,63,Asia,19,1114.25
ff229324ad064ebbb16f48e719c00004,97,57,40,Asia,18,689.39
ff24580caa3c4b7da3c2e7338178c110,326,288,38,Oceania,20,2307.2
ff2665e6149b4fc48755fedc83152a4c,249,225,24,Asia,17,1823.13
ff2668bf3b0c46cda9020b6a9acb2c93,333,290,43,Europe,17,2328.53
ff2b0de676f94ad29a46261b8a172de3,91,45,46,North America,19,590.45
ff2c5ac9be0d404185a7cf0c9acdfab6,29,2,27,Africa,16,385.89
ff2d533eef484393a65977ada2f10485,333,314,19,Africa,22,2244.26
ff320e884f2a417ba4b77368a26af704,269,221,48,Asia,17,1388.25
ff33dbbcc3634b9fa61f0b92bb05a44a,304,248,56,Oceania,18,1059.2
ff365fbc519a4b9da16ab24648d96481,251,202,49,Oceania,19,1315.11
ff36965b15b2421198cfe57bec82eb5c,75,30,45,South America,20,561.29
ff37ea6ff86643528d12fb2973c069f9,148,107,41,Europe,23,1221.12
ff398b1f6c0f4f2785874e12f9825347,315,281,34,Oceania,23,1760.73
ff4197570af34a9f9c0548232d3d10e9,123,95,28,North America,22,1134.52
ff463ff2446f491eb5c16f6364bec920,91,52,39,South America,20,498.19
ff4695b61ddc4f198f210e9c62cee77f,126,78,48,North America,18,506.5
ff47570c440e4ceebdfbb36294bf952f,273,253,20,Africa,21,1630.09
ff4797dd16d9409282e2dad3000f97f8,299,248,51,Africa,24,1790.12
ff486c41036f498b8858a5b673d0c20b,81,23,58,South America,22,731.61
ff48b3e5c21b43c3b9fab0684f7ec016,141,107,34,Oceania,24,1254.22
ff4b6e42d1684e7dbadb03337c364e16,209,185,24,Africa,21,1722.49
ff4b8ed73417494dbf3e3b33fa782a1d,314,277,37,Africa,18,1560.64
ff4cbfa3c53342f8b92ead5db15fd56a,362,343,19,Africa,27,1702.82
ff4e6cb32d3649c196c385a718dc8690,50,11,39,Asia,18,372.51
ff4f0a4351f9470bbf67811b7e0d733e,322,277,45,Africa,27,1564.22
ff51dd1df4ce4ce1b6d5ed699605c693,219,183,36,Europe,23,2305.72
ff51ff3ac7a441d0974b4c54b511b2ab,174,120,54,Africa,19,530.15
ff55445afa4043138e6664eb200dc401,150,125,25,Europe,25,1004.42
ff55777601d149e8bee69d744d2fecfe,213,189,24,Asia,19,1811.25
ff5695aaad8b46a593b2d729955d2745,244,204,40,Europe,21,994.45
ff5784e8d406424d91d828517b53dc7c,176,132,44,Africa,21,1492.37
ff58427442dc4f3c9b26a17e8fd77770,253,201,52,South America,18,1204.22
ff5b357e180747c18c72bc3a18e4c8c5,76,43,33,Europe,15,642.99
ff5c17d366bc439fb6ec2c99d0e4b9cc,181,135,46,South America,21,964.65
ff5c75cb2e514b5bb5875f7572f09126,301,270,31,Europe,21,2279.06
ff5c8cd955764a5bb4d2a87417a7b68c,61,33,28,Europe,20,509.07
ff5d1bf5fc3f4616ac67984531b92dbe,364,356,8,North America,23,1643.6
ff6062dbbee3401f8d992483ed392e1d,332,288,44,Africa,19,1353.05
ff60ab43db654210a8aa85fa81e9294d,199,162,37,Europe,20,1156.64
ff61855f097d4108bd011c1bb99ff4f8,184,161,23,South America,16,1569.71
ff6273f1912d4e899c5472d42296c9f3,61,13,48,Oceania,20,454.64
ff62a6cacf094fd09ce6ca45c44eb374,275,239,36,Oceania,25,2014.6
ff6658d557c14456b41184efab75e85a,138,71,67,Africa,17,688.58
ff66aa0caaf14114978e219fffb8242e,83,49,34,Oceania,23,691.45
ff66e54d37b049dbad018de043490089,154,104,50,South America,16,861.94
ff6907d1abfc4ea79c1b822e328f59c4,302,278,24,Europe,23,3458.1
ff6af77129a4409482fc0fe191fa364e,266,230,36,North America,21,2039.33
ff6b22fb41c4415f810ce8f6ae7af16b,355,309,46,North America,18,1704.85
ff6b6c2990d24fdb9175c995296704c7,315,278,37,North America,21,3117.53
ff6f0278be8144f58b4c3d8bde553410,179,162,17,Oceania,22,875.15
ff6f302a3e014ac2bcd5de40c4fa227d,174,121,53,Europe,27,682.3
ff6f7b4e99a3451d8f555dded72f56a0,354,304,50,Asia,22,1735.19
ff712c0131c24a4d9f381c95818da826,120,76,44,North America,12,696.38
ff7195b883e34e13adc6abbcc6629b16,80,44,36,North America,19,481.03
ff7489489ced420d9ff677be409922de,77,46,31,North America,20,362.05
ff753de64d30484184dddbfb1c95b09c,231,182,49,Europe,17,1133.36
ff76726ea9fc4588b36098630d657897,109,86,23,Asia,23,605.02
ff78c9b9cf944e9c954e91c39377f6c1,189,146,43,Africa,26,1896.59
ff7b8fa2e60c467b9fa4f92bc204fa15,365,359,6,Africa,20,2066.42
ff7c02274b874f029292ae13ced67a40,363,344,19,Africa,20,2216.18
ff7ed1f696cb4971a9d9c1910fc37c9a,177,145,32,North America,23,1103.31
ff7f343555f04deead94c624d4b51cbd,364,345,19,Asia,21,2703.87
ff7f54e2bddd4199b27749c383c611f3,250,214,36,Africa,21,1788.28
ff7fef34b7a343fd8deb326296172050,273,232,41,Asia,20,2315.65
ff824c93bbc548c7a9391fef2cda5712,363,340,23,Europe,22,1693.72
ff829d15944b444c9e5b2557ea294b59,47,1,46,Oceania,18,133.36
ff83d4bc8efe4c019b4bd1013d3ef647,116,93,23,Europe,23,493.34
ff8595a034264cd1ab77a5e1b783d4bf,365,355,10,Oceania,22,3281.62
ff8698f7ef324862b6782d2267dca865,88,36,52,North America,21,192.88
ff89c0aab60c4cb68910a7ba4db91e08,365,319,46,Oceania,19,1428.24
ff89f62a03ae40e0b00483cb8115cc46,65,44,21,Asia,23,309.4
ff8b42df0a2a47e88208a0e1391c4202,87,68,19,Oceania,18,274.11
ff8b7379812d47578989db710bbe41c6,363,340,23,Oceania,20,1632.35
ff8c13156cb24a598927f5bb02ca0e93,117,78,39,North America,19,901.73
ff8c86d43f6442f08ac9ed0e83c6e926,67,30,37,North America,19,350.48
ff8ef580e40d485899f37032aec3bf75,351,325,26,North America,21,2581.31
ff903ca64b2a472eb6d27a63bd123053,321,268,53,North America,20,1771.57
ff903dbb4cbb468399d1dcbc78dbd8cc,93,65,28,Oceania,16,951.17
ff9044dc261e4764901774806fee9ae9,128,91,37,North America,21,830.88
ff9272005ac049c4a8a0a078a1772344,236,202,34,North America,21,1920.84
ff9599f478f84bdfa5671c372103f6fe,296,268,28,Europe,25,2445.17
ff9ca6d7203a47f1a368fc40ad72fd18,285,258,27,Asia,21,2531.37
ff9cedc5440b4ce787db975cdb0c0dfb,298,266,32,Asia,23,2089.24
ffa20c2a23cf49ad845ff21e4ca89ee2,244,217,27,Oceania,21,1726.99
ffa24537d28047f781efcfe0f807c77b,159,130,29,South America,14,953.67
ffa270ee959349c3b396e889d3e78a79,291,252,39,Oceania,22,1674.89
ffa419224bb74859a77d97cf2279eff8,353,332,21,Africa,19,2282.39
ffa693874aab47bdb1bbac6b7a4fdc90,294,249,45,North America,18,1504.21
ffa7b7a1f63245f196983b50c33bd260,175,143,32,South America,24,1208
ffa839b6c07e4179a3572fc976e762de,129,96,33,Asia,20,1104.27
ffa932c88fc64add881b598e769d625f,81,34,47,Oceania,22,93.29
ffa9af75a343465f873f8c0c1c553206,293,265,28,North America,20,2657.99
ffa9ecd4078c4562ac674310e913620e,105,58,47,Asia,23,488.37
ffaa0cbc18c74003a2077ebca5720aaa,206,176,30,South America,24,2068.31
ffac65ea2a9640f99b46038e98669db3,78,26,52,North America,14,499.64
ffb384ab33be430294b749ffbd5cd330,299,265,34,Africa,18,1975.22
ffb5193904e3468bb097a9812278d81b,70,22,48,North America,19,389.93
ffb5be2de02442669322e4153b697d0e,262,224,38,North America,25,2173.59
ffb5c74f56924c4aaaf98a59743caa86,301,277,24,Africa,20,3055.7
ffb71d446ce54730bbf0365bceaf5408,106,51,55,Africa,20,308.86
ffb76985c01f42c5979d0a0d206e18f3,283,238,45,Oceania,14,1975.74
ffb86ae4203e4a40b9a8d025e771cb8b,291,237,54,Oceania,24,1918.66
ffbacf007d7842c2bc20aa821a8db8af,95,64,31,Europe,25,841.24
ffbc427098744b3e9a396ecb0d85a3b8,137,102,35,Africa,19,955.54
ffc3eefbcbb44afea643b17a4b805a43,94,60,34,Africa,19,474.82
ffc83cbfb643498586b03e440f3a8f63,232,188,44,Europe,21,1105.79
ffc86d2131af43259fd93b46af5ce877,306,250,56,Africa,23,1593.04
ffc896c890184284a3fe2616e75f8be7,283,257,26,Europe,19,2280.64
ffcc26f877e34cbdabdb83d8e079b8ca,292,255,37,North America,17,1779.01
ffcd2698810f4d10b76a6d768cfe41d1,73,31,42,South America,19,668.81
ffcdeb4c34074aff9aeafaff7df6c838,88,46,42,Oceania,19,649.27
ffd0789d135f47ea868b127f242457ca,121,88,33,Oceania,18,1128.83
ffd0da501ef3498f85d7928765e71a02,209,161,48,Africa,21,1421.48
ffd0de88c12d45418a6bec377ea39a8a,94,46,48,South America,22,580.12
ffd1a8b7b6a64777ace67985dcd6edc2,55,11,44,North America,19,225.83
ffd47b75bd044c928b58a309a8c02ef3,128,105,23,Europe,21,1220.26
ffd549f89f1d4fe08f581528a27c36bf,66,21,45,Asia,22,436.73
ffd663638c114e3993ed3b331fa28d1c,352,328,24,Asia,18,2786.46
ffd672026e124db4bcf329b83e24c68a,334,295,39,Oceania,18,2373.47
ffd932dd9f6243a5a66a51e5e2311a46,363,323,40,Africa,19,2135.75
ffd945480a32437bbf9ecd0e2e2b59ba,335,309,26,North America,21,2195.08
ffd945a33f1f45509c6de70864de6516,348,310,38,Europe,18,2219.28
ffd9f0c44d6541668da83529f1a78a4f,360,335,25,North America,19,2352.84
ffdb35d6357a497782d259bafdd38e68,283,242,41,South America,13,1501.17
ffdcbdd85a1d4931ba3249211ef34122,40,10,30,Oceania,16,149.39
ffdd0532099f4d67a5dee384f4be89c6,68,15,53,North America,20,489.03
ffde97179fcc4d52aff863bce514bb8b,294,256,38,Africa,23,2291.55
ffdf447c3a604087b3dea1798e915c35,145,99,46,Africa,19,763.99
ffdf7fdf053f4b92a069fd37fb3636fe,195,148,47,Asia,29,922.09
ffe2b0ba48df45ad969df0358ad7b19f,255,224,31,Asia,18,1788.34
ffe4be9b427d402ebf1d0bc1be3698ce,361,339,22,North America,19,3600.8
ffeb60a01cb4472182b873bc709eb0de,130,86,44,Oceania,21,597.87
ffeb9bb8b6a9405e8622f26a0985767d,241,201,40,South America,17,1925.14
ffebd71ef684422a82cb596547e2d071,178,140,38,Oceania,19,2022.95
ffebfe6788ee4bc98cadaceb418a094e,106,71,35,South America,16,610.03
ffec4a0194d542e18617ae150aac9a86,283,232,51,Africa,19,1328.07
ffed5bb0f67845068f3eb524afdc51b1,299,272,27,Oceania,26,2279.78
ffee3e08f3dd40f78f5c84e2b60f7402,140,107,33,Asia,22,1163.42
ffeead043b2b447da4b754eda880d152,218,171,47,South America,17,1100.79
ffef17d73f1045268eaa8c8ff0efde99,115,67,48,North America,20,651.77
fff0f273a2f74d8ea87b744a4f2e5608,76,44,32,Asia,23,477.05
fff13b3f96064adc8c4edbc8f9e64ca3,162,134,28,Oceania,17,1135.38
fff2f57f871348da9ee247a649af3157,337,288,49,North America,18,2228.28
fff329727129409085cccb09628de8eb,342,318,24,North America,18,2541.79
fff3379a8baf4e3abcf3b1a9e0c6fed4,136,111,25,Asia,19,917.13
fff3dc16dd5b4b718870e4f1cd2b5554,328,311,17,Asia,19,2639.99
fff3e2774af74b40a007d2f0574a98a8,356,324,32,South America,20,2889.91
fff4518b9fe64df0ab955e6a1e8a1af8,152,115,37,Oceania,19,939.81
fff7fd3509604a36b162fa6be8e7e39c,108,76,32,Africa,13,624.63
fff865b068b345c28502620a02dad40f,233,199,34,Asia,19,2035.15
fff9a09ac2944bacbee465a3d7a5ac22,77,55,22,Asia,17,828.39
fffbdf043faa4afc9171826912c19742,74,55,19,North America,20,574.94
fffc65f7b54548d4ab4c5d4ae1caa3c6,245,220,25,North America,20,1662.56
fffc7d7921754b43bf4dc764aba7523a,278,241,37,Africa,19,2062.6
fffd6ebe74c34f948a3a0b20dca22c19,90,64,26,Europe,22,451.56
fffdef738d0c41059c6711e3fece581a,188,141,47,Oceania,21,1156.52
fffdf97373454d64a978ea75d5d55035,365,338,27,Africa,27,1855.33
fffe3064a2f94aecb85dc1c41e1e8be4,292,268,24,Asia,20,2252.42